"id","whiteh","whitel","blackh","blackl","otherh","otherl","hisph","hispl","pop"
"01001020100",1617,103,113,37,60,18,17,0,1965
"01001020200",532,256,843,245,103,4,14,0,1997
"01001020300",1958,254,458,93,175,30,0,0,2968
"01001020400",3600,92,204,0,527,0,464,0,4887
"01001020500",6981,329,1831,803,548,71,80,0,10643
"01001020600",2873,418,355,104,68,33,303,200,4354
"01001020700",1803,338,108,456,53,3,104,0,2865
"01001020801",2460,258,283,58,30,98,18,22,3227
"01001020802",8789,1104,538,392,56,24,150,0,11053
"01001020900",4484,344,647,41,134,0,23,0,5673
"01001021000",2327,89,494,318,24,9,25,0,3286
"01001021100",1321,145,1303,490,36,0,17,0,3312
"01003010100",2536,476,499,169,113,0,10,0,3803
"01003010200",1817,664,176,123,50,39,38,0,2907
"01003010300",5638,338,751,88,117,29,31,0,6992
"01003010400",3595,534,151,47,91,95,16,206,4735
"01003010500",3491,630,166,324,136,0,58,0,4805
"01003010600",1137,136,1492,612,0,0,119,0,3496
"01003010701",6843,383,218,0,359,0,360,0,8163
"01003010703",14163,359,649,66,647,191,932,0,17007
"01003010704",4524,82,654,0,71,80,312,10,5733
"01003010705",6333,999,1375,232,418,0,211,22,9590
"01003010800",4473,599,1557,798,21,0,0,0,7448
"01003010903",4012,365,322,301,57,51,262,71,5441
"01003010904",5616,681,84,14,336,187,308,168,7394
"01003010905",5904,820,450,151,320,159,537,127,8468
"01003010906",4266,450,106,7,83,0,304,13,5229
"01003011000",2490,1142,217,6,252,79,170,14,4370
"01003011101",8349,472,0,185,214,0,399,0,9619
"01003011102",3477,432,38,0,207,27,50,0,4231
"01003011201",3520,605,141,259,154,19,88,43,4829
"01003011202",4270,231,814,344,215,127,175,4,6180
"01003011300",3938,514,56,159,46,0,79,203,4995
"01003011401",8261,1199,999,0,152,0,583,0,11194
"01003011403",8408,611,223,0,120,99,577,95,10133
"01003011405",3445,211,18,6,15,14,310,14,4033
"01003011406",2613,519,0,0,91,377,89,0,3689
"01003011407",3492,1018,0,0,379,48,69,0,5006
"01003011408",663,41,0,0,0,0,0,0,704
"01003011501",4684,499,9,267,184,0,113,28,5784
"01003011502",7364,1008,559,1674,592,318,734,39,12288
"01003011601",4702,1485,38,23,96,12,577,15,6948
"01003011602",4767,463,309,0,159,26,139,11,5874
"01003990000",0,0,0,0,0,0,0,0,0
"01005950100",1563,138,1092,565,21,134,0,134,3647
"01005950200",702,75,1205,756,30,2,21,4,2795
"01005950300",600,186,473,359,39,14,19,14,1704
"01005950400",1536,154,428,239,73,0,67,52,2549
"01005950500",1914,356,293,746,514,84,254,23,4184
"01005950600",877,135,398,293,48,208,43,198,2200
"01005950700",634,16,550,548,0,0,5,0,1753
"01005950800",1096,95,687,191,12,0,145,7,2233
"01005950900",1356,45,1278,991,184,91,145,19,4109
"01007010001",2313,244,147,0,149,0,124,0,2977
"01007010002",4714,1457,156,88,56,4,149,175,6799
"01007010003",3420,384,600,378,66,0,0,0,4848
"01007010004",3858,293,1716,626,84,14,0,0,6591
"01009050101",5570,1307,273,44,176,67,682,584,8703
"01009050102",5203,1384,203,5,433,8,1102,493,8831
"01009050200",2830,477,3,4,98,0,450,43,3905
"01009050300",3582,1213,11,0,175,253,311,307,5852
"01009050400",3651,1043,0,0,44,26,166,110,5040
"01009050500",5370,1254,58,48,146,110,153,412,7551
"01009050601",3510,506,34,8,38,0,0,12,4108
"01009050602",8331,648,32,0,155,20,107,3,9296
"01009050700",7471,1100,36,0,141,27,37,0,8812
"01011952100",112,11,1290,567,9,0,0,0,1989
"01011952200",1059,209,2917,948,0,13,352,114,5612
"01011952500",1215,47,818,691,192,0,0,0,2963
"01013952700",1037,246,650,147,14,41,0,0,2135
"01013952800",902,115,372,62,22,0,0,0,1473
"01013952900",888,142,646,597,24,0,127,37,2461
"01013953000",840,44,231,316,77,0,0,0,1508
"01013953100",564,52,1160,1154,39,4,0,0,2973
"01013953200",2116,244,930,425,59,19,36,19,3848
"01013953300",1310,334,165,0,30,0,0,0,1839
"01013953400",803,250,1173,500,6,4,0,0,2736
"01013953500",603,346,312,37,16,15,0,21,1350
"01015000200",927,346,1045,889,130,21,13,0,3371
"01015000300",208,292,1057,887,0,0,86,15,2545
"01015000400",321,377,1275,443,0,53,20,14,2503
"01015000500",54,31,576,786,66,4,66,34,1617
"01015000600",107,116,498,756,0,119,10,0,1606
"01015000700",1107,266,513,409,308,124,43,19,2789
"01015000800",408,102,353,173,47,21,2,0,1106
"01015000900",2193,125,476,660,207,0,28,0,3689
"01015001000",3914,282,1302,259,201,84,262,39,6343
"01015001100",4944,477,778,274,200,19,641,0,7333
"01015001201",1710,209,497,490,132,81,260,57,3436
"01015001202",2719,314,454,69,295,5,175,0,4031
"01015001300",1633,500,24,0,72,0,46,0,2275
"01015001400",2004,410,782,158,0,0,33,0,3387
"01015001500",3917,471,88,184,276,139,216,150,5441
"01015001600",2021,839,345,246,132,0,127,12,3722
"01015001700",3951,184,1625,269,761,11,327,0,7128
"01015001800",4298,1102,674,0,350,47,102,159,6732
"01015002000",5653,1125,21,104,69,71,31,253,7327
"01015002101",742,739,353,542,17,0,0,10,2403
"01015002102",2563,318,108,120,102,104,5,104,3424
"01015002103",4262,1184,630,634,339,27,274,67,7417
"01015002200",2472,602,64,93,57,4,31,0,3323
"01015002300",2167,858,321,133,46,80,120,0,3725
"01015002400",3764,560,28,0,0,7,0,0,4359
"01015002501",6287,656,90,231,0,21,0,65,7350
"01015002502",3692,475,0,28,174,3,21,0,4393
"01015002600",4140,475,132,8,5,0,26,0,4786
"01015981901",4,0,0,0,0,0,0,0,4
"01015981902",0,0,0,0,0,0,0,0,0
"01015981903",0,0,0,0,0,0,0,0,0
"01017953800",2080,724,729,268,34,0,0,0,3835
"01017953900",1280,151,1042,565,9,47,0,0,3094
"01017954000",2339,109,2720,996,69,0,34,0,6267
"01017954200",2211,489,486,63,0,64,9,11,3333
"01017954300",2360,509,1124,504,268,0,21,0,4786
"01017954400",74,44,549,224,15,0,10,0,916
"01017954500",1525,135,1247,951,13,49,0,55,3975
"01017954600",1927,250,656,218,0,9,0,0,3060
"01017954700",2642,520,905,384,110,0,12,0,4573
"01019955701",2536,719,238,41,39,13,27,19,3632
"01019955702",2868,1248,14,32,23,43,93,16,4337
"01019955800",4304,716,153,31,30,14,5,116,5369
"01019955900",3260,738,81,124,44,38,53,0,4338
"01019956000",3026,520,250,100,82,86,15,7,4086
"01019956100",3483,408,125,0,101,47,40,0,4204
"01021060101",2925,256,872,333,44,26,46,7,4509
"01021060102",4368,906,313,344,32,223,356,183,6725
"01021060200",2271,495,59,0,0,0,0,0,2825
"01021060300",2939,724,21,0,110,6,258,62,4120
"01021060401",4269,716,500,89,321,68,372,113,6448
"01021060402",5570,1390,303,266,644,599,702,816,10290
"01021060500",1873,308,508,168,12,12,25,0,2906
"01021060600",2417,591,188,18,116,27,131,101,3589
"01021060700",3887,533,243,190,189,0,178,0,5220
"01023956700",670,50,1575,703,2,15,0,0,3015
"01023956800",2095,449,993,579,39,0,0,48,4203
"01023956900",2662,309,581,134,42,3,0,0,3731
"01023957000",787,338,659,513,4,0,0,0,2301
"01025957500",838,200,195,71,15,0,10,0,1329
"01025957601",613,74,211,156,0,0,17,0,1071
"01025957602",2384,312,1791,410,117,0,0,0,5014
"01025957700",537,280,516,274,0,0,0,0,1607
"01025957800",1798,560,1610,750,36,34,0,16,4804
"01025957901",2138,385,926,529,33,23,0,0,4034
"01025957902",1805,236,1226,790,0,24,0,24,4105
"01025958001",418,270,237,95,2,0,0,0,1022
"01025958002",369,13,761,621,0,0,0,0,1764
"01027958900",3595,310,761,159,148,44,213,0,5230
"01027959000",2076,414,308,260,136,48,197,13,3452
"01027959100",2020,446,92,26,0,115,0,0,2699
"01027959200",1665,295,217,84,0,0,0,0,2261
"01029959500",2159,403,0,6,12,17,13,14,2624
"01029959600",2627,524,201,83,34,142,45,61,3717
"01029959700",2618,671,77,9,85,68,19,162,3709
"01029959800",4327,577,25,8,104,0,31,0,5072
"01031010100",1453,434,70,8,171,54,10,18,2218
"01031010200",1384,279,116,23,47,53,8,0,1910
"01031010300",3929,421,166,134,226,32,123,4,5035
"01031010400",1353,177,185,94,122,27,52,0,2010
"01031010500",2141,449,815,514,40,144,11,103,4217
"01031010600",1158,295,5,6,82,19,0,2,1567
"01031010700",1846,153,61,3,92,81,136,8,2380
"01031010800",2272,223,60,30,110,28,77,0,2800
"01031010900",1203,393,437,310,10,24,16,58,2451
"01031011000",2603,269,472,154,72,15,195,82,3862
"01031011100",1394,176,203,152,52,27,91,45,2140
"01031011201",6073,550,660,43,771,67,487,104,8755
"01031011202",5190,483,1792,542,423,49,914,251,9644
"01031011300",1456,848,847,756,89,42,341,127,4506
"01033020100",2001,515,320,352,156,116,122,0,3582
"01033020200",1433,355,315,131,29,13,59,6,2341
"01033020300",695,193,382,468,53,51,4,0,1846
"01033020400",1246,58,0,0,88,8,4,0,1404
"01033020500",4006,415,201,188,106,63,0,0,4979
"01033020600",2003,512,918,144,355,98,91,0,4121
"01033020701",4097,510,733,357,137,28,0,0,5862
"01033020703",3461,382,1393,17,62,12,32,0,5359
"01033020704",3616,471,391,64,42,17,13,64,4678
"01033020801",3074,445,638,159,61,434,53,434,5298
"01033020802",2340,579,344,143,97,29,117,0,3649
"01033020901",3116,655,64,23,106,23,12,8,4007
"01033020902",2883,536,193,32,263,8,151,0,4066
"01033021000",2667,749,320,51,184,2,144,3,4120
"01035960200",656,157,605,157,127,0,39,0,1741
"01035960300",1077,272,101,96,27,12,11,0,1596
"01035960400",1251,421,1364,617,30,23,9,56,3771
"01035960500",747,242,317,207,80,81,82,13,1769
"01035960600",1575,289,489,1746,23,0,0,0,4122
"01037961000",1243,199,1520,658,169,0,58,32,3879
"01037961100",2937,632,118,27,7,0,0,0,3721
"01037961200",2101,198,542,359,40,0,119,28,3387
"01039961600",3463,483,71,7,19,0,0,0,4043
"01039961700",3186,726,303,57,80,22,97,8,4479
"01039961800",1672,300,431,461,48,20,68,7,3007
"01039961900",1770,238,157,62,0,0,44,0,2271
"01039962000",2303,628,660,225,91,8,98,0,4013
"01039962100",729,219,429,328,33,11,11,0,1760
"01039962300",2700,303,0,4,58,7,6,0,3078
"01039962400",2718,509,0,0,59,0,0,0,3286
"01039962500",972,273,53,0,95,0,0,0,1393
"01039962600",682,521,24,271,0,0,0,0,1498
"01039962700",830,112,359,381,10,0,24,0,1716
"01039962800",1483,256,0,0,68,6,7,4,1824
"01039962900",1353,263,0,20,125,0,21,18,1800
"01039963000",2155,577,313,142,152,75,138,7,3559
"01041963400",1100,74,608,178,70,0,0,0,2030
"01041963500",1388,193,84,136,151,0,99,6,2057
"01041963600",2082,353,438,75,85,3,43,3,3082
"01041963700",1959,439,590,251,262,18,79,0,3598
"01041963800",888,66,470,125,65,26,6,1,1647
"01041963900",1020,234,165,117,6,0,0,0,1542
"01043964100",4595,695,33,8,131,19,65,0,5546
"01043964200",5970,1055,0,0,189,98,114,127,7553
"01043964300",4000,787,20,7,99,168,242,365,5688
"01043964400",3324,835,0,0,72,0,8,11,4250
"01043964500",3545,480,0,25,72,135,0,62,4319
"01043964600",3427,455,0,0,166,0,251,45,4344
"01043964700",4159,593,0,63,35,51,197,173,5271
"01043964800",3136,1216,4,15,127,106,36,275,4915
"01043964900",4814,1023,7,70,104,2,211,28,6259
"01043965000",4476,1132,0,0,36,141,195,239,6219
"01043965100",2865,715,0,0,128,20,62,194,3984
"01043965200",1992,215,0,13,58,6,0,0,2284
"01043965300",3668,970,5,2,60,21,189,60,4975
"01043965401",1885,471,95,12,80,98,14,0,2655
"01043965402",2887,880,22,15,65,8,49,96,4022
"01043965500",4158,975,305,74,143,9,23,68,5755
"01043965600",2015,390,0,0,0,0,0,18,2423
"01043965700",2077,717,0,0,22,24,26,0,2866
"01045020000",3297,196,234,133,246,0,636,69,4811
"01045020100",2606,525,261,74,29,48,13,17,3573
"01045020200",2049,220,39,0,27,22,95,0,2452
"01045020300",1899,201,228,137,5,0,0,0,2470
"01045020400",1592,192,230,12,57,47,25,11,2166
"01045020500",1278,156,221,355,50,4,116,7,2187
"01045020700",885,403,946,761,72,35,0,4,3106
"01045020801",2015,226,820,205,239,62,42,117,3726
"01045020802",2268,490,655,412,121,117,55,172,4290
"01045021101",3487,480,370,213,261,265,459,150,5685
"01045021102",2072,758,809,301,250,85,52,239,4566
"01045021200",1567,219,249,29,272,78,171,80,2665
"01045021300",2980,478,445,63,190,22,91,10,4279
"01045021400",3070,675,718,603,209,4,234,41,5554
"01047956100",2893,500,2325,838,105,122,0,0,6783
"01047956201",1223,422,387,462,11,0,14,0,2519
"01047956202",1230,158,423,126,18,0,0,0,1955
"01047956300",266,91,1979,1395,88,0,0,0,3819
"01047956400",31,40,1364,1911,0,86,0,0,3432
"01047956500",112,68,1483,1799,7,7,0,0,3476
"01047956600",338,44,1602,1040,22,103,0,0,3149
"01047956701",1142,105,497,183,33,0,0,0,1960
"01047956702",604,145,330,339,78,0,54,0,1550
"01047956800",770,31,744,687,98,0,0,0,2330
"01047956900",383,0,985,1068,0,30,0,20,2486
"01047957000",311,22,495,347,0,0,0,0,1175
"01047957100",457,16,720,252,15,8,0,0,1468
"01047957200",52,4,898,692,20,0,0,0,1666
"01047957300",356,79,2147,1353,26,7,16,7,3991
"01049960100",4794,1058,0,0,393,45,0,0,6290
"01049960200",2620,537,0,0,143,49,22,78,3449
"01049960300",5351,1123,37,29,174,196,256,187,7353
"01049960400",5463,416,212,0,171,0,0,0,6262
"01049960500",4238,588,18,3,418,11,41,18,5335
"01049960600",5093,669,0,0,320,299,656,279,7316
"01049960700",5091,1138,0,0,1222,1366,1709,1259,11785
"01049960800",2711,841,151,184,567,265,742,353,5814
"01049960900",2169,845,186,40,80,35,223,311,3889
"01049961000",3033,449,12,9,59,202,561,204,4529
"01049961100",2239,355,137,10,399,42,393,47,3622
"01049961200",1813,122,6,0,210,35,282,0,2468
"01049961300",3358,818,116,62,967,350,1298,748,7717
"01049961400",2993,769,5,2,169,171,89,183,4381
"01051030100",4885,1036,218,62,94,0,17,0,6312
"01051030200",3651,421,284,219,67,19,0,0,4661
"01051030300",2286,96,94,0,0,0,9,0,2485
"01051030400",4510,415,1353,230,409,0,196,0,7113
"01051030500",3511,416,280,72,84,17,66,0,4446
"01051030600",3684,949,1061,105,57,0,102,57,6015
"01051030701",5381,445,979,24,296,17,56,0,7198
"01051030702",3318,303,381,87,153,0,122,0,4364
"01051030800",4106,261,1675,369,151,34,114,0,6710
"01051030901",4669,173,1002,28,104,2,204,0,6182
"01051030902",2243,304,773,214,108,88,153,150,4033
"01051031000",4019,874,889,1465,213,52,65,462,8039
"01051031100",3298,181,699,153,122,3,19,0,4475
"01051031200",658,29,491,401,159,20,151,20,1929
"01051031300",2280,470,549,280,171,0,113,60,3923
"01053969800",2739,826,1033,785,102,10,60,46,5601
"01053969900",3100,501,483,122,41,117,59,0,4423
"01053970100",2615,572,861,93,64,13,19,0,4237
"01053970200",299,52,652,810,13,0,0,0,1826
"01053970300",2204,576,451,265,88,0,9,20,3613
"01053970400",1355,419,220,34,701,197,110,42,3078
"01053970500",3180,582,622,794,195,0,42,0,5415
"01053970600",646,94,1923,1118,11,15,10,0,3817
"01053970700",2220,431,826,92,257,91,18,0,3935
"01055000200",1031,460,972,445,62,58,0,0,3028
"01055000300",303,289,1133,1116,18,0,0,0,2859
"01055000400",3597,306,79,15,180,0,86,0,4263
"01055000500",1241,363,69,0,85,0,243,16,2017
"01055000600",1043,478,161,97,50,0,32,134,1995
"01055000700",445,147,186,402,0,4,0,0,1184
"01055000800",336,154,319,292,0,0,80,36,1217
"01055000900",1466,932,187,168,43,156,65,83,3100
"01055001000",290,225,478,275,162,92,147,80,1749
"01055001100",3803,278,177,13,258,0,51,6,4586
"01055001200",1556,494,358,175,170,19,92,95,2959
"01055001300",1004,652,614,267,12,15,47,265,2876
"01055001600",816,189,1853,609,96,0,159,0,3722
"01055001700",536,139,609,179,172,6,129,0,1770
"01055010100",1116,457,265,193,80,47,24,42,2224
"01055010200",3713,562,428,18,110,83,319,0,5233
"01055010300",2347,136,112,39,26,0,0,0,2660
"01055010401",2253,625,380,172,47,9,55,71,3612
"01055010402",4243,899,238,23,72,0,76,2,5553
"01055010501",7614,331,53,39,144,0,148,0,8329
"01055010502",4266,482,242,19,69,73,17,0,5168
"01055010601",5063,455,0,0,74,0,32,0,5624
"01055010602",3035,463,0,0,153,11,64,0,3726
"01055010700",2987,496,321,0,55,0,41,5,3905
"01055010800",2031,474,0,52,50,66,38,36,2747
"01055010900",1284,183,40,30,11,0,10,0,1558
"01055011001",3663,795,22,0,108,15,60,32,4695
"01055011002",4761,655,121,0,52,0,381,29,5999
"01055011100",3055,1315,22,0,78,18,38,64,4590
"01055011200",433,413,821,623,0,298,8,273,2869
"01057020000",1341,266,6,0,0,3,0,0,1616
"01057020100",2812,234,126,36,16,0,0,0,3224
"01057020200",3133,270,364,152,80,19,34,0,4052
"01057020300",2168,401,585,664,87,85,63,25,4078
"01057020400",2842,833,55,40,2,52,0,0,3824
"01059972900",2254,546,297,0,212,32,360,115,3816
"01059973000",2602,1896,641,96,536,122,1276,1184,8353
"01059973100",2331,332,0,0,14,22,41,0,2740
"01059973200",2403,823,162,142,453,230,830,408,5451
"01059973300",1933,185,89,0,185,10,560,10,2972
"01059973400",1948,780,0,47,0,0,22,0,2797
"01059973500",1934,280,9,0,72,0,35,0,2330
"01059973600",1345,298,9,5,70,19,42,0,1788
"01059973700",4604,1114,0,0,109,41,40,33,5941
"01061050100",3258,923,219,195,127,80,168,27,4997
"01061050200",1804,268,91,121,58,0,28,0,2370
"01061050300",3228,1251,322,170,392,74,51,0,5488
"01061050400",3810,1001,225,367,176,100,91,262,6032
"01061050500",3028,691,491,34,16,95,121,55,4531
"01061050600",3005,681,22,36,48,62,120,50,4024
"01063060000",118,14,771,487,0,0,0,4,1394
"01063060100",731,123,1764,1072,128,0,57,0,3875
"01063060200",365,183,1283,1600,7,0,0,0,3438
"01065040000",1753,331,859,254,130,0,95,0,3422
"01065040100",716,122,462,203,9,0,0,0,1512
"01065040200",823,56,620,179,37,6,37,0,1758
"01065040300",268,44,1218,648,0,0,0,0,2178
"01065040400",1100,192,1679,1547,18,0,0,0,4536
"01065040500",506,58,727,334,36,37,36,2,1736
"01067030100",1045,68,632,104,33,0,9,0,1891
"01067030200",1028,240,932,570,23,0,27,0,2820
"01067030300",1775,357,334,126,42,0,22,0,2656
"01067030400",1150,282,298,141,2,21,124,24,2042
"01067030500",4433,255,1209,272,49,0,80,0,6298
"01067030600",1169,163,180,23,16,35,112,31,1729
"01069040100",4228,436,254,34,98,74,289,116,5529
"01069040201",7695,339,890,113,436,59,110,18,9660
"01069040202",7129,375,628,120,374,50,218,15,8909
"01069040301",2033,167,992,505,102,34,99,8,3940
"01069040302",1317,311,1094,533,222,53,205,34,3769
"01069040400",1908,111,201,273,52,3,37,0,2585
"01069040500",2608,259,342,158,45,15,53,70,3550
"01069040600",145,167,787,889,12,73,36,46,2155
"01069040700",1344,299,687,403,69,35,37,61,2935
"01069040800",5405,1052,675,384,273,137,225,306,8457
"01069040900",3173,387,930,193,189,27,152,36,5087
"01069041000",1265,327,2121,1391,183,71,81,49,5488
"01069041100",2025,410,783,237,140,90,69,56,3810
"01069041200",566,291,732,774,50,46,28,56,2543
"01069041400",524,48,1346,980,25,10,26,3,2962
"01069041500",843,99,2030,1156,23,37,35,0,4223
"01069041600",2895,517,1253,319,144,77,142,36,5383
"01069041700",972,150,86,89,1,24,32,0,1354
"01069041800",1265,166,433,160,31,8,19,0,2082
"01069041900",5649,831,617,345,304,54,132,31,7963
"01069042000",4336,892,407,158,84,35,37,4,5953
"01069042100",5771,828,435,58,82,0,73,230,7477
"01071950100",4446,885,0,0,272,25,0,0,5628
"01071950200",2255,549,174,159,103,120,0,10,3370
"01071950300",4182,887,297,141,178,124,124,140,6073
"01071950400",1381,335,0,0,128,95,21,54,2014
"01071950500",2956,649,5,21,137,39,49,9,3865
"01071950600",4358,792,135,120,278,85,79,4,5851
"01071950700",3613,631,58,23,93,0,51,0,4469
"01071950800",2922,497,46,151,222,228,54,271,4391
"01071950900",5256,371,176,0,170,0,248,0,6221
"01071951000",3544,795,2,0,120,11,13,5,4490
"01071951100",4946,1385,10,42,440,255,54,263,7395
"01073000100",320,243,1548,952,10,185,26,193,3477
"01073000300",110,307,1045,522,398,0,190,267,2839
"01073000400",203,119,1688,1291,9,0,9,0,3319
"01073000500",30,131,1669,1451,53,21,49,0,3404
"01073000700",0,0,888,1714,0,49,0,56,2707
"01073000800",14,49,2660,915,78,20,60,58,3854
"01073001100",0,0,3784,767,14,0,0,0,4565
"01073001200",178,74,1849,643,119,0,217,116,3196
"01073001400",61,0,1285,527,27,81,24,81,2086
"01073001500",54,79,1475,976,8,35,40,0,2667
"01073001600",300,65,1063,1175,65,62,148,53,2931
"01073001902",39,102,977,563,115,36,126,90,2048
"01073002000",328,435,1767,1152,40,0,47,0,3769
"01073002100",361,76,1364,840,0,0,0,0,2641
"01073002200",146,39,1670,697,0,18,5,37,2612
"01073002303",56,18,1566,2197,5,101,0,0,3943
"01073002305",2120,199,561,284,21,10,87,0,3282
"01073002306",2561,187,784,138,163,0,101,0,3934
"01073002400",900,209,807,1686,89,7,203,42,3943
"01073002700",1109,271,661,705,90,10,0,0,2846
"01073002900",0,0,1287,860,0,0,0,0,2147
"01073003001",196,78,1390,276,0,0,68,0,2008
"01073003002",6,29,1102,1233,10,0,0,19,2399
"01073003100",152,24,2019,1393,0,20,46,20,3674
"01073003200",0,134,503,558,5,0,0,0,1200
"01073003300",0,0,626,321,0,0,0,0,947
"01073003400",85,123,1237,1031,6,0,14,10,2506
"01073003500",217,79,1570,985,0,9,0,0,2860
"01073003600",118,9,3223,743,0,0,0,0,4093
"01073003700",236,46,2851,1182,411,11,193,0,4930
"01073003802",211,48,3769,1160,0,34,13,0,5235
"01073003803",112,3,2216,1318,0,0,0,0,3649
"01073003900",23,33,656,754,19,9,37,42,1573
"01073004000",44,8,1995,1246,14,0,15,0,3322
"01073004200",3,9,1301,622,0,9,2,9,1955
"01073004500",342,168,350,1500,86,81,0,6,2533
"01073004701",2906,611,66,52,230,48,361,75,4349
"01073004702",2796,300,109,181,16,49,16,43,3510
"01073004800",1555,202,114,13,78,0,77,0,2039
"01073004901",714,177,127,15,69,66,30,15,1213
"01073004902",1536,742,299,134,220,140,170,49,3290
"01073005000",1698,589,593,134,351,62,504,202,4133
"01073005101",59,36,731,1245,15,18,74,32,2210
"01073005103",75,244,1840,426,38,177,0,234,3034
"01073005104",778,373,1611,1055,313,125,527,158,4940
"01073005200",0,0,2378,1168,33,20,0,0,3599
"01073005302",1486,197,1586,193,115,0,0,0,3577
"01073005500",158,382,951,788,17,0,19,64,2379
"01073005600",3289,588,286,297,0,45,13,0,4518
"01073005701",23,0,1927,484,13,0,13,0,2460
"01073005702",19,15,2078,593,0,2,0,2,2709
"01073005800",811,369,1293,610,94,150,117,40,3484
"01073005903",938,271,2851,570,52,0,74,164,4920
"01073005905",1011,264,2890,1011,82,154,341,154,5907
"01073005907",526,7,1465,122,71,0,67,0,2258
"01073005908",833,240,1904,704,27,0,93,170,3971
"01073005909",229,9,2042,337,48,0,0,0,2665
"01073005910",300,136,4105,840,17,68,23,38,5527
"01073010001",2531,424,1112,153,65,197,0,144,4626
"01073010002",3271,444,1211,45,158,101,94,138,5462
"01073010100",14,27,874,716,0,0,8,0,1639
"01073010200",455,385,1077,386,0,300,0,300,2903
"01073010301",410,135,1054,740,27,10,13,0,2389
"01073010302",165,28,1996,1974,39,95,51,0,4348
"01073010401",692,241,1601,774,68,140,58,0,3574
"01073010402",398,191,981,292,185,6,175,0,2228
"01073010500",359,110,716,510,0,12,0,0,1707
"01073010602",80,17,3056,1711,251,65,212,0,5392
"01073010603",100,0,2024,411,16,0,0,0,2551
"01073010701",984,235,230,245,55,24,71,134,1978
"01073010702",3620,355,161,144,187,17,36,17,4537
"01073010703",1996,87,20,0,74,5,6,0,2188
"01073010704",2062,262,367,11,62,8,183,11,2966
"01073010705",3244,385,110,0,92,101,32,101,4065
"01073010706",2660,827,1549,252,274,70,32,0,5664
"01073010801",4979,221,155,0,205,0,146,0,5706
"01073010802",3390,80,0,18,8,6,65,6,3573
"01073010803",3130,218,2515,474,113,0,114,0,6564
"01073010804",2745,90,1,8,50,10,37,0,2941
"01073010805",6419,421,154,36,260,97,67,0,7454
"01073010900",1321,335,1511,1264,415,181,107,166,5300
"01073011001",4257,406,617,49,131,22,405,45,5932
"01073011002",810,204,647,404,8,15,25,6,2119
"01073011104",3183,330,3446,423,57,0,174,59,7672
"01073011107",9671,327,612,0,319,60,69,0,11058
"01073011108",3590,272,567,8,277,6,14,6,4740
"01073011109",3125,381,104,0,37,42,0,0,3689
"01073011110",4455,338,1064,0,178,0,0,0,6035
"01073011111",6164,212,869,36,591,0,94,0,7966
"01073011205",1365,105,305,25,63,0,41,0,1904
"01073011206",4370,233,650,223,41,14,0,0,5531
"01073011207",1403,56,2705,888,105,294,45,294,5790
"01073011208",2832,270,653,35,96,0,31,73,3990
"01073011209",635,101,1734,891,83,87,154,0,3685
"01073011210",1283,217,1472,855,193,0,222,0,4242
"01073011301",1779,436,255,181,321,32,364,0,3368
"01073011302",5458,585,141,13,74,2,29,0,6302
"01073011400",4783,1057,724,12,131,13,38,125,6883
"01073011500",4742,554,0,12,75,0,0,0,5383
"01073011600",3229,381,111,125,75,0,22,0,3943
"01073011703",7263,386,1296,324,220,7,61,7,9564
"01073011704",3185,179,11,25,71,0,0,0,3471
"01073011705",5947,544,445,98,58,204,321,218,7835
"01073011706",1712,172,40,165,68,0,70,0,2227
"01073011802",2561,125,2544,1619,39,65,33,0,6986
"01073011803",1198,57,2444,1286,222,10,48,12,5277
"01073011804",501,71,1662,531,61,133,40,110,3109
"01073011901",889,498,429,219,284,171,275,297,3062
"01073011904",12,23,1849,313,6,78,0,69,2350
"01073012001",1624,401,1645,552,43,0,3,0,4268
"01073012002",3021,594,1892,791,584,37,443,0,7362
"01073012103",1637,313,1410,489,100,46,0,111,4106
"01073012104",1700,276,689,223,3,379,28,379,3677
"01073012200",2234,379,0,0,25,0,17,4,2659
"01073012302",3334,157,110,9,20,0,11,0,3641
"01073012304",1574,124,797,33,15,20,0,0,2563
"01073012305",2531,327,4686,167,18,0,40,0,7769
"01073012401",252,24,3070,399,11,37,67,0,3860
"01073012402",864,277,1198,195,8,46,15,0,2603
"01073012403",1473,294,1182,305,65,0,0,0,3319
"01073012500",2051,737,946,459,44,25,8,0,4270
"01073012602",1739,328,668,353,39,16,57,16,3216
"01073012701",1925,657,519,46,270,298,499,778,4992
"01073012703",5666,240,458,85,265,55,961,122,7852
"01073012704",1682,200,182,0,76,7,70,0,2217
"01073012802",2246,90,162,19,147,44,112,38,2858
"01073012803",3768,375,87,35,155,7,67,0,4494
"01073012905",3792,103,221,7,133,6,95,0,4357
"01073012906",4907,402,511,0,309,48,36,247,6460
"01073012907",2896,361,621,15,575,0,86,0,4554
"01073012908",2082,172,1398,238,408,484,357,484,5623
"01073012910",2660,161,483,0,147,15,39,0,3505
"01073012911",5299,293,0,0,118,0,54,0,5764
"01073012912",1198,139,1982,355,501,606,360,539,5680
"01073012913",1276,203,1756,205,942,307,731,361,5781
"01073012914",1738,230,21,7,137,0,117,0,2250
"01073012915",5300,109,348,50,683,0,293,0,6783
"01073013002",3,2,868,703,0,0,0,0,1576
"01073013100",42,0,2888,1749,0,0,10,0,4689
"01073013200",150,28,1560,628,0,0,0,56,2422
"01073013300",148,101,1712,723,334,408,325,456,4207
"01073013400",356,51,3683,483,122,0,59,0,4754
"01073013601",264,26,2281,686,70,104,83,81,3595
"01073013801",119,118,915,671,96,22,91,53,2085
"01073013901",366,61,969,310,32,0,14,0,1752
"01073013902",1210,158,606,209,24,0,0,20,2227
"01073014001",3522,274,15,27,27,14,0,0,3879
"01073014002",2634,420,814,0,15,24,25,0,3932
"01073014102",3899,419,207,129,79,39,24,0,4796
"01073014104",1515,65,1106,423,183,0,123,0,3415
"01073014105",787,107,2453,532,133,150,12,0,4174
"01073014203",8316,317,3368,0,720,0,264,0,12985
"01073014204",7582,386,1405,0,754,0,363,0,10490
"01073014301",1684,177,704,270,70,9,17,9,2940
"01073014302",3291,263,1707,396,403,0,252,0,6312
"01073014404",3715,197,873,281,347,97,164,65,5739
"01073014405",2963,112,442,109,276,9,83,0,3994
"01073014406",4890,17,511,74,545,0,81,0,6118
"01073014408",1561,169,1294,78,651,16,107,43,3919
"01073014409",2613,134,239,16,172,144,47,151,3516
"01073014410",3244,124,538,19,737,48,103,0,4813
"01073014412",4332,38,8,0,593,5,398,0,5374
"01073014413",7626,64,819,0,691,21,114,27,9362
"01075030000",3217,1031,328,228,34,15,20,104,4977
"01075030100",3368,1151,285,194,115,14,11,41,5179
"01075030200",2930,571,325,162,24,16,16,0,4044
"01077010100",463,231,168,153,5,33,68,0,1121
"01077010200",835,512,203,233,7,21,23,6,1840
"01077010300",54,22,520,442,13,19,45,0,1115
"01077010400",1611,655,320,97,127,47,9,25,2891
"01077010600",1182,907,515,229,181,140,52,54,3260
"01077010700",806,541,295,347,10,96,0,19,2114
"01077010800",2319,793,544,279,82,106,51,64,4238
"01077010900",4670,900,551,424,222,38,145,68,7018
"01077011000",2323,1093,889,248,183,26,160,225,5147
"01077011101",4852,560,724,0,63,29,51,0,6279
"01077011102",3459,263,309,45,37,0,0,0,4113
"01077011200",2950,497,381,42,119,0,52,144,4185
"01077011300",1583,402,0,0,88,0,41,10,2124
"01077011400",5416,1040,52,1,106,11,164,87,6877
"01077011501",4831,376,305,0,68,0,66,13,5659
"01077011502",4332,630,22,18,145,120,0,0,5267
"01077011602",4541,602,28,4,23,0,20,0,5218
"01077011603",3876,469,161,2,39,0,254,0,4801
"01077011604",5983,659,43,38,226,12,57,47,7065
"01077011700",3573,414,51,10,157,53,36,0,4294
"01077011801",3670,656,0,36,35,3,19,0,4419
"01077011802",2782,547,145,28,97,33,82,7,3721
"01079979100",632,196,668,212,83,0,44,0,1835
"01079979200",1876,417,1609,356,24,80,41,11,4414
"01079979300",2883,773,0,0,892,33,28,27,4636
"01079979400",2616,638,294,250,273,75,51,0,4197
"01079979500",3730,989,125,0,540,268,0,181,5833
"01079979600",3976,686,0,12,646,93,152,99,5664
"01079979700",1524,260,64,18,174,0,26,0,2066
"01079979800",2679,280,14,0,281,21,0,0,3275
"01079979900",1141,453,99,17,164,98,0,31,2003
"01081040200",2819,1121,367,314,207,382,126,47,5383
"01081040300",1148,611,127,106,89,65,38,0,2184
"01081040400",3548,2043,633,522,387,167,203,32,7535
"01081040500",6513,152,562,426,713,102,408,28,8904
"01081040602",2081,474,1177,1114,372,16,98,0,5332
"01081040603",505,221,350,114,0,0,0,16,1206
"01081040604",1626,2551,472,667,114,99,172,324,6025
"01081040700",283,535,63,48,0,12,0,4,945
"01081040800",468,1953,13,262,131,270,54,0,3151
"01081040901",2348,553,415,123,131,4,82,23,3679
"01081040902",2064,1388,785,121,1471,0,676,97,6602
"01081041000",3691,551,2000,841,689,2,17,4,7795
"01081041100",3504,1471,1912,1302,902,767,471,746,11075
"01081041200",3928,196,584,172,44,0,22,0,4946
"01081041300",1916,208,619,521,91,41,32,1,3429
"01081041400",296,315,1767,1156,112,0,136,158,3940
"01081041600",862,79,1222,991,212,28,0,6,3400
"01081041700",4874,960,2030,422,262,56,47,44,8695
"01081041800",4642,1413,787,361,97,21,0,0,7321
"01081041900",5789,814,589,229,116,0,120,81,7738
"01081042002",5142,425,1093,0,286,40,187,14,7187
"01081042003",2322,643,326,28,63,0,39,0,3421
"01081042004",8139,895,2252,208,721,25,652,0,12892
"01081042005",3055,324,1116,116,99,31,81,0,4822
"01081042006",1291,110,310,23,247,7,93,0,2081
"01081042101",2328,150,686,623,37,0,7,0,3831
"01081042102",4935,784,811,457,95,219,0,48,7349
"01083020101",3509,652,181,0,18,387,27,461,5235
"01083020102",4798,792,138,11,242,90,34,0,6105
"01083020201",3888,1260,163,36,52,0,265,301,5965
"01083020202",4094,775,134,24,160,26,66,308,5587
"01083020300",3382,366,0,22,79,0,7,0,3856
"01083020401",4086,1230,211,54,169,12,167,9,5938
"01083020402",4109,527,160,207,64,149,238,304,5758
"01083020500",1387,281,412,60,240,11,169,0,2560
"01083020600",2705,720,338,188,408,181,736,261,5537
"01083020700",1175,403,369,75,84,89,137,150,2482
"01083020801",4247,546,630,82,376,205,119,87,6292
"01083020802",6786,456,362,48,336,0,132,0,8120
"01083020900",3460,128,320,140,232,149,138,137,4704
"01083021000",1256,143,1012,108,133,0,84,40,2776
"01083021100",4247,376,1270,223,134,37,469,0,6756
"01083021200",7914,431,2154,177,1037,198,242,33,12186
"01085780800",922,31,1674,807,0,0,3,0,3437
"01085781000",888,31,1239,755,19,0,26,0,2958
"01085781100",101,6,771,727,6,0,0,0,1611
"01085781200",701,23,1293,632,0,23,0,0,2672
"01087231400",456,80,495,132,25,30,106,30,1354
"01087231500",1259,334,917,411,36,9,17,0,2983
"01087231601",198,0,546,144,0,0,0,0,888
"01087231602",68,12,808,486,69,5,0,0,1448
"01087231603",57,4,926,268,13,0,14,0,1282
"01087231700",0,10,182,162,13,22,0,17,406
"01087231800",24,17,790,330,0,0,9,0,1170
"01087231900",18,4,989,396,3,7,12,0,1429
"01087232000",71,0,1083,419,28,0,10,0,1611
"01087232100",0,0,1296,283,10,0,0,0,1589
"01087232200",560,48,1201,506,7,0,6,0,2328
"01087232300",35,0,1038,514,29,3,0,0,1619
"01089000201",32,136,567,308,13,3,0,0,1059
"01089000202",405,188,694,485,126,49,63,18,2028
"01089000301",778,336,2232,542,26,22,199,212,4347
"01089000302",484,259,2016,456,143,0,244,172,3774
"01089000403",673,73,3354,464,107,71,112,15,4869
"01089000501",379,36,1404,216,54,16,116,16,2237
"01089000502",239,168,1363,430,101,6,90,9,2406
"01089000503",350,16,1184,218,27,0,110,0,1905
"01089000601",361,132,649,159,86,5,5,0,1397
"01089000602",494,71,1214,358,100,50,36,68,2391
"01089000701",203,226,1680,616,89,312,49,290,3465
"01089000702",535,375,1369,221,159,16,139,0,2814
"01089000901",3407,442,275,0,153,77,44,51,4449
"01089000902",1568,222,63,8,129,34,10,0,2034
"01089001000",1964,484,236,27,67,77,100,42,2997
"01089001200",32,101,955,1865,12,149,0,15,3129
"01089001301",540,242,1383,831,209,87,159,20,3471
"01089001302",575,37,949,330,192,19,114,0,2216
"01089001401",1316,82,140,0,203,25,180,0,1946
"01089001402",2151,443,1552,637,336,223,147,27,5516
"01089001500",1391,269,902,429,247,202,61,32,3533
"01089001700",1769,32,0,0,31,0,11,0,1843
"01089001801",3906,99,25,0,109,0,161,0,4300
"01089001901",3320,16,27,0,172,8,71,0,3614
"01089001902",1237,33,17,0,38,0,24,0,1349
"01089001903",2290,68,5,0,94,4,83,0,2544
"01089002000",1921,159,0,0,73,0,27,79,2259
"01089002100",724,646,688,965,66,189,39,350,3667
"01089002200",880,405,222,158,135,55,213,103,2171
"01089002300",2639,841,290,1166,62,162,391,695,6246
"01089002400",1989,943,551,566,412,0,541,391,5393
"01089002501",886,925,672,671,127,234,413,889,4817
"01089002502",663,439,603,512,161,183,244,226,3031
"01089002600",2975,297,266,30,155,199,87,0,4009
"01089002701",2200,131,163,7,100,15,36,6,2658
"01089002721",3430,190,287,0,143,37,119,8,4214
"01089002722",2636,8,179,0,106,64,49,0,3042
"01089002801",3151,248,274,228,248,53,97,57,4356
"01089002802",5131,657,497,0,542,43,132,0,7002
"01089002911",4020,196,218,0,180,10,416,0,5040
"01089002912",2280,70,36,0,160,0,68,0,2614
"01089002921",4973,459,134,143,568,49,89,10,6425
"01089002922",3771,109,89,0,437,0,56,0,4462
"01089003000",865,395,541,528,101,60,28,7,2525
"01089003100",1454,202,86,221,41,22,32,6,2064
"01089010100",6734,317,1198,64,626,46,120,0,9105
"01089010200",4572,268,586,0,204,0,96,0,5726
"01089010301",6219,695,305,136,292,97,11,0,7755
"01089010302",3149,348,473,143,95,0,11,0,4219
"01089010401",4224,897,263,360,390,152,219,0,6505
"01089010402",4149,304,982,209,356,0,112,64,6176
"01089010501",7396,235,2611,569,436,211,231,113,11802
"01089010502",1683,97,1121,538,75,31,60,0,3605
"01089010612",3194,160,1528,30,135,42,173,17,5279
"01089010621",4709,133,1891,0,385,15,165,0,7298
"01089010622",3291,502,2533,2048,993,193,150,0,9710
"01089010623",4447,111,1356,36,491,18,139,18,6616
"01089010624",6150,127,1361,29,268,9,223,0,8167
"01089010701",5061,720,1518,168,720,112,454,0,8753
"01089010702",4703,785,2319,175,429,143,607,120,9281
"01089010800",8427,576,855,56,434,51,301,0,10700
"01089010901",12431,279,186,0,645,0,348,0,13889
"01089010902",2085,333,152,64,91,31,29,0,2785
"01089011011",7620,103,850,7,1070,46,392,0,10088
"01089011012",4889,157,263,0,539,0,225,13,6086
"01089011013",3898,189,842,39,144,65,199,6,5382
"01089011014",5746,597,1189,430,928,89,332,79,9390
"01089011021",2469,249,1261,334,465,82,157,31,5048
"01089011022",4753,648,1232,0,563,83,192,342,7813
"01089011100",433,72,268,21,156,0,43,0,993
"01089011200",5070,229,2138,652,974,48,474,0,9585
"01089011300",4856,511,55,27,332,113,127,0,6021
"01089011400",3631,426,9,0,144,25,20,0,4255
"01091972900",948,256,1736,1465,0,107,0,135,4647
"01091973000",2129,71,1236,941,74,14,65,30,4560
"01091973100",561,214,623,389,4,6,70,0,1867
"01091973200",907,60,981,593,6,0,0,0,2547
"01091973300",1157,182,660,257,5,0,0,0,2261
"01091973400",2632,253,1019,408,132,28,131,28,4631
"01093964000",3202,1185,0,0,69,20,0,10,4486
"01093964100",1902,708,0,0,58,0,0,10,2678
"01093964200",1323,181,16,3,6,0,0,0,1529
"01093964300",3598,510,205,16,241,13,518,39,5140
"01093964400",3850,838,197,162,218,0,24,0,5289
"01093964500",1970,407,0,0,16,10,17,0,2420
"01093964600",2034,919,88,99,33,35,6,0,3214
"01093964700",4593,721,40,131,33,2,91,11,5622
"01095030100",1865,687,0,0,66,121,101,148,2988
"01095030201",4578,661,0,0,221,39,58,0,5557
"01095030202",4457,282,0,5,53,6,0,0,4803
"01095030300",5775,422,0,3,125,0,85,0,6410
"01095030401",3447,815,0,0,266,10,70,104,4712
"01095030402",3134,307,0,2,17,0,77,5,3542
"01095030500",5787,1007,10,17,118,72,78,60,7149
"01095030600",4360,1408,355,227,201,58,102,128,6839
"01095030701",2417,413,140,82,108,79,136,135,3510
"01095030702",2851,330,120,6,163,255,29,247,4001
"01095030801",3551,1141,116,2,238,357,628,480,6513
"01095030802",4460,2399,1,11,202,503,1258,1876,10710
"01095030902",3694,472,14,1,91,33,223,70,4598
"01095030903",4061,1229,120,214,223,319,1162,609,7937
"01095030904",3795,1088,4,2,222,83,493,511,6198
"01095031000",3904,1427,0,0,264,100,675,182,6552
"01095031100",3128,1368,173,21,388,28,619,721,6446
"01095031200",4793,329,0,0,333,353,500,369,6677
"01097000200",389,168,235,188,17,13,0,0,1010
"01097000401",0,6,665,643,0,0,0,0,1314
"01097000402",0,0,297,371,0,0,0,0,668
"01097000500",0,4,1198,796,12,4,12,0,2026
"01097000600",25,6,1064,1021,0,0,14,1,2131
"01097000701",0,0,1280,1059,0,4,17,0,2360
"01097000702",0,13,1638,699,0,60,0,0,2410
"01097000800",155,41,3329,1046,31,0,50,0,4652
"01097000901",1074,125,382,264,20,16,24,0,1905
"01097000902",1424,138,147,84,61,34,6,45,1939
"01097000903",528,95,692,279,5,0,17,20,1636
"01097001001",719,132,319,389,28,0,63,0,1650
"01097001002",871,74,561,373,29,15,78,0,2001
"01097001100",22,0,1235,470,9,3,13,0,1752
"01097001200",11,0,633,555,0,0,0,53,1252
"01097001302",30,65,1722,1043,9,0,0,39,2908
"01097001400",12,4,1070,793,0,0,0,0,1879
"01097001501",6,0,620,969,0,0,0,0,1595
"01097001502",0,0,436,940,10,10,0,33,1429
"01097001800",562,309,938,367,139,10,71,66,2462
"01097001901",728,424,762,341,90,9,13,0,2367
"01097001902",1057,149,1021,622,24,135,45,90,3143
"01097002000",1258,25,233,152,36,0,37,0,1741
"01097002100",632,270,2363,809,0,18,11,0,4103
"01097002200",463,129,1167,848,73,32,45,32,2789
"01097002301",113,58,1113,568,0,0,36,0,1888
"01097002302",34,29,911,1079,0,0,0,0,2053
"01097002400",410,93,1466,941,53,35,0,75,3073
"01097002501",3039,162,74,104,91,0,191,11,3672
"01097002502",1813,236,181,11,1,0,0,0,2242
"01097002600",176,55,1301,833,5,0,2,0,2372
"01097002700",160,90,1037,1024,12,43,0,0,2366
"01097002800",1802,730,1339,763,148,39,12,27,4860
"01097002900",1691,261,787,899,90,51,153,32,3964
"01097003000",1767,200,569,92,209,0,77,0,2914
"01097003100",3909,236,310,98,255,0,126,0,4934
"01097003202",1179,92,915,117,137,61,172,34,2707
"01097003203",1767,442,876,419,67,14,0,73,3658
"01097003204",1372,165,1331,710,373,166,254,0,4371
"01097003205",653,12,803,1205,265,142,56,142,3278
"01097003301",1460,346,509,141,106,0,58,0,2620
"01097003302",2992,270,337,17,35,0,262,0,3913
"01097003402",764,67,2530,779,0,10,0,0,4150
"01097003404",404,38,1154,777,0,0,55,0,2428
"01097003405",687,37,990,168,50,26,0,22,1980
"01097003406",1129,120,970,446,126,0,63,0,2854
"01097003407",3302,601,3193,136,66,115,65,242,7720
"01097003408",890,322,2199,237,10,0,40,0,3698
"01097003501",2769,517,348,191,8,94,0,0,3927
"01097003502",2392,84,25,4,2,2,21,0,2530
"01097003602",177,267,432,366,0,44,86,0,1372
"01097003605",0,0,0,0,0,0,0,0,0
"01097003606",2302,244,699,203,126,90,301,11,3976
"01097003607",1404,501,1285,578,209,23,243,0,4243
"01097003608",326,58,810,58,104,0,20,0,1376
"01097003703",1928,153,792,122,339,98,226,53,3711
"01097003704",3200,254,571,84,78,28,158,0,4373
"01097003705",2652,194,541,19,225,0,131,0,3762
"01097003706",2240,202,344,115,78,8,74,99,3160
"01097003707",2300,447,1420,267,502,275,82,0,5293
"01097003708",2922,108,964,0,355,0,239,0,4588
"01097003709",4185,474,1235,137,650,0,618,0,7299
"01097003710",2375,489,1254,40,83,0,26,0,4267
"01097003800",519,94,451,108,56,0,0,0,1228
"01097003901",1,8,1325,676,0,2,0,1,2013
"01097003902",0,0,449,346,0,5,0,0,800
"01097004000",0,0,1257,1013,0,14,0,0,2284
"01097004100",0,0,432,526,0,0,0,0,958
"01097004800",34,88,618,537,0,0,0,0,1277
"01097004900",32,91,2157,1220,0,0,0,0,3500
"01097005000",345,121,888,380,10,0,0,0,1744
"01097005100",445,266,336,540,29,44,41,74,1775
"01097005200",728,102,330,243,15,2,4,0,1424
"01097005300",1200,267,358,224,11,0,95,25,2180
"01097005400",3132,415,425,77,252,31,89,0,4421
"01097005500",1529,210,460,162,255,98,54,0,2768
"01097005600",5046,716,513,237,258,22,41,0,6833
"01097005700",5389,746,708,167,274,48,0,18,7350
"01097005800",1401,280,1089,450,743,269,0,30,4262
"01097005900",3582,82,214,221,319,11,31,0,4460
"01097006000",2722,529,945,110,333,29,78,0,4746
"01097006102",1497,469,278,77,117,11,57,0,2506
"01097006103",1311,436,2684,785,54,0,0,0,5270
"01097006104",3324,716,464,15,116,152,41,0,4828
"01097006105",4310,510,1331,50,130,0,159,0,6490
"01097006200",3860,664,243,98,44,0,0,0,4909
"01097006301",8046,1323,820,15,161,20,57,0,10442
"01097006302",4964,422,870,0,420,95,391,0,7162
"01097006402",2681,527,811,201,67,55,13,0,4355
"01097006403",1056,175,393,248,100,0,159,0,2131
"01097006404",7061,650,2578,216,804,143,297,0,11749
"01097006405",5561,287,885,311,474,162,43,0,7723
"01097006406",6279,320,1035,36,344,0,178,236,8428
"01097006407",6076,95,568,31,29,0,0,0,6799
"01097006501",3699,325,814,70,223,0,82,0,5213
"01097006502",9675,1003,372,79,449,0,437,0,12015
"01097006600",4480,480,343,68,61,61,120,0,5613
"01097006701",4162,637,470,413,272,482,233,197,6866
"01097006702",1816,516,319,96,450,73,0,42,3312
"01097006801",6378,314,1417,63,874,59,271,1,9377
"01097006802",2356,226,242,116,161,0,205,24,3330
"01097006901",5188,1164,626,741,70,227,41,0,8057
"01097006902",3080,538,194,218,453,47,351,0,4881
"01097007000",4287,214,121,0,275,10,59,9,4975
"01097007101",3289,307,402,198,293,18,242,59,4808
"01097007102",1012,223,1270,460,85,68,129,0,3247
"01097007103",2603,518,159,135,113,0,7,0,3535
"01097007201",1915,341,170,0,262,52,0,0,2740
"01097007202",2164,185,8,0,59,14,51,0,2481
"01097007300",2068,509,167,321,647,330,203,5,4250
"01097007400",1350,342,956,713,43,22,0,0,3426
"01097007500",0,4,797,719,0,4,0,0,1524
"01097007600",0,0,1106,907,8,0,0,0,2021
"01097007700",0,0,926,718,28,0,0,0,1672
"01097990000",0,0,0,0,0,0,0,0,0
"01099075600",262,68,527,448,14,0,0,0,1319
"01099075700",585,230,499,486,7,0,0,0,1807
"01099075800",294,97,694,300,0,0,0,36,1421
"01099075900",2236,497,1461,1542,178,0,77,104,6095
"01099076000",1026,120,842,1128,14,0,21,0,3151
"01099076100",4400,1127,610,603,75,12,4,0,6831
"01099076200",1009,214,131,23,214,6,0,0,1597
"01101000100",181,35,15,142,0,13,7,4,397
"01101000200",96,119,498,105,13,0,0,0,831
"01101000300",164,116,677,330,9,0,9,0,1305
"01101000400",1062,350,1003,1762,44,6,0,12,4239
"01101000500",1208,297,543,414,186,62,293,184,3187
"01101000600",11,0,402,756,8,0,0,0,1177
"01101000700",289,37,654,564,4,0,46,0,1594
"01101000900",715,20,132,2,77,0,52,0,998
"01101001000",97,38,304,644,4,24,0,0,1111
"01101001100",0,0,1669,2195,14,9,0,0,3887
"01101001200",6,0,745,770,0,14,0,0,1535
"01101001300",618,35,652,288,168,17,183,0,1961
"01101001400",2129,318,842,70,33,2,27,2,3423
"01101001500",483,47,765,829,68,104,63,0,2359
"01101001600",1073,629,875,838,112,9,24,236,3796
"01101001700",3459,260,519,815,25,0,39,12,5129
"01101001800",1921,224,445,177,45,32,4,40,2888
"01101001900",2345,474,255,70,95,0,264,0,3503
"01101002000",2814,78,887,414,169,0,63,0,4425
"01101002100",765,95,2235,1089,24,0,15,0,4223
"01101002201",86,37,2897,976,30,44,0,28,4098
"01101002202",6,0,472,668,16,0,0,0,1162
"01101002300",7,0,1819,636,10,15,0,0,2487
"01101002400",0,7,1291,381,15,0,0,0,1694
"01101002500",496,105,1013,757,203,31,91,0,2696
"01101002600",3830,388,906,126,217,82,73,0,5622
"01101002700",2994,49,880,220,111,16,116,0,4386
"01101002800",1042,38,2293,738,23,0,53,96,4283
"01101002900",127,19,4622,2411,355,104,363,104,8105
"01101003000",341,309,1294,1666,87,0,35,251,3983
"01101003100",188,29,2810,732,42,17,0,0,3818
"01101003200",387,41,3867,1413,56,0,0,109,5873
"01101003301",1955,103,1087,206,12,0,22,0,3385
"01101003302",1883,109,2374,1387,475,57,76,0,6361
"01101005101",710,16,2180,292,211,0,55,0,3464
"01101005102",370,257,2649,1539,0,5,44,5,4869
"01101005301",382,13,149,59,134,20,62,11,830
"01101005302",695,158,638,339,205,128,212,109,2484
"01101005402",1486,396,2918,918,339,41,146,96,6340
"01101005403",816,142,1981,904,172,0,14,0,4029
"01101005406",6531,142,1784,363,796,210,118,45,9989
"01101005407",2322,193,1208,47,321,0,16,0,4107
"01101005408",3893,514,2929,173,551,42,92,0,8194
"01101005409",905,90,1239,256,9,0,0,0,2499
"01101005410",1675,96,2258,796,243,211,0,0,5279
"01101005501",367,6,747,230,47,0,117,0,1514
"01101005502",644,158,437,88,80,0,71,0,1478
"01101005503",3461,79,914,138,391,35,56,0,5074
"01101005504",718,0,288,61,12,0,17,0,1096
"01101005603",475,842,2902,2161,302,385,567,1061,8695
"01101005604",2115,25,1249,44,30,0,58,0,3521
"01101005605",897,96,2560,73,115,9,135,9,3894
"01101005606",372,0,3352,1441,0,41,10,0,5216
"01101005607",2930,46,540,26,661,16,72,0,4291
"01101005608",1262,42,239,0,101,0,0,0,1644
"01101005609",1490,208,2071,303,316,0,54,0,4442
"01101005610",471,18,554,190,134,0,10,0,1377
"01101005611",1871,24,688,34,629,309,37,0,3592
"01101005612",749,5,509,0,85,0,0,0,1348
"01101005700",746,75,413,180,14,0,0,0,1428
"01101005800",1096,306,643,177,54,0,0,0,2276
"01101005901",2368,377,1655,482,107,17,219,68,5293
"01101005902",0,44,2059,1391,0,0,0,0,3494
"01101006000",1446,828,973,319,73,20,211,586,4456
"01101006100",38,28,1566,526,54,0,28,4,2244
"01103000100",2109,640,462,560,29,81,375,267,4523
"01103000200",3403,90,9,0,190,0,51,0,3743
"01103000300",2352,108,147,129,28,11,154,36,2965
"01103000400",1822,242,722,120,278,35,250,12,3481
"01103000600",326,401,810,785,122,173,157,454,3228
"01103000700",902,817,1524,770,114,36,420,503,5086
"01103000800",1460,642,407,107,271,0,385,379,3651
"01103000900",2421,1409,806,406,391,231,1145,645,7454
"01103001000",1835,332,566,162,349,0,365,133,3742
"01103005101",4264,455,422,94,258,124,317,34,5968
"01103005103",638,152,129,0,128,0,62,0,1109
"01103005105",1758,208,120,12,90,13,178,0,2379
"01103005106",3960,672,353,446,224,68,60,0,5783
"01103005107",4356,116,106,0,254,21,95,0,4948
"01103005108",2783,129,302,382,136,55,122,0,3909
"01103005109",2105,973,991,367,220,136,635,371,5798
"01103005200",5671,657,0,15,156,14,64,0,6577
"01103005301",7089,440,519,161,220,91,126,26,8672
"01103005302",3299,113,78,3,154,0,215,13,3875
"01103005303",2981,455,231,32,83,0,5,55,3842
"01103005304",4978,275,211,0,15,28,39,13,5559
"01103005404",4269,402,80,0,123,10,44,69,4997
"01103005405",3860,713,224,18,84,0,51,74,5024
"01103005500",4190,647,42,0,259,20,339,17,5514
"01103005600",5133,537,45,0,131,3,54,0,5903
"01103005701",2145,571,0,0,68,0,0,0,2784
"01103005702",4653,936,218,1,341,84,101,382,6716
"01105686800",478,95,251,162,0,0,6,0,992
"01105687000",1172,169,1773,1465,57,0,0,0,4636
"01105687100",502,203,1652,1279,17,0,0,0,3653
"01107050000",3492,599,505,291,29,9,29,0,4954
"01107050100",2038,234,660,664,35,23,31,0,3685
"01107050200",1283,287,354,110,6,0,4,0,2044
"01107050300",1348,76,1224,666,4,16,56,9,3399
"01107050400",1248,228,2128,1581,67,17,7,0,5276
"01109188600",1339,235,140,89,79,0,7,0,1889
"01109188700",752,76,586,154,36,0,12,11,1627
"01109188800",1698,283,391,111,40,20,9,0,2552
"01109188900",1108,479,2469,1737,51,31,33,35,5943
"01109189000",4182,679,1507,835,233,0,26,0,7462
"01109189100",2131,1183,782,467,235,218,78,0,5094
"01109189200",1743,213,448,312,113,4,34,5,2872
"01109189300",1691,273,1267,704,30,55,14,7,4041
"01111000100",2222,831,110,76,33,128,53,226,3679
"01111000200",2436,246,102,23,143,12,38,0,3000
"01111000300",2629,654,523,233,4,0,5,0,4048
"01111000400",2864,519,810,223,98,74,79,143,4810
"01111000500",2594,553,1495,482,25,66,11,0,5226
"01111000600",1325,212,175,176,31,3,70,0,1992
"01113030200",551,376,590,927,44,48,0,65,2601
"01113030300",2000,400,255,307,55,86,232,0,3335
"01113030401",4013,279,1001,78,602,0,479,0,6452
"01113030402",2118,287,504,42,105,0,0,0,3056
"01113030500",1317,198,317,179,118,3,55,0,2187
"01113030600",1581,396,4046,1433,219,133,166,298,8272
"01113030700",865,148,1345,1161,147,73,294,102,4135
"01113030800",125,67,2276,885,0,11,0,1,3365
"01113030901",3703,1445,993,136,242,88,75,0,6682
"01113030902",4355,667,4007,638,471,180,603,89,11010
"01113031000",2285,385,574,116,94,0,89,0,3543
"01113031100",253,70,878,380,2,7,3,0,1593
"01113031200",2210,275,910,141,69,9,196,53,3863
"01115040103",7142,586,830,156,257,20,20,0,9011
"01115040104",4555,125,554,0,21,0,63,0,5318
"01115040105",2695,1387,12,80,141,10,140,384,4849
"01115040106",5221,635,446,286,175,0,21,0,6784
"01115040201",4051,1011,14,34,199,15,134,15,5473
"01115040203",3409,1338,851,600,177,0,106,22,6503
"01115040204",5414,715,604,203,156,122,25,22,7261
"01115040205",4684,454,454,0,92,12,0,0,5696
"01115040300",3717,1151,366,52,61,55,0,0,5402
"01115040401",2706,1501,513,153,164,90,112,89,5328
"01115040402",3187,433,32,0,55,65,56,54,3882
"01115040501",9760,828,144,47,60,36,18,0,10893
"01115040502",6320,1063,496,154,696,0,589,0,9318
"01117030102",2654,339,702,329,65,45,3,49,4186
"01117030103",806,49,0,42,170,7,0,2,1076
"01117030211",2391,210,295,0,85,0,10,0,2991
"01117030212",1376,345,1009,208,460,108,223,217,3946
"01117030213",3273,256,486,156,405,43,420,25,5064
"01117030214",7109,297,396,47,191,0,185,131,8356
"01117030215",3538,87,345,0,194,4,73,0,4241
"01117030216",5238,259,627,0,550,0,51,0,6725
"01117030217",4852,222,406,0,328,0,119,0,5927
"01117030303",6164,232,703,60,266,315,130,53,7923
"01117030304",5382,117,248,0,205,0,60,0,6012
"01117030305",3812,69,44,0,144,7,14,0,4090
"01117030306",2476,210,293,110,176,243,201,196,3905
"01117030314",2351,124,667,112,129,0,369,0,3752
"01117030315",3792,355,296,100,770,177,1099,345,6934
"01117030316",4576,71,912,0,717,0,491,40,6807
"01117030317",3297,75,533,0,188,40,61,40,4234
"01117030319",770,96,803,129,299,155,238,220,2710
"01117030320",4394,239,555,23,254,58,293,94,5910
"01117030330",4552,325,88,54,242,20,100,0,5381
"01117030331",3799,251,104,0,286,40,300,29,4809
"01117030332",1027,20,64,8,27,0,0,0,1146
"01117030333",3910,136,378,0,766,0,43,53,5286
"01117030334",3682,104,246,34,89,0,26,16,4197
"01117030336",5073,108,493,27,429,0,15,13,6158
"01117030337",1144,185,97,41,247,0,219,50,1983
"01117030340",4403,189,642,79,100,0,90,7,5510
"01117030341",1207,157,418,9,271,127,220,171,2580
"01117030342",2111,32,22,36,220,0,92,3,2516
"01117030344",2491,130,339,0,130,0,144,18,3252
"01117030345",2470,34,121,0,357,17,291,11,3301
"01117030405",641,96,550,77,11,0,20,0,1395
"01117030406",2239,566,244,42,66,246,335,331,4069
"01117030407",449,367,171,111,16,0,73,17,1204
"01117030408",2020,302,392,82,63,5,19,0,2883
"01117030501",4549,570,1430,66,321,115,456,439,7946
"01117030502",1849,117,408,6,54,0,17,0,2451
"01117030604",4685,289,945,60,491,481,615,466,8032
"01117030605",5591,363,868,0,87,504,157,504,8074
"01117030607",4630,533,552,1,250,94,160,252,6472
"01117030608",2612,134,485,0,138,0,23,0,3392
"01117030609",5178,216,1096,0,491,0,199,0,7180
"01117030701",2779,474,319,116,51,27,32,20,3818
"01117030703",2751,510,281,230,163,30,171,0,4136
"01117030704",2708,590,162,136,27,0,7,42,3672
"01117030800",3119,496,203,90,66,9,44,2,4029
"01117030900",2248,209,38,0,15,0,15,0,2525
"01117980000",0,0,0,0,0,0,0,0,0
"01119011300",1122,501,1287,2068,24,0,0,8,5010
"01119011400",337,14,761,456,103,0,7,0,1678
"01119011500",557,63,1964,1904,0,21,5,0,4514
"01119011600",445,49,616,296,7,0,15,0,1428
"01121010101",3981,241,571,205,197,50,101,0,5346
"01121010102",3199,397,563,308,30,77,0,67,4641
"01121010201",2256,503,780,91,15,0,15,0,3660
"01121010202",2665,420,600,111,207,116,0,0,4119
"01121010301",1532,716,194,504,0,19,0,0,2965
"01121010302",2848,238,1102,435,21,89,0,0,4733
"01121010400",1719,532,407,78,55,15,42,2,2850
"01121010500",970,93,995,731,191,24,281,0,3285
"01121010600",296,194,1154,1188,54,0,33,31,2950
"01121010700",83,20,758,48,0,0,0,0,909
"01121010900",1409,443,772,179,18,65,0,74,2960
"01121011000",1949,325,423,28,187,0,0,0,2912
"01121011100",2089,417,1632,776,76,0,60,0,5050
"01121011200",794,178,950,154,50,0,0,0,2126
"01121011300",2594,786,954,1235,128,34,18,0,5749
"01121011400",1342,350,723,410,42,8,99,0,2974
"01121011500",4302,624,352,69,110,0,0,4,5461
"01121011600",2527,707,654,564,15,54,19,0,4540
"01121011700",2647,484,609,389,25,86,51,55,4346
"01121011800",877,327,213,504,7,258,51,176,2413
"01121011900",1484,256,684,231,89,0,36,0,2780
"01121012000",1001,122,758,397,0,47,137,53,2515
"01123961900",1920,390,181,155,22,0,10,22,2700
"01123962000",2079,200,1265,670,0,49,28,10,4301
"01123962100",1452,282,1034,1094,63,0,50,0,3975
"01123962200",2550,618,851,388,60,82,100,20,4669
"01123962300",3285,1172,1113,261,108,248,0,579,6766
"01123962400",2340,558,928,419,17,42,0,0,4304
"01123962501",3415,434,213,64,21,0,12,0,4159
"01123962502",2422,243,131,0,6,12,41,63,2918
"01123962600",312,86,776,468,17,0,18,6,1683
"01123962700",4236,566,563,616,74,0,51,0,6106
"01125010101",3518,27,133,0,405,0,93,0,4176
"01125010102",2507,258,70,0,55,0,0,0,2890
"01125010103",5170,521,151,115,72,29,16,29,6103
"01125010201",3152,159,76,74,149,0,7,13,3630
"01125010202",8199,308,1325,142,8,31,624,76,10713
"01125010203",2337,307,281,0,81,38,40,0,3084
"01125010204",3274,360,602,39,143,38,36,0,4492
"01125010301",4971,322,624,362,107,0,23,0,6409
"01125010302",2476,421,35,74,46,0,233,0,3285
"01125010303",1717,115,585,263,17,0,0,0,2697
"01125010403",1671,514,1065,284,120,0,37,274,3965
"01125010404",944,41,599,901,38,0,0,0,2523
"01125010405",2436,239,318,0,290,273,61,189,3806
"01125010406",4385,314,168,102,165,55,173,0,5362
"01125010407",1817,250,452,239,21,93,63,0,2935
"01125010500",583,350,742,644,16,5,96,140,2576
"01125010601",3417,937,189,18,44,5,159,6,4775
"01125010602",9116,900,753,47,189,0,22,0,11027
"01125010701",4007,512,1137,577,136,50,84,0,6503
"01125010702",5831,878,500,20,162,8,304,2,7705
"01125010703",2151,433,89,7,23,6,114,0,2823
"01125010802",3142,325,764,102,81,0,0,0,4414
"01125010803",1316,262,700,635,19,64,168,94,3258
"01125010804",1784,345,589,67,80,12,116,50,3043
"01125011200",274,116,10,19,7,6,0,0,432
"01125011401",440,583,10,114,59,26,0,0,1232
"01125011402",550,1175,38,61,260,116,0,84,2284
"01125011600",489,131,1419,561,33,6,22,0,2661
"01125011701",15,0,1402,971,0,0,0,0,2388
"01125011703",198,27,3234,1438,13,10,0,8,4928
"01125011800",3,5,2063,1544,0,0,0,19,3634
"01125011901",926,357,688,436,220,33,192,27,2879
"01125011902",191,247,868,258,54,111,0,234,1963
"01125012000",1339,868,0,15,66,51,270,0,2609
"01125012100",3371,1105,890,235,405,123,516,140,6785
"01125012303",3990,429,1708,1061,337,10,141,134,7810
"01125012304",514,197,1953,699,33,76,61,10,3543
"01125012305",1904,148,2477,590,51,0,96,15,5281
"01125012403",1656,105,1506,239,20,0,13,0,3539
"01125012404",660,184,1291,359,8,19,180,0,2701
"01125012405",1347,606,3141,1907,29,27,123,0,7180
"01125012501",256,67,1165,227,0,0,16,0,1731
"01125012502",4088,315,2189,204,186,0,23,0,7005
"01125012503",3066,229,1070,8,171,0,105,124,4773
"01125012600",611,612,202,266,63,29,111,0,1894
"01125012700",1642,547,1259,592,62,172,0,172,4446
"01125012800",121,39,1074,1003,4,43,0,0,2284
"01127020100",1633,407,513,364,297,23,195,0,3432
"01127020200",3341,543,10,105,39,31,239,106,4414
"01127020300",4425,1257,434,247,38,35,69,184,6689
"01127020400",1206,313,346,48,14,36,102,30,2095
"01127020600",2082,316,40,21,90,0,54,53,2656
"01127020700",2373,111,0,17,102,24,55,24,2706
"01127020800",4612,818,124,58,64,237,42,29,5984
"01127020900",3587,1178,1,1,23,0,0,0,4790
"01127021000",2406,1289,0,0,35,64,5,4,3803
"01127021100",2225,844,87,31,117,26,0,1,3331
"01127021200",2523,1061,0,0,22,11,0,86,3703
"01127021300",2971,575,64,43,156,25,0,24,3858
"01127021400",2792,904,153,42,31,69,0,23,4014
"01127021500",2061,696,114,79,56,43,33,25,3107
"01127021600",1040,254,108,0,36,14,15,14,1481
"01127021700",3351,636,200,119,54,24,37,13,4434
"01127021800",2551,739,101,79,27,63,0,16,3576
"01127021900",1570,612,42,0,7,66,0,0,2297
"01129043900",1580,344,440,114,122,6,75,0,2681
"01129044000",2376,144,501,245,9,0,43,8,3326
"01129044100",1915,477,710,150,13,11,0,0,3276
"01129044200",1493,737,1391,261,1222,74,16,0,5194
"01129044300",1476,453,210,114,61,70,0,70,2454
"01131034700",68,9,351,552,0,0,0,0,980
"01131034800",1269,163,1756,1682,5,0,5,0,4880
"01131035100",1031,119,924,943,2,61,0,61,3141
"01131035200",258,40,1166,557,0,0,0,0,2021
"01133965501",1769,514,0,0,8,18,0,0,2309
"01133965502",1938,576,0,0,0,0,0,0,2514
"01133965503",2299,380,0,0,4,40,30,0,2753
"01133965600",3886,774,6,0,49,232,54,0,5001
"01133965700",3427,953,0,0,179,63,204,134,4960
"01133965800",3042,1125,31,0,78,76,201,11,4564
"01133965900",1690,384,0,0,5,22,0,12,2113
"02013000100",621,88,208,95,1910,370,317,78,3687
"02016000100",150,38,0,0,605,112,33,23,961
"02016000200",1422,56,164,78,2670,215,505,18,5128
"02020000101",4526,411,0,0,1008,64,208,75,6292
"02020000102",4144,34,219,0,737,467,179,13,5793
"02020000201",3720,47,179,0,724,73,505,0,5248
"02020000202",5088,433,0,0,951,138,458,0,7068
"02020000203",9506,263,162,0,1718,19,883,0,12551
"02020000204",2784,102,15,0,362,27,116,0,3406
"02020000300",4475,283,674,0,1275,0,1306,0,8013
"02020000400",3122,30,841,77,594,37,407,96,5204
"02020000500",806,102,143,30,796,64,108,24,2073
"02020000600",1555,326,349,214,2695,1265,638,149,7191
"02020000701",3050,70,453,3,1996,227,709,24,6532
"02020000702",2606,248,813,100,1262,358,367,19,5773
"02020000703",2006,195,375,168,2680,387,412,7,6230
"02020000801",2559,195,488,78,2771,1341,917,133,8482
"02020000802",2129,237,395,37,1676,400,443,136,5453
"02020000901",1439,244,298,300,1722,702,345,109,5159
"02020000902",1379,58,332,162,977,317,123,105,3453
"02020001000",1682,472,312,88,745,99,265,58,3721
"02020001100",365,57,50,38,133,15,55,1,714
"02020001200",2944,108,122,0,391,45,118,9,3737
"02020001300",2689,125,11,0,344,12,264,0,3445
"02020001400",2627,146,306,508,1059,249,470,39,5404
"02020001500",3236,149,139,27,1256,134,258,0,5199
"02020001601",2091,44,316,9,1609,73,384,17,4543
"02020001602",2637,122,102,25,976,83,291,0,4236
"02020001701",3869,146,853,70,1871,361,439,47,7656
"02020001702",3320,164,456,0,1027,139,449,8,5563
"02020001731",3291,72,563,69,1660,354,309,47,6365
"02020001732",3787,103,572,18,1384,320,340,0,6524
"02020001801",3021,165,196,126,1215,15,186,72,4996
"02020001802",2442,154,261,12,1863,423,382,145,5682
"02020001900",1433,155,85,54,1839,579,403,11,4559
"02020002000",1614,261,179,37,1094,313,416,99,4013
"02020002100",2296,120,133,29,1382,10,107,7,4084
"02020002201",2812,223,35,0,1853,154,342,0,5419
"02020002202",1611,316,120,0,828,257,155,350,3637
"02020002301",4902,553,195,0,1591,6,361,15,7623
"02020002302",3449,204,60,217,1124,66,339,30,5489
"02020002303",5184,251,346,93,2365,323,817,0,9379
"02020002400",2010,159,123,0,633,88,110,23,3146
"02020002501",3273,88,113,0,1339,145,570,57,5585
"02020002502",3109,123,13,39,1900,74,753,0,6011
"02020002601",2836,263,187,21,1891,167,387,176,5928
"02020002602",3205,221,524,11,2210,156,537,21,6885
"02020002603",4204,39,20,0,1781,35,308,0,6387
"02020002702",7502,147,152,0,2216,67,648,41,10773
"02020002711",4518,20,76,32,1488,38,378,0,6550
"02020002712",4813,216,377,41,2771,474,912,120,9724
"02020002811",3652,129,292,97,2172,311,765,92,7510
"02020002812",6251,278,536,7,934,1,297,151,8455
"02020002813",4390,135,1,0,541,2,172,0,5241
"02020002821",4176,104,91,45,747,15,514,0,5692
"02020002822",3584,23,0,0,376,9,49,0,4041
"02020002823",4795,31,243,23,628,22,289,22,6053
"02020002900",2260,84,0,0,252,41,355,1,2993
"02050000100",168,30,3,0,6414,3218,43,25,9901
"02050000200",1569,72,125,0,3620,611,165,20,6182
"02050000300",187,9,4,0,871,424,20,1,1516
"02060000100",530,12,2,0,357,57,62,4,1024
"02068000100",1514,224,13,0,218,30,33,16,2048
"02070000100",141,8,4,0,1876,606,3,0,2638
"02070000200",746,22,13,0,1271,258,110,30,2450
"02090000100",1159,132,24,0,355,94,150,6,1920
"02090000200",1814,294,69,33,584,340,103,75,3312
"02090000300",1490,340,507,102,1401,410,320,5,4575
"02090000400",2987,150,90,17,1180,268,365,0,5057
"02090000500",1757,37,324,57,689,132,560,11,3567
"02090000600",2570,384,226,46,996,122,106,0,4450
"02090000700",2737,154,149,98,916,281,345,142,4822
"02090000800",3819,260,380,0,1174,293,709,84,6719
"02090000900",4415,270,22,0,864,31,177,0,5779
"02090001000",1115,129,27,0,112,124,0,3,1510
"02090001100",4185,658,971,23,1094,62,1087,127,8207
"02090001200",5952,100,24,0,696,86,332,0,7190
"02090001300",4613,369,23,0,611,50,53,0,5719
"02090001400",6084,299,38,0,893,186,389,37,7926
"02090001500",9329,243,91,0,1756,1,689,0,12109
"02090001600",3547,206,370,0,702,206,219,0,5250
"02090001700",1043,93,0,0,27,6,30,0,1199
"02090001800",1592,151,167,0,414,3,330,12,2669
"02090001900",9138,339,0,7,785,66,314,6,10655
"02100000100",1963,96,0,0,456,39,35,3,2592
"02105000200",12,0,0,0,47,7,0,0,66
"02105000300",984,73,47,0,784,172,28,19,2107
"02110000100",4351,77,0,0,508,32,182,9,5159
"02110000200",4565,175,113,20,2230,107,587,43,7840
"02110000300",3411,91,75,0,1995,279,289,14,6154
"02110000400",2108,63,82,13,1815,380,262,3,4726
"02110000500",2588,249,14,14,674,95,189,85,3908
"02110000600",4216,282,59,3,1026,230,223,55,6094
"02122000100",166,2,0,0,180,45,0,0,393
"02122000200",4227,366,8,3,670,114,339,39,5766
"02122000300",1049,41,0,0,23,49,23,14,1199
"02122000400",5638,618,49,0,402,81,108,0,6896
"02122000500",5316,256,8,0,775,181,299,70,6905
"02122000600",5245,610,25,0,1333,199,112,72,7596
"02122000700",7992,603,101,0,1295,96,529,20,10636
"02122000800",2796,364,2,0,287,55,40,13,3557
"02122000900",1812,168,0,0,133,18,36,0,2167
"02122001000",3146,461,26,0,466,113,121,73,4406
"02122001100",2542,319,13,5,168,60,89,56,3252
"02122001200",390,73,3,1,336,204,1,1,1009
"02122001300",2727,315,9,0,831,138,23,0,4043
"02130000100",2786,113,0,0,431,70,97,8,3505
"02130000200",2498,339,11,6,1602,377,221,56,5110
"02130000300",1467,249,33,0,825,342,146,55,3117
"02130000400",1652,75,2,0,567,69,37,29,2431
"02150000100",865,41,12,35,678,250,90,11,1982
"02150000200",3700,501,0,0,2133,298,578,0,7210
"02150000300",622,61,0,0,2072,164,326,64,3309
"02150000400",409,69,0,0,449,47,4,6,984
"02150000500",969,72,13,1,203,13,84,1,1356
"02158000100",304,60,24,1,4924,2561,75,6,7955
"02164000100",313,10,8,0,899,237,26,4,1497
"02170000101",479,192,0,15,34,24,2,12,758
"02170000102",1706,169,0,0,135,73,28,0,2111
"02170000200",983,223,4,15,123,88,40,0,1476
"02170000300",5207,272,39,0,777,27,333,5,6660
"02170000401",1277,242,20,0,376,49,51,37,2052
"02170000402",1638,273,0,0,186,5,111,7,2220
"02170000501",1421,131,0,0,424,4,113,0,2093
"02170000502",1613,207,0,0,219,27,86,0,2152
"02170000601",3809,387,0,6,633,30,50,21,4936
"02170000603",5432,332,0,0,732,143,230,0,6869
"02170000604",3420,409,0,0,548,39,79,24,4519
"02170000701",2510,198,0,0,337,8,151,0,3204
"02170000703",2566,638,11,0,476,76,188,20,3975
"02170000705",3355,265,0,0,415,55,331,0,4421
"02170000706",4394,690,30,0,720,222,219,0,6275
"02170000800",3698,491,49,82,728,194,234,18,5494
"02170000900",2052,65,88,13,362,91,60,44,2775
"02170001001",2820,144,17,0,464,71,111,13,3640
"02170001003",2836,318,36,1,602,44,259,40,4136
"02170001004",3961,309,51,0,623,44,173,0,5161
"02170001100",4368,324,172,34,687,70,194,7,5856
"02170001201",3906,357,45,43,786,122,339,19,5617
"02170001202",3876,342,95,0,828,208,296,5,5650
"02170001300",5039,425,37,0,557,128,209,33,6428
"02180000100",233,11,0,0,3407,2159,17,6,5833
"02180000200",1277,90,42,5,2046,327,168,0,3955
"02185000100",347,2,15,5,3389,491,199,0,4448
"02185000200",155,25,5,0,1715,339,19,1,2259
"02185000300",2502,100,24,0,411,14,89,0,3140
"02188000100",173,54,2,0,2962,1246,12,24,4473
"02188000200",702,4,17,6,1971,514,105,0,3319
"02195000200",2087,229,83,14,702,84,260,42,3501
"02198000100",1026,200,2,0,736,151,11,0,2126
"02198000200",1397,172,10,0,721,190,57,7,2554
"02198000300",7,6,0,0,0,0,0,0,13
"02198940100",128,13,0,0,1359,189,111,10,1810
"02220000100",2174,68,43,11,1004,187,193,0,3680
"02220000200",3203,287,25,0,1573,245,308,33,5674
"02230000100",746,35,0,0,208,9,45,0,1043
"02240000100",1094,165,0,0,648,311,0,9,2227
"02240000400",3788,515,75,0,344,20,242,60,5044
"02261000100",1560,163,0,0,528,282,42,0,2575
"02261000200",1844,6,0,0,595,144,9,0,2598
"02261000300",3101,293,0,0,814,141,346,17,4712
"02275000300",1531,120,0,4,558,155,30,3,2401
"02282000100",251,4,9,0,348,31,17,0,660
"02290000100",131,33,0,0,689,346,0,31,1230
"02290000200",495,105,3,0,650,151,13,11,1428
"02290000300",304,23,0,0,1247,370,23,0,1967
"02290000400",164,33,14,0,637,191,5,25,1069
"04001942600",0,0,0,0,827,685,0,0,1512
"04001942700",52,0,0,0,2906,1738,12,7,4715
"04001944000",207,24,147,57,2991,2560,77,26,6089
"04001944100",42,9,4,0,2957,2610,11,33,5666
"04001944201",319,21,27,6,2456,1500,20,94,4443
"04001944202",77,44,16,0,1723,2119,58,55,4092
"04001944300",85,4,4,1,4193,2994,41,6,7328
"04001944901",34,114,7,25,2321,1270,6,60,3837
"04001944902",51,30,0,0,2509,2326,43,65,5024
"04001945001",98,93,8,0,3394,1417,46,8,5064
"04001945002",15,21,4,3,2408,1619,83,38,4191
"04001945100",65,19,8,4,1422,911,60,8,2497
"04001970200",3202,822,10,7,331,60,565,38,5035
"04001970300",2125,543,0,0,614,313,754,341,4690
"04001970501",3545,940,27,0,383,180,755,311,6141
"04001970502",2776,454,0,9,354,300,232,156,4281
"04003000100",996,170,7,0,257,110,403,100,2043
"04003000201",2104,283,0,0,861,0,1328,92,4668
"04003000202",2727,594,25,0,591,101,1952,347,6337
"04003000203",1856,356,0,0,297,91,314,85,2999
"04003000301",2465,857,24,0,252,82,725,243,4648
"04003000302",4339,305,4,0,102,0,254,22,5026
"04003000303",2895,464,0,0,24,45,243,74,3745
"04003000400",1457,422,0,0,211,43,319,148,2600
"04003000500",2268,432,9,16,339,36,631,62,3793
"04003000600",1345,643,0,0,542,314,1626,791,5261
"04003000700",1984,1025,0,0,330,404,2077,1416,7236
"04003000800",1813,531,13,0,883,214,2165,655,6274
"04003000901",876,618,0,0,361,402,1179,983,4419
"04003000902",556,305,25,0,370,279,830,483,2848
"04003001000",770,268,0,13,129,44,164,6,1394
"04003001100",2053,866,1,0,380,298,1189,651,5438
"04003001200",1997,338,12,0,162,446,933,619,4507
"04003001300",3538,822,32,105,939,107,681,445,6669
"04003001401",1398,281,166,0,217,25,261,11,2359
"04003001402",526,22,103,0,249,0,230,17,1147
"04003001501",1529,523,163,55,787,196,999,204,4456
"04003001502",2412,692,188,23,929,153,1254,345,5996
"04003001601",3627,501,221,0,1008,66,2255,66,7744
"04003001602",1449,664,136,172,315,22,556,207,3521
"04003001701",2197,341,201,0,678,475,905,457,5254
"04003001702",2193,845,217,26,732,51,915,472,5451
"04003001703",3551,161,226,91,779,111,1004,22,5945
"04003001800",7001,220,684,4,966,28,1453,21,10377
"04003001900",5049,191,304,23,790,12,839,54,7262
"04003002001",3371,1027,27,0,411,343,821,549,6549
"04003002002",3905,592,27,37,166,20,943,261,5951
"04003002100",4583,347,59,0,252,313,703,123,6380
"04005000100",2891,219,16,0,409,140,263,39,3977
"04005000200",2739,431,10,2,253,133,608,101,4277
"04005000300",2705,1107,217,63,1380,1510,1310,1240,9532
"04005000400",3173,603,107,0,1191,298,791,412,6575
"04005000500",2671,422,68,0,1085,183,1148,301,5878
"04005000600",4414,230,123,0,866,107,413,14,6167
"04005000700",2374,407,14,2,410,230,373,66,3876
"04005000800",1571,1882,110,79,730,387,395,336,5490
"04005000900",4208,917,40,54,956,488,728,390,7781
"04005001000",207,704,0,13,66,293,62,67,1412
"04005001101",3027,640,220,23,712,55,525,71,5273
"04005001102",3383,1459,16,38,1252,872,1082,726,8828
"04005001200",1947,466,17,19,172,35,330,185,3171
"04005001301",4253,211,50,0,654,24,545,164,5901
"04005001302",4377,471,167,0,368,18,746,118,6265
"04005001500",2400,290,0,0,250,16,254,0,3210
"04005001600",2682,210,0,0,158,0,76,12,3138
"04005001700",2359,791,35,0,361,132,609,339,4626
"04005002000",1581,275,0,0,213,89,27,14,2199
"04005002100",3578,371,0,0,2780,700,614,105,8148
"04005002200",4762,389,0,0,393,404,343,277,6568
"04005002300",3486,878,17,62,646,264,453,144,5950
"04005942201",16,3,0,2,2685,1184,35,15,3940
"04005942202",16,0,36,0,2049,1563,32,16,3712
"04005944900",76,12,0,0,3162,1833,65,6,5154
"04005945000",21,0,28,0,2731,1593,94,10,4477
"04005945100",30,12,2,0,2310,1223,48,29,3654
"04005945200",148,9,0,0,3395,1284,35,0,4871
"04007000100",1454,125,0,0,29,0,78,0,1686
"04007000200",1685,388,0,0,39,0,158,9,2279
"04007000301",4739,1047,0,0,280,14,335,382,6797
"04007000302",2227,393,0,0,81,11,96,71,2879
"04007000400",3372,291,0,59,171,29,414,10,4346
"04007000500",4569,477,7,0,269,28,146,12,5508
"04007000600",965,265,0,0,35,160,28,164,1617
"04007000700",1153,399,0,1,0,1,0,2,1556
"04007000800",1269,351,0,0,35,7,552,103,2317
"04007000900",2046,765,0,0,238,13,1048,266,4376
"04007001000",3715,1390,0,0,243,0,1088,556,6992
"04007001100",2966,458,0,59,291,156,1488,233,5651
"04007001200",3021,562,125,31,338,382,931,426,5816
"04007001300",867,227,0,0,104,58,651,227,2134
"04007940200",31,0,6,0,1031,935,0,0,2003
"04007940400",115,30,36,10,2825,2717,109,50,5892
"04009940500",8,55,5,6,2306,2307,147,198,5032
"04009961100",3515,597,12,0,194,113,795,314,5540
"04009961201",2050,550,0,27,307,78,416,248,3676
"04009961202",2764,653,0,0,275,0,1142,303,5137
"04009961300",2192,763,56,0,188,123,1033,382,4737
"04009961400",3820,509,28,0,483,19,1973,275,7107
"04009961500",3020,1148,4,6,162,19,967,404,5730
"04009961600",714,134,11,3,13,5,92,52,1024
"04009961700",3099,228,39,0,214,103,1075,121,4879
"04011960100",2265,202,57,0,196,25,1502,115,4362
"04011960200",2726,239,63,0,363,44,1632,215,5282
"04011960300",1851,666,9,0,133,39,540,222,3460
"04012020100",1557,471,0,0,198,81,476,324,3107
"04012020201",1365,430,0,0,18,0,79,30,1922
"04012020202",483,43,0,0,6,6,33,0,571
"04012020501",1387,258,0,0,365,0,437,0,2447
"04012020502",3664,445,0,0,17,5,157,21,4309
"04012020602",1128,179,0,0,101,0,361,0,1769
"04012940200",1417,183,3,0,1007,261,958,141,3970
"04012940300",1457,380,0,0,2076,1082,1520,547,7062
"04012980000",0,0,0,0,0,0,0,0,0
"04013010101",4622,214,0,0,121,0,29,0,4986
"04013010102",3573,267,24,2,152,0,67,6,4091
"04013030401",3669,259,0,0,65,4,157,22,4176
"04013030402",3402,263,10,0,241,13,116,21,4066
"04013040502",3989,1096,0,0,86,14,503,250,5938
"04013040506",5000,300,0,0,34,0,0,0,5334
"04013040507",5357,482,37,0,155,0,0,0,6031
"04013040512",1398,93,13,0,62,0,34,0,1600
"04013040513",2843,49,41,0,9,0,0,0,2942
"04013040514",2673,105,0,0,89,0,47,0,2914
"04013040515",3680,733,0,18,37,70,644,649,5831
"04013040516",3586,328,32,0,52,0,283,16,4297
"04013040517",5165,1131,420,37,287,96,850,351,8337
"04013040518",5791,454,578,97,449,25,1229,371,8994
"04013040519",4158,171,26,0,326,0,287,0,4968
"04013040520",3776,72,102,17,240,16,287,0,4510
"04013040521",4692,180,451,10,867,91,683,18,6992
"04013040522",3972,273,0,0,87,0,0,0,4332
"04013040523",2470,127,25,9,146,0,34,0,2811
"04013040524",1386,10,60,0,10,0,25,0,1491
"04013040525",2977,127,55,0,20,8,85,13,3285
"04013040526",1862,101,57,0,23,0,70,0,2113
"04013040527",3180,426,143,0,144,5,330,86,4314
"04013040528",5753,337,16,23,127,0,63,26,6345
"04013040529",2781,48,0,0,67,0,64,0,2960
"04013040530",3055,648,141,0,316,27,719,143,5049
"04013040531",2687,445,181,57,127,0,384,64,3945
"04013050603",3408,495,40,0,169,118,1016,198,5444
"04013050604",2568,685,0,0,228,32,1032,342,4887
"04013050605",5397,272,423,0,646,93,1220,130,8181
"04013050606",6103,764,295,44,382,93,1084,361,9126
"04013050607",4471,1727,406,55,671,198,2021,845,10394
"04013050608",4331,767,394,37,1503,306,1869,413,9620
"04013050609",3380,150,421,293,425,171,1456,138,6434
"04013050610",5800,992,716,33,1308,198,2891,819,12757
"04013050611",3785,194,104,26,1397,7,1614,130,7257
"04013050701",3180,802,363,80,688,177,1328,768,7386
"04013050702",3024,1232,280,30,605,180,1845,819,8015
"04013060801",2884,2172,232,127,365,207,1795,1652,9434
"04013060802",1677,199,193,5,418,30,928,76,3526
"04013060901",3138,675,291,92,205,82,1500,439,6422
"04013060902",1785,794,164,52,429,452,1823,1124,6623
"04013060903",3358,915,193,0,523,385,2685,765,8824
"04013060904",1869,910,156,16,409,69,1088,494,5011
"04013061009",7027,390,793,1,1181,2,2427,21,11842
"04013061010",4073,245,69,0,269,0,708,72,5436
"04013061011",3690,438,415,10,750,59,1520,11,6893
"04013061012",5241,651,509,0,1689,77,1257,552,9976
"04013061013",3778,331,643,13,1024,35,1391,215,7430
"04013061014",3847,326,771,105,733,57,1694,241,7774
"04013061015",4247,475,379,117,788,21,1728,98,7853
"04013061016",3868,140,439,37,668,51,990,76,6269
"04013061017",0,0,0,0,0,0,0,0,0
"04013061018",4181,227,60,0,132,39,63,65,4767
"04013061019",2444,96,408,1,601,87,1323,108,5068
"04013061020",2814,137,339,0,560,35,929,0,4814
"04013061021",1204,19,200,70,454,0,389,0,2336
"04013061022",7496,1254,1004,467,918,163,3534,581,15417
"04013061023",7355,500,1289,280,1228,171,3423,390,14636
"04013061024",1456,102,73,218,231,5,931,65,3081
"04013061025",6393,122,282,75,802,274,1810,17,9775
"04013061026",3832,605,226,0,524,70,857,72,6186
"04013061027",3775,280,44,0,485,30,1309,57,5980
"04013061028",1888,200,207,123,111,5,262,42,2838
"04013061029",3982,427,203,0,199,6,548,21,5386
"04013061030",6441,64,576,0,958,0,1200,2,9241
"04013061031",3052,214,339,64,168,128,747,60,4772
"04013061032",4318,907,113,105,374,126,792,155,6890
"04013061033",5213,678,122,27,488,53,847,522,7950
"04013061034",4885,470,398,30,474,57,1561,2,7877
"04013061035",5457,158,602,17,935,151,1190,179,8689
"04013061036",1814,164,618,1,302,0,415,16,3330
"04013061037",4341,301,106,0,233,0,1111,26,6118
"04013061038",3263,76,715,71,378,13,1108,63,5687
"04013061039",3638,327,63,0,385,152,922,23,5510
"04013061040",2882,409,301,43,473,50,1301,188,5647
"04013061041",2510,260,420,14,1086,316,1696,396,6698
"04013061042",1347,420,97,0,48,7,280,168,2367
"04013061043",1945,237,128,52,281,54,914,152,3763
"04013061044",5572,424,324,0,436,51,1390,75,8272
"04013061045",4436,155,74,0,476,138,753,0,6032
"04013061046",3771,79,850,412,458,177,1785,60,7592
"04013061047",2317,213,447,2,529,16,737,98,4359
"04013061100",1079,142,242,61,189,29,415,29,2186
"04013061200",2706,2138,319,206,407,182,2432,2082,10472
"04013061300",1370,380,8,32,256,46,926,250,3268
"04013061401",914,727,173,16,138,113,928,729,3738
"04013061402",1593,1831,480,222,710,285,1802,1866,8789
"04013071503",4394,198,38,0,56,14,90,0,4790
"04013071504",3302,180,16,0,0,51,31,0,3580
"04013071505",5993,417,66,77,81,0,375,77,7086
"04013071506",3531,376,27,0,110,31,199,80,4354
"04013071509",4369,585,243,16,1089,71,543,99,7015
"04013071510",3610,134,108,43,596,0,515,8,5014
"04013071511",2244,296,359,40,376,72,397,22,3806
"04013071512",5467,219,35,0,727,2,951,14,7415
"04013071513",1457,52,31,0,128,2,231,30,1931
"04013071514",3640,381,9,0,216,179,580,9,5014
"04013071515",2718,220,175,12,246,27,440,72,3910
"04013071516",2352,255,223,12,123,49,216,41,3271
"04013071517",3618,112,209,2,352,39,872,88,5292
"04013071600",2044,943,138,25,356,99,990,409,5004
"04013071701",2270,327,19,0,125,1,670,72,3484
"04013071702",2620,330,0,21,60,0,173,15,3219
"04013071801",3571,618,76,97,67,31,127,32,4619
"04013071802",3068,263,58,13,138,0,96,31,3667
"04013071903",5765,226,111,22,773,29,2098,0,9024
"04013071906",3699,564,61,160,976,240,1708,510,7918
"04013071909",3647,226,115,1,183,212,1363,48,5795
"04013071910",5089,1371,105,1,569,325,2202,643,10305
"04013071911",2232,417,279,0,419,111,856,268,4582
"04013071912",1573,659,287,0,114,26,578,434,3671
"04013071913",2959,1198,352,83,503,88,1478,508,7169
"04013071914",2177,496,52,0,599,296,1501,346,5467
"04013071915",2144,442,194,33,258,51,826,288,4236
"04013082002",4788,189,438,231,561,42,2936,105,9290
"04013082007",2062,313,39,17,1148,68,2348,198,6193
"04013082008",2253,1260,216,300,1123,317,2537,1473,9479
"04013082009",2391,1380,592,44,838,252,2517,1516,9530
"04013082010",2081,882,85,65,665,257,2080,935,7050
"04013082012",4084,289,389,0,1442,91,3340,339,9974
"04013082016",1336,205,63,37,743,4,1441,132,3961
"04013082017",2422,254,1268,186,797,141,1856,129,7053
"04013082018",2971,662,368,15,1068,371,3008,959,9422
"04013082019",1809,69,366,0,196,21,675,59,3195
"04013082020",2426,265,627,7,451,22,954,153,4905
"04013082021",1305,53,170,6,252,0,702,14,2502
"04013082022",2779,217,303,59,838,122,1862,224,6404
"04013082023",3430,755,232,58,655,62,2046,696,7934
"04013082024",2583,723,508,0,356,305,1147,870,6492
"04013082025",1617,175,235,135,340,10,1007,102,3621
"04013082026",3683,264,254,50,1022,95,2401,102,7871
"04013082027",2912,606,302,7,334,91,2116,570,6938
"04013082028",1369,984,177,213,1382,170,1932,884,7111
"04013082203",5859,1133,856,0,1212,299,4893,1245,15497
"04013082204",3721,782,656,333,854,105,3697,744,10892
"04013082205",3270,692,565,84,525,64,2828,626,8654
"04013082206",2551,117,252,301,296,94,1951,181,5743
"04013082207",2168,261,65,5,325,72,1816,261,4973
"04013082208",1816,1010,70,15,237,65,1786,964,5963
"04013082209",1720,874,22,0,231,88,1864,944,5743
"04013082210",3221,583,383,220,602,75,2630,480,8194
"04013082211",3460,301,342,156,1021,10,2722,250,8262
"04013083000",3727,1697,231,168,856,127,3893,1647,12346
"04013092305",3195,597,82,0,311,64,951,321,5521
"04013092306",3895,901,204,119,929,128,701,669,7546
"04013092307",4230,920,406,14,928,60,1833,596,8987
"04013092308",4152,1011,152,0,715,348,1551,669,8598
"04013092309",3712,625,189,102,531,130,1447,262,6998
"04013092311",1435,522,52,63,87,38,521,237,2955
"04013092312",3287,1040,126,0,335,228,1305,289,6610
"04013092401",1934,958,359,172,563,205,1454,646,6291
"04013092402",1943,614,127,17,678,8,983,282,4652
"04013092500",2694,882,435,61,769,69,2002,570,7482
"04013092600",987,1215,11,161,438,953,777,1737,6279
"04013092705",1624,474,354,151,698,288,1104,580,5273
"04013092708",1364,368,63,58,252,10,603,277,2995
"04013092709",3228,512,146,87,674,11,1497,180,6335
"04013092710",3093,368,156,0,499,8,1349,163,5636
"04013092711",1866,533,89,27,886,61,1254,359,5075
"04013092712",2506,683,596,111,726,30,1795,636,7083
"04013092713",3050,906,260,0,740,58,2053,651,7718
"04013092715",2095,1062,105,116,807,71,2168,1062,7486
"04013092716",2214,880,107,0,490,139,1702,794,6326
"04013092717",2514,865,373,46,699,475,1960,1212,8144
"04013092718",1690,1066,275,123,237,371,1110,1258,6130
"04013092719",2296,203,469,40,807,143,1066,135,5159
"04013092720",3650,187,417,0,591,67,1927,83,6922
"04013092721",1736,102,428,14,621,42,863,50,3856
"04013092723",3170,366,147,34,191,111,1090,277,5386
"04013092724",2836,327,114,5,225,36,687,43,4273
"04013092801",2028,1615,55,343,628,554,2031,1836,9090
"04013092802",2760,1588,45,215,559,448,2518,1706,9839
"04013092900",1053,915,84,39,291,191,1067,888,4528
"04013093001",1973,1201,241,375,551,848,1399,1622,8210
"04013093002",1572,1872,68,193,911,120,1502,1479,7717
"04013093101",2260,1253,268,68,977,392,2110,1436,8764
"04013093104",1884,1571,160,224,427,255,1721,1317,7559
"04013093105",2253,2341,117,226,499,296,1878,2242,9852
"04013093106",1864,903,94,36,1162,402,2171,886,7518
"04013093200",1316,651,357,80,236,317,817,559,4333
"04013103205",2557,150,28,0,158,0,161,2,3056
"04013103206",2352,98,28,0,158,0,178,13,2827
"04013103207",2337,52,21,9,47,7,113,0,2586
"04013103208",3206,323,118,0,313,98,774,39,4871
"04013103209",4161,556,7,0,276,69,35,241,5345
"04013103210",4248,1310,142,17,677,101,422,737,7654
"04013103211",3691,156,0,0,221,7,266,0,4341
"04013103212",3683,277,0,0,143,23,199,0,4325
"04013103214",3397,64,42,20,403,14,107,0,4047
"04013103215",2399,66,0,0,146,0,193,4,2808
"04013103216",4075,192,112,0,483,52,438,33,5385
"04013103217",4820,502,46,0,1139,117,385,0,7009
"04013103219",2385,164,13,0,292,10,39,0,2903
"04013103220",2303,82,35,0,413,80,118,0,3031
"04013103302",5176,1234,370,168,627,0,1878,310,9763
"04013103303",2622,484,14,0,194,8,211,144,3677
"04013103304",1993,1555,392,206,920,924,1837,2235,10062
"04013103305",1590,676,80,0,477,366,1531,729,5449
"04013103306",1866,1234,237,8,468,364,1249,1001,6427
"04013103400",3464,644,11,109,382,11,1039,83,5743
"04013103501",2453,550,62,47,407,80,659,384,4642
"04013103502",5023,432,0,19,203,135,327,201,6340
"04013103604",2746,600,45,53,616,132,770,316,5278
"04013103605",5300,125,11,0,270,16,364,0,6086
"04013103606",3212,443,0,365,190,144,543,121,5018
"04013103607",3933,314,61,9,381,28,451,216,5393
"04013103608",2557,348,129,36,697,26,557,55,4405
"04013103609",3077,605,246,59,645,143,896,219,5890
"04013103611",4526,173,62,0,279,82,165,82,5369
"04013103612",3467,284,300,155,570,90,733,227,5826
"04013103614",2518,362,30,13,519,11,515,106,4074
"04013103615",2098,1445,249,328,348,313,1514,1158,7453
"04013103701",2295,995,181,61,809,79,634,277,5331
"04013103702",2677,322,59,37,335,0,896,87,4413
"04013103900",4069,1005,56,2,573,269,807,403,7184
"04013104000",4469,854,225,105,930,91,1335,282,8291
"04013104100",4369,927,14,0,1147,133,866,313,7769
"04013104202",4099,380,197,0,210,42,534,71,5533
"04013104203",4999,442,49,42,718,38,1485,178,7951
"04013104204",2312,274,13,100,371,68,555,10,3703
"04013104205",3305,363,146,22,1090,262,1554,148,6890
"04013104206",2490,535,145,0,867,176,1166,216,5595
"04013104207",3537,290,57,2,241,78,892,41,5138
"04013104212",4671,559,293,129,561,166,1172,199,7750
"04013104214",1951,170,21,12,155,7,314,58,2688
"04013104215",3391,464,143,17,328,143,617,220,5323
"04013104216",3600,697,244,7,297,106,609,232,5792
"04013104217",3985,552,96,0,362,131,581,63,5770
"04013104218",2858,367,26,25,316,39,666,49,4346
"04013104219",2315,324,105,0,276,18,635,3,3676
"04013104221",4198,485,87,84,696,262,1123,283,7218
"04013104222",4147,454,421,16,946,25,828,222,7059
"04013104223",1452,171,11,0,248,100,333,0,2315
"04013104224",4128,724,66,85,391,152,449,83,6078
"04013104225",3040,193,9,0,237,177,390,144,4190
"04013104226",3015,283,420,62,246,66,547,21,4660
"04013104227",1388,301,172,21,226,8,467,233,2816
"04013104301",2723,690,182,85,155,185,865,563,5448
"04013104302",1896,684,335,256,230,56,546,71,4074
"04013104401",2879,412,201,42,412,148,1234,252,5580
"04013104402",1082,299,33,78,1024,288,370,109,3283
"04013104501",1270,1201,176,195,214,349,887,1096,5388
"04013104502",2667,1979,90,239,115,206,1955,1699,8950
"04013104600",2285,1493,187,19,216,231,1071,1253,6755
"04013104701",1448,479,92,25,370,179,536,400,3529
"04013104702",2307,1026,118,73,226,193,779,646,5368
"04013104801",2808,193,0,0,325,7,144,107,3584
"04013104802",4700,276,204,0,276,42,384,3,5885
"04013104900",3882,148,34,0,154,15,549,14,4796
"04013105002",2522,247,7,0,235,0,223,124,3358
"04013105003",3955,404,13,3,173,0,200,27,4775
"04013105004",2614,234,176,0,404,0,315,35,3778
"04013105101",3948,152,67,0,98,6,214,12,4497
"04013105102",3380,305,0,0,298,50,190,15,4238
"04013105103",2636,94,11,4,145,0,158,2,3050
"04013105200",4102,1150,273,220,370,219,1401,571,8306
"04013105300",3834,1054,65,17,135,18,1017,487,6627
"04013105400",3008,156,318,38,131,4,424,29,4108
"04013105501",959,772,199,194,408,133,631,550,3846
"04013105502",619,438,264,125,281,265,437,262,2691
"04013105503",1255,605,252,426,458,170,643,343,4152
"04013105601",2508,962,14,187,360,334,1668,894,6927
"04013105602",3070,1908,699,412,586,445,1116,1292,9528
"04013105701",1989,484,99,0,435,64,497,468,4036
"04013105702",2428,547,106,57,409,244,1218,556,5565
"04013105800",3875,792,146,0,1173,620,2446,712,9764
"04013105900",2841,1485,132,172,361,131,1046,804,6972
"04013106001",851,504,73,109,170,36,402,297,2442
"04013106002",1444,356,77,36,112,172,661,196,3054
"04013106003",1777,612,195,43,383,234,937,524,4705
"04013106100",3850,364,86,30,369,46,529,165,5439
"04013106200",2961,108,61,0,224,0,245,0,3599
"04013106300",3474,847,118,27,99,26,398,83,5072
"04013106400",2113,176,92,0,531,32,333,63,3340
"04013106501",2404,329,18,0,381,197,463,200,3992
"04013106502",2526,284,195,83,440,58,582,33,4201
"04013106600",3177,107,40,0,333,25,472,19,4173
"04013106701",1364,805,129,387,244,705,547,347,4528
"04013106702",934,98,75,107,83,332,208,21,1858
"04013106703",1819,159,55,0,211,47,598,12,2901
"04013106801",1076,1068,454,334,469,404,993,918,5716
"04013106802",2218,671,83,43,493,32,1008,381,4929
"04013106900",3933,1324,509,51,1589,500,3511,1222,12639
"04013107000",3505,1593,146,241,822,363,2675,1163,10508
"04013107101",2235,1282,187,117,522,337,1953,1078,7711
"04013107102",1417,2268,462,151,307,576,1216,2242,8639
"04013107201",810,468,79,78,369,792,727,823,4146
"04013107202",2471,1660,45,25,1164,58,2263,1059,8745
"04013107300",2927,1485,438,186,1419,236,2410,1145,10246
"04013107400",3242,1214,502,452,966,744,1480,878,9478
"04013107500",2838,120,185,26,220,64,260,19,3732
"04013107601",2127,635,14,107,277,295,605,222,4282
"04013107602",1856,212,79,100,302,386,445,373,3753
"04013107700",2446,304,371,27,537,90,429,152,4356
"04013107800",2341,131,11,0,79,0,94,16,2672
"04013107900",3171,35,0,18,304,172,264,0,3964
"04013108000",3169,28,0,0,162,0,195,0,3554
"04013108100",1485,103,48,0,127,64,183,39,2049
"04013108200",2715,314,42,23,161,105,509,99,3968
"04013108301",3123,348,0,0,200,48,387,143,4249
"04013108302",2157,163,35,26,342,102,216,88,3129
"04013108400",3548,420,40,188,436,307,795,155,5889
"04013108501",1479,206,97,28,426,116,584,143,3079
"04013108502",2572,413,161,14,802,116,604,317,4999
"04013108601",745,721,220,72,638,155,661,598,3810
"04013108602",2157,329,98,174,1366,299,1514,352,6289
"04013108802",1040,295,27,66,432,92,295,128,2375
"04013108901",1171,434,119,85,612,240,599,502,3762
"04013108902",1884,1239,137,143,561,395,932,813,6104
"04013109001",1527,1713,220,262,740,501,1328,1611,7902
"04013109002",1538,1210,298,265,452,546,1169,1292,6770
"04013109003",1958,2478,57,195,932,526,2268,2505,10919
"04013109101",1421,1024,80,109,460,343,1449,1168,6054
"04013109102",2147,1432,186,357,1057,136,2806,1282,9403
"04013109200",1332,1583,58,341,326,336,1231,1501,6708
"04013109300",2304,2027,245,84,415,50,2226,1911,9262
"04013109400",2122,3267,86,105,1026,913,1825,3582,12926
"04013109500",2868,497,184,99,1418,167,3056,585,8874
"04013109601",2620,1419,262,158,1238,197,3157,1379,10430
"04013109602",2774,1681,401,144,793,877,2947,2297,11914
"04013109603",2550,1607,313,0,553,399,2708,1805,9935
"04013109604",1859,649,149,307,647,315,1966,1005,6897
"04013109701",2560,2552,30,185,1699,1356,3695,3490,15567
"04013109702",2477,1445,104,240,1011,440,2870,1632,10219
"04013109703",1122,801,74,47,763,99,1444,800,5150
"04013109704",1078,425,186,18,647,505,1487,861,5207
"04013109705",1112,522,66,0,379,31,1257,529,3896
"04013109801",1714,1034,85,111,964,493,2442,1506,8349
"04013109802",2251,1230,9,49,939,714,2452,1745,9389
"04013109900",2948,3119,235,131,342,539,2735,3536,13585
"04013110001",2042,1160,62,80,404,208,1934,1161,7051
"04013110002",714,1511,79,213,554,299,1120,1597,6087
"04013110100",2065,3383,140,0,521,188,2348,3352,11997
"04013110400",3202,483,25,63,708,236,1302,109,6128
"04013110501",2092,179,84,30,653,78,380,48,3544
"04013110502",1130,397,242,58,578,89,507,59,3060
"04013110600",2279,491,989,0,259,286,686,399,5389
"04013110701",1137,702,179,104,191,318,625,584,3840
"04013110702",2264,829,78,159,502,211,1396,698,6137
"04013110801",2309,813,322,112,792,520,1028,477,6373
"04013110802",1577,388,29,22,216,72,589,244,3137
"04013110901",1785,593,0,139,382,570,666,630,4765
"04013110902",2585,1007,110,60,748,980,1262,1293,8045
"04013111000",3445,265,340,57,516,167,890,151,5831
"04013111100",3094,190,29,74,473,60,523,10,4453
"04013111201",2166,1242,485,97,909,1066,1190,1794,8949
"04013111202",651,288,94,59,404,242,645,401,2784
"04013111203",430,195,277,320,254,77,199,27,1779
"04013111204",1244,281,228,13,309,45,364,222,2706
"04013111300",3851,345,260,142,696,221,1480,241,7236
"04013111401",2127,798,146,0,1246,530,2515,1087,8449
"04013111402",2134,554,399,80,651,673,1715,827,7033
"04013111501",523,400,5,0,339,452,714,832,3265
"04013111502",2091,963,106,96,1412,836,2251,1445,9200
"04013111601",1043,677,181,45,983,466,1425,832,5652
"04013111602",1417,1237,45,44,1103,850,1838,1722,8256
"04013111700",2963,992,156,2,935,732,1258,1164,8202
"04013111800",2795,365,88,90,338,25,444,28,4173
"04013111900",1672,121,145,10,246,82,418,110,2804
"04013112100",1575,1891,7,31,322,206,1678,1997,7707
"04013112201",2158,1390,56,1,216,197,2180,1483,7681
"04013112202",2112,1085,253,33,443,285,2099,1241,7551
"04013112301",2027,1245,204,89,1308,600,3038,1844,10355
"04013112302",2388,2046,340,105,1856,880,3303,2728,13646
"04013112401",2859,1360,500,252,735,560,3353,2007,11626
"04013112402",2755,1476,153,133,999,32,3454,1505,10507
"04013112502",1990,1917,225,0,1116,402,2700,2231,10581
"04013112503",3309,2247,70,58,1881,1140,4235,2967,15907
"04013112504",1780,1193,195,31,571,292,2012,1360,7434
"04013112505",3329,3599,55,41,1475,348,4003,3865,16715
"04013112507",717,1207,113,80,273,366,957,1385,5098
"04013112508",1192,552,0,38,116,74,956,576,3504
"04013112509",3516,2768,944,254,1407,838,4020,3024,16771
"04013112510",3199,684,294,58,557,16,3251,711,8770
"04013112511",6417,1187,251,136,627,185,5933,1083,15819
"04013112512",1056,648,170,57,181,49,882,608,3651
"04013112513",5637,653,722,413,843,495,5179,761,14703
"04013112514",1554,401,994,19,1214,321,1558,658,6719
"04013112601",1029,993,35,86,241,193,974,954,4505
"04013112602",1647,4425,0,20,736,472,2020,4668,13988
"04013112700",2362,2858,126,145,538,326,2683,3089,12127
"04013112900",2117,1868,80,214,592,134,1422,1505,7932
"04013113000",1493,189,129,20,145,13,327,67,2383
"04013113100",822,567,257,113,197,80,291,129,2456
"04013113201",897,918,22,60,323,733,1069,1438,5460
"04013113202",449,681,54,62,355,470,614,919,3604
"04013113203",895,635,24,47,467,349,945,829,4191
"04013113300",1191,1542,73,180,371,1678,1022,2711,8768
"04013113400",0,0,0,0,0,0,0,0,0
"04013113501",1588,558,333,410,1251,668,2382,1147,8337
"04013113502",635,516,71,184,611,808,1122,1274,5221
"04013113601",1390,709,279,44,1615,289,1967,885,7178
"04013113602",610,639,481,256,743,807,1096,1338,5970
"04013113700",2809,888,479,1121,1353,1209,2343,1520,11722
"04013113801",731,327,79,0,355,383,431,561,2867
"04013113802",0,0,0,0,0,0,0,0,0
"04013113900",95,353,36,48,133,255,148,574,1642
"04013114000",591,434,300,79,163,326,240,446,2579
"04013114100",482,90,54,32,53,27,45,29,812
"04013114200",485,683,24,209,68,91,400,627,2587
"04013114301",215,419,82,49,13,64,114,120,1076
"04013114302",650,824,580,519,266,135,785,826,4585
"04013114401",759,869,107,96,172,98,862,809,3772
"04013114402",520,718,56,138,64,144,497,777,2914
"04013114500",864,1551,159,86,454,302,1124,1815,6355
"04013114600",848,1040,0,2,215,77,1000,1075,4257
"04013114703",376,443,0,10,83,65,384,415,1776
"04013114800",1519,889,178,184,368,407,1648,1058,6251
"04013114900",672,1279,91,96,222,241,627,1272,4500
"04013115200",868,579,436,250,267,241,655,587,3883
"04013115300",908,453,316,344,514,460,1208,805,5008
"04013115400",749,522,76,9,722,297,1368,712,4455
"04013115500",1785,907,48,0,556,187,1953,1008,6444
"04013115600",1755,689,853,535,420,395,1662,908,7217
"04013115700",2690,2172,425,0,970,509,3317,2540,12623
"04013115801",1428,1759,126,138,404,752,1660,2294,8561
"04013115802",1615,1246,203,217,381,131,1763,1254,6810
"04013115900",1211,1051,824,230,1145,799,1886,1766,8912
"04013116000",2301,358,1061,568,1141,289,2203,454,8375
"04013116100",1125,1216,522,327,348,240,1341,1350,6469
"04013116202",1980,953,294,264,1470,389,2836,1079,9265
"04013116203",1953,464,517,150,967,740,1340,991,7122
"04013116204",1388,217,175,23,1478,149,1922,202,5554
"04013116205",1501,993,499,158,703,753,812,1346,6765
"04013116300",1581,382,1382,241,1908,1141,2626,1440,10701
"04013116400",2054,652,687,141,1357,1221,2762,1654,10528
"04013116500",2257,927,334,75,831,582,2776,1424,9206
"04013116602",3464,1500,1518,160,931,613,3355,1911,13452
"04013116603",3295,90,1372,328,1436,120,2801,115,9557
"04013116604",1892,341,769,341,910,485,1641,428,6807
"04013116605",2919,331,781,543,1061,198,2585,282,8700
"04013116606",2587,700,1323,112,1654,241,2903,878,10398
"04013116607",1574,32,1009,142,265,111,1574,56,4763
"04013116608",1777,477,433,104,653,54,1195,377,5070
"04013116609",1901,131,1310,0,440,8,946,12,4748
"04013116610",2470,309,846,415,983,204,1898,210,7335
"04013116611",2516,35,287,208,809,83,1546,34,5518
"04013116612",2197,482,960,0,1652,0,2347,365,8003
"04013116613",2711,830,796,118,1394,229,1547,998,8623
"04013116702",2937,1244,621,184,1846,1084,3382,1977,13275
"04013116703",1626,183,777,5,1278,283,1624,443,6219
"04013116704",3790,207,1270,42,1703,159,2046,125,9342
"04013116707",2104,73,15,0,430,0,370,0,2992
"04013116708",4350,216,120,76,399,81,455,137,5834
"04013116709",1187,109,155,5,336,16,192,4,2004
"04013116710",3607,103,103,10,585,18,507,12,4945
"04013116711",1274,60,286,29,395,15,202,5,2266
"04013116712",4338,365,279,88,1022,137,1026,102,7357
"04013116713",5237,482,224,75,536,174,1072,403,8203
"04013116714",2835,175,153,0,483,13,406,13,4078
"04013116715",1767,70,28,0,242,0,316,31,2454
"04013116717",2305,97,422,49,1090,172,773,79,4987
"04013116718",1852,158,234,56,231,148,592,47,3318
"04013116719",5399,188,181,48,647,29,1122,76,7690
"04013116720",2575,319,157,11,734,21,883,89,4789
"04013116721",2803,307,21,0,266,34,265,43,3739
"04013116725",3923,159,241,0,485,17,464,64,5353
"04013116727",3123,69,68,12,435,0,332,0,4039
"04013116728",3865,59,183,0,724,16,418,0,5265
"04013116729",3453,82,123,0,559,13,347,46,4623
"04013116730",1178,64,188,0,498,5,136,0,2069
"04013116731",2776,100,57,0,352,0,349,0,3634
"04013116732",2071,754,136,0,682,181,1596,711,6131
"04013116733",373,0,0,0,39,0,28,0,440
"04013116800",1541,900,113,0,103,16,698,606,3977
"04013116900",841,977,30,0,95,219,862,1141,4165
"04013117000",2444,947,619,230,1007,632,2024,870,8773
"04013117100",1408,234,108,10,537,11,596,29,2933
"04013117200",262,183,57,0,303,275,505,430,2015
"04013117300",258,721,7,20,36,84,240,779,2145
"04013216806",2597,133,14,17,217,82,137,8,3205
"04013216807",4580,185,10,0,162,0,156,0,5093
"04013216809",4265,156,142,0,515,90,86,9,5263
"04013216810",1001,93,4,0,144,12,65,0,1319
"04013216813",3838,94,58,0,163,17,33,0,4203
"04013216816",4362,566,0,0,478,12,191,195,5804
"04013216818",5826,317,236,83,138,21,85,22,6728
"04013216819",5840,172,38,4,167,19,152,5,6397
"04013216820",3913,322,0,0,268,28,345,55,4931
"04013216821",5239,288,38,62,183,39,58,19,5926
"04013216822",3472,186,96,0,234,0,118,25,4131
"04013216826",3683,303,74,0,214,50,38,18,4380
"04013216829",3826,219,192,31,548,0,58,0,4874
"04013216830",2611,233,112,0,125,75,73,28,3257
"04013216831",2484,158,18,0,99,69,144,145,3117
"04013216832",1596,159,11,0,35,0,81,0,1882
"04013216833",3578,585,20,0,346,38,212,55,4834
"04013216834",1851,42,42,0,47,2,170,18,2172
"04013216835",1847,145,108,29,158,8,183,19,2497
"04013216836",2527,553,8,0,268,50,68,0,3474
"04013216837",4039,257,40,0,674,0,270,41,5321
"04013216838",4011,137,93,0,592,0,260,3,5096
"04013216839",3341,166,35,0,221,0,218,0,3981
"04013216840",4524,137,60,0,143,24,84,0,4972
"04013216841",3069,141,9,0,348,24,170,25,3786
"04013216842",3148,154,0,25,412,25,235,0,3999
"04013216843",2859,80,0,0,121,26,104,0,3190
"04013216844",3209,265,7,0,264,3,143,0,3891
"04013216845",1643,29,70,0,256,50,191,0,2239
"04013216846",6216,347,133,0,572,42,430,0,7740
"04013216847",5371,429,14,0,763,20,499,0,7096
"04013216848",5222,263,0,1,622,0,373,60,6541
"04013216849",5157,235,0,0,712,19,183,13,6319
"04013216850",3175,60,18,0,379,0,699,29,4360
"04013216851",3115,188,59,0,134,77,214,28,3815
"04013216852",2887,111,7,27,256,20,343,0,3651
"04013216853",3731,617,72,11,534,89,138,9,5201
"04013216901",2406,119,0,0,92,153,50,130,2950
"04013216902",3308,243,29,16,177,1,192,9,3975
"04013217001",3889,555,0,0,405,0,331,0,5180
"04013217002",4497,260,104,0,439,57,627,0,5984
"04013217101",2255,214,0,0,148,64,194,92,2967
"04013217102",2439,312,0,9,80,32,244,150,3266
"04013217201",1055,197,14,0,159,29,204,28,1686
"04013217203",2727,261,236,0,200,61,185,138,3808
"04013217204",2062,410,132,64,319,619,178,659,4443
"04013217300",2644,179,31,26,161,21,152,9,3223
"04013217400",2945,247,23,12,112,3,301,12,3655
"04013217501",1607,925,95,29,209,776,345,1486,5472
"04013217502",2246,344,120,113,149,107,525,139,3743
"04013217600",3651,458,195,2,659,100,1234,196,6495
"04013217700",4242,601,173,44,135,55,488,429,6167
"04013217800",4962,1353,428,0,526,82,714,740,8805
"04013217900",3419,181,31,19,305,281,359,290,4885
"04013218000",4153,876,119,0,150,335,1021,335,6989
"04013218100",1529,169,178,0,173,12,441,108,2610
"04013218200",3379,700,69,0,1529,306,1859,418,8260
"04013218300",3155,548,0,0,418,43,309,15,4488
"04013318400",1822,1251,51,0,808,270,1256,696,6154
"04013318501",2515,584,30,0,441,77,834,115,4596
"04013318700",419,206,8,12,28,54,10,14,751
"04013318800",2990,1154,311,47,1006,658,1089,704,7959
"04013318900",3665,1250,234,1,713,743,1188,320,8114
"04013319000",1420,599,42,18,121,69,88,41,2398
"04013319101",367,744,8,209,322,936,205,559,3350
"04013319103",944,1630,120,79,618,1425,356,538,5710
"04013319104",1989,1675,62,198,609,1114,592,673,6912
"04013319201",2064,1335,305,120,673,586,994,753,6830
"04013319202",1335,866,260,283,193,536,266,552,4291
"04013319300",1157,628,165,149,604,132,835,139,3809
"04013319401",4601,663,321,27,596,167,996,327,7698
"04013319402",3122,149,147,8,437,78,483,58,4482
"04013319403",2764,589,300,112,354,438,514,403,5474
"04013319404",2687,169,73,15,282,22,560,22,3830
"04013319500",3384,1070,247,24,1051,85,1135,106,7102
"04013319600",4404,604,70,73,713,103,984,93,7044
"04013319703",2486,344,82,141,753,276,662,140,4884
"04013319704",850,270,112,0,274,57,337,77,1977
"04013319705",2085,324,92,104,286,301,462,256,3910
"04013319706",2480,922,363,41,1231,498,1590,1134,8259
"04013319800",3555,895,461,70,926,455,1263,570,8195
"04013319902",1721,237,62,90,409,0,475,55,3049
"04013319903",4569,338,85,14,1107,28,1149,43,7333
"04013319904",3948,157,318,0,381,36,987,52,5879
"04013319905",4053,390,61,14,507,47,955,36,6063
"04013319906",2329,55,220,13,670,38,422,10,3757
"04013319907",2077,48,67,0,94,0,132,0,2418
"04013319908",1465,178,108,43,487,18,606,57,2962
"04013319909",2004,54,36,1,281,46,244,12,2678
"04013319910",3162,212,31,0,961,180,279,59,4884
"04013320001",2803,387,1040,243,1661,431,1187,195,7947
"04013320002",1049,253,47,99,3394,1130,2813,667,9452
"04013320007",3805,377,464,15,2361,565,2315,315,10217
"04013320100",1710,363,12,58,473,142,347,86,3191
"04013420104",4687,325,26,0,225,28,604,12,5907
"04013420105",4943,251,0,8,330,35,414,55,6036
"04013420107",5722,71,80,0,211,0,358,0,6442
"04013420108",1248,34,15,0,62,0,158,0,1517
"04013420109",3902,123,106,0,164,27,279,5,4606
"04013420110",4531,650,46,0,61,42,633,142,6105
"04013420111",3145,501,11,0,371,24,903,30,4985
"04013420112",2591,121,7,143,194,11,347,47,3461
"04013420113",1995,796,111,33,437,92,542,99,4105
"04013420114",2034,981,154,35,391,71,652,295,4613
"04013420115",1936,623,47,0,94,150,601,194,3645
"04013420116",1806,423,8,15,214,29,240,171,2906
"04013420202",4677,405,30,68,334,0,756,155,6425
"04013420206",2727,548,0,0,92,0,78,72,3517
"04013420207",2282,121,0,0,128,0,153,0,2684
"04013420208",4139,575,92,42,311,174,1108,456,6897
"04013420209",3686,194,100,0,227,10,361,44,4622
"04013420210",3796,411,52,0,457,185,635,148,5684
"04013420211",3762,78,13,0,259,20,274,10,4416
"04013420212",2673,211,20,2,57,1,121,43,3128
"04013420213",2233,177,0,0,31,0,12,0,2453
"04013420214",2679,456,119,0,118,107,229,117,3825
"04013420215",1067,334,30,18,141,0,128,102,1820
"04013420216",3116,419,110,225,130,78,429,131,4638
"04013420301",1760,98,43,4,229,10,233,5,2382
"04013420302",4083,605,39,46,387,49,504,41,5754
"04013420303",3008,276,7,41,376,39,301,232,4280
"04013420304",946,36,3,0,214,10,11,0,1220
"04013420401",2328,1331,53,98,239,447,874,850,6220
"04013420402",1437,355,0,3,102,11,95,61,2064
"04013420501",4280,1082,187,144,604,313,1968,626,9204
"04013420503",2238,513,351,64,407,133,223,242,4171
"04013420504",2245,299,57,29,453,22,542,152,3799
"04013420602",4083,377,90,0,246,11,901,196,5904
"04013420603",2831,315,71,0,441,0,549,87,4294
"04013420604",3454,186,51,0,289,27,528,27,4562
"04013420704",4005,598,199,10,224,198,594,248,6076
"04013420705",2824,210,26,8,455,0,117,8,3648
"04013420706",3158,443,55,10,496,51,421,196,4830
"04013420707",1921,339,102,26,96,66,171,92,2813
"04013420708",3055,371,105,0,398,136,322,36,4423
"04013420709",2972,339,0,11,44,164,329,73,3932
"04013420710",2423,601,222,51,27,76,603,320,4323
"04013420800",3459,702,92,7,224,52,682,500,5718
"04013420901",2211,1277,159,0,109,262,1215,957,6190
"04013420902",2284,584,37,47,283,127,648,390,4400
"04013421001",2496,798,102,32,56,202,670,643,4999
"04013421002",1520,546,81,112,398,87,646,380,3770
"04013421101",2752,742,171,27,570,143,1316,453,6174
"04013421102",3337,1017,351,71,1259,490,1163,578,8266
"04013421201",3209,582,303,83,637,385,912,307,6418
"04013421202",2940,517,73,107,611,115,1282,262,5907
"04013421302",3366,1171,125,0,543,309,1773,1301,8588
"04013421303",2601,882,147,239,800,269,1327,533,6798
"04013421304",1418,477,132,104,557,158,529,198,3573
"04013421400",1204,447,75,124,281,109,599,263,3102
"04013421501",2056,779,0,0,664,225,1463,657,5844
"04013421502",2130,745,28,122,105,141,1079,787,5137
"04013421601",2138,919,26,3,499,104,1155,696,5540
"04013421602",2725,1032,23,16,353,246,1888,1201,7484
"04013421701",2795,585,511,107,585,171,1300,173,6227
"04013421702",2813,588,86,0,275,68,1342,434,5606
"04013421801",1539,436,14,0,357,373,988,657,4364
"04013421802",2976,1169,0,137,339,346,1792,1287,8046
"04013421901",2503,446,69,156,331,298,1749,329,5881
"04013421902",2991,1898,29,65,977,681,3175,2291,12107
"04013422001",2126,1932,40,7,87,241,1286,1859,7578
"04013422002",2347,1046,70,94,212,69,1771,817,6426
"04013422102",2972,588,74,74,716,261,2174,355,7214
"04013422103",1763,912,111,76,714,334,440,358,4708
"04013422104",2964,873,107,186,604,994,1316,1179,8223
"04013422105",2051,798,18,18,253,200,1001,638,4977
"04013422106",3120,1789,288,276,588,318,2009,1663,10051
"04013422107",1878,756,205,139,664,272,934,262,5110
"04013422203",2779,1257,425,66,665,81,726,589,6588
"04013422204",1813,375,144,76,561,157,491,126,3743
"04013422205",1145,38,0,0,121,0,158,9,1471
"04013422209",4880,629,437,0,747,313,1439,152,8597
"04013422210",4320,496,82,69,622,126,1094,113,6922
"04013422211",2186,149,0,0,195,0,287,46,2863
"04013422212",3220,329,125,0,456,16,480,129,4755
"04013422213",2224,209,22,4,311,32,583,32,3417
"04013422215",1560,188,87,26,233,2,450,84,2630
"04013422216",4711,257,49,0,455,79,894,64,6509
"04013422217",2669,342,102,0,488,12,509,28,4150
"04013422218",2188,185,20,10,401,75,507,29,3415
"04013422219",2357,213,80,20,384,96,611,47,3808
"04013422220",1673,91,46,0,277,0,272,0,2359
"04013422221",2637,352,99,0,494,26,538,137,4283
"04013422222",1558,221,77,49,299,65,337,144,2750
"04013422301",3557,1400,154,29,586,124,2713,1267,9830
"04013422302",3240,395,78,0,700,307,1129,402,6251
"04013422304",2286,217,117,51,275,9,833,104,3892
"04013422305",4369,275,99,0,1022,51,628,54,6498
"04013422307",3722,235,255,37,439,132,1312,26,6158
"04013422308",4040,265,174,8,973,94,1199,118,6871
"04013422309",3827,304,100,13,939,83,994,21,6281
"04013422401",1874,230,278,25,691,76,930,121,4225
"04013422402",3625,635,18,10,624,316,1025,539,6792
"04013422403",4104,312,58,0,757,14,960,47,6252
"04013422404",3807,103,53,0,541,11,600,0,5115
"04013422501",4467,329,441,26,659,2,1529,153,7606
"04013422502",4053,762,179,32,679,34,850,417,7006
"04013422503",4741,777,78,0,591,16,1697,364,8264
"04013422504",3938,616,59,20,475,198,990,400,6696
"04013422506",4148,307,185,0,518,55,866,16,6095
"04013422507",3615,321,46,0,563,0,367,80,4992
"04013422508",2793,430,46,0,258,180,226,55,3988
"04013422509",4177,215,131,0,734,21,745,114,6137
"04013422510",2783,249,9,30,317,162,338,30,3918
"04013422511",2783,83,41,0,222,0,322,48,3499
"04013422512",4363,195,141,0,925,0,1082,0,6706
"04013422513",3584,241,217,137,193,59,712,26,5169
"04013422514",3491,463,151,184,186,11,910,56,5452
"04013422606",9115,158,34,2,1209,0,1165,4,11687
"04013422607",3899,212,0,13,84,0,393,7,4608
"04013422609",2865,375,79,2,635,85,992,161,5194
"04013422610",2474,198,51,0,55,0,78,0,2856
"04013422615",5329,492,247,0,959,31,1029,86,8173
"04013422616",4067,368,93,0,365,0,734,15,5642
"04013422617",4765,234,194,10,664,109,636,22,6634
"04013422618",2776,108,9,0,16,0,79,0,2988
"04013422620",2896,77,15,10,332,16,402,0,3748
"04013422621",3468,643,21,0,620,0,634,0,5386
"04013422622",4457,118,117,38,433,48,797,0,6008
"04013422623",3310,607,154,1,553,186,581,200,5592
"04013422624",2303,323,0,11,31,0,67,17,2752
"04013422625",2274,463,44,0,246,66,48,65,3206
"04013422626",2020,401,0,5,56,9,105,166,2762
"04013422627",2672,918,0,0,290,64,1024,104,5072
"04013422628",2362,1227,62,30,89,23,779,353,4925
"04013422629",2627,212,71,1,117,0,559,0,3587
"04013422630",3175,1430,0,0,18,6,209,575,5413
"04013422631",2984,460,613,0,542,67,719,146,5531
"04013422632",3220,432,249,0,98,13,667,1,4680
"04013422633",2609,522,56,30,355,43,745,239,4599
"04013422634",3437,777,19,0,59,0,930,383,5605
"04013422635",1846,143,0,0,114,6,395,0,2504
"04013422636",1732,83,200,25,232,127,115,16,2530
"04013422637",2800,266,221,0,232,0,430,79,4028
"04013422638",2770,630,257,0,377,67,935,200,5236
"04013422639",2948,408,38,0,114,0,26,0,3534
"04013422640",3856,273,53,0,306,135,602,181,5406
"04013422641",4271,552,202,14,694,106,1007,103,6949
"04013422642",3932,201,56,65,1218,0,1076,22,6570
"04013422643",4892,297,173,3,722,37,1303,60,7487
"04013422644",6287,592,0,0,465,0,421,249,8014
"04013422646",7745,135,418,66,797,322,1235,322,11040
"04013522800",528,227,24,27,81,42,47,23,999
"04013522901",3177,420,133,10,544,131,1150,141,5706
"04013522903",3057,1004,398,253,294,454,2546,1261,9267
"04013522904",2030,1571,225,30,1028,324,1383,1747,8338
"04013523002",3777,1267,129,0,432,302,2463,1226,9596
"04013523003",3765,1008,447,69,1053,441,1721,932,9436
"04013523005",3699,241,112,130,857,30,1093,38,6200
"04013523006",3936,746,252,34,783,122,1006,489,7368
"04013523102",3089,1369,319,170,472,335,1766,1404,8924
"04013523103",3579,297,424,23,1098,210,952,282,6865
"04013523104",3442,859,150,188,655,73,1993,698,8058
"04013610000",5016,107,78,0,774,0,390,0,6365
"04013610100",793,23,26,0,130,0,106,0,1078
"04013610200",7028,301,33,0,275,0,1232,0,8869
"04013610300",8112,245,63,0,1126,0,980,27,10553
"04013610400",5345,92,39,0,303,24,704,11,6518
"04013610500",5776,164,0,0,308,0,420,0,6668
"04013610600",4539,227,95,1,327,0,367,15,5571
"04013610700",6586,1017,39,0,325,3,985,36,8991
"04013610800",3216,82,238,0,553,0,511,35,4635
"04013610900",5891,73,95,10,1138,43,486,2,7738
"04013611000",2298,10,48,53,191,17,46,18,2681
"04013611100",2820,34,47,0,188,28,269,0,3386
"04013611200",4747,112,220,14,689,0,713,17,6512
"04013611300",3735,296,88,21,529,19,577,12,5277
"04013611400",5791,193,213,0,311,0,553,0,7061
"04013611500",5200,124,96,1,1142,1,468,2,7034
"04013611600",2817,77,36,0,278,0,387,0,3595
"04013611700",5131,286,95,19,106,58,283,0,5978
"04013611800",6004,453,69,0,521,0,606,0,7653
"04013611900",2318,71,47,0,282,5,240,0,2963
"04013612000",2731,16,23,0,136,0,134,0,3040
"04013612200",3292,406,118,0,625,0,536,0,4977
"04013612300",6015,420,303,3,1469,50,1062,282,9604
"04013612400",6283,317,0,0,708,83,557,36,7984
"04013612500",3955,155,27,0,108,0,170,0,4415
"04013612600",2034,41,11,0,62,0,82,0,2230
"04013612700",2089,70,0,0,90,18,118,0,2385
"04013612800",1916,83,0,0,117,0,132,12,2260
"04013612900",2295,59,0,6,89,1,105,1,2556
"04013613000",3466,201,12,0,185,1,375,0,4240
"04013613100",2290,148,18,0,261,0,61,0,2778
"04013613200",3133,215,14,0,418,41,71,0,3892
"04013613300",6411,615,62,0,499,0,528,40,8155
"04013613400",3331,288,0,0,57,0,299,23,3998
"04013613500",3821,252,54,1,352,9,386,0,4875
"04013613600",3658,160,34,3,396,87,626,2,4966
"04013613700",4795,212,115,0,364,47,534,85,6152
"04013613800",3614,10,201,0,182,0,407,0,4414
"04013613900",5396,288,10,0,606,12,532,0,6844
"04013614000",4055,188,63,0,193,0,434,0,4933
"04013614100",4975,199,372,0,858,0,630,83,7117
"04013614200",4198,206,65,0,346,96,390,11,5312
"04013614300",2256,94,77,1,484,68,190,9,3179
"04013614400",2567,448,61,0,270,12,518,12,3888
"04013614500",3007,544,131,0,586,72,485,259,5084
"04013614600",4588,556,290,147,472,45,781,67,6946
"04013614700",1621,475,133,71,48,0,415,138,2901
"04013614800",2906,491,44,11,482,146,616,12,4708
"04013614900",2582,330,123,13,703,94,183,0,4028
"04013615000",6788,410,79,0,1119,0,563,107,9066
"04013615100",3086,263,16,0,408,0,231,65,4069
"04013615200",5239,170,83,0,491,13,497,0,6493
"04013615300",1937,261,9,0,35,11,49,1,2303
"04013615400",2430,195,0,0,36,9,28,18,2716
"04013615500",2538,89,28,0,36,0,64,0,2755
"04013615600",3470,282,0,0,3,0,433,27,4215
"04013615700",2231,105,30,0,238,0,107,2,2713
"04013615800",4208,254,65,0,722,43,472,19,5783
"04013615900",2973,688,12,0,466,97,305,47,4588
"04013616000",1201,109,25,5,306,19,209,6,1880
"04013616100",2902,177,52,0,178,56,551,21,3937
"04013616200",2844,218,73,0,221,8,548,11,3923
"04013616300",1666,126,0,1,172,0,295,1,2261
"04013616400",2509,336,26,107,1850,156,91,24,5099
"04013616500",2100,247,236,120,366,27,449,114,3659
"04013616600",5044,508,236,1,413,39,1128,33,7402
"04013616700",3536,331,75,0,511,0,806,0,5259
"04013616800",4538,830,100,0,597,3,1036,344,7448
"04013616900",3366,477,72,87,160,268,282,61,4773
"04013617000",4370,1166,150,0,615,42,1399,465,8207
"04013617100",1970,138,50,0,178,23,141,35,2535
"04013617200",2295,38,74,0,295,0,284,0,2986
"04013617300",2574,107,50,9,535,3,366,0,3644
"04013617400",6127,638,272,21,106,19,413,0,7596
"04013617500",3071,252,27,0,71,0,182,0,3603
"04013617600",4807,436,184,0,638,10,893,9,6977
"04013617700",2903,280,107,50,590,68,420,73,4491
"04013617800",2472,68,17,0,40,6,310,0,2913
"04013617900",2270,183,36,0,217,76,477,102,3361
"04013618000",3702,518,195,17,588,80,615,18,5733
"04013618100",3674,195,46,0,420,14,496,29,4874
"04013618200",2803,315,91,43,309,224,492,9,4286
"04013618300",2480,123,88,0,300,64,509,0,3564
"04013618400",2705,608,150,10,323,29,574,348,4747
"04013618500",2946,350,117,36,311,60,842,112,4774
"04013618600",3190,986,0,0,311,171,779,514,5951
"04013618700",2232,498,11,0,210,77,453,321,3802
"04013618800",3001,1262,178,29,470,42,1058,738,6778
"04013618900",4318,775,215,65,945,45,617,155,7135
"04013619000",2938,164,35,35,201,0,401,49,3823
"04013619100",1605,534,302,56,270,67,715,124,3673
"04013619200",3258,1758,114,190,385,192,1867,1012,8776
"04013619300",3131,932,32,20,504,22,874,570,6085
"04013619400",2915,641,133,0,658,69,877,394,5687
"04013619500",4384,1005,67,0,474,114,1121,602,7767
"04013619600",1581,124,60,0,173,16,277,8,2239
"04013619700",3028,272,195,18,316,66,985,108,4988
"04013619800",2943,211,127,2,1335,44,453,11,5126
"04013619900",4352,245,41,0,1033,0,304,0,5975
"04013723303",45,0,0,0,0,0,0,0,45
"04013723304",3220,726,39,98,270,0,1398,369,6120
"04013723305",1598,462,18,0,216,262,1276,380,4212
"04013723306",46,59,0,0,0,6,3,65,179
"04013723307",2035,66,37,0,246,18,308,25,2735
"04013723308",5921,355,317,0,623,117,1232,175,8740
"04013810000",1188,23,58,0,507,68,129,37,2010
"04013810100",5464,168,115,8,825,55,684,0,7319
"04013810200",2189,161,377,14,674,19,198,112,3744
"04013810300",4195,574,182,78,1031,32,977,325,7394
"04013810400",3272,243,240,62,1045,120,824,150,5956
"04013810500",4188,53,337,0,606,71,653,0,5908
"04013810600",4898,96,319,1,943,12,850,2,7121
"04013810700",4840,237,657,2,851,590,1474,327,8978
"04013810800",3279,258,23,13,1044,97,596,149,5459
"04013810900",4114,73,556,0,646,197,701,0,6287
"04013811000",2392,13,15,0,455,0,415,0,3290
"04013811100",1902,52,48,6,220,185,464,0,2877
"04013811200",1682,77,183,133,804,78,558,0,3515
"04013811300",2359,200,40,33,547,24,577,91,3871
"04013811400",4593,243,73,0,478,0,992,77,6456
"04013811500",1795,51,215,7,434,73,371,24,2970
"04013811600",2917,420,213,0,766,17,602,220,5155
"04013811700",3548,345,171,37,535,11,1270,213,6130
"04013811800",1438,16,203,10,715,0,210,7,2599
"04013811900",4893,118,118,0,1031,24,1268,62,7514
"04013812000",2757,685,84,0,570,234,745,512,5587
"04013812100",4093,274,455,1,1493,105,1424,234,8079
"04013812200",6324,74,167,1,1332,38,1568,18,9522
"04013812300",3669,154,359,16,823,121,617,81,5840
"04013812400",2834,227,79,0,864,69,345,0,4418
"04013812500",1564,2,4,213,636,0,414,0,2833
"04013812600",3439,202,190,0,507,16,443,14,4811
"04013812700",4310,164,246,0,1119,253,529,335,6956
"04013812800",3180,447,94,0,1230,17,540,25,5533
"04013812900",2001,178,52,0,583,13,222,0,3049
"04013813000",3164,81,49,0,888,40,206,18,4446
"04013813100",1971,0,16,6,592,5,235,0,2825
"04013813200",3172,29,71,21,843,12,293,0,4441
"04013813300",4397,6,59,3,1416,17,693,0,6591
"04013813400",2678,73,111,0,834,1,679,26,4402
"04013813500",2848,33,194,0,431,0,304,0,3810
"04013813600",2671,32,133,0,551,32,378,12,3809
"04013813700",2226,156,72,0,48,0,64,0,2566
"04013813800",2300,227,0,0,16,0,46,0,2589
"04013813900",4371,254,404,59,737,132,1247,22,7226
"04013814000",2325,175,0,0,63,0,231,0,2794
"04013814100",4647,305,157,0,913,72,1415,46,7555
"04013814200",2050,132,77,20,291,40,202,47,2859
"04013814300",3055,94,182,0,614,94,576,1,4616
"04013814400",4339,175,162,0,491,55,823,31,6076
"04013814500",4504,157,256,0,538,0,1091,45,6591
"04013814600",3750,219,93,0,554,63,857,115,5651
"04013814700",3604,143,719,0,230,9,490,63,5258
"04013814800",5187,463,155,181,1108,0,1098,37,8229
"04013814900",2223,33,26,0,347,14,544,11,3198
"04013815000",3799,62,76,11,463,3,509,17,4940
"04013815100",3562,104,367,0,922,19,1105,47,6126
"04013815200",6499,647,80,0,490,1,1101,140,8958
"04013815300",3512,162,67,0,781,36,614,0,5172
"04013815400",6455,366,130,36,1252,70,1482,92,9883
"04013815500",4622,158,0,0,1203,44,975,56,7058
"04013815600",4188,71,260,23,805,92,266,11,5716
"04013815700",4898,732,37,13,481,0,1110,575,7846
"04013815800",4735,184,94,0,710,54,1181,7,6965
"04013815900",5952,158,215,31,1724,9,1110,25,9224
"04013816000",9583,752,565,3,973,332,931,3,13142
"04013816100",6061,289,297,12,604,55,1303,37,8658
"04013816200",3261,291,50,0,646,0,697,30,4975
"04013816300",3204,195,21,0,142,79,220,0,3861
"04013816400",6283,551,63,0,893,0,1221,46,9057
"04013816500",3276,241,123,9,371,29,441,87,4577
"04013816600",4595,158,116,0,260,0,639,1,5769
"04013816700",2126,140,148,0,347,6,571,3,3341
"04013816800",2782,44,174,14,447,0,553,6,4020
"04013816900",3519,415,103,0,379,0,656,0,5072
"04013817000",3392,117,14,0,27,10,268,2,3830
"04013817100",5612,1464,98,36,975,164,1468,1053,10870
"04013817200",5847,376,123,28,186,125,902,263,7850
"04013817300",4762,363,16,0,159,0,59,0,5359
"04013817400",2626,165,0,0,27,0,80,0,2898
"04013817500",2491,180,0,0,37,0,20,0,2728
"04013817600",663,178,31,0,175,193,301,302,1843
"04013940700",0,0,0,0,20,103,0,0,123
"04013941000",129,163,6,14,1741,1808,310,338,4509
"04013941100",0,11,0,0,32,0,4,11,58
"04013941200",44,35,30,2,577,350,76,25,1139
"04013941300",1529,274,16,0,2735,1638,834,138,7164
"04013980100",0,0,0,0,0,0,0,0,0
"04013980400",0,6,0,2,0,2,0,0,10
"04013980500",32,0,0,0,37,0,69,0,138
"04013980600",121,20,35,0,0,0,43,0,219
"04013980700",0,0,0,0,0,0,0,0,0
"04015940400",48,20,1,0,649,395,18,24,1155
"04015940501",2259,181,3,0,122,48,282,14,2909
"04015950100",6417,3909,0,0,372,60,569,153,11480
"04015950401",1409,626,0,0,15,0,29,24,2103
"04015950402",2749,600,37,0,306,31,107,60,3890
"04015950500",814,316,6,16,44,22,30,49,1297
"04015950600",6316,2106,0,15,767,203,487,458,10352
"04015950703",1978,1070,17,69,214,72,127,81,3628
"04015950704",4696,977,0,0,252,15,509,73,6522
"04015950705",2417,1081,10,0,367,81,541,202,4699
"04015950706",2321,1335,0,0,142,329,141,499,4767
"04015951401",3039,564,21,111,208,43,297,269,4552
"04015951402",2867,585,75,0,308,55,560,98,4548
"04015951501",2746,596,17,57,125,33,510,157,4241
"04015951502",4245,357,37,0,457,60,412,138,5706
"04015951601",1929,441,0,30,514,113,682,266,3975
"04015951602",3283,763,63,0,104,91,933,189,5426
"04015951700",3394,1666,6,6,198,183,1182,580,7215
"04015951800",1982,827,43,27,500,178,611,333,4501
"04015951900",2993,706,31,6,471,130,540,462,5339
"04015952001",1669,108,4,0,171,4,163,36,2155
"04015952002",5915,272,0,0,351,52,971,84,7645
"04015952003",3668,564,0,0,390,18,563,207,5410
"04015952004",2431,347,80,0,262,27,503,125,3775
"04015952400",1795,474,0,0,92,414,197,396,3368
"04015952500",4352,587,30,0,205,0,660,169,6003
"04015952600",2543,715,0,18,281,0,437,339,4333
"04015952700",3893,950,12,0,147,105,445,182,5734
"04015952800",5001,553,37,0,316,63,673,13,6656
"04015952900",3477,912,60,18,152,285,284,281,5469
"04015953000",4829,738,0,0,186,2,556,19,6330
"04015953100",2641,358,0,24,155,13,717,163,4071
"04015953200",2250,52,0,0,108,7,279,0,2696
"04015953300",5592,143,10,78,296,8,818,91,7036
"04015953401",3416,798,3,0,366,143,425,206,5357
"04015953402",4641,721,3,0,644,0,920,88,7017
"04015953601",6855,1166,0,0,906,178,885,201,10191
"04015953602",1127,767,103,12,49,25,144,266,2493
"04015953800",3848,999,0,43,768,62,588,347,6655
"04015953900",4589,1104,66,40,697,70,517,98,7181
"04015954800",4670,803,52,23,295,163,386,42,6434
"04015954900",2381,1111,44,0,123,82,277,170,4188
"04015955000",2823,1199,0,1,716,250,796,509,6294
"04017940008",0,0,0,0,688,402,0,0,1090
"04017940010",21,4,0,0,1365,1555,3,18,2966
"04017940011",28,21,0,0,1576,985,15,26,2651
"04017940012",31,0,3,0,2146,1054,38,18,3290
"04017940013",77,44,0,0,2577,1712,50,21,4481
"04017940014",10,11,3,0,1320,1514,10,49,2917
"04017940015",5,15,0,0,2430,1968,80,62,4560
"04017940100",243,16,29,0,2310,2218,289,111,5216
"04017940301",4,9,0,0,2322,2194,10,4,4543
"04017940302",13,6,0,0,1997,1361,40,6,3423
"04017942300",28,0,0,0,1393,907,3,9,2340
"04017942400",7,0,7,0,1092,1476,15,0,2597
"04017942500",158,17,0,0,2564,1956,13,23,4731
"04017960100",726,178,24,0,553,246,291,91,2109
"04017960200",2034,487,52,7,720,295,451,338,4384
"04017960400",1558,375,53,27,1094,378,690,314,4489
"04017960500",1050,396,0,0,557,498,445,359,3305
"04017960600",1449,256,98,61,1165,1131,895,462,5517
"04017961300",2898,346,0,0,317,50,626,127,4364
"04017961700",4677,1394,29,0,244,13,637,242,7236
"04017962500",2464,601,1,0,323,39,332,96,3856
"04017963300",3627,702,0,0,213,9,208,125,4884
"04017963400",2823,374,22,0,84,32,88,17,3440
"04017963700",1169,203,0,0,24,20,127,55,1598
"04017963800",3062,591,23,0,508,39,445,198,4866
"04017964201",980,349,0,0,68,2,0,82,1481
"04017964202",1114,474,0,0,179,193,291,96,2347
"04017964800",3730,448,0,0,224,34,257,131,4824
"04017964900",2025,156,0,0,37,0,202,0,2420
"04017965200",3059,764,0,9,309,217,102,378,4838
"04017965300",2750,1084,15,0,273,218,449,281,5070
"04019000100",486,138,38,13,48,40,186,31,980
"04019000200",1484,1002,0,29,714,830,1409,1251,6719
"04019000300",756,370,37,21,262,124,475,175,2220
"04019000400",1583,1130,22,75,305,169,510,277,4071
"04019000500",1082,1210,48,79,265,319,449,307,3759
"04019000600",3570,831,40,47,412,18,318,58,5294
"04019000700",3119,595,76,100,565,111,1775,278,6619
"04019000800",967,189,36,62,261,199,486,243,2443
"04019000900",1259,872,72,13,208,236,561,817,4038
"04019001000",637,198,108,0,74,36,464,169,1686
"04019001100",1338,635,38,37,548,277,1563,770,5206
"04019001200",1212,779,216,148,1003,558,1710,928,6554
"04019001302",662,540,27,55,255,453,483,362,2837
"04019001303",931,476,89,46,660,331,1087,587,4207
"04019001304",1406,2201,126,59,718,567,1164,1258,7499
"04019001400",2238,2253,191,54,640,503,1113,488,7480
"04019001500",2509,1652,0,0,218,358,449,309,5495
"04019001600",2683,815,26,0,311,82,704,120,4741
"04019001700",2066,606,84,37,263,33,536,145,3770
"04019001801",2481,1228,352,236,1082,604,816,667,7466
"04019001802",1380,445,23,29,327,114,490,35,2843
"04019001900",2568,880,56,6,316,101,553,255,4735
"04019002000",4039,760,227,31,1209,197,3578,582,10623
"04019002100",2051,1502,362,169,1614,399,3034,1821,10952
"04019002201",1153,742,162,0,980,452,1834,1040,6363
"04019002202",1302,327,239,136,596,475,1609,467,5151
"04019002300",1757,1765,51,111,1103,884,2571,2063,10305
"04019002400",2447,1250,149,8,1100,950,3214,2017,11135
"04019002501",2034,786,10,114,754,324,2424,746,7192
"04019002503",2112,759,35,0,877,302,2066,856,7007
"04019002504",2415,1128,8,9,1260,813,2679,1681,9993
"04019002505",2688,1863,61,0,1168,842,3194,2309,12125
"04019002506",3441,1667,123,26,1201,1350,3391,2602,13801
"04019002602",2372,1000,52,35,655,390,830,681,6015
"04019002603",976,785,100,385,441,677,635,806,4805
"04019002604",1235,1246,105,149,439,630,894,924,5622
"04019002702",3395,822,158,0,362,158,717,347,5959
"04019002703",1884,1029,74,67,406,425,737,533,5155
"04019002704",1356,421,48,0,79,13,349,117,2383
"04019002801",1107,344,85,91,79,49,515,176,2446
"04019002802",1875,1008,83,378,469,406,667,557,5443
"04019002803",1315,666,93,8,210,100,447,124,2963
"04019002901",3817,1307,682,269,483,242,608,503,7911
"04019002904",2568,290,43,0,166,87,325,192,3671
"04019002905",2571,858,80,100,205,196,205,489,4704
"04019002906",1732,281,11,0,252,21,520,34,2851
"04019003002",2562,1063,94,29,383,331,470,694,5626
"04019003003",2550,440,133,185,487,178,1074,278,5325
"04019003004",1286,171,66,0,199,43,362,19,2146
"04019003101",2883,1831,213,219,607,211,1151,809,7924
"04019003102",2337,522,275,87,325,93,807,139,4585
"04019003200",3895,1218,267,39,840,163,1423,337,8182
"04019003302",3224,436,151,15,579,55,930,139,5529
"04019003303",2498,492,56,72,424,44,882,105,4573
"04019003304",1944,346,105,35,379,386,640,426,4261
"04019003400",3836,440,95,4,1313,203,2274,221,8386
"04019003501",2993,1741,319,267,1118,1168,2232,1751,11589
"04019003502",2110,886,54,102,699,749,1354,677,6631
"04019003503",1869,735,61,140,592,1364,1102,1564,7427
"04019003504",1410,551,60,89,404,119,690,208,3531
"04019003600",3101,388,569,114,611,91,643,239,5756
"04019003702",2757,1456,113,1,1191,1092,3423,2156,12189
"04019003704",2064,1564,0,24,763,838,2389,2042,9684
"04019003705",2873,911,15,94,896,795,3158,1687,10429
"04019003706",2577,1672,72,58,660,406,2742,1974,10161
"04019003707",1650,719,10,8,507,687,1769,1268,6618
"04019003801",1162,876,151,0,508,526,1684,1091,5998
"04019003802",2584,852,0,2,1125,691,3317,1405,9976
"04019003901",929,333,112,25,409,301,1224,623,3956
"04019003902",1474,718,12,6,546,243,1868,792,5659
"04019003903",2337,364,0,0,439,72,2538,392,6142
"04019004008",3462,518,222,19,559,208,1146,289,6423
"04019004010",2043,390,68,29,410,66,487,200,3693
"04019004011",4141,1194,382,122,1161,875,1701,1374,10950
"04019004022",5039,435,180,68,619,183,1038,278,7840
"04019004025",5506,392,11,0,324,65,424,31,6753
"04019004026",4285,344,296,0,279,0,690,36,5930
"04019004029",2808,562,210,32,545,172,1141,272,5742
"04019004030",1694,47,0,0,39,23,186,3,1992
"04019004031",3191,189,90,0,404,172,602,132,4780
"04019004032",2794,467,157,17,191,146,615,110,4497
"04019004033",2305,615,90,253,631,264,1207,345,5710
"04019004034",2108,330,141,314,824,159,996,351,5223
"04019004035",2354,468,335,104,228,232,412,283,4416
"04019004036",1641,492,144,0,378,17,515,215,3402
"04019004037",1900,392,136,252,526,14,607,127,3954
"04019004038",1658,192,141,0,570,41,547,69,3218
"04019004039",1795,422,84,3,239,54,218,151,2966
"04019004042",3272,475,190,40,659,129,634,23,5422
"04019004043",3112,65,216,1,601,21,739,21,4776
"04019004044",3108,369,93,9,317,45,435,172,4548
"04019004046",3695,442,49,52,181,89,840,57,5405
"04019004047",2241,207,38,0,124,5,257,57,2929
"04019004048",3497,244,23,0,389,39,643,52,4887
"04019004049",1907,193,99,1,179,66,360,69,2874
"04019004050",1825,58,0,1,144,0,182,1,2211
"04019004051",4129,325,37,0,352,3,279,140,5265
"04019004052",1679,48,35,0,137,22,105,17,2043
"04019004053",2548,36,10,0,328,9,256,9,3196
"04019004054",1295,85,24,0,60,19,89,0,1572
"04019004055",2756,45,103,60,477,11,397,47,3896
"04019004056",1343,262,85,33,268,65,465,90,2611
"04019004057",3302,350,311,61,408,110,725,265,5532
"04019004058",3148,371,334,135,634,101,775,251,5749
"04019004061",3831,527,57,26,326,111,717,167,5762
"04019004062",4063,191,245,14,649,154,1406,235,6957
"04019004063",3777,239,491,57,829,10,1448,44,6895
"04019004064",6558,502,29,1,821,91,1091,180,9273
"04019004065",3004,116,88,7,574,0,694,28,4511
"04019004066",2418,157,164,0,310,6,678,105,3838
"04019004067",1757,477,97,30,289,119,377,228,3374
"04019004068",3930,613,112,0,293,84,1301,211,6544
"04019004069",2310,582,145,81,539,227,680,425,4989
"04019004070",1703,514,184,16,528,89,782,217,4033
"04019004071",3512,320,373,44,540,172,802,146,5909
"04019004072",1826,302,105,10,437,25,528,219,3452
"04019004073",4316,106,99,0,424,33,957,16,5951
"04019004074",1653,122,19,8,230,4,406,75,2517
"04019004107",8373,303,838,3,636,19,2489,47,12708
"04019004109",4864,241,87,0,301,0,710,46,6249
"04019004110",2262,424,12,4,679,38,2633,365,6417
"04019004112",1494,565,66,24,346,218,1278,521,4512
"04019004113",0,0,0,0,0,0,0,0,0
"04019004114",1990,1838,0,1,783,360,1946,2129,9047
"04019004115",2648,2612,234,35,696,911,2566,3349,13051
"04019004116",1066,458,131,125,741,92,1185,457,4255
"04019004117",3155,835,382,147,793,737,3113,1492,10654
"04019004118",2722,333,230,48,645,107,1881,358,6324
"04019004119",5452,225,233,0,170,0,969,31,7080
"04019004120",804,76,5,0,50,0,352,5,1292
"04019004121",4319,749,376,0,1150,31,3875,509,11009
"04019004122",1810,690,10,9,916,669,2350,1273,7727
"04019004125",4466,237,316,11,652,45,1367,37,7131
"04019004307",2974,214,18,0,71,8,248,79,3612
"04019004310",1327,265,9,0,252,138,1198,291,3480
"04019004311",2630,314,84,39,849,343,2646,473,7378
"04019004312",3154,1139,69,0,643,457,2900,1099,9461
"04019004313",2847,1132,19,0,286,77,1022,538,5921
"04019004316",2191,358,48,59,156,56,499,207,3574
"04019004317",2415,263,0,0,23,10,180,12,2903
"04019004320",1445,683,15,0,454,348,1347,691,4983
"04019004321",2679,576,77,3,1229,324,3015,607,8510
"04019004322",3870,1065,41,6,1135,567,3623,1034,11341
"04019004323",2818,117,27,103,833,7,1298,29,5232
"04019004324",2595,109,8,0,78,0,39,0,2829
"04019004325",1889,20,0,0,7,0,80,0,1996
"04019004326",2564,224,132,0,208,20,1356,151,4655
"04019004327",3188,642,40,16,331,10,1180,211,5618
"04019004328",3350,170,0,0,13,0,15,0,3548
"04019004329",8123,234,346,0,1064,70,3403,66,13306
"04019004330",1677,81,0,0,31,0,31,0,1820
"04019004331",3398,146,16,0,25,0,313,0,3898
"04019004332",1305,57,5,0,6,0,14,6,1393
"04019004333",2619,427,105,87,967,103,2729,358,7395
"04019004334",3932,852,327,35,3076,469,4969,1095,14755
"04019004404",2689,160,0,19,161,15,216,21,3281
"04019004407",2516,923,500,81,1784,602,3356,1148,10910
"04019004411",4435,1402,110,109,1123,507,2957,978,11621
"04019004412",2205,446,25,38,449,54,1119,149,4485
"04019004413",2344,88,179,0,607,34,1457,28,4737
"04019004414",1970,256,93,177,317,273,1460,258,4804
"04019004415",1148,99,37,1,421,24,1058,79,2867
"04019004418",2735,150,57,0,452,45,678,0,4117
"04019004419",3786,564,84,53,310,72,733,11,5613
"04019004421",4837,906,150,49,1111,283,2268,499,10103
"04019004422",4334,188,47,0,964,128,2846,134,8641
"04019004423",3115,582,0,35,290,120,419,35,4596
"04019004424",2696,650,11,43,585,147,1772,192,6096
"04019004425",4789,592,0,0,264,15,1188,134,6982
"04019004426",2238,97,130,0,440,0,797,18,3720
"04019004427",6350,270,149,0,1182,0,1822,29,9802
"04019004428",2943,163,69,11,244,84,685,105,4304
"04019004429",4955,756,428,0,1344,2,1420,58,8963
"04019004430",1620,311,7,0,204,80,503,253,2978
"04019004431",2784,405,12,0,736,259,1034,278,5508
"04019004504",3554,1985,77,98,927,314,2654,1479,11088
"04019004505",2151,771,27,33,493,514,1224,924,6137
"04019004506",3208,723,78,15,488,428,1621,560,7121
"04019004508",2590,668,99,36,942,131,1226,609,6301
"04019004510",1011,1230,91,216,504,532,677,782,5043
"04019004511",2360,781,151,153,546,247,972,538,5748
"04019004512",2583,810,20,0,572,354,966,664,5969
"04019004513",1419,649,25,38,629,161,838,524,4283
"04019004610",4229,613,64,33,971,129,1674,473,8186
"04019004613",2839,375,87,0,537,94,938,134,5004
"04019004614",2460,95,17,0,149,28,342,0,3091
"04019004615",2235,190,48,10,294,18,408,17,3220
"04019004616",2454,336,80,0,847,8,816,90,4631
"04019004617",2242,153,8,0,116,43,372,62,2996
"04019004618",2551,362,45,5,295,32,915,111,4316
"04019004619",2449,250,88,0,494,0,360,62,3703
"04019004620",1205,194,10,1,241,10,293,40,1994
"04019004621",1782,73,0,0,157,0,233,14,2259
"04019004622",2569,217,39,0,211,52,468,45,3601
"04019004623",4217,401,14,0,783,16,1032,77,6540
"04019004624",5144,718,24,24,494,0,1824,0,8228
"04019004625",1196,240,17,0,194,73,341,84,2145
"04019004626",2049,371,237,12,870,215,904,155,4813
"04019004627",2302,165,19,7,262,107,575,47,3484
"04019004628",1137,51,29,1,82,3,200,28,1531
"04019004630",1688,242,96,0,157,85,589,147,3004
"04019004631",3056,150,58,0,342,22,441,60,4129
"04019004632",2138,150,17,0,193,0,486,0,2984
"04019004633",2489,55,7,0,273,89,421,89,3423
"04019004634",691,69,22,3,155,7,83,3,1033
"04019004635",4456,180,36,0,560,81,277,0,5590
"04019004636",6248,97,21,0,847,0,1190,0,8403
"04019004638",8947,413,313,0,804,75,1148,212,11912
"04019004639",3449,63,201,0,345,15,914,23,5010
"04019004640",4121,189,107,11,619,63,722,10,5842
"04019004641",3164,102,49,72,348,11,705,32,4483
"04019004642",3084,37,30,0,52,0,265,0,3468
"04019004643",3966,341,0,0,51,0,55,35,4448
"04019004644",2319,88,17,0,279,9,741,18,3471
"04019004645",4078,106,55,0,802,95,1398,42,6576
"04019004646",2856,598,16,0,496,40,658,91,4755
"04019004647",3247,161,110,0,667,62,1043,86,5376
"04019004710",2709,310,99,0,322,199,635,115,4389
"04019004711",3729,324,95,0,406,0,238,57,4849
"04019004712",2310,235,216,24,243,76,253,22,3379
"04019004713",2936,424,23,9,167,41,322,147,4069
"04019004714",4284,258,169,27,601,35,598,98,6070
"04019004715",3277,324,25,0,486,244,845,281,5482
"04019004716",5380,313,43,0,299,13,713,40,6801
"04019004717",1851,72,19,0,156,45,230,0,2373
"04019004718",1642,169,0,1,238,33,354,47,2484
"04019004719",4775,197,51,0,504,16,252,0,5795
"04019004720",1162,83,55,0,141,0,122,0,1563
"04019004721",2773,192,84,0,186,13,512,23,3783
"04019004722",2124,95,11,0,45,20,192,9,2496
"04019004723",3630,104,218,0,644,54,466,34,5150
"04019004724",2308,116,0,0,238,6,362,3,3033
"04019004725",2044,241,10,0,278,73,441,41,3128
"04019004726",3672,93,0,0,463,0,582,31,4841
"04019005200",2014,664,14,0,734,673,1137,466,5702
"04019005300",2887,234,63,18,238,59,446,50,3995
"04019940600",29,11,0,0,555,450,6,7,1058
"04019940700",33,5,0,51,534,989,7,101,1720
"04019940800",59,0,0,0,2055,1878,16,0,4008
"04019940900",469,123,9,5,925,608,450,147,2736
"04019941000",74,115,12,2,2028,1703,545,500,4979
"04021000201",4287,315,40,0,335,56,437,16,5486
"04021000204",5996,574,450,57,774,77,997,0,8925
"04021000205",12829,2420,189,446,1700,293,3597,779,22253
"04021000206",3126,810,313,35,132,12,448,205,5081
"04021000207",8411,1275,287,0,595,128,1928,400,13024
"04021000208",1695,86,58,0,228,0,958,0,3025
"04021000209",7966,886,664,26,612,145,1693,218,12210
"04021000210",7025,359,87,138,1499,1818,2727,374,14027
"04021000211",3289,295,89,13,459,617,1083,16,5861
"04021000212",4225,567,304,29,753,188,1401,42,7509
"04021000213",7698,1420,971,0,1029,620,913,919,13570
"04021000214",5986,740,373,245,1435,57,1687,236,10759
"04021000215",1700,198,24,0,225,0,662,26,2835
"04021000307",1719,514,0,0,54,0,58,15,2360
"04021000308",3526,1385,0,0,276,0,537,631,6355
"04021000309",1708,531,0,0,77,9,10,20,2355
"04021000310",1886,733,41,0,114,38,92,204,3108
"04021000311",2413,157,0,0,40,0,176,0,2786
"04021000312",2634,1167,21,97,94,0,718,477,5208
"04021000313",3747,701,10,0,200,30,405,226,5319
"04021000314",3556,790,0,0,302,551,496,188,5883
"04021000315",2625,1683,0,0,349,263,221,502,5643
"04021000316",6628,318,53,0,190,12,234,140,7575
"04021000317",2041,89,54,15,37,0,65,0,2301
"04021000318",5298,655,52,111,700,0,529,99,7444
"04021000319",1047,145,0,0,28,0,7,0,1227
"04021000400",2008,395,6,13,332,153,1705,468,5080
"04021000603",4869,242,13,0,160,35,349,29,5697
"04021000604",4349,77,0,0,13,0,77,0,4516
"04021000700",3190,614,0,2,148,74,1895,448,6371
"04021000801",10376,1181,477,0,460,559,2352,240,15645
"04021000802",3299,293,87,18,153,76,626,85,4637
"04021000803",744,165,0,0,58,18,287,129,1401
"04021000901",906,120,21,36,34,122,471,166,1876
"04021000902",1880,572,85,0,211,145,1003,617,4513
"04021001000",2348,1712,141,43,371,271,1320,1115,7321
"04021001100",4056,905,379,0,980,252,1757,629,8958
"04021001200",3098,833,36,0,685,223,1420,679,6974
"04021001301",4999,781,299,1,687,674,2318,1072,10831
"04021001303",903,191,7,4,279,0,371,140,1895
"04021001304",5979,504,720,0,1136,78,1495,259,10171
"04021001305",4455,237,89,0,1207,24,3101,22,9135
"04021001306",2528,658,326,12,563,231,1132,457,5907
"04021001403",2562,333,133,174,915,352,1353,313,6135
"04021001404",2872,591,29,0,410,10,1203,239,5354
"04021001405",3497,382,20,96,219,17,841,96,5168
"04021001406",1533,1393,507,200,1459,196,1887,1031,8206
"04021001407",1267,580,14,0,392,52,625,472,3402
"04021001408",1777,138,62,0,213,0,208,0,2398
"04021001500",1208,1206,107,56,627,438,1475,1151,6268
"04021001600",3515,596,111,38,822,70,2230,358,7740
"04021001701",471,211,0,0,117,52,141,185,1177
"04021001702",2082,254,158,55,433,0,907,226,4115
"04021001703",1269,261,61,39,351,27,712,142,2862
"04021001704",4529,459,447,37,1155,98,1463,182,8370
"04021001705",4584,294,215,35,771,121,1615,200,7835
"04021001706",2649,283,509,15,902,0,677,43,5078
"04021001707",2903,234,1230,74,1354,85,1136,30,7046
"04021001708",4572,509,492,0,457,13,982,143,7168
"04021001709",2110,324,123,62,852,14,856,10,4351
"04021001710",4860,227,296,54,190,36,914,36,6613
"04021001711",1628,72,507,0,136,20,613,24,3000
"04021001900",1439,521,124,65,204,189,1034,655,4231
"04021002001",2393,877,0,35,336,82,1129,669,5521
"04021002002",418,350,45,0,47,21,218,288,1387
"04021002003",1736,1224,10,129,391,142,1943,1366,6941
"04021002101",4412,916,434,3,683,261,2104,587,9400
"04021002102",519,85,65,0,66,29,228,88,1080
"04021002103",3187,560,181,27,561,83,1396,277,6272
"04021002200",3876,608,0,0,92,170,1748,272,6766
"04021002300",1961,513,25,0,371,27,1194,322,4413
"04021002400",1428,404,0,0,310,40,1120,291,3593
"04021941200",86,91,13,1,2972,3375,135,300,6973
"04021941300",124,60,0,0,1428,1529,92,120,3353
"04021941400",3976,1413,251,0,1615,1005,2137,914,11311
"04023966000",2440,486,0,0,147,22,451,182,3728
"04023966101",2362,162,0,0,254,7,1172,43,4000
"04023966103",523,254,0,0,152,189,661,438,2217
"04023966104",6150,665,82,0,1861,766,6587,1289,17400
"04023966105",6431,1586,0,0,1639,105,7394,1489,18644
"04023966200",2975,987,0,0,596,258,3191,1203,9210
"04023966301",2691,779,0,0,586,430,3108,1167,8761
"04023966302",1202,1255,1,0,230,438,1264,1688,6078
"04023966401",2457,410,6,0,240,221,2512,568,6414
"04023966402",2058,1406,0,30,648,514,2571,1717,8944
"04025000202",6063,1104,10,0,576,8,557,277,8595
"04025000203",4623,466,0,0,372,13,279,83,5836
"04025000204",4993,1504,0,71,298,171,950,464,8451
"04025000300",3992,618,0,31,206,307,420,65,5639
"04025000401",4818,457,11,0,404,85,215,129,6119
"04025000402",4458,190,21,0,194,31,105,5,5004
"04025000500",5092,298,4,0,207,37,694,12,6344
"04025000604",4156,610,78,0,218,63,521,394,6040
"04025000605",6274,1748,83,0,1230,201,1459,905,11900
"04025000606",3932,1472,0,12,344,181,840,870,7651
"04025000607",4925,671,21,0,465,70,376,208,6736
"04025000608",2924,574,0,0,122,25,372,198,4215
"04025000609",3386,1178,19,0,134,155,735,756,6363
"04025000610",2902,1191,39,0,93,75,437,406,5143
"04025000700",2842,509,19,0,102,8,196,135,3811
"04025000801",3034,343,88,7,120,38,449,44,4123
"04025000802",2870,375,33,28,97,47,136,76,3662
"04025000900",2585,1239,0,25,88,148,226,100,4411
"04025001001",3149,834,0,16,137,47,201,153,4537
"04025001002",2725,460,0,0,105,41,244,221,3796
"04025001101",3518,606,10,0,75,4,91,21,4325
"04025001102",3376,477,0,3,135,24,303,78,4396
"04025001200",5418,619,0,2,182,43,285,12,6561
"04025001300",2074,69,0,0,188,0,513,0,2844
"04025001401",1927,479,0,0,19,53,79,8,2565
"04025001402",2165,446,3,3,82,2,170,19,2890
"04025001403",2505,541,15,0,140,61,219,206,3687
"04025001500",5487,931,22,0,177,39,530,173,7359
"04025001601",2892,1043,0,10,1108,356,968,258,6635
"04025001602",3077,911,0,0,109,156,503,54,4810
"04025001603",5269,983,0,0,447,273,720,210,7902
"04025001701",5326,305,116,0,127,1,772,0,6647
"04025001702",3861,355,35,2,176,28,219,49,4725
"04025001703",2269,158,8,37,209,17,230,53,2981
"04025001801",2961,311,0,0,109,11,270,0,3662
"04025001802",4040,262,0,0,359,154,971,75,5861
"04025001900",12676,892,44,2,738,194,969,214,15729
"04025002001",3063,510,0,2,662,495,807,584,6123
"04025002002",2918,970,29,0,616,35,1147,110,5825
"04025002003",3398,970,42,0,163,431,453,815,6272
"04025002004",6713,888,80,0,579,104,1009,91,9464
"04025002100",1219,960,0,9,182,98,327,397,3192
"04027000100",954,500,21,44,122,153,703,473,2970
"04027000200",1331,487,9,43,740,580,1613,987,5790
"04027000301",1265,863,18,0,713,577,1455,1216,6107
"04027000302",1439,1238,124,21,1313,815,2689,1791,9430
"04027000402",1141,387,121,0,1176,156,2052,489,5522
"04027000403",624,226,14,32,389,287,632,343,2547
"04027000404",1190,580,42,0,857,796,1394,1215,6074
"04027000501",1543,248,15,0,882,173,1245,119,4225
"04027000502",2018,287,62,0,300,214,849,363,4093
"04027000600",3117,887,33,37,651,140,2399,901,8165
"04027000700",2080,996,14,30,520,355,2161,1163,7319
"04027000800",3061,1211,117,61,480,20,1778,977,7705
"04027000901",1810,454,80,8,794,17,1383,376,4922
"04027000902",1859,514,47,54,256,106,1066,391,4293
"04027000903",2031,28,63,0,903,89,1262,89,4465
"04027000905",5275,312,255,32,1933,241,5985,552,14585
"04027000907",3718,575,206,65,2111,525,4039,846,12085
"04027000908",1998,109,25,0,886,192,1260,239,4709
"04027001001",2056,254,96,0,121,29,435,65,3056
"04027001003",589,171,11,20,417,139,581,248,2176
"04027001004",922,546,91,69,452,232,1099,430,3841
"04027001100",2854,528,184,83,1017,331,2148,492,7637
"04027001200",2586,241,114,0,772,199,1560,301,5773
"04027010905",1963,264,7,21,408,390,544,396,3993
"04027010907",4251,339,0,0,1005,30,1473,118,7216
"04027010910",1274,116,0,0,35,0,216,40,1681
"04027010911",4121,189,56,35,1338,406,2835,558,9538
"04027010913",447,104,0,0,301,173,482,239,1746
"04027010914",369,77,0,0,48,0,175,52,721
"04027011000",943,151,0,0,532,494,736,475,3331
"04027011104",2270,367,253,0,894,181,1278,289,5532
"04027011106",4898,328,37,0,809,323,2213,342,8950
"04027011107",1593,85,0,1,503,11,942,56,3191
"04027011108",2907,203,29,0,482,15,1123,15,4774
"04027011110",2396,241,0,0,81,36,296,21,3071
"04027011111",2671,612,28,0,253,0,586,87,4237
"04027011112",2265,70,13,0,84,0,102,0,2534
"04027011114",1529,186,25,0,254,0,175,86,2255
"04027011115",2730,185,0,0,41,126,97,64,3243
"04027011201",3199,279,0,160,666,76,790,94,5264
"04027011202",671,207,0,0,827,67,901,101,2774
"04027011403",2956,1462,0,0,143,0,3099,1462,9122
"04027011405",3321,1678,0,0,324,301,3585,1979,11188
"04027011406",5903,3288,0,0,127,92,5994,3380,18784
"04027011501",1117,647,14,12,359,343,912,674,4078
"04027011503",3506,1536,0,0,310,130,3691,1487,10660
"04027011504",5757,2510,61,0,339,71,5974,2546,17258
"04027011600",7288,1690,0,0,106,196,7389,1879,18548
"04027011700",850,104,9,0,136,65,218,81,1463
"04027011800",3642,722,38,0,979,258,2954,877,9470
"04027012100",741,57,33,7,370,36,575,75,1894
"04027980003",0,0,0,0,0,0,0,0,0
"04027980004",0,0,0,0,0,0,0,0,0
"04027980005",0,0,0,0,0,0,0,0,0
"04027980006",1463,91,334,0,450,57,585,24,3004
"05001480100",1258,147,81,48,0,0,5,0,1539
"05001480200",1165,154,99,29,11,8,0,0,1466
"05001480300",1464,143,582,380,12,26,65,78,2750
"05001480400",588,168,1362,729,27,1,112,0,2987
"05001480500",2930,383,215,298,159,9,88,8,4090
"05001480600",1333,155,19,0,12,7,0,0,1526
"05001480700",1596,654,566,164,63,7,0,138,3188
"05001480800",1041,181,112,14,14,0,0,38,1400
"05003960100",1135,151,289,353,21,20,32,49,2050
"05003960200",1996,237,235,45,118,15,109,0,2755
"05003960300",2824,558,579,621,177,109,305,160,5333
"05003960400",776,189,317,151,36,0,9,0,1478
"05003960500",2070,285,115,135,126,10,113,0,2854
"05003960600",2999,418,1046,817,0,0,253,30,5563
"05003960700",1113,100,632,138,22,0,0,0,2005
"05005950100",3826,661,0,0,197,0,236,47,4967
"05005950200",3181,736,0,1,70,22,28,10,4048
"05005950300",3770,755,0,0,24,84,143,0,4776
"05005950400",2513,256,0,0,63,85,0,0,2917
"05005950500",4387,698,51,0,181,0,97,0,5414
"05005950600",3419,510,0,0,54,27,6,0,4016
"05005950700",2491,768,0,0,87,0,10,48,3404
"05005950800",5190,828,0,0,190,7,87,5,6307
"05005950900",4301,996,0,0,89,18,56,24,5484
"05007020101",4508,791,8,41,139,182,149,24,5842
"05007020102",4918,590,162,0,411,0,604,0,6685
"05007020201",3193,748,83,46,390,46,961,396,5863
"05007020203",2796,239,18,13,380,0,509,72,4027
"05007020205",4666,1089,0,0,636,181,2551,783,9906
"05007020206",5049,756,88,1,1139,231,3590,421,11275
"05007020301",1914,1368,49,3,427,73,773,908,5515
"05007020302",2933,1142,59,0,80,12,768,910,5904
"05007020304",2347,651,62,91,442,8,318,458,4377
"05007020305",2958,589,10,0,465,28,974,337,5361
"05007020401",4757,1234,13,25,167,9,647,363,7215
"05007020402",3357,563,0,0,451,67,1183,334,5955
"05007020404",4096,404,85,0,178,139,1290,408,6600
"05007020405",2892,70,93,28,297,8,233,0,3621
"05007020501",4101,435,0,5,1033,15,528,35,6152
"05007020503",2311,490,129,0,1137,0,532,0,4599
"05007020504",2530,615,12,0,135,0,590,219,4101
"05007020603",4555,155,404,0,1844,0,441,25,7424
"05007020604",3367,416,18,4,484,34,465,63,4851
"05007020605",3668,306,90,168,188,31,261,70,4782
"05007020606",3290,79,0,0,257,0,221,0,3847
"05007020701",5173,107,44,0,115,24,126,0,5589
"05007020703",4406,180,20,0,218,40,103,0,4967
"05007020704",3931,190,10,0,10,0,0,0,4141
"05007020801",4009,55,63,0,83,0,129,0,4339
"05007020803",3245,392,0,0,128,0,8,0,3773
"05007020805",4512,223,14,0,226,31,828,0,5834
"05007020806",4439,94,32,26,161,37,70,15,4874
"05007020901",5916,375,375,47,956,53,602,50,8374
"05007020902",5462,464,2,0,574,147,388,0,7037
"05007021001",3678,1001,28,0,310,81,174,18,5290
"05007021002",4720,1347,0,10,613,133,444,427,7694
"05007021101",3084,664,2,5,362,295,1162,233,5807
"05007021102",2535,584,129,0,485,108,460,298,4599
"05007021201",2593,604,0,27,450,260,577,111,4622
"05007021202",2061,626,52,0,297,53,343,405,3837
"05007021301",5401,560,0,2,566,130,572,183,7414
"05007021304",4390,283,188,29,1017,133,354,87,6481
"05007021305",3928,317,72,0,381,84,350,133,5265
"05007021306",3510,85,10,0,361,17,429,0,4412
"05007021308",2950,19,35,0,278,0,125,0,3407
"05007021310",6725,263,0,0,391,0,827,0,8206
"05007021311",4140,337,105,0,606,161,394,180,5923
"05007021404",2740,518,3,19,167,19,144,217,3827
"05007021405",1514,183,4,0,70,14,2,0,1787
"05007021406",4028,561,16,0,884,662,1422,125,7698
"05007021407",3954,503,13,0,66,53,159,26,4774
"05007021408",3475,874,66,85,633,237,1188,566,7124
"05007021409",1907,129,0,0,55,25,10,6,2132
"05009790100",5505,762,0,0,115,59,51,43,6535
"05009790200",4538,1168,0,0,84,64,129,94,6077
"05009790300",4353,918,9,0,56,51,12,30,5429
"05009790400",5993,325,0,0,88,6,1,0,6413
"05009790501",2734,564,0,0,304,0,15,0,3617
"05009790502",2584,1021,0,33,33,153,25,0,3849
"05009790600",3634,1276,67,0,57,65,359,51,5509
"05011950100",1333,196,452,133,240,198,240,211,3003
"05011950200",858,346,467,308,0,100,11,144,2234
"05011950300",1060,293,567,256,70,41,166,47,2500
"05011950400",672,137,275,189,309,90,322,149,2143
"05011950500",1317,492,166,397,81,42,119,155,2769
"05013480100",1775,93,405,217,23,3,49,0,2565
"05013480200",1561,508,410,71,20,15,133,0,2718
"05015950100",2055,381,1,0,81,38,17,8,2581
"05015950200",5296,829,0,93,141,0,181,74,6614
"05015950300",5132,1551,0,0,100,350,1344,540,9017
"05015950400",3684,603,0,1,157,43,51,0,4539
"05015950500",5254,1052,3,0,423,60,1296,439,8527
"05017080100",1949,341,413,29,56,92,41,156,3077
"05017080200",336,54,1075,832,4,0,17,16,2334
"05017080300",1124,195,834,608,60,143,99,188,3251
"05017080400",374,114,1061,975,13,2,11,59,2609
"05019953601",1833,609,580,641,70,0,23,46,3802
"05019953602",1930,527,201,181,52,0,148,158,3197
"05019953700",3243,664,394,64,122,11,0,35,4533
"05019953800",1907,557,827,286,98,67,46,131,3919
"05019953900",2649,588,1159,481,109,40,224,131,5381
"05021950100",1726,335,0,0,41,5,16,0,2123
"05021950200",1646,290,0,1,14,0,5,0,1956
"05021950300",1623,357,36,0,83,4,3,5,2111
"05021950400",2344,780,0,0,0,0,0,0,3124
"05021950500",1543,556,0,0,22,54,30,24,2229
"05021950600",2626,860,0,0,195,82,185,0,3948
"05023480100",3713,629,0,0,78,0,136,0,4556
"05023480201",1021,213,0,0,7,0,8,0,1249
"05023480202",3600,418,0,43,27,0,86,0,4174
"05023480300",4234,1312,0,0,68,0,115,0,5729
"05023480400",3054,490,55,1,23,9,62,55,3749
"05023480501",2318,262,0,0,151,0,78,59,2868
"05023480502",3072,286,0,0,195,13,7,7,3580
"05025970100",3241,658,330,442,96,59,22,0,4848
"05025970200",2851,552,124,35,36,5,63,84,3750
"05027950100",2294,199,769,296,140,21,112,0,3831
"05027950200",2091,266,1039,687,42,261,31,245,4662
"05027950300",3490,624,693,241,0,0,23,31,5102
"05027950400",3093,699,1365,337,145,314,35,0,5988
"05027950500",672,266,1023,1590,33,22,9,143,3758
"05029950100",4219,680,227,5,126,23,19,0,5299
"05029950200",2656,656,77,29,111,23,16,0,3568
"05029950300",2756,1198,616,406,76,22,95,347,5516
"05029950400",1225,661,80,163,29,8,66,70,2302
"05029950500",1412,399,760,94,36,0,118,39,2858
"05029950600",1712,223,0,78,34,41,40,7,2135
"05031000101",1831,747,467,526,100,347,33,217,4268
"05031000102",2408,281,402,276,66,257,158,209,4057
"05031000200",2153,697,958,161,22,24,40,216,4271
"05031000300",4951,866,348,628,337,88,63,74,7355
"05031000401",3821,838,987,0,207,80,234,47,6214
"05031000402",3883,1467,899,913,289,208,165,101,7925
"05031000501",5781,511,344,0,110,0,139,0,6885
"05031000502",2749,1296,460,147,159,148,1,84,5044
"05031000601",2646,426,728,862,109,204,90,122,5187
"05031000602",982,836,477,1282,235,407,533,427,5179
"05031000700",6070,623,515,417,157,0,621,208,8611
"05031000801",6222,212,171,0,361,0,0,0,6966
"05031000802",5987,429,493,209,310,29,228,0,7685
"05031000900",4385,768,111,37,196,18,148,47,5710
"05031001000",3186,585,0,11,40,3,73,15,3913
"05031001100",6146,1137,60,41,138,30,21,0,7573
"05031001200",4119,578,11,40,224,25,312,0,5309
"05033020100",4605,1033,2,2,157,10,27,0,5836
"05033020201",4491,709,0,0,344,126,60,36,5766
"05033020203",6499,1010,59,0,552,140,467,75,8802
"05033020204",3809,817,70,0,267,22,48,31,5064
"05033020301",3104,775,27,0,204,195,122,210,4637
"05033020302",3396,434,62,0,453,25,394,127,4891
"05033020401",3546,362,31,0,434,55,179,4,4611
"05033020402",3396,933,3,56,113,36,50,113,4700
"05033020501",2141,1129,44,0,653,267,706,671,5611
"05033020502",2301,1415,77,54,179,120,291,58,4495
"05033020600",8354,1336,134,0,249,243,134,261,10711
"05035030101",73,6,1228,1019,4,11,0,0,2341
"05035030102",299,11,1535,1203,0,0,11,0,3059
"05035030201",3545,620,820,125,120,83,25,0,5338
"05035030202",2252,40,723,166,268,0,11,0,3460
"05035030301",806,52,1229,1031,27,0,0,0,3145
"05035030302",291,138,1107,754,28,11,48,11,2388
"05035030501",16,13,476,397,2,0,18,0,922
"05035030502",32,0,362,463,0,0,0,0,857
"05035030600",1641,178,1409,1097,88,8,214,2,4637
"05035030701",680,86,537,48,42,5,27,54,1479
"05035030702",180,4,423,483,3,92,13,0,1198
"05035030703",1117,388,228,36,97,23,231,42,2162
"05035030803",1321,6,538,0,72,0,32,0,1969
"05035030804",1589,128,687,451,248,25,6,0,3134
"05035030805",1899,75,1034,108,169,63,180,63,3591
"05035030806",2379,131,440,187,102,50,60,33,3382
"05035030807",854,41,398,146,17,0,8,0,1464
"05035031000",857,22,314,287,22,14,29,0,1545
"05035031100",451,152,1144,749,19,6,0,2,2523
"05035031200",6,27,960,504,6,39,0,0,1542
"05037950100",542,86,485,241,16,0,0,0,1370
"05037950200",2388,739,113,12,36,29,3,0,3320
"05037950300",1234,119,0,0,8,6,2,0,1369
"05037950400",2197,205,107,230,31,0,14,0,2784
"05037950500",1644,617,1405,789,35,23,13,7,4533
"05037950600",2834,316,525,49,143,0,239,0,4106
"05039970100",729,37,541,107,26,0,58,4,1502
"05039970200",1247,254,157,76,21,19,19,105,1898
"05039970300",1575,170,1737,478,174,0,0,0,4134
"05041950100",1015,143,239,115,22,11,0,2,1547
"05041950200",1933,148,1039,1039,74,13,18,13,4277
"05041950300",74,167,719,688,29,6,30,167,1880
"05041950400",921,119,462,1133,0,65,0,72,2772
"05041950500",1302,181,335,177,11,24,180,93,2303
"05043490100",1547,283,308,202,16,98,15,89,2558
"05043490200",908,128,650,876,14,80,0,0,2656
"05043490300",2935,970,287,825,101,17,86,107,5328
"05043490400",1897,276,431,529,125,36,184,7,3485
"05043490500",2719,391,555,290,56,22,12,22,4067
"05045030101",2374,513,285,15,56,0,10,3,3256
"05045030102",4143,465,26,48,77,57,60,5,4881
"05045030103",3126,172,13,0,19,109,266,0,3705
"05045030104",4222,618,25,6,109,20,149,20,5169
"05045030200",4290,971,19,0,128,29,116,23,5576
"05045030301",3976,550,350,26,52,32,123,0,5109
"05045030302",5338,556,3,0,107,0,96,0,6100
"05045030303",3743,629,112,0,104,15,49,0,4652
"05045030401",1955,106,169,0,31,0,165,0,2426
"05045030402",3135,205,0,0,189,6,21,3,3559
"05045030403",2028,569,512,313,116,0,92,204,3834
"05045030404",1942,101,413,128,44,202,0,170,3000
"05045030501",9234,473,1287,267,954,184,284,54,12737
"05045030502",3103,593,475,158,127,49,53,188,4746
"05045030600",4314,199,408,210,54,0,149,0,5334
"05045030701",1385,324,497,422,46,19,56,11,2760
"05045030702",1973,521,509,500,54,15,71,28,3671
"05045030800",2751,724,441,125,89,111,163,28,4432
"05045030900",894,1296,203,402,209,85,220,207,3516
"05045031001",2886,557,711,0,143,122,172,178,4769
"05045031003",1394,545,135,23,176,34,135,34,2476
"05045031005",5404,862,802,243,477,132,170,64,8154
"05045031006",2236,551,579,81,176,14,201,0,3838
"05045031101",3810,513,530,242,140,59,344,0,5638
"05045031102",4301,488,569,122,117,42,59,6,5704
"05047950100",2610,943,41,41,106,5,10,37,3793
"05047950200",5134,1734,0,0,141,14,170,113,7306
"05047950300",5173,1086,29,10,446,21,101,42,6908
"05049550100",4378,1247,0,0,230,4,0,0,5859
"05049550200",4911,1056,1,2,46,74,99,33,6222
"05051010300",3530,1202,207,59,161,153,153,121,5586
"05051010400",5325,1762,40,0,104,164,38,10,7443
"05051010500",5172,309,13,126,225,0,151,0,5996
"05051010600",1798,725,488,640,157,47,241,13,4109
"05051010700",793,675,135,70,149,111,56,88,2077
"05051010800",946,677,206,396,135,50,42,51,2503
"05051010900",1807,494,424,202,87,54,36,58,3162
"05051011000",2910,1091,50,39,230,16,158,67,4561
"05051011100",6617,1055,91,0,873,152,238,45,9071
"05051011200",6354,768,138,24,143,0,107,39,7573
"05051011300",2277,490,418,826,537,0,534,2,5084
"05051011400",1685,509,152,323,233,429,311,180,3822
"05051011500",805,377,496,391,93,52,100,60,2374
"05051011601",4541,517,346,178,88,44,138,44,5896
"05051011602",3553,395,101,58,127,248,262,282,5026
"05051011700",3332,1110,417,149,211,154,115,486,5974
"05051011800",2940,477,350,15,421,15,233,41,4492
"05051011900",4763,836,20,60,202,0,47,0,5928
"05051012001",4354,725,94,0,62,0,99,16,5350
"05051012002",3152,347,0,16,81,0,113,89,3798
"05053470100",4125,518,208,192,81,0,0,0,5124
"05053470200",3125,96,0,0,44,0,0,0,3265
"05053470300",3028,727,178,69,89,69,69,96,4325
"05053470400",4675,455,0,0,138,8,30,0,5306
"05055480100",2366,706,0,0,11,7,13,4,3107
"05055480200",3741,547,63,0,75,12,171,29,4638
"05055480300",2695,676,0,0,172,0,78,0,3621
"05055480400",5551,1177,0,0,187,12,78,16,7021
"05055480500",4343,1546,209,0,87,0,260,39,6484
"05055480600",5743,1003,0,2,108,30,0,0,6886
"05055480700",1381,730,0,32,59,41,74,61,2378
"05055480801",4852,270,0,0,142,9,16,0,5289
"05055480802",3216,622,0,0,33,150,150,123,4294
"05057480100",3450,780,281,292,111,46,41,166,5167
"05057480200",1134,217,824,131,116,0,16,0,2438
"05057480300",1486,715,1940,637,263,122,534,492,6189
"05057480400",2904,856,286,57,82,34,23,289,4531
"05057480500",1919,936,1231,886,59,231,564,641,6467
"05059020100",5761,956,23,0,101,5,158,11,7015
"05059020200",1414,380,937,356,31,25,45,0,3188
"05059020300",1181,300,382,72,62,45,77,0,2119
"05059020400",3140,971,928,657,30,41,65,147,5979
"05059020500",3145,741,24,0,101,17,82,114,4224
"05059020600",3236,351,0,0,98,0,28,9,3722
"05059020700",4455,1040,25,0,230,18,226,0,5994
"05061950100",3041,495,134,24,79,163,69,94,4099
"05061950200",2858,428,1002,243,330,0,333,0,5194
"05061950300",1718,439,856,669,405,449,486,449,5471
"05063490100",4737,1331,0,0,215,35,28,27,6373
"05063490200",1695,688,21,3,78,21,73,117,2696
"05063490300",3807,866,100,229,61,20,207,300,5590
"05063490400",3457,829,26,9,35,40,66,79,4541
"05063490500",2177,209,23,0,89,0,4,0,2502
"05063490600",1632,688,57,34,244,131,473,180,3439
"05063490700",5717,1372,10,112,100,131,348,217,8007
"05063490800",3594,1033,0,2,54,0,35,0,4718
"05065960100",2328,897,0,8,59,36,60,33,3421
"05065960200",3967,828,2,0,9,23,0,2,4831
"05065960300",1716,608,0,0,11,3,78,44,2460
"05065960400",1852,260,0,0,72,0,0,0,2184
"05067480100",2406,858,166,5,73,15,22,0,3545
"05067480200",1250,502,522,396,9,115,0,13,2807
"05067480300",1984,513,400,463,124,36,46,102,3668
"05067480400",1715,719,130,0,67,2,67,0,2700
"05067480500",1597,195,0,0,11,0,73,0,1876
"05069000102",9,9,9,0,0,0,0,0,27
"05069000301",2447,525,282,61,41,0,23,9,3388
"05069000302",4054,516,337,0,411,0,251,0,5569
"05069000303",1534,840,476,503,51,54,54,27,3539
"05069000502",0,43,1382,634,0,0,0,31,2090
"05069000900",304,22,1924,751,22,0,10,0,3033
"05069001000",41,12,805,574,5,12,0,0,1449
"05069001200",117,29,742,1086,0,0,0,0,1974
"05069001300",20,16,826,708,10,0,0,0,1580
"05069001401",245,34,884,577,19,32,0,0,1791
"05069001402",125,0,1741,891,12,0,13,0,2782
"05069001501",666,20,2117,554,10,114,104,114,3699
"05069001502",439,160,1961,774,37,0,0,0,3371
"05069001600",166,74,1827,1173,95,7,76,7,3425
"05069001700",53,23,1693,755,0,7,0,7,2538
"05069001800",1022,130,1397,827,163,0,0,0,3539
"05069001901",524,103,389,414,26,0,32,7,1495
"05069001903",96,0,1151,1090,79,0,0,0,2416
"05069002000",2495,253,1909,170,421,0,88,0,5336
"05069002103",1958,307,551,415,118,17,0,0,3366
"05069002104",2692,298,848,13,137,28,70,8,4094
"05069002300",1248,211,1100,378,48,0,201,0,3186
"05069002400",3125,513,128,83,77,23,61,0,4010
"05069002500",410,116,287,219,16,7,0,17,1072
"05071951700",3214,1133,0,0,231,0,203,288,5069
"05071951800",3631,854,0,0,152,83,56,11,4787
"05071951900",2329,427,0,0,181,0,154,127,3218
"05071952000",2387,862,144,150,390,256,528,582,5299
"05071952100",2499,613,95,0,161,8,568,265,4209
"05071952200",4187,1182,17,0,37,6,439,105,5973
"05073470100",2037,341,1201,778,4,14,75,0,4450
"05073470200",1748,221,341,359,28,18,12,0,2727
"05075470100",1012,368,0,3,51,0,0,0,1434
"05075470200",3292,895,0,0,46,53,16,6,4308
"05075470300",1652,517,0,0,19,27,25,3,2243
"05075470400",1138,414,0,0,45,0,2,0,1599
"05075470501",1846,772,20,0,28,7,32,16,2721
"05075470502",3244,820,50,0,3,23,0,67,4207
"05077470100",563,143,340,88,14,0,84,0,1232
"05077470200",989,153,498,215,0,0,59,0,1914
"05077470300",973,72,1739,1321,9,0,0,0,4114
"05077470400",532,93,404,217,60,2,49,0,1357
"05079960300",1458,443,321,39,66,0,59,0,2386
"05079960400",2519,534,105,26,116,5,126,56,3487
"05079960500",1489,461,294,152,10,7,60,0,2473
"05079960600",429,48,679,537,75,5,49,58,1880
"05081030101",1002,187,660,85,55,6,42,9,2046
"05081030102",2618,822,896,163,113,211,94,211,5128
"05081030200",1657,257,425,193,117,4,0,0,2653
"05081030300",2222,391,108,38,154,45,22,19,2999
"05083950100",3264,707,0,0,259,3,91,0,4324
"05083950200",2564,580,68,4,186,79,101,0,3582
"05083950300",2546,538,12,145,100,112,0,0,3453
"05083950400",2722,255,0,0,88,40,26,17,3148
"05083950500",2908,1062,32,76,16,132,76,159,4461
"05083950600",2549,353,11,20,13,52,0,88,3086
"05085020101",6432,371,24,0,336,13,108,8,7292
"05085020102",4944,848,165,0,139,43,18,6,6163
"05085020103",5328,354,8,8,11,41,168,0,5918
"05085020104",6188,314,0,0,264,301,202,220,7489
"05085020201",3610,107,0,0,248,0,143,0,4108
"05085020202",3023,624,8,124,200,69,129,93,4270
"05085020204",4521,848,16,0,328,0,382,17,6112
"05085020205",4227,703,13,1,206,62,131,107,5450
"05085020206",3684,367,29,0,273,5,201,29,4588
"05085020301",2888,214,292,116,188,100,168,12,3978
"05085020302",2772,724,34,0,217,7,136,0,3890
"05085020400",2129,184,249,23,0,0,14,42,2641
"05085020500",2705,466,649,315,96,0,120,11,4362
"05085020600",914,110,453,131,13,0,109,0,1730
"05085020700",1485,378,561,463,28,15,39,4,2973
"05085020800",1000,80,302,159,16,9,70,3,1639
"05087960100",2732,793,0,0,247,62,35,0,3869
"05087960200",2387,781,61,9,49,92,260,87,3726
"05087960300",4265,832,0,0,45,6,148,171,5467
"05087960400",2394,555,0,0,179,53,93,12,3286
"05089960100",3843,706,0,0,152,36,19,77,4833
"05089960201",2200,699,0,24,54,5,52,14,3048
"05089960202",2639,970,13,0,128,14,82,56,3902
"05089960300",4072,571,0,0,93,39,55,13,4843
"05091020100",1964,500,998,440,96,120,119,115,4352
"05091020200",1506,263,773,447,74,33,67,0,3163
"05091020400",955,231,339,481,54,9,109,0,2178
"05091020500",783,336,611,444,106,180,56,11,2527
"05091020600",338,123,613,857,41,10,93,12,2087
"05091020701",2148,186,774,136,189,0,207,0,3640
"05091020702",1611,257,1392,454,28,0,0,0,3742
"05091020801",1667,227,605,118,85,67,61,85,2915
"05091020802",1986,338,51,8,0,9,0,0,2392
"05091020900",6643,815,402,228,161,0,266,3,8518
"05091021000",6363,997,136,273,250,7,0,0,8026
"05091980000",0,0,53,0,0,0,0,0,53
"05093010100",285,99,770,441,106,0,69,44,1814
"05093010200",1796,874,2335,1324,124,68,0,93,6614
"05093010300",299,156,1513,802,0,0,8,0,2778
"05093010600",3525,902,1379,604,0,0,229,0,6639
"05093010700",3200,307,340,0,130,0,127,0,4104
"05093010800",4555,1413,6,0,294,40,240,28,6576
"05093010900",1003,363,368,406,123,30,99,4,2396
"05093011000",1004,298,1232,1599,153,165,43,185,4679
"05093011100",1348,244,533,375,161,9,74,9,2753
"05093011200",1343,274,195,99,27,0,33,64,2035
"05093011300",1306,326,238,159,68,43,103,62,2305
"05093011400",1863,310,554,51,47,0,142,15,2982
"05095950100",1303,423,807,853,115,0,53,0,3554
"05095950200",961,394,270,291,37,98,12,93,2156
"05095950300",1021,150,610,292,4,0,0,0,2077
"05097953000",2464,467,0,11,218,59,66,43,3328
"05097953100",1692,355,28,0,30,39,34,17,2195
"05097953200",2892,685,0,0,83,4,175,4,3843
"05099090100",1307,316,438,316,24,8,2,15,2426
"05099090200",1854,1101,1195,352,97,12,39,226,4876
"05099090300",972,239,275,80,31,0,0,0,1597
"05101180100",3242,600,0,0,101,58,6,0,4007
"05101180200",2884,891,0,0,124,88,56,23,4066
"05103950100",3245,481,923,396,81,72,93,0,5291
"05103950200",1392,244,522,372,68,0,0,0,2598
"05103950300",3759,469,879,492,16,0,65,0,5680
"05103950400",1135,405,1152,906,95,0,29,0,3722
"05103950500",1584,354,1168,575,115,0,65,21,3882
"05103950600",761,217,1608,965,211,0,67,131,3960
"05105952700",4058,788,146,14,40,133,58,5,5242
"05105952800",2534,399,0,24,165,9,160,0,3291
"05105952900",1518,239,15,6,71,12,39,9,1909
"05107480100",1278,105,703,798,8,0,12,0,2904
"05107480200",3039,321,1472,572,56,55,124,22,5661
"05107480300",1132,186,2728,1756,0,36,0,0,5838
"05107480400",263,29,496,863,25,4,49,7,1736
"05107480500",325,22,559,1407,44,0,0,0,2357
"05107480600",543,139,571,504,32,85,97,10,1981
"05109953300",2626,884,31,3,400,142,393,148,4627
"05109953400",1958,341,0,0,43,15,0,0,2357
"05109953500",3390,525,175,121,72,168,10,175,4636
"05111490100",2828,1007,276,132,23,93,3,73,4435
"05111490200",1425,206,0,0,0,0,0,0,1631
"05111490300",2092,1059,72,218,11,84,13,169,3718
"05111490400",3296,398,140,214,82,20,0,20,4170
"05111490500",4815,881,4,94,120,41,21,121,6097
"05111490600",1570,138,18,0,19,2,34,1,1782
"05111490700",1131,468,402,346,0,15,91,43,2496
"05113950100",3085,557,19,0,286,68,153,72,4240
"05113950200",4096,1606,0,0,127,163,142,0,6134
"05113950300",2062,690,0,0,44,52,5,14,2867
"05113950400",2559,397,0,0,102,62,23,10,3153
"05113950500",1291,614,8,0,92,23,34,11,2073
"05113950600",1386,432,0,0,198,214,466,347,3043
"05115950700",3120,596,0,0,116,32,50,2,3916
"05115950800",3423,600,30,7,73,41,60,0,4234
"05115950900",5331,816,86,0,459,10,64,52,6818
"05115951000",3142,1170,0,0,111,0,103,0,4526
"05115951100",3384,435,46,0,105,11,57,8,4046
"05115951200",7221,1339,53,0,173,0,692,85,9563
"05115951300",4142,1663,179,22,480,213,801,274,7774
"05115951400",1488,558,87,54,155,29,65,56,2492
"05115951501",3069,141,22,0,196,0,62,0,3490
"05115951502",4289,1942,90,145,327,127,236,621,7777
"05115951600",5020,1302,459,322,535,243,903,598,9382
"05117460100",2588,649,137,37,50,41,52,21,3575
"05117460200",1747,320,313,113,21,0,20,0,2534
"05117460300",1427,394,193,212,15,0,0,0,2241
"05119000200",217,27,542,154,14,0,0,0,954
"05119000500",79,47,1804,953,0,258,13,0,3154
"05119001100",40,81,1370,448,25,36,0,0,2000
"05119001200",134,151,460,454,42,16,50,18,1325
"05119001300",97,263,1085,854,0,33,19,0,2351
"05119001501",2914,242,220,56,481,32,45,2,3992
"05119001502",2701,575,261,77,165,41,95,0,3915
"05119001600",5624,139,49,150,119,18,110,17,6226
"05119001800",506,124,2066,1322,29,42,12,0,4101
"05119001900",224,59,1739,802,31,77,16,26,2974
"05119002001",1468,357,2345,1124,101,0,495,278,6168
"05119002002",1060,411,2081,871,309,35,712,378,5857
"05119002102",1387,358,964,909,240,46,112,229,4245
"05119002103",1898,178,1114,235,149,0,205,0,3779
"05119002104",4057,212,286,130,503,153,107,0,5448
"05119002203",2935,496,1010,642,13,42,99,17,5254
"05119002204",5107,327,776,332,278,30,33,0,6883
"05119002206",2083,150,712,0,413,112,56,49,3575
"05119002208",1518,82,776,56,109,0,258,0,2799
"05119002209",1489,131,1370,508,221,20,209,0,3948
"05119002403",617,278,2306,521,47,46,246,150,4211
"05119002405",1024,114,2383,171,478,62,275,35,4542
"05119002406",1143,263,1312,315,69,107,177,207,3593
"05119002407",1312,80,513,10,91,0,52,0,2058
"05119002408",893,141,4038,1289,291,14,241,14,6921
"05119002500",602,103,325,152,41,0,0,0,1223
"05119002600",120,75,675,476,21,0,17,0,1384
"05119002700",1078,146,3866,2082,316,90,118,0,7696
"05119002800",7,0,992,1753,0,47,0,0,2799
"05119002900",240,145,691,446,63,6,70,0,1661
"05119003001",602,540,893,1158,21,0,57,264,3535
"05119003002",782,120,902,1640,32,15,20,0,3511
"05119003100",68,22,291,192,0,0,17,9,599
"05119003202",3110,1162,2298,536,448,250,683,865,9352
"05119003205",0,0,0,0,0,0,0,0,0
"05119003207",1120,343,207,89,55,45,75,75,2009
"05119003208",1900,694,1411,649,42,0,517,393,5606
"05119003303",4099,260,306,25,30,68,0,1,4789
"05119003304",4363,400,715,80,77,0,76,114,5825
"05119003305",2475,421,501,38,101,218,463,220,4437
"05119003306",1524,262,715,609,92,0,99,8,3309
"05119003402",4782,592,583,71,298,0,123,62,6511
"05119003403",1929,422,246,0,361,10,307,0,3275
"05119003404",3887,1064,58,0,324,43,106,0,5482
"05119003500",1429,92,257,0,387,34,329,31,2559
"05119003604",4344,646,1205,120,239,36,94,0,6684
"05119003605",2344,456,1517,478,282,101,302,17,5497
"05119003606",785,515,732,867,159,36,138,65,3297
"05119003607",1930,370,2076,704,199,46,338,0,5663
"05119003608",2566,188,1229,497,230,25,296,0,5031
"05119003609",2784,499,592,121,146,11,231,94,4478
"05119003703",4933,150,1015,410,199,0,243,0,6950
"05119003704",2534,295,511,335,194,55,130,96,4150
"05119003706",819,33,56,118,67,0,19,0,1112
"05119003707",2598,80,855,218,254,0,104,0,4109
"05119003710",2537,184,392,22,148,18,291,0,3592
"05119003711",2878,471,962,319,194,51,213,51,5139
"05119003712",3301,229,551,0,69,0,141,24,4315
"05119003713",2682,291,252,28,54,0,164,25,3496
"05119003800",893,410,1761,351,136,83,181,265,4080
"05119003900",2247,124,1227,68,84,43,63,14,3870
"05119004001",253,49,1752,442,0,0,11,3,2510
"05119004004",2902,216,472,11,0,21,119,93,3834
"05119004005",418,94,976,200,156,77,84,0,2005
"05119004006",2262,515,275,64,53,84,258,62,3573
"05119004007",502,92,1713,344,104,10,152,10,2927
"05119004103",792,619,1755,617,31,27,385,558,4784
"05119004104",989,424,480,24,44,32,87,272,2352
"05119004105",1316,181,2793,1337,176,148,383,277,6611
"05119004106",762,342,3892,800,270,16,317,54,6453
"05119004107",733,381,1230,656,123,80,421,257,3881
"05119004108",1030,320,1810,1189,104,161,677,307,5598
"05119004201",2142,191,89,54,0,8,0,0,2484
"05119004202",3302,152,23,9,46,20,0,0,3552
"05119004205",2561,127,504,167,193,0,165,12,3729
"05119004207",5251,662,989,49,867,213,77,480,8588
"05119004212",4770,208,331,0,786,164,62,53,6374
"05119004213",3846,215,75,0,367,0,166,0,4669
"05119004214",2077,239,549,196,171,0,208,56,3496
"05119004215",4677,32,862,108,327,19,122,0,6147
"05119004216",3966,12,1137,356,1001,17,326,17,6832
"05119004218",2322,200,430,7,88,56,366,141,3610
"05119004219",4627,152,362,0,789,125,238,0,6293
"05119004220",2285,109,2301,597,283,0,692,24,6291
"05119004221",2697,252,1694,259,551,58,150,42,5703
"05119004302",3542,520,484,32,366,49,198,22,5213
"05119004303",5758,1171,3629,178,471,56,38,0,11301
"05119004305",5805,141,929,158,36,0,180,0,7249
"05119004306",3320,311,845,298,391,0,85,0,5250
"05119004400",1025,66,99,182,77,10,39,0,1498
"05119004500",39,34,1219,723,37,67,13,0,2132
"05119004600",766,247,1694,612,25,38,35,21,3438
"05119004700",914,170,1213,586,33,22,88,0,3026
"05119004800",1488,332,588,86,117,38,27,18,2694
"05119004900",5591,184,273,254,102,61,122,0,6587
"05121960100",2830,1070,4,1,42,6,20,49,4022
"05121960200",4991,992,23,2,184,37,51,61,6341
"05121960301",2767,831,10,2,66,51,20,18,3765
"05121960302",2684,579,35,18,10,62,10,62,3460
"05123960100",1119,147,1204,852,42,53,77,72,3566
"05123960200",3295,528,1167,503,55,16,143,16,5723
"05123960300",1503,162,555,161,63,7,57,14,2522
"05123960400",468,354,2712,1367,76,28,0,6,5011
"05123960500",1599,122,902,506,185,84,138,0,3536
"05123960600",702,299,1953,618,151,50,67,31,3871
"05125010101",3477,255,323,4,207,0,241,0,4507
"05125010102",7039,836,285,0,205,240,172,137,8914
"05125010103",6040,436,998,132,386,61,86,13,8152
"05125010301",3215,107,161,100,135,10,277,0,4005
"05125010302",2813,252,86,0,41,15,16,0,3223
"05125010303",3346,130,0,0,15,0,14,0,3505
"05125010404",6346,452,635,19,334,0,261,121,8168
"05125010405",3795,224,268,0,192,0,10,19,4508
"05125010406",5052,498,81,0,414,38,307,15,6405
"05125010407",4116,386,15,0,201,0,314,0,5032
"05125010408",4502,539,917,148,109,41,232,54,6542
"05125010409",1656,411,233,68,108,5,86,26,2593
"05125010503",5311,901,26,0,84,0,72,181,6575
"05125010506",6485,272,131,0,98,0,19,15,7020
"05125010507",2743,306,14,0,80,0,30,0,3173
"05125010508",3651,205,102,0,43,28,45,40,4114
"05125010509",3881,274,7,54,69,24,78,0,4387
"05125010510",7703,687,435,0,544,0,745,235,10349
"05125010511",4030,334,349,0,24,43,42,0,4822
"05125010512",2792,69,39,0,68,0,15,0,2983
"05125010600",4976,963,476,271,60,338,556,141,7781
"05127950100",3837,413,10,0,468,33,142,0,4903
"05127950200",2315,1158,0,0,426,133,506,106,4644
"05127950300",1485,423,3,0,60,5,12,48,2036
"05129970100",1913,363,2,0,142,0,0,0,2420
"05129970200",2575,826,0,4,89,13,58,83,3648
"05129970300",1250,597,0,0,34,52,14,0,1947
"05131000100",1112,1276,852,580,1404,260,1126,819,7429
"05131000200",1472,1276,101,526,1009,413,879,870,6546
"05131000300",866,705,133,202,305,254,435,454,3354
"05131000400",1286,1094,341,154,269,66,697,547,4454
"05131000501",1999,1784,455,360,588,260,1627,1385,8458
"05131000502",1599,496,274,11,430,235,597,494,4136
"05131000600",3711,780,127,47,246,94,517,0,5522
"05131000700",2771,1259,174,441,112,219,804,589,6369
"05131000800",2226,1290,155,118,474,159,499,533,5454
"05131001001",2647,963,150,205,586,187,139,392,5269
"05131001002",1866,116,61,0,70,135,37,20,2305
"05131001101",2832,328,196,63,376,74,133,26,4028
"05131001102",1788,345,111,41,548,44,128,17,3022
"05131001201",2575,370,82,23,131,336,62,181,3760
"05131001202",2089,926,107,129,441,126,266,77,4161
"05131001301",1990,202,25,168,257,96,17,74,2829
"05131001302",6640,1220,138,129,1337,33,448,0,9945
"05131001303",3900,1281,270,64,539,263,423,188,6928
"05131001304",5546,622,238,295,408,242,64,66,7481
"05131001305",3720,471,77,1,702,20,31,0,5022
"05131010101",5024,864,28,0,469,27,329,54,6795
"05131010102",5485,1095,7,0,149,80,106,0,6922
"05131010201",3467,819,0,0,63,83,44,22,4498
"05131010202",3069,434,0,0,92,0,14,0,3609
"05131010301",5037,684,0,0,461,104,315,8,6609
"05131010302",5515,857,0,0,183,51,11,56,6673
"05133080100",2792,352,0,0,790,86,637,137,4794
"05133080200",2472,627,34,37,427,456,390,579,5022
"05133080300",1795,719,467,66,2187,870,2512,1231,9847
"05133080400",2008,476,213,18,65,48,36,35,2899
"05135470100",1378,443,0,27,93,21,10,13,1985
"05135470200",3823,1110,0,0,111,71,221,3,5339
"05135470300",2607,1080,0,0,145,17,4,22,3875
"05135470400",4445,1116,6,0,149,59,23,38,5836
"05137950100",3269,536,0,0,62,183,121,0,4171
"05137950201",949,316,0,0,77,0,18,2,1362
"05137950202",4903,2007,0,0,83,0,15,57,7065
"05139950100",1600,145,985,288,8,0,4,1,3031
"05139950200",2620,584,615,38,60,85,43,29,4074
"05139950300",1568,215,273,214,17,14,12,29,2342
"05139950400",4343,640,793,315,224,37,379,376,7107
"05139950500",4979,531,307,76,0,0,88,0,5981
"05139950600",1343,243,962,965,29,6,173,68,3789
"05139950700",2619,546,1119,600,170,0,53,0,5107
"05139950800",2196,401,513,180,213,0,0,0,3503
"05139950900",559,122,1061,658,65,13,114,29,2621
"05139951000",552,114,2017,1108,59,34,55,0,3939
"05141460100",2135,988,0,0,36,85,4,14,3262
"05141460200",2721,771,0,0,199,34,188,13,3926
"05141460301",1492,300,0,0,90,4,11,0,1897
"05141460302",3177,610,0,65,30,0,115,0,3997
"05141460400",3093,677,61,0,129,40,122,20,4142
"05143010101",2810,488,0,0,628,372,544,166,5008
"05143010102",7363,327,50,2,766,232,302,232,9274
"05143010104",4239,492,141,42,480,76,30,35,5535
"05143010105",7414,651,193,0,473,72,321,3,9127
"05143010106",4255,432,202,73,735,215,401,34,6347
"05143010107",4673,541,38,0,223,14,187,0,5676
"05143010200",2439,1233,13,23,2492,1423,2145,1629,11397
"05143010301",4765,1173,172,0,1202,2046,1867,2365,13590
"05143010302",7017,1264,490,557,3388,1985,5030,1623,21354
"05143010401",3355,378,5,0,1720,734,1892,779,8863
"05143010402",2747,373,19,0,992,361,1298,446,6236
"05143010403",3381,664,59,73,1509,1569,1363,927,9545
"05143010501",4223,626,0,0,347,154,210,121,5681
"05143010503",5888,378,189,202,1011,57,689,16,8430
"05143010504",5468,739,0,31,533,73,265,36,7145
"05143010506",7821,1462,266,0,1233,396,647,139,11964
"05143010507",5186,998,247,108,648,170,255,75,7687
"05143010508",4972,557,491,13,358,236,238,210,7075
"05143010509",5937,462,31,0,1251,264,806,196,8947
"05143010510",3300,185,17,44,1018,148,1282,309,6303
"05143010600",3039,2105,355,83,876,197,409,104,7168
"05143010701",2900,2046,235,140,816,865,841,273,8116
"05143010702",3115,1293,146,57,296,263,233,285,5688
"05143011001",6695,900,24,0,393,85,96,56,8249
"05143011002",3382,943,18,4,344,210,80,37,5018
"05143011003",3914,466,33,239,141,56,11,28,4888
"05143011004",2749,352,1,1,106,4,44,0,3257
"05143011101",3267,1853,77,284,397,138,573,44,6633
"05143011102",5075,1242,82,333,450,111,690,262,8245
"05143011103",3496,694,0,0,66,13,82,41,4392
"05143011200",998,251,37,0,607,196,641,296,3026
"05143011300",1526,1033,36,78,101,123,51,77,3025
"05145070100",3569,747,8,0,46,45,45,42,4502
"05145070200",3767,742,0,0,81,47,219,47,4903
"05145070300",4028,501,0,164,207,83,235,20,5238
"05145070401",4672,547,346,39,125,1,138,32,5900
"05145070402",3416,830,101,27,183,23,85,33,4698
"05145070500",4721,1010,279,8,154,50,192,171,6585
"05145070600",2983,1074,67,0,58,132,13,141,4468
"05145070700",2743,453,123,217,103,81,0,109,3829
"05145070800",2255,1047,329,82,141,188,102,123,4267
"05145070900",6926,1128,452,159,204,2,248,107,9226
"05145071000",5940,673,0,0,286,82,47,33,7061
"05145071100",3946,1219,159,211,568,227,283,302,6915
"05145071200",7120,2023,316,297,168,16,5,306,10251
"05147490100",2476,645,568,157,106,31,6,12,4001
"05147490200",1319,343,730,389,52,47,9,5,2894
"05149952301",1760,814,197,146,384,136,662,502,4601
"05149952302",1783,482,64,0,628,78,714,265,4014
"05149952401",2082,421,16,0,378,69,382,138,3486
"05149952402",4801,493,0,75,123,115,60,131,5798
"05149952500",2327,504,68,0,1002,307,909,363,5480
"05149952600",1792,363,0,0,96,6,7,6,2270
"06001400100",2041,84,106,0,702,19,99,0,3051
"06001400200",1501,90,29,0,339,25,159,21,2164
"06001400300",3361,143,503,185,1016,102,364,0,5674
"06001400400",2713,210,411,40,670,55,345,22,4466
"06001400500",2021,221,753,135,401,104,348,170,4153
"06001400600",602,34,611,33,329,42,184,21,1856
"06001400700",1708,323,1308,523,629,53,564,27,5135
"06001400800",1380,127,1087,99,711,75,442,0,3921
"06001400900",901,80,674,190,254,42,47,35,2223
"06001401000",1610,724,1581,799,1164,101,866,309,7154
"06001401100",2100,312,748,200,705,145,546,92,4848
"06001401200",1371,118,323,46,580,34,390,54,2916
"06001401300",825,341,755,600,900,290,335,179,4225
"06001401400",611,489,1118,770,724,426,509,427,5074
"06001401500",764,111,682,241,258,157,184,23,2420
"06001401600",518,287,602,136,251,172,123,167,2256
"06001401700",1063,177,537,295,571,147,609,154,3553
"06001401800",367,136,611,430,244,159,284,91,2322
"06001402200",720,204,594,271,494,157,395,121,2956
"06001402400",346,134,1479,371,306,302,239,13,3190
"06001402500",240,77,511,665,211,203,167,154,2228
"06001402600",145,80,208,105,353,343,46,0,1280
"06001402700",424,181,475,339,343,37,215,85,2099
"06001402800",743,436,783,670,457,409,160,101,3759
"06001402900",319,31,169,73,537,238,117,38,1522
"06001403000",171,61,8,58,1684,722,33,34,2771
"06001403100",438,45,89,98,465,317,72,6,1530
"06001403300",1109,56,333,36,1689,838,131,64,4256
"06001403400",1527,121,757,60,1514,359,506,40,4884
"06001403501",1219,448,1098,216,1117,402,622,70,5192
"06001403502",1162,108,264,156,452,53,152,50,2397
"06001403600",1775,74,1142,91,1030,255,410,40,4817
"06001403701",1513,141,384,91,545,100,220,37,3031
"06001403702",1265,43,172,26,365,47,171,7,2096
"06001403800",2319,141,149,57,655,51,223,48,3643
"06001403900",1947,156,723,112,952,93,78,57,4118
"06001404000",1674,136,134,44,701,111,415,44,3259
"06001404101",2140,119,55,26,547,90,181,1,3159
"06001404102",1354,50,189,5,587,205,212,47,2649
"06001404200",2496,28,244,67,616,10,168,0,3629
"06001404300",2397,7,144,23,798,28,277,23,3697
"06001404400",3563,234,189,25,1171,92,317,62,5653
"06001404501",1256,35,63,0,408,0,88,0,1850
"06001404502",4059,124,227,0,986,36,414,0,5846
"06001404600",3029,122,184,14,939,19,153,26,4486
"06001404700",1572,68,146,0,322,27,109,0,2244
"06001404800",1207,64,528,92,873,147,330,39,3280
"06001404900",2425,104,229,60,1204,96,447,96,4661
"06001405000",2072,111,391,30,719,41,309,31,3704
"06001405100",2765,60,586,14,823,0,174,0,4422
"06001405200",2076,140,537,46,1797,187,604,4,5391
"06001405301",1377,22,589,117,632,40,303,0,3080
"06001405302",805,160,322,67,799,379,386,99,3017
"06001405401",804,304,734,217,1437,617,839,359,5311
"06001405402",340,200,632,223,1261,310,335,141,3442
"06001405500",826,184,629,71,1799,538,491,261,4799
"06001405600",976,154,728,51,1108,188,354,117,3676
"06001405700",425,227,862,274,1386,168,549,158,4049
"06001405800",495,236,685,401,1616,723,526,330,5012
"06001405901",379,318,522,236,1838,759,891,570,5513
"06001405902",492,243,126,173,1653,773,698,491,4649
"06001406000",717,134,545,111,966,999,166,114,3752
"06001406100",1158,738,342,45,2097,498,2174,854,7906
"06001406201",822,473,406,219,1498,773,1203,644,6038
"06001406202",1300,687,304,284,1132,759,1693,889,7048
"06001406300",948,335,592,94,1586,439,800,416,5210
"06001406400",550,105,519,150,674,165,306,146,2615
"06001406500",1651,493,952,279,2167,680,1996,849,9067
"06001406601",880,79,1032,617,2248,139,908,34,5937
"06001406602",737,288,349,106,1202,209,609,407,3907
"06001406700",3098,86,319,148,1080,275,563,61,5630
"06001406800",1571,31,337,226,1243,70,550,25,4053
"06001406900",1507,144,726,305,1006,141,383,16,4228
"06001407000",977,19,937,425,2493,866,1276,363,7356
"06001407101",863,636,449,103,959,745,911,1114,5780
"06001407102",1422,290,693,283,1030,324,1628,314,5984
"06001407200",1980,1103,355,241,1815,973,2776,1641,10884
"06001407300",800,320,198,106,894,169,952,370,3809
"06001407400",1228,165,479,241,1647,750,2390,795,7695
"06001407500",775,240,895,443,1144,321,1331,350,5499
"06001407600",1095,307,1705,779,1911,295,1532,231,7855
"06001407700",1308,40,1858,315,538,21,554,21,4655
"06001407800",531,38,749,33,556,14,366,20,2307
"06001407900",1356,96,407,11,993,39,250,0,3152
"06001408000",1200,43,381,26,649,79,192,12,2582
"06001408100",2393,97,1555,97,1743,138,581,66,6670
"06001408200",962,42,1513,605,839,135,484,39,4619
"06001408300",1182,159,1708,279,1137,92,729,69,5355
"06001408400",516,222,1007,550,694,516,842,533,4880
"06001408500",641,224,1815,354,1797,818,2094,950,8693
"06001408600",1329,489,1174,922,1693,613,2562,947,9729
"06001408700",1196,788,2408,1037,1485,608,2526,1378,11426
"06001408800",948,238,672,1281,2419,726,2769,681,9734
"06001408900",460,519,595,506,563,570,806,879,4898
"06001409000",859,188,1132,461,911,324,1324,487,5686
"06001409100",450,47,517,410,534,259,737,177,3131
"06001409200",485,229,1106,170,1178,172,1156,311,4807
"06001409300",1200,235,1231,337,1387,793,2120,979,8282
"06001409400",984,513,846,354,1341,526,1922,734,7220
"06001409500",647,374,823,490,1272,559,1646,725,6536
"06001409600",844,386,1238,309,1645,763,2349,966,8500
"06001409700",1315,340,1631,687,1129,305,2081,551,8039
"06001409800",164,121,1504,295,1011,23,478,8,3604
"06001409900",976,64,1488,135,659,22,478,22,3844
"06001410000",1203,18,1393,108,405,5,214,0,3346
"06001410100",458,318,1272,362,472,18,393,75,3368
"06001410200",445,378,1179,401,699,140,1017,455,4714
"06001410300",773,210,617,395,1083,303,1622,451,5454
"06001410400",1094,182,1403,340,1178,127,1655,240,6219
"06001410500",95,86,864,597,436,243,105,63,2489
"06001420100",1689,88,72,0,613,25,231,0,2718
"06001420200",1472,173,211,46,1240,120,360,74,3696
"06001420300",1791,117,266,0,2032,325,380,99,5010
"06001420400",1029,500,84,55,1445,509,445,360,4427
"06001420500",1236,72,82,16,896,41,227,0,2570
"06001420600",2046,76,19,0,769,16,259,16,3201
"06001421100",1598,76,12,0,390,25,82,0,2183
"06001421200",2938,109,12,0,547,47,250,0,3903
"06001421300",3071,193,127,0,638,9,115,20,4173
"06001421400",1360,30,50,0,271,32,95,19,1857
"06001421500",2989,107,78,0,514,18,159,12,3877
"06001421600",2675,226,0,17,482,116,149,49,3714
"06001421700",2311,310,43,4,744,168,427,79,4086
"06001421800",1597,77,37,3,394,29,78,13,2228
"06001421900",2238,155,269,12,724,380,142,23,3943
"06001422000",972,320,108,196,235,109,148,125,2213
"06001422100",1329,152,334,9,575,21,463,93,2976
"06001422200",2073,291,174,1,731,194,350,64,3878
"06001422300",2267,394,110,70,873,308,282,57,4361
"06001422400",2024,221,20,36,1139,729,193,153,4515
"06001422500",1624,476,62,30,593,404,200,79,3468
"06001422600",86,0,0,0,0,0,0,0,86
"06001422700",1001,659,0,41,237,592,184,177,2891
"06001422800",760,538,63,83,617,950,96,100,3207
"06001422900",1120,733,322,176,964,1026,122,43,4506
"06001423000",3199,334,44,17,998,133,528,28,5281
"06001423100",1837,351,244,144,1091,377,355,83,4482
"06001423200",1358,137,297,60,574,368,660,360,3814
"06001423300",1752,118,1197,278,567,143,450,147,4652
"06001423400",2651,451,401,173,1275,267,570,89,5877
"06001423500",1499,347,346,79,649,142,318,110,3490
"06001423601",1650,320,55,0,536,147,269,41,3018
"06001423602",1734,1071,61,273,663,1943,358,168,6271
"06001423700",1854,633,23,16,400,437,161,57,3581
"06001423800",2438,117,0,0,493,26,342,7,3423
"06001423901",1300,127,85,131,273,62,318,5,2301
"06001423902",1027,147,30,6,185,21,127,28,1571
"06001424001",1440,353,837,383,922,168,665,144,4912
"06001424002",712,115,651,223,441,126,324,159,2751
"06001425101",817,161,135,0,437,32,25,0,1607
"06001425102",1224,227,230,63,1100,175,170,0,3189
"06001425103",1289,65,205,52,1156,50,311,0,3128
"06001425104",1180,194,753,77,1002,195,386,154,3941
"06001426100",4232,345,37,0,1502,85,237,24,6462
"06001426200",3404,97,58,0,1260,47,230,0,5096
"06001427100",2355,125,121,14,764,37,116,52,3584
"06001427200",2166,109,145,70,1062,489,1021,92,5154
"06001427300",2076,17,570,23,1816,623,542,72,5739
"06001427600",977,426,586,474,2211,865,460,113,6112
"06001427700",2598,198,317,30,1631,186,538,76,5574
"06001427800",2795,370,348,33,1533,64,590,44,5777
"06001427900",2598,89,369,17,1612,104,531,49,5369
"06001428000",1199,107,176,40,1314,280,372,83,3571
"06001428100",2968,236,80,24,1563,53,684,9,5617
"06001428200",3518,106,358,75,2419,177,673,29,7355
"06001428301",2406,75,49,0,3910,144,649,43,7276
"06001428302",3078,36,177,2,3628,61,294,1,7277
"06001428400",2097,212,144,8,1399,233,613,14,4720
"06001428500",1486,150,148,16,1394,163,458,37,3852
"06001428600",1180,107,238,42,1431,24,214,0,3236
"06001428700",1117,118,302,256,1699,271,286,66,4115
"06001430101",2477,426,299,0,3722,47,521,0,7492
"06001430102",1467,16,60,0,591,5,256,5,2400
"06001430200",4823,0,96,7,1550,72,783,19,7350
"06001430300",2065,75,730,4,727,5,356,11,3973
"06001430400",1331,12,21,0,678,13,347,0,2402
"06001430500",2671,419,627,122,1674,157,1553,325,7548
"06001430600",3096,93,193,1,2074,227,644,0,6328
"06001430700",2776,29,136,10,888,50,490,35,4414
"06001430800",3669,166,91,13,1807,286,1174,138,7344
"06001430900",2026,498,453,202,1356,291,1274,148,6248
"06001431000",1694,172,58,9,754,253,878,190,4008
"06001431100",1708,226,229,151,880,70,1013,44,4321
"06001431200",2637,582,630,17,1228,321,872,256,6543
"06001432100",1695,53,613,79,1297,52,667,27,4483
"06001432200",1937,291,669,32,978,83,961,199,5150
"06001432300",1492,480,437,9,2149,198,1329,473,6567
"06001432400",2108,472,554,147,2167,502,1311,413,7674
"06001432501",1604,372,221,0,2504,142,1010,339,6192
"06001432502",1358,164,741,12,2093,149,1210,138,5865
"06001432600",2588,296,1041,273,2611,336,2127,270,9542
"06001432700",1672,83,161,8,599,6,697,29,3255
"06001432800",1685,45,379,0,1145,24,820,0,4098
"06001433000",2065,57,286,21,1127,255,901,86,4798
"06001433102",1647,111,189,12,1807,76,976,78,4896
"06001433103",1712,160,883,150,1210,32,1642,140,5929
"06001433104",1474,226,669,63,1407,124,1044,216,5223
"06001433200",2155,371,1092,331,2967,354,1091,341,8702
"06001433300",2513,125,488,2,3510,577,1610,24,8849
"06001433400",1685,47,499,25,3408,929,964,0,7557
"06001433500",1734,200,222,13,2622,50,1669,170,6680
"06001433600",1693,185,167,106,3278,394,1069,54,6946
"06001433700",1914,275,411,0,720,26,1653,229,5228
"06001433800",3034,325,758,96,3586,245,3019,47,11110
"06001433900",2270,943,1654,653,1473,565,2364,1089,11011
"06001434000",2143,283,674,535,1333,534,2285,600,8387
"06001435102",2083,104,324,55,1556,252,808,13,5195
"06001435103",2238,76,511,48,3566,222,581,0,7242
"06001435104",1364,413,557,88,2359,667,1279,449,7176
"06001435200",1328,354,1264,17,1326,63,834,76,5262
"06001435300",1506,277,825,356,806,205,704,302,4981
"06001435400",2014,286,686,217,893,126,1259,201,5682
"06001435500",1796,376,277,38,861,149,1214,360,5071
"06001435601",1379,707,393,273,2114,616,2449,846,8777
"06001435602",2552,884,355,89,916,444,2016,736,7992
"06001435700",2326,372,284,95,1618,54,2011,344,7104
"06001435800",2636,237,135,0,2080,273,1842,378,7581
"06001435900",2666,109,145,182,2079,192,1440,41,6854
"06001436000",2102,168,104,0,1831,93,1323,27,5648
"06001436100",2502,257,324,19,2845,284,2213,278,8722
"06001436200",1448,390,390,249,1181,222,1848,487,6215
"06001436300",2790,376,879,355,2971,543,3085,1044,12043
"06001436401",4302,301,692,405,1768,351,2369,443,10631
"06001436402",1642,82,494,25,589,40,683,44,3599
"06001436500",1405,577,530,167,1812,464,1378,619,6952
"06001436601",2602,238,633,105,2326,312,2999,497,9712
"06001436602",1439,550,876,271,1910,361,1897,632,7936
"06001436700",990,208,278,87,1784,90,1275,138,4850
"06001436800",1183,357,721,0,1780,219,1736,311,6307
"06001436900",2757,565,200,75,2649,318,3703,616,10883
"06001437000",1412,113,491,26,1158,125,1003,101,4429
"06001437101",1902,83,286,18,4499,76,1147,8,8019
"06001437102",1201,123,304,55,2337,314,1224,116,5674
"06001437200",2494,101,668,236,3619,500,1780,231,9629
"06001437300",844,200,322,87,1689,238,958,275,4613
"06001437400",1612,86,68,0,1496,78,1690,97,5127
"06001437500",1217,700,146,75,1606,709,1780,1251,7484
"06001437600",1275,115,315,57,1420,267,1537,189,5175
"06001437701",1059,453,288,38,1466,479,1405,744,5932
"06001437702",1742,687,194,87,1861,322,2872,862,8627
"06001437800",1281,128,394,81,2550,39,1786,72,6331
"06001437900",830,60,177,12,1075,130,1293,68,3645
"06001438000",1849,307,4,5,1239,95,1037,302,4838
"06001438100",2854,42,378,376,3263,185,2250,194,9542
"06001438201",1739,78,214,153,2486,191,2249,198,7308
"06001438203",983,89,437,15,2687,268,761,163,5403
"06001438204",1768,60,435,14,2960,95,1311,4,6647
"06001438300",1268,82,363,72,2192,176,1555,138,5846
"06001438400",991,23,236,47,1146,53,761,28,3285
"06001440100",918,100,74,12,1224,139,527,33,3027
"06001440200",1230,221,165,3,4057,470,3954,559,10659
"06001440301",1889,14,638,12,3695,556,1736,500,9040
"06001440304",706,9,162,112,4072,82,877,0,6020
"06001440305",837,44,263,56,2627,243,615,11,4696
"06001440306",394,107,181,133,2921,418,215,33,4402
"06001440307",1266,231,82,101,2144,172,675,72,4743
"06001440308",1025,217,213,30,3851,223,1715,103,7377
"06001440331",586,26,189,5,2589,197,604,75,4271
"06001440332",399,17,26,0,3016,71,234,5,3768
"06001440333",550,5,159,0,1962,125,238,7,3046
"06001440334",616,109,98,0,3569,275,313,94,5074
"06001440335",964,68,163,0,5682,121,516,35,7549
"06001440336",1101,256,548,10,2893,373,861,218,6260
"06001441100",1875,73,36,0,1980,201,943,121,5229
"06001441200",2846,192,327,77,3909,18,1166,49,8584
"06001441301",861,123,112,2,2028,47,304,7,3484
"06001441302",1654,161,168,93,3295,327,791,59,6548
"06001441401",1856,64,302,18,4809,452,714,125,8340
"06001441402",1423,39,73,63,3561,45,512,8,5724
"06001441501",783,27,122,236,5303,131,366,25,6993
"06001441503",273,55,181,21,5754,100,156,10,6550
"06001441521",1149,74,266,4,4599,42,327,16,6477
"06001441522",1122,258,76,36,3705,171,774,61,6203
"06001441523",407,8,169,0,3520,199,204,13,4520
"06001441524",229,83,13,0,3917,129,144,37,4552
"06001441601",1606,230,181,0,2756,19,959,24,5775
"06001441602",1959,114,456,29,5094,350,1634,150,9786
"06001441700",2490,94,391,63,3864,346,1903,204,9355
"06001441800",2842,115,73,56,3770,125,863,14,7858
"06001441921",1091,45,101,8,2497,18,929,7,4696
"06001441923",756,356,20,77,3955,341,468,183,6156
"06001441924",2535,1085,48,0,3925,176,568,571,8908
"06001441925",1295,111,246,0,4427,49,373,0,6501
"06001441926",736,100,91,14,3466,166,1686,114,6373
"06001441927",529,66,241,8,3334,134,237,53,4602
"06001442000",718,34,2,1,2370,103,26,0,3254
"06001442100",1018,25,29,0,4053,120,209,10,5464
"06001442200",1479,120,41,0,5216,32,271,13,7172
"06001442301",1266,39,207,103,2814,382,671,65,5547
"06001442302",1222,150,610,13,3034,447,663,87,6226
"06001442400",1868,243,87,174,4028,540,1755,543,9238
"06001442500",1946,140,590,17,4197,273,1128,86,8377
"06001442601",1552,94,77,6,1991,28,637,27,4412
"06001442602",2095,227,131,138,1961,386,772,164,5874
"06001442700",1663,73,25,0,1460,30,593,16,3860
"06001442800",1277,56,62,85,1401,154,497,35,3567
"06001442900",2792,62,321,6,4376,108,1367,1,9033
"06001443001",936,47,59,2,1819,13,1010,40,3926
"06001443002",1961,81,64,0,3929,237,1409,0,7681
"06001443102",883,20,15,4,3968,93,343,14,5340
"06001443103",278,109,100,0,3450,179,31,0,4147
"06001443104",1086,57,48,8,4329,215,305,22,6070
"06001443105",750,29,29,0,3623,21,0,0,4452
"06001443200",639,13,13,0,2784,204,85,8,3746
"06001443301",1004,108,128,0,2673,172,239,11,4335
"06001443321",607,59,0,0,2738,65,223,0,3692
"06001443322",763,23,20,0,2509,57,122,0,3494
"06001444100",3956,115,46,21,3216,191,1902,108,9555
"06001444200",1930,212,214,102,4169,153,2950,101,9831
"06001444301",1624,162,72,0,2078,48,1146,40,5170
"06001444302",857,429,97,0,2766,436,1876,703,7164
"06001444400",1219,156,101,126,3187,113,2268,179,7349
"06001444500",1855,251,419,159,3921,341,2299,327,9572
"06001444601",2186,174,319,0,2221,122,839,56,5917
"06001444602",1052,49,272,0,2852,116,521,0,4862
"06001450101",1631,106,371,0,2483,146,256,9,5002
"06001450102",1489,56,77,0,2476,59,817,0,4974
"06001450200",2927,156,214,0,1770,36,517,0,5620
"06001450300",3007,211,255,7,1558,76,593,164,5871
"06001450400",4061,132,62,3,1645,105,813,42,6863
"06001450501",2444,120,156,10,736,18,355,57,3896
"06001450502",3444,80,85,2,1554,11,415,13,5604
"06001450601",2181,120,156,0,962,109,144,0,3672
"06001450602",6118,207,115,133,2945,101,869,37,10525
"06001450603",3237,74,17,0,1518,37,460,9,5352
"06001450604",3735,217,19,6,1111,0,479,45,5612
"06001450605",2740,126,35,15,1025,29,399,16,4385
"06001450606",3853,39,26,14,1970,72,334,16,6324
"06001450607",3265,161,149,226,1404,97,685,251,6238
"06001450701",5126,468,0,16,2876,32,452,19,8989
"06001450741",3647,189,142,0,991,102,1110,128,6309
"06001450742",3300,22,81,0,1182,44,516,15,5160
"06001450743",1985,200,55,61,3240,68,380,0,5989
"06001450744",3145,58,73,0,1759,79,515,63,5692
"06001450745",2665,16,99,0,3366,61,331,0,6538
"06001450746",2578,190,30,0,663,18,435,0,3914
"06001450750",1956,216,144,32,1855,109,494,53,4859
"06001450751",1604,16,208,0,3677,171,264,0,5940
"06001450752",1779,28,286,7,3497,14,386,13,6010
"06001451101",4932,179,57,90,1470,0,748,48,7524
"06001451102",3128,71,13,12,694,53,221,3,4195
"06001451201",4806,292,89,0,1653,115,1416,53,8424
"06001451202",2940,252,52,3,1049,0,847,24,5167
"06001451300",5455,176,104,27,1124,199,1136,172,8393
"06001451401",4744,477,12,35,1038,166,1005,364,7841
"06001451403",1630,102,44,0,377,5,457,19,2634
"06001451404",4429,519,170,15,797,193,2663,419,9205
"06001451501",3803,93,52,0,722,16,702,0,5388
"06001451503",3998,245,0,0,1117,204,1448,110,7122
"06001451504",1288,25,38,0,388,10,261,0,2010
"06001451505",2869,25,0,0,345,26,407,0,3672
"06001451506",2399,437,76,55,535,25,1142,389,5058
"06001451601",4277,111,0,11,807,16,449,22,5693
"06001451602",5563,183,25,0,973,39,988,14,7785
"06001451701",2269,51,41,2,516,25,414,2,3320
"06001451703",3167,120,24,0,1265,25,713,24,5338
"06001451704",3723,152,63,0,345,51,763,12,5109
"06001981900",23,0,0,0,0,0,0,0,23
"06001982000",46,0,0,0,23,0,16,0,85
"06001983200",286,17,45,24,219,9,70,9,679
"06001990000",0,0,0,0,0,0,0,0,0
"06003010000",644,134,0,0,276,61,68,40,1223
"06005000101",2911,199,5,2,153,137,173,36,3616
"06005000102",1107,186,3,0,186,67,122,26,1697
"06005000200",2950,431,0,4,494,67,423,64,4433
"06005000301",1187,83,25,0,30,0,85,16,1426
"06005000303",5706,934,1,0,629,85,745,64,8164
"06005000304",3063,369,0,0,216,141,278,261,4328
"06005000401",3539,440,0,0,218,69,418,128,4812
"06005000402",3060,758,2,1,488,16,359,38,4722
"06005000500",2655,162,0,0,48,40,88,25,3018
"06007000102",3050,559,15,0,561,32,623,82,4922
"06007000103",3111,238,22,12,565,32,616,52,4648
"06007000104",4052,918,135,17,479,91,664,236,6592
"06007000201",3274,746,0,0,219,174,617,389,5419
"06007000202",2195,610,159,0,281,259,226,90,3820
"06007000300",2618,878,32,61,624,122,580,277,5192
"06007000401",2076,265,11,0,333,92,569,87,3433
"06007000402",6139,466,7,24,600,115,1102,38,8491
"06007000501",2398,819,17,7,490,197,502,332,4762
"06007000502",1403,1857,20,38,325,639,518,426,5226
"06007000601",2814,387,0,14,158,101,311,83,3868
"06007000603",1132,796,0,65,143,107,145,220,2608
"06007000604",1337,1788,9,190,251,535,165,643,4918
"06007000700",3551,907,52,20,238,141,150,229,5288
"06007000800",3838,621,0,3,959,81,851,248,6601
"06007000901",2282,88,0,0,169,13,297,0,2849
"06007000903",3920,909,130,135,968,274,715,323,7374
"06007000904",4872,463,38,64,622,64,472,71,6666
"06007001000",2266,1315,17,51,345,111,621,116,4842
"06007001100",1624,1233,8,138,148,469,132,339,4091
"06007001200",1707,930,52,0,193,318,317,186,3703
"06007001300",1972,804,16,41,264,966,655,649,5367
"06007001400",4541,521,24,1,488,27,598,39,6239
"06007001500",4435,849,27,0,120,107,362,460,6360
"06007001600",3748,386,45,0,424,33,402,53,5091
"06007001702",4112,738,0,0,394,98,366,90,5798
"06007001703",2469,279,0,7,119,80,156,13,3123
"06007001704",2165,802,0,0,151,17,163,116,3414
"06007001800",4232,729,2,0,334,69,264,132,5762
"06007001900",2746,353,0,0,161,43,135,129,3567
"06007002000",4427,756,0,0,333,101,278,76,5971
"06007002100",3472,565,0,58,279,17,206,42,4639
"06007002200",3613,873,24,0,262,38,146,47,5003
"06007002300",3912,722,13,0,133,61,264,49,5154
"06007002400",3441,1177,36,3,445,162,394,165,5823
"06007002500",2496,640,194,160,663,289,261,133,4836
"06007002601",1570,188,65,0,352,0,176,1,2352
"06007002602",2843,364,23,0,227,24,132,38,3651
"06007002700",3571,705,0,7,1073,218,523,45,6142
"06007002800",1645,875,227,25,613,567,420,200,4572
"06007002900",1534,525,0,5,822,451,159,86,3582
"06007003001",1611,648,44,23,358,927,230,288,4129
"06007003002",1727,779,0,17,525,535,566,405,4554
"06007003100",3008,315,108,1,661,57,459,35,4644
"06007003200",2453,884,53,0,761,165,751,542,5609
"06007003300",2706,887,159,0,677,102,434,246,5211
"06007003400",1952,481,6,9,403,25,639,283,3798
"06007003501",2197,289,9,0,734,45,678,124,4076
"06007003502",2311,996,0,19,1223,143,1748,644,7084
"06007003600",2042,461,6,0,498,261,636,386,4290
"06007003700",2607,756,0,0,787,582,392,185,5309
"06009000120",4605,358,12,0,176,73,515,22,5761
"06009000121",3426,726,0,0,64,55,363,138,4772
"06009000122",3474,559,0,0,200,0,109,172,4514
"06009000210",7806,1088,2,21,568,221,1314,55,11075
"06009000220",4929,180,105,0,770,38,853,24,6899
"06009000300",4665,773,62,0,544,61,356,294,6755
"06009000400",2417,831,1,2,233,49,187,91,3811
"06009000501",2754,352,0,0,25,0,281,0,3412
"06009000503",1395,114,0,0,48,26,28,0,1611
"06009000504",332,56,0,0,18,7,3,1,417
"06011000100",3917,625,0,0,572,146,2989,509,8758
"06011000200",3300,645,12,52,723,155,1842,597,7326
"06011000300",4706,539,15,11,534,291,3477,738,10311
"06011000400",1903,188,40,1,53,67,562,137,2951
"06011000500",1848,367,1,11,387,73,1052,285,4024
"06013301000",3230,159,245,64,450,80,730,137,5095
"06013302005",3522,950,136,155,1851,150,2017,518,9299
"06013302006",3081,12,113,0,884,11,1408,12,5521
"06013302007",4174,228,377,186,1339,66,2405,147,8922
"06013302008",4819,506,1048,16,2194,192,3088,212,12075
"06013302009",2225,159,1258,369,2569,349,1817,229,8975
"06013302010",7377,366,542,8,2180,234,3148,186,14041
"06013303102",5252,559,545,42,2007,268,2436,526,11635
"06013303103",7519,454,538,41,2047,781,3615,456,15451
"06013303201",4997,528,1478,344,3510,224,2012,240,13333
"06013303202",4753,70,403,7,1705,193,1502,125,8758
"06013303203",6300,411,535,254,1740,0,1556,4,10800
"06013303204",3667,133,201,203,483,225,1348,235,6495
"06013303205",6475,202,24,0,948,0,1295,96,9040
"06013304001",2649,363,129,0,1124,27,675,65,5032
"06013304002",1175,55,0,0,63,0,506,28,1827
"06013304003",3021,183,39,335,342,9,418,27,4374
"06013304004",3293,64,27,0,486,12,559,0,4441
"06013304005",5509,313,205,0,1410,21,1242,225,8925
"06013305000",2238,908,773,426,1894,317,2267,712,9535
"06013306002",1961,153,180,0,529,151,849,142,3965
"06013306003",2067,832,465,188,1152,242,1459,491,6896
"06013306004",1777,302,605,70,415,183,818,389,4559
"06013307101",2718,368,206,107,820,95,1537,244,6095
"06013307102",2518,888,209,66,1209,491,2215,1133,8729
"06013307201",1518,285,176,54,898,337,1209,281,4758
"06013307202",887,578,1043,340,823,494,891,542,5598
"06013307204",2042,432,354,113,810,393,1284,526,5954
"06013307205",2596,391,845,397,1610,383,1974,108,8304
"06013308001",3546,643,308,527,1488,212,1405,160,8289
"06013308002",1870,50,738,110,1552,25,1053,14,5412
"06013309000",1107,148,1134,164,586,115,902,164,4320
"06013310000",1535,252,1023,156,2488,1025,2785,1077,10341
"06013311000",1242,237,858,398,2018,449,1764,437,7403
"06013312000",393,233,481,307,503,273,567,377,3134
"06013313101",2153,690,705,303,2480,1110,1240,1346,10027
"06013313102",1373,113,849,287,1040,168,1019,135,4984
"06013313103",3030,18,968,32,3248,902,2105,490,10793
"06013313203",1487,75,128,8,1416,122,1171,127,4534
"06013313204",1648,397,454,281,2332,275,2023,442,7852
"06013313205",608,18,138,0,955,8,724,0,2451
"06013313206",1267,805,941,274,2280,598,2329,1169,9663
"06013314102",1705,306,334,188,2511,566,2478,562,8650
"06013314103",1460,612,654,483,2141,921,2326,1132,9729
"06013314104",2290,1023,491,521,2260,642,3127,1167,11521
"06013314200",2526,889,178,31,2665,447,3908,1142,11786
"06013315000",1773,176,104,38,1166,193,563,62,4075
"06013316000",522,136,40,16,53,7,165,0,939
"06013317000",1560,107,92,91,395,24,209,14,2492
"06013318000",2442,181,39,0,490,51,558,61,3822
"06013319000",5924,578,92,47,1043,276,1221,446,9627
"06013320001",2311,588,90,25,1067,105,1539,341,6066
"06013320003",1897,166,77,0,670,0,396,33,3239
"06013320004",4703,251,98,25,1265,119,1125,18,7604
"06013321101",5032,202,232,29,1240,57,1108,0,7900
"06013321102",4851,191,22,37,1572,140,878,60,7751
"06013321103",3527,92,17,2,555,13,537,2,4745
"06013321200",2886,326,116,0,1216,928,548,125,6145
"06013322000",3924,588,36,49,1144,413,636,261,7051
"06013323000",3921,182,7,3,605,43,734,41,5536
"06013324001",3161,329,109,48,1707,104,706,4,6168
"06013324002",3761,212,110,3,948,84,811,114,6043
"06013325000",4405,296,64,7,652,35,809,18,6286
"06013326000",2717,240,112,11,381,0,217,2,3680
"06013327000",5058,411,17,4,1668,454,2783,417,10812
"06013328000",959,318,195,49,651,188,355,108,2823
"06013329000",4142,706,219,7,1503,108,1910,399,8994
"06013330000",3484,607,99,39,1372,294,1145,508,7548
"06013331000",4473,432,153,152,1874,325,1449,295,9153
"06013332000",5646,538,9,0,1500,274,1581,421,9969
"06013333101",3032,121,59,70,1060,1,929,1,5273
"06013333102",2813,174,127,0,650,33,433,49,4279
"06013333200",4478,130,64,15,931,123,1306,181,7228
"06013334001",2466,222,240,0,758,87,592,1,4366
"06013334004",4514,485,365,232,1657,189,1497,0,8939
"06013334006",2975,111,117,0,1397,105,452,24,5181
"06013334200",5970,66,209,10,1283,0,871,6,8415
"06013335000",2205,131,106,49,504,307,770,193,4265
"06013336101",2346,805,295,21,1117,572,2146,856,8158
"06013336102",2604,930,350,531,2917,384,3701,930,12347
"06013336201",2486,287,0,0,1109,276,1935,433,6526
"06013336202",2780,1537,127,19,1073,794,2511,1764,10605
"06013337100",2485,286,125,7,628,53,626,138,4348
"06013337200",5293,459,179,233,1262,136,1732,204,9498
"06013337300",4678,58,136,5,668,0,651,23,6219
"06013338101",1996,689,127,179,1493,268,1632,398,6782
"06013338102",2569,290,62,0,751,42,660,58,4432
"06013338201",2725,149,28,5,538,68,340,0,3853
"06013338203",3197,284,77,0,1168,52,216,0,4994
"06013338204",4422,132,31,30,1414,31,336,8,6404
"06013338301",2314,133,23,7,513,23,378,0,3391
"06013338302",4728,115,137,35,992,178,460,5,6650
"06013339001",2279,134,65,17,708,85,583,36,3907
"06013339002",3498,724,715,0,1529,137,377,294,7274
"06013340001",3862,615,32,22,1289,27,824,170,6841
"06013340002",5822,217,0,0,1388,53,479,41,8000
"06013341000",3813,490,62,0,754,23,378,6,5526
"06013343001",3534,187,48,2,729,242,390,130,5262
"06013343002",3877,110,14,7,694,50,671,7,5430
"06013343003",3397,39,11,2,574,0,97,0,4120
"06013345101",3752,163,110,0,1763,124,811,56,6779
"06013345102",2562,277,0,9,966,47,519,29,4409
"06013345103",3244,58,40,0,1324,121,365,24,5176
"06013345105",5099,227,50,0,1004,152,506,48,7086
"06013345108",3896,94,207,0,3052,18,497,18,7782
"06013345111",2030,49,27,0,3003,69,364,0,5542
"06013345112",3472,36,35,0,3075,138,775,40,7571
"06013345113",3445,38,165,0,658,12,365,11,4694
"06013345114",5583,242,13,4,662,12,262,2,6780
"06013345115",3436,31,60,0,2309,61,303,28,6228
"06013345116",1724,57,0,0,1034,18,405,24,3262
"06013345202",4891,59,267,0,2844,80,597,0,8738
"06013345203",5625,79,32,0,837,6,194,0,6773
"06013345204",3656,67,0,0,100,21,151,0,3995
"06013346101",2871,39,0,0,509,33,203,0,3655
"06013346102",4996,54,32,4,670,6,350,0,6112
"06013346201",5989,498,159,0,627,76,262,0,7611
"06013346203",3034,244,0,2,454,29,135,8,3906
"06013346204",5774,224,0,0,1344,0,485,0,7827
"06013347000",4910,71,123,0,1207,22,430,0,6763
"06013348000",3763,86,10,2,675,14,265,0,4815
"06013349000",3754,460,140,29,518,152,366,269,5688
"06013350000",4893,294,332,0,1132,51,490,25,7217
"06013351101",2089,35,17,0,291,9,46,0,2487
"06013351102",2695,219,0,0,641,21,164,41,3781
"06013351103",1699,116,0,0,181,1,300,12,2309
"06013351200",5037,44,0,0,957,0,434,0,6472
"06013352101",1590,40,31,0,379,44,63,9,2156
"06013352102",4117,56,0,0,854,45,343,11,5426
"06013352201",3841,391,0,0,1495,70,479,0,6276
"06013352202",1784,124,20,0,552,22,152,20,2674
"06013353001",2830,47,250,54,654,10,6,0,3851
"06013353002",3512,63,50,1,830,2,514,12,4984
"06013354001",1550,45,0,0,316,31,47,6,1995
"06013354002",4780,104,24,16,1484,0,377,1,6786
"06013355107",2634,156,379,207,1678,61,1504,47,6666
"06013355108",4185,183,3420,276,4950,362,3438,51,16865
"06013355109",3384,343,1465,135,1708,747,1440,533,9755
"06013355110",1754,76,506,0,1371,38,1673,0,5418
"06013355111",2894,19,1399,475,1858,99,1753,131,8628
"06013355112",4101,216,90,67,544,90,333,0,5441
"06013355113",3139,60,162,0,1505,32,305,0,5203
"06013355114",5331,81,159,62,5494,305,630,0,12062
"06013355115",1402,384,423,189,2542,528,405,195,6068
"06013355116",1639,66,126,0,5556,105,276,66,7834
"06013355117",1369,51,50,0,5776,79,190,0,7515
"06013355200",1866,119,1274,68,5155,303,1641,79,10505
"06013355301",5337,359,299,1,1995,132,807,86,9016
"06013355302",2743,53,39,0,736,10,136,55,3772
"06013355304",6497,249,106,30,1200,110,600,91,8883
"06013355306",4386,60,24,4,563,20,470,9,5536
"06013356001",1608,180,382,167,1684,133,980,27,5161
"06013356002",2115,108,658,23,2338,59,713,11,6025
"06013357000",2342,241,36,0,541,37,655,43,3895
"06013358000",2757,393,824,116,1502,395,1153,84,7224
"06013359102",2186,224,831,52,2158,277,1200,181,7109
"06013359103",2202,219,506,104,1694,168,688,169,5750
"06013359104",412,38,253,96,1024,80,212,16,2131
"06013359105",1147,31,1020,0,2443,96,687,0,5424
"06013359202",3256,111,422,0,1989,60,1385,71,7294
"06013359203",1660,22,1417,213,3458,179,850,0,7799
"06013359204",986,66,606,2,3080,7,607,46,5400
"06013360101",2106,169,429,10,2102,206,1298,100,6420
"06013360102",1950,80,285,19,1804,80,833,1,5052
"06013360200",2261,324,571,32,1426,128,1020,94,5856
"06013361000",2089,275,711,126,1330,275,1065,121,5992
"06013362000",1552,121,203,77,636,76,370,61,3096
"06013363000",3011,139,1487,137,2133,168,1783,22,8880
"06013364002",2220,329,458,255,2027,193,1790,205,7477
"06013365002",1477,901,754,547,1834,635,2330,1347,9825
"06013365003",1810,187,1262,94,1489,94,1053,71,6060
"06013366001",1844,394,331,75,1533,170,1805,380,6532
"06013366002",3182,375,740,199,1469,369,3353,463,10150
"06013367100",1208,327,1527,405,1318,304,1262,185,6536
"06013367200",1922,445,684,81,1614,516,1841,607,7710
"06013368001",2651,816,273,42,1134,183,3269,907,9275
"06013368002",1289,332,209,97,865,231,1344,480,4847
"06013369001",1898,1076,1070,440,1347,816,1820,954,9421
"06013369002",1131,90,369,205,675,26,841,38,3375
"06013370000",1724,95,196,138,772,24,437,0,3386
"06013371000",2161,261,765,79,2103,692,1762,638,8461
"06013372000",2978,641,679,84,2995,245,3339,818,11779
"06013373000",1481,358,400,153,1122,289,2453,619,6875
"06013374000",1499,199,492,272,1489,438,1658,560,6607
"06013375000",1613,409,236,310,1944,470,3270,755,9007
"06013376000",1548,776,961,598,1517,720,2538,1295,9953
"06013377000",2106,669,533,631,2519,432,3313,766,10969
"06013378000",2413,99,171,0,454,73,470,58,3738
"06013379000",936,474,1553,474,2313,487,2864,901,10002
"06013380000",2249,395,1576,253,1559,356,943,318,7649
"06013381000",1725,336,1793,360,1864,603,2657,786,10124
"06013382000",1072,213,2252,924,2423,464,2158,370,9876
"06013383000",1856,281,485,197,1613,204,443,59,5138
"06013384000",2179,116,245,12,931,201,261,34,3979
"06013385100",1749,21,208,0,794,50,234,2,3058
"06013385200",619,19,64,0,538,80,84,0,1404
"06013386000",1219,124,420,103,1160,411,477,24,3938
"06013387000",1607,166,234,0,799,88,254,21,3169
"06013388000",1651,88,45,22,905,187,404,22,3324
"06013389100",1115,110,65,0,714,30,331,60,2425
"06013389200",432,64,119,52,745,129,237,27,1805
"06013390100",1523,51,79,2,542,73,283,1,2554
"06013390200",1180,44,51,1,369,20,81,0,1746
"06013391000",2055,137,53,0,423,25,153,2,2848
"06013392000",2002,115,48,9,528,102,89,6,2899
"06013392200",3864,543,1432,254,4152,407,3303,518,14473
"06013392300",480,14,569,63,1870,120,248,25,3389
"06013990000",0,0,0,0,0,0,0,0,0
"06015000101",2010,770,37,10,445,373,154,140,3939
"06015000102",2342,579,0,7,499,376,185,98,4086
"06015000104",1379,306,0,9,267,375,264,250,2850
"06015000105",4439,723,0,0,992,107,596,212,7069
"06015000201",2584,253,0,32,261,174,92,95,3491
"06015000202",2191,636,0,0,406,62,434,310,4039
"06015000203",526,276,0,3,311,136,42,28,1322
"06015990000",0,0,0,0,0,0,0,0,0
"06017030200",2955,521,7,58,1126,225,1746,421,7059
"06017030301",1200,363,0,0,621,0,614,159,2957
"06017030302",1701,401,45,0,333,276,484,289,3529
"06017030401",3050,231,0,0,481,94,456,101,4413
"06017030402",2090,571,81,0,547,150,549,222,4210
"06017030502",2260,121,0,0,13,0,146,0,2540
"06017030504",1935,303,0,0,263,9,191,135,2836
"06017030505",2199,85,0,32,216,23,281,28,2864
"06017030601",4905,259,0,0,148,0,145,0,5457
"06017030602",5804,467,0,22,335,20,540,44,7232
"06017030603",2510,357,0,1,203,1,152,43,3267
"06017030701",5929,49,16,0,427,0,521,0,6942
"06017030704",4461,581,308,7,889,187,597,136,7166
"06017030706",4749,62,149,26,592,19,504,2,6103
"06017030709",4262,9,30,0,629,1,472,0,5403
"06017030710",3970,94,253,0,1045,0,393,20,5775
"06017030801",3785,112,10,0,503,56,380,4,4850
"06017030803",6546,454,17,3,312,44,607,13,7996
"06017030804",5355,758,42,16,241,261,383,454,7510
"06017030807",3743,265,18,0,236,40,411,22,4735
"06017030808",5804,112,2,0,1004,53,1075,27,8077
"06017030809",2096,246,17,0,138,13,272,36,2818
"06017030810",2318,576,0,0,257,149,445,209,3954
"06017030901",2596,188,1,0,186,6,59,4,3040
"06017030902",4004,376,24,0,383,24,339,22,5172
"06017031000",3982,1295,0,0,445,19,308,523,6572
"06017031100",3856,582,12,0,739,95,640,310,6234
"06017031200",3732,417,6,0,170,15,403,14,4757
"06017031301",3039,405,5,0,143,29,211,31,3863
"06017031302",3722,907,0,0,35,58,98,208,5028
"06017031402",4295,652,12,0,311,8,364,15,5657
"06017031404",1974,281,7,0,137,0,131,19,2549
"06017031405",2088,109,0,1,120,6,36,16,2376
"06017031406",4640,337,0,1,275,133,432,15,5833
"06017031502",4684,430,7,109,665,415,409,462,7181
"06017031503",2447,214,0,0,163,13,250,0,3087
"06017031504",4315,836,0,0,168,92,519,75,6005
"06017031600",1191,431,49,80,1752,409,1572,490,5974
"06017031700",2335,14,16,0,551,25,147,0,3088
"06017031800",4375,619,203,0,1885,332,434,91,7939
"06017031900",65,21,0,0,7,0,2,6,101
"06017032000",501,62,0,0,81,2,2,0,648
"06017990000",0,0,0,0,0,0,0,0,0
"06019000100",95,229,54,70,32,73,31,147,731
"06019000200",532,812,445,117,401,853,705,1348,5213
"06019000300",260,349,286,508,869,941,723,1167,5103
"06019000400",1380,1243,56,306,1473,1407,2490,2277,10632
"06019000501",396,161,15,213,828,935,1014,853,4415
"06019000502",713,753,11,20,1196,464,1590,1035,5782
"06019000600",880,1180,277,385,613,1788,1091,2574,8788
"06019000700",975,754,648,319,667,446,1330,1074,6213
"06019000800",292,223,53,98,205,248,376,370,1865
"06019000901",440,463,194,280,1047,635,842,752,4653
"06019000902",548,963,521,332,799,1676,1103,1781,7723
"06019001000",669,607,498,492,887,518,1072,889,5632
"06019001100",992,729,226,146,314,392,1258,993,5050
"06019001201",1353,840,54,421,1170,1280,2217,1687,9022
"06019001202",817,377,122,333,2168,1088,2198,1206,8309
"06019001301",1467,1041,20,188,1130,1394,2348,2056,9644
"06019001303",346,407,45,135,1026,440,1091,598,4088
"06019001304",734,712,268,129,1737,1762,1639,1632,8613
"06019001407",591,761,545,564,903,951,1019,1422,6756
"06019001408",821,164,196,69,570,306,685,247,3058
"06019001409",974,61,158,28,551,291,348,152,2563
"06019001410",2299,307,163,258,5919,1911,5008,1460,17325
"06019001411",1928,542,274,150,1971,968,1394,1006,8233
"06019001412",1206,109,133,0,1284,170,911,190,4003
"06019001413",2339,183,81,0,2210,508,1426,432,7179
"06019001414",3178,190,385,10,3330,995,2113,474,10675
"06019001500",1153,350,0,3,215,446,810,553,3530
"06019001600",2386,678,8,0,1240,604,2319,1231,8466
"06019001700",2485,662,51,1,1834,1124,2613,1505,10275
"06019001800",2843,504,63,19,931,306,2407,529,7602
"06019001900",1376,426,119,0,597,238,1143,514,4413
"06019002000",1391,1593,224,206,1564,1136,1757,2125,9996
"06019002100",2781,1641,155,2,627,330,1952,1438,8926
"06019002200",1837,371,165,21,405,576,908,598,4881
"06019002300",1448,759,82,104,590,456,1153,733,5325
"06019002400",1317,961,39,203,1193,1118,1678,1477,7986
"06019002501",1075,1088,102,22,995,1802,1516,2025,8625
"06019002502",876,1081,12,213,1299,2134,1273,2285,9173
"06019002601",1375,1043,0,273,1359,1567,2493,2571,10681
"06019002602",1152,464,164,6,1369,512,1847,887,6401
"06019002701",1200,668,86,122,1253,1043,2030,1446,7848
"06019002702",796,751,163,61,1563,1693,2117,1847,8991
"06019002800",683,863,96,407,1377,1250,1518,1512,7706
"06019002903",605,392,118,80,1258,1669,1006,1374,6502
"06019002904",855,357,109,66,1401,431,1440,694,5353
"06019002905",936,393,112,149,1062,572,1284,717,5225
"06019002906",1394,550,214,209,2022,1289,2092,794,8564
"06019003001",716,316,133,198,1286,581,959,608,4797
"06019003003",683,765,103,174,1217,1156,1071,1242,6411
"06019003004",1010,163,125,19,952,605,1064,487,4425
"06019003102",3830,1068,234,188,1557,810,2298,529,10514
"06019003103",2760,1233,109,106,868,442,1565,756,7839
"06019003104",2180,273,238,33,792,658,1021,455,5650
"06019003201",1641,815,346,96,1396,969,1628,1303,8194
"06019003202",1586,408,584,56,1597,1216,1816,1011,8274
"06019003301",1087,119,79,98,899,824,782,341,4229
"06019003302",1611,994,96,89,1017,906,1546,1645,7904
"06019003400",1078,1071,130,207,1470,1156,1283,1770,8165
"06019003500",1758,905,216,77,1240,1070,2175,932,8373
"06019003600",2348,755,54,25,575,124,979,449,5309
"06019003701",1368,280,65,136,955,703,1547,595,5649
"06019003702",1130,562,613,250,1165,827,1176,841,6564
"06019003803",4365,499,361,66,3514,470,3499,517,13291
"06019003804",2388,563,511,95,1875,140,2150,514,8236
"06019003805",2234,1367,145,79,1538,1380,2144,1788,10675
"06019003807",1673,545,208,46,633,190,1356,432,5083
"06019003808",2033,297,517,78,2046,485,2468,474,8398
"06019003809",2123,649,336,28,1025,534,2213,487,7395
"06019003810",2675,725,333,17,1504,600,2083,675,8612
"06019003900",3176,1477,0,0,255,285,1890,1497,8580
"06019004001",4317,1242,0,0,1388,496,4001,1691,13135
"06019004002",3756,1385,0,1,1692,567,3934,1722,13057
"06019004100",1704,485,25,0,397,206,1190,311,4318
"06019004205",2613,1374,631,160,949,1095,1765,1737,10324
"06019004207",4145,998,286,451,3014,253,3171,1106,13424
"06019004208",4481,533,350,34,2309,0,1336,0,9043
"06019004210",1714,376,234,103,695,261,874,208,4465
"06019004211",4038,430,341,122,1240,5,2363,193,8732
"06019004212",5454,931,589,1070,2673,1074,3593,1139,16523
"06019004213",2609,261,51,27,720,44,1410,76,5198
"06019004214",3386,358,34,33,1217,67,1461,119,6675
"06019004215",2593,11,408,0,1523,58,1785,34,6412
"06019004216",1571,82,299,0,711,109,1133,71,3976
"06019004301",3179,152,157,28,423,47,873,25,4884
"06019004302",4016,94,16,0,981,338,715,319,6479
"06019004303",3097,302,49,43,358,33,465,253,4600
"06019004404",1274,625,0,9,1187,526,1494,770,5885
"06019004405",2809,218,89,1,850,51,1001,1,5020
"06019004406",3193,556,157,0,718,78,1235,167,6104
"06019004408",2490,145,228,0,628,56,630,30,4207
"06019004409",2207,360,81,2,1025,21,1343,171,5210
"06019004503",3306,203,169,0,835,88,840,90,5531
"06019004504",2754,784,267,43,893,213,1402,475,6831
"06019004505",1999,882,75,170,1192,967,1677,1126,8088
"06019004506",2247,228,45,0,681,45,516,82,3844
"06019004601",2185,242,94,98,235,158,653,214,3879
"06019004602",1675,376,62,0,205,73,351,85,2827
"06019004701",2565,768,502,1027,1514,1091,2472,962,10901
"06019004703",1287,726,284,107,1190,807,1644,1071,7116
"06019004704",1697,861,234,391,642,912,1270,1428,7435
"06019004801",1854,931,375,204,828,712,1781,1191,7876
"06019004802",1965,934,190,354,972,777,1729,1222,8143
"06019004901",1450,843,73,204,732,383,1021,918,5624
"06019004902",961,234,0,0,374,381,647,286,2883
"06019005000",2109,906,130,269,612,274,1333,804,6437
"06019005100",1680,936,535,427,1735,781,1803,1156,9053
"06019005202",1067,461,95,75,1255,886,1419,715,5973
"06019005203",1367,714,250,168,1435,578,1819,913,7244
"06019005204",1968,1113,174,81,486,486,1024,841,6173
"06019005301",2073,634,561,148,2054,572,2076,810,8928
"06019005302",2228,633,178,568,1261,798,1564,719,7949
"06019005304",1985,741,188,492,1405,901,1607,1273,8592
"06019005305",1387,452,39,66,1315,151,1517,184,5111
"06019005403",1015,1047,202,356,694,758,1143,1059,6274
"06019005405",2713,329,143,39,513,43,1001,157,4938
"06019005406",2341,275,319,21,774,64,1142,176,5112
"06019005407",2196,310,79,0,718,135,764,140,4342
"06019005408",402,686,13,269,38,229,149,273,2059
"06019005409",1627,678,111,195,428,717,577,562,4895
"06019005410",1514,161,30,74,1118,152,1275,162,4486
"06019005503",3858,291,43,0,763,33,755,34,5777
"06019005504",1814,67,39,0,735,9,394,14,3072
"06019005505",4006,27,155,0,1720,496,1118,314,7836
"06019005507",3236,280,227,0,1797,183,1571,51,7345
"06019005508",3511,259,172,0,1516,91,908,63,6520
"06019005509",2792,481,157,65,1229,257,1035,304,6320
"06019005510",3075,506,93,0,1059,62,1014,52,5861
"06019005512",3602,124,73,10,847,56,1290,72,6074
"06019005513",1989,117,45,0,667,36,493,109,3456
"06019005514",2940,285,30,0,739,0,559,43,4596
"06019005515",1189,93,0,0,279,0,101,0,1662
"06019005516",3436,474,438,15,1177,97,1359,53,7049
"06019005517",6046,318,14,0,1269,0,1374,0,9021
"06019005518",2604,128,173,0,570,26,582,39,4122
"06019005520",1918,103,22,0,710,0,350,14,3117
"06019005522",3234,316,55,0,978,80,494,74,5231
"06019005524",3330,97,153,0,809,25,788,18,5220
"06019005525",976,78,0,2,173,7,56,48,1340
"06019005602",3107,839,35,0,998,232,1399,330,6940
"06019005605",1029,26,23,1,342,44,330,17,1812
"06019005606",2140,252,120,7,1198,394,1215,2,5328
"06019005607",2275,867,169,44,412,527,889,584,5767
"06019005608",2198,316,188,48,421,145,713,180,4209
"06019005701",2158,124,46,0,1054,326,1264,197,5169
"06019005702",3976,185,48,0,677,106,976,82,6050
"06019005703",3629,284,162,0,817,228,785,252,6157
"06019005704",2963,501,65,0,1441,995,1700,1065,8730
"06019005801",3163,465,88,31,845,248,1366,178,6384
"06019005802",2702,142,323,11,980,57,932,71,5218
"06019005804",3428,1311,22,5,1171,835,2016,491,9279
"06019005805",2592,51,126,26,1541,193,1190,83,5802
"06019005904",2521,116,67,0,1618,60,1095,70,5547
"06019005905",5390,443,54,0,1247,73,830,60,8097
"06019005906",1690,125,0,14,542,6,630,107,3114
"06019005907",2018,116,72,17,1104,15,871,25,4238
"06019005909",3598,301,50,0,2187,75,1076,67,7354
"06019005911",2313,147,28,0,1309,67,884,3,4751
"06019005912",2889,146,0,0,504,104,793,17,4453
"06019006000",5053,1317,69,32,1674,261,4729,1281,14416
"06019006100",3862,962,0,0,2629,697,5182,1638,14970
"06019006201",1245,449,7,0,547,429,1696,865,5238
"06019006202",2759,1265,28,0,2042,680,4245,1867,12886
"06019006300",4342,739,42,0,2084,121,3018,602,10948
"06019006402",2538,88,8,10,494,153,128,62,3481
"06019006403",3948,252,0,0,954,299,620,267,6340
"06019006404",4015,297,10,0,387,267,428,19,5423
"06019006405",3592,564,0,0,374,0,805,217,5552
"06019006501",1566,2192,26,39,1765,1363,3105,3537,13593
"06019006502",1584,1855,42,15,810,318,2295,2101,9020
"06019006602",1585,938,30,21,1379,1577,2629,2445,10604
"06019006603",1218,208,3,56,437,46,896,115,2979
"06019006604",3142,1649,8,2,2866,1192,5326,2628,16813
"06019006700",4059,583,22,0,1307,527,2787,946,10231
"06019006802",1626,719,0,8,838,701,1846,1305,7043
"06019006900",1178,458,10,0,659,668,1420,1012,5405
"06019007002",2432,757,0,3,879,306,2726,938,8041
"06019007003",4542,1606,37,0,2356,140,4951,1570,15202
"06019007004",2800,332,30,0,1774,495,2787,717,8935
"06019007100",3181,1762,66,30,1692,940,4141,2654,14466
"06019007201",5149,1093,0,0,1371,121,2435,500,10669
"06019007202",2968,836,8,0,1068,191,2100,783,7954
"06019007300",2049,802,5,0,1183,378,1693,954,7064
"06019007400",1449,761,13,0,798,402,1443,951,5817
"06019007500",2124,764,0,0,1457,872,2184,1327,8728
"06019007600",1913,980,57,29,1071,804,1872,1551,8277
"06019007700",2226,353,128,141,2389,1505,3297,1771,11810
"06019007801",1317,243,0,0,965,257,2219,492,5493
"06019007802",1169,878,0,18,1525,1468,2636,2237,9931
"06019007901",0,0,0,0,0,0,0,0,0
"06019007902",1049,671,56,83,1347,440,1784,600,6030
"06019008000",3003,817,59,0,804,442,1725,733,7583
"06019008100",2625,759,223,135,1617,484,2209,912,8964
"06019008200",3243,2826,0,0,513,183,3331,2846,12942
"06019008301",3124,1673,0,13,626,371,3594,2057,11458
"06019008302",2636,2977,8,80,516,326,3076,3326,12945
"06019008401",4793,2195,22,4,1050,565,5458,2570,16657
"06019008402",762,213,12,0,104,78,595,261,2025
"06019008501",1402,1882,0,0,513,838,1751,2627,9013
"06019008502",3031,1728,75,0,2372,1012,5255,2724,16197
"06021010100",4989,1886,14,15,928,313,3041,910,12096
"06021010200",3620,1050,0,4,277,59,1158,668,6836
"06021010300",1467,172,0,3,139,92,154,5,2032
"06021010400",4981,823,107,17,989,316,1884,470,9587
"06021010501",2696,526,21,25,260,267,1782,607,6184
"06021010502",1270,139,0,0,89,14,238,10,1760
"06023000100",2237,1002,66,53,380,264,267,248,4517
"06023000200",3853,496,7,113,1074,383,602,66,6594
"06023000300",3409,1329,62,0,779,939,393,253,7164
"06023000400",2337,765,0,8,648,191,411,295,4655
"06023000500",2109,916,72,18,492,179,309,54,4149
"06023000600",3228,539,51,53,613,261,337,17,5099
"06023000700",4272,402,47,21,377,78,252,38,5487
"06023000800",3899,341,10,1,881,133,390,42,5697
"06023000900",4071,850,52,0,266,206,375,234,6054
"06023001000",1972,1979,37,35,591,384,413,244,5655
"06023001101",3562,1440,34,106,615,830,620,423,7630
"06023001200",2625,1155,14,36,290,205,88,242,4655
"06023001300",900,298,5,10,142,28,29,38,1450
"06023010102",1245,462,38,0,367,460,258,12,2842
"06023010200",1802,318,18,0,224,61,82,12,2517
"06023010300",2581,642,19,2,465,62,25,73,3869
"06023010400",2635,304,12,15,407,109,370,0,3852
"06023010501",5529,935,113,18,881,239,826,95,8636
"06023010502",4314,528,0,0,347,177,273,4,5643
"06023010600",1607,107,0,0,188,0,138,5,2045
"06023010700",5457,789,25,28,657,272,787,60,8075
"06023010800",2692,544,19,25,344,194,201,249,4268
"06023010901",2684,640,0,23,898,200,873,250,5568
"06023010902",3065,417,0,0,294,43,113,28,3960
"06023011000",3691,445,34,0,470,94,471,114,5319
"06023011100",3710,555,27,0,376,68,390,42,5168
"06023011200",2627,392,14,5,253,8,365,127,3791
"06023011500",2491,777,0,0,190,79,238,72,3847
"06023011600",2545,842,14,64,142,109,145,0,3861
"06023940000",262,102,0,1,1629,956,93,32,3075
"06023990100",0,0,0,0,0,0,0,0,0
"06025010101",159,14,0,0,7,10,64,4,258
"06025010102",2392,1073,81,3,625,455,2648,1445,8722
"06025010200",1093,602,14,32,299,137,1169,683,4029
"06025010300",716,67,0,0,145,89,486,116,1619
"06025010400",3744,2552,19,125,986,184,4483,2484,14577
"06025010500",4316,1056,21,38,752,296,3986,1169,11634
"06025010600",5250,510,0,0,640,150,3787,461,10798
"06025010700",2200,1243,81,0,973,232,3049,1441,9219
"06025010800",998,28,32,0,380,48,528,70,2084
"06025010900",3787,1315,6,22,613,1178,2746,2440,12107
"06025011000",9198,735,457,0,1975,218,8345,771,21699
"06025011100",2136,572,89,10,412,25,1855,497,5596
"06025011201",4361,624,90,0,931,156,4213,730,11105
"06025011202",2111,1006,13,121,1155,912,2857,1879,10054
"06025011300",6146,1132,0,0,2347,534,7751,1635,19545
"06025011400",1601,775,170,66,1507,599,3018,1384,9120
"06025011500",2358,1452,168,167,1061,797,3230,2277,11510
"06025011600",2688,1288,26,3,1149,813,3249,1931,11147
"06025011700",2936,401,23,0,1239,646,3424,1029,9698
"06025011801",2397,83,96,2,944,6,2206,76,5810
"06025011802",2982,861,12,164,1396,217,3383,1019,10034
"06025011803",4030,225,231,0,2143,31,4745,178,11583
"06025011900",7810,1084,0,28,1691,846,9251,1892,22602
"06025012001",1948,1237,0,7,997,433,2938,1620,9180
"06025012002",6549,1200,30,0,1341,244,7526,1242,18132
"06025012100",2551,2974,0,0,876,515,3335,3487,13738
"06025012200",4525,1706,0,0,803,561,5222,2212,15029
"06025012301",684,171,28,0,101,157,248,181,1570
"06025012302",3027,1358,52,0,1073,523,2722,1310,10065
"06025012400",580,151,6,16,46,7,50,7,863
"06025940000",662,230,6,5,874,561,415,361,3114
"06027000100",2404,201,0,0,124,0,438,95,3262
"06027000200",1320,42,1,1,176,49,217,6,1812
"06027000300",2418,63,28,0,154,15,348,12,3038
"06027000400",3534,682,24,0,1123,237,1393,92,7085
"06027000500",1651,123,9,0,468,169,249,49,2718
"06027000800",2068,321,43,6,198,110,537,84,3367
"06029000101",9697,1363,395,0,1037,213,2278,181,15164
"06029000102",2102,638,0,0,262,134,183,15,3334
"06029000200",3598,3352,47,113,604,412,600,704,9430
"06029000300",2119,1544,0,36,241,180,502,334,4956
"06029000400",1844,1541,0,52,383,249,648,411,5128
"06029000503",5294,442,129,0,1333,45,1331,24,8598
"06029000504",3308,896,21,123,286,7,1056,529,6226
"06029000505",3258,161,31,67,443,74,578,23,4635
"06029000506",1716,172,76,65,563,54,399,174,3219
"06029000507",2758,223,11,0,429,25,897,47,4390
"06029000600",2374,1598,319,743,613,637,1447,1646,9377
"06029000700",3477,831,6,9,577,100,1892,571,7463
"06029000800",3210,911,13,51,632,79,2250,517,7663
"06029000902",2407,488,163,0,580,100,1415,281,5434
"06029000903",2269,547,73,39,724,515,1457,1001,6625
"06029000904",2439,468,17,32,1024,428,2146,375,6929
"06029000905",1533,652,0,29,324,10,1292,508,4348
"06029000906",3173,167,49,0,630,128,2731,235,7113
"06029000907",1729,218,38,48,463,201,1591,355,4643
"06029000908",3323,411,339,336,963,133,2384,278,8167
"06029000909",1913,24,24,0,429,0,774,0,3164
"06029000910",6737,1484,425,253,1719,179,3928,1172,15897
"06029001000",6864,2136,0,1,1176,281,5225,1324,17007
"06029001101",2859,1534,1,35,395,186,2264,1494,8768
"06029001102",2607,2488,308,28,840,350,2917,2447,11985
"06029001103",1927,2425,131,3,354,458,2077,2551,9926
"06029001201",948,1148,0,16,491,221,1247,1164,5235
"06029001202",1555,2407,43,281,741,780,1840,2675,10322
"06029001300",2716,1947,263,374,1112,1057,3549,2703,13721
"06029001400",2356,3712,146,167,888,1255,2754,4406,15684
"06029001500",954,874,185,173,207,357,1067,1101,4918
"06029001600",638,240,98,86,208,128,485,140,2023
"06029001700",2821,285,94,12,794,139,1060,100,5305
"06029001801",2994,1391,482,18,1082,112,1866,969,8914
"06029001802",3417,377,426,7,735,84,1646,101,6793
"06029001901",2461,559,51,53,659,119,1376,339,5617
"06029001902",2042,828,357,453,537,396,1376,832,6821
"06029002000",1840,2170,1306,381,669,519,2041,1922,10848
"06029002100",1010,920,146,162,500,668,1528,1554,6488
"06029002200",927,1974,561,574,839,802,1716,2678,10071
"06029002301",4437,2426,402,537,2215,818,5901,2736,19472
"06029002302",1292,903,0,14,824,491,2066,1398,6988
"06029002400",3983,1165,290,0,2065,1042,4472,2002,15019
"06029002500",3023,2879,734,555,1178,820,3492,3294,15975
"06029002600",1552,617,257,142,556,229,1817,643,5813
"06029002700",3000,1547,79,95,1008,320,2472,1550,10071
"06029002804",2043,150,60,10,218,80,604,20,3185
"06029002806",1293,115,70,0,313,57,448,13,2309
"06029002807",3038,38,87,22,373,41,811,13,4423
"06029002808",4750,242,360,0,1672,47,1578,114,8763
"06029002811",2522,28,55,0,745,16,400,0,3766
"06029002812",2408,1522,230,563,482,420,1360,1449,8434
"06029002813",1813,706,224,205,788,536,1443,542,6257
"06029002814",2450,732,324,25,620,176,1509,782,6618
"06029002815",2806,432,318,284,329,387,1704,514,6774
"06029002816",3696,884,391,415,435,192,2515,665,9193
"06029002817",2073,980,582,217,900,344,1411,904,7411
"06029002818",2526,402,164,70,473,37,888,327,4887
"06029002819",2859,655,226,75,888,66,1565,271,6605
"06029002820",4715,164,313,19,1405,36,2561,54,9267
"06029002821",3579,312,137,75,782,7,1372,127,6391
"06029002900",3497,1179,767,142,656,1089,2675,1499,11504
"06029003000",3655,2493,168,354,950,430,3711,2648,14409
"06029003103",1884,586,67,2,969,417,2254,806,6985
"06029003112",3149,352,430,239,1129,233,2577,244,8353
"06029003113",2645,765,553,71,779,417,2236,877,8343
"06029003114",3158,523,727,362,2085,671,2955,673,11154
"06029003115",2442,1733,479,346,981,92,2526,1585,10184
"06029003121",4016,1763,335,636,1114,296,3717,1805,13682
"06029003122",4426,985,328,227,1531,584,4829,1436,14346
"06029003123",10105,614,1699,43,5394,156,7233,460,25704
"06029003124",3337,597,359,41,1252,136,1779,240,7741
"06029003202",6817,2071,489,333,6268,1437,10177,2984,30576
"06029003203",2038,62,46,1,321,31,636,2,3137
"06029003204",5556,152,437,0,2610,154,1981,183,11073
"06029003205",5012,984,686,80,2515,573,4849,1259,15958
"06029003206",7373,1276,489,263,4746,1139,6431,1504,23221
"06029003303",834,463,2,0,130,34,121,196,1780
"06029003304",1694,302,46,0,161,32,445,58,2738
"06029003305",2563,640,0,0,221,24,391,150,3989
"06029003306",3602,657,0,0,367,24,713,211,5574
"06029003400",2101,1609,0,0,301,51,965,1099,6126
"06029003500",4279,1119,0,0,751,232,1400,363,8144
"06029003600",3613,1083,93,11,352,23,1094,404,6673
"06029003700",2532,762,28,59,467,85,1753,730,6416
"06029003803",4466,311,21,15,757,45,1444,8,7067
"06029003804",11173,688,240,45,2512,81,3132,197,18068
"06029003805",8211,52,107,0,1422,71,3231,2,13096
"06029003806",3008,77,247,84,1123,122,903,66,5630
"06029003807",2336,277,43,23,549,18,579,18,3843
"06029003808",3083,256,199,0,816,85,1304,185,5928
"06029003809",8867,543,471,2,1514,35,2416,180,14028
"06029003810",2152,87,63,3,317,10,439,15,3086
"06029003811",2415,152,0,0,208,85,481,83,3424
"06029003812",3123,293,317,6,798,55,1130,56,5778
"06029003813",5961,304,28,0,1501,29,1916,252,9991
"06029003900",631,209,7,7,26,6,401,134,1421
"06029004000",5628,1113,30,19,857,82,5683,1044,14456
"06029004101",3272,854,64,22,333,198,2343,893,7979
"06029004102",3215,1504,0,0,487,139,3361,1483,10189
"06029004200",724,386,8,41,60,78,451,465,2213
"06029004301",4752,1622,211,2,872,425,5053,1971,14908
"06029004302",0,0,0,0,0,0,0,0,0
"06029004401",4789,1421,11,145,924,199,4650,1478,13617
"06029004402",2015,2392,37,98,118,395,1834,2765,9654
"06029004500",2110,1155,18,0,106,23,2032,1150,6594
"06029004601",0,0,0,0,0,0,0,0,0
"06029004603",0,0,0,0,0,0,0,0,0
"06029004604",7038,1815,6,0,2520,723,7765,2049,21916
"06029004701",4308,3283,0,9,713,226,4869,3381,16789
"06029004702",2473,972,0,0,453,173,2921,978,7970
"06029004800",3673,4746,24,164,1554,389,4685,4997,20232
"06029004901",2436,1231,0,8,1002,578,2459,1417,9131
"06029004902",4359,1429,17,0,2655,342,4990,1615,15407
"06029005003",1546,1017,89,115,530,140,1768,1061,6266
"06029005004",3699,1355,140,0,1978,169,4203,1490,13034
"06029005103",2072,186,0,0,202,29,314,0,2803
"06029005104",3020,296,92,0,352,21,604,0,4385
"06029005201",4451,586,6,0,115,9,384,51,5602
"06029005203",3012,1233,0,0,270,165,91,48,4819
"06029005204",3174,1796,15,0,342,142,239,496,6204
"06029005300",1093,593,24,0,123,31,397,142,2403
"06029005401",4293,806,68,0,1214,67,1244,181,7873
"06029005402",4163,363,92,12,510,27,683,164,6014
"06029005403",4863,626,128,174,1553,820,997,395,9556
"06029005404",4308,735,367,397,1411,1,949,289,8457
"06029005501",4156,923,194,240,437,0,476,108,6534
"06029005506",3761,509,62,0,918,17,1477,224,6968
"06029005507",3610,719,1139,597,874,104,1185,470,8698
"06029005508",2262,637,273,378,722,205,810,515,5802
"06029005600",1264,385,35,270,245,120,219,170,2708
"06029005700",1721,150,185,76,294,14,181,23,2644
"06029005801",3958,504,923,105,1158,191,1664,479,8982
"06029005802",3082,1457,616,467,2092,538,1835,1537,11624
"06029005900",1359,593,270,337,933,288,1524,648,5952
"06029006002",0,0,0,0,0,0,0,0,0
"06029006003",4678,626,0,28,310,70,1283,229,7224
"06029006004",943,448,5,0,130,16,125,186,1853
"06029006006",2891,156,48,9,189,16,300,99,3708
"06029006007",5073,420,0,13,187,65,1031,141,6930
"06029006008",4906,229,54,10,428,0,342,0,5969
"06029006100",5722,1404,135,220,536,291,1970,841,11119
"06029006201",2110,538,0,0,317,194,1743,605,5507
"06029006202",4736,1246,111,9,1054,248,5585,1288,14277
"06029006301",2624,988,52,42,459,176,2907,871,8119
"06029006303",3635,2010,102,8,644,148,4114,1921,12582
"06029006304",2159,1304,89,0,320,124,2332,1370,7698
"06029006401",4191,2584,47,0,908,746,4735,3146,16357
"06029006403",3424,2008,0,0,953,171,4124,2030,12710
"06029006404",1357,1235,8,0,406,203,1622,1421,6252
"06029006500",1329,454,58,48,205,122,260,83,2559
"06031000100",2104,503,22,0,353,76,700,444,4202
"06031000200",1634,128,21,9,357,100,703,130,3082
"06031000300",2886,432,338,275,1094,105,1103,260,6493
"06031000402",3595,604,311,72,754,286,1525,550,7697
"06031000403",2729,796,254,33,1054,601,1293,959,7719
"06031000404",5559,739,357,6,2640,231,2837,695,13064
"06031000405",2902,328,307,33,2173,519,2787,625,9674
"06031000500",2795,533,117,106,1289,460,2401,715,8416
"06031000601",6010,1181,233,94,2198,536,2965,960,14177
"06031000602",4047,230,329,0,600,0,1026,151,6383
"06031000701",4198,495,213,0,994,26,1793,166,7885
"06031000702",3147,676,94,14,358,6,1449,341,6085
"06031000800",2947,933,13,26,372,214,1743,687,6935
"06031000900",4169,2289,435,113,654,457,2937,1609,12663
"06031001001",2728,339,71,1,714,48,1360,139,5400
"06031001002",2630,953,147,195,704,145,2317,757,7848
"06031001003",4076,781,137,0,849,188,3402,774,10207
"06031001100",2664,1460,434,340,1130,631,3070,1901,11630
"06031001200",2096,233,19,7,257,26,1120,112,3870
"06031001300",2098,1990,272,147,84,133,1912,1733,8369
"06031001401",1689,815,12,17,267,86,1800,848,5534
"06031001402",699,1002,25,4,273,69,813,769,3654
"06031001500",2684,978,5,88,450,97,2406,833,7541
"06031001601",1440,862,67,76,1346,697,1989,1194,7671
"06031001602",0,0,0,0,0,0,0,0,0
"06031001701",2312,2076,30,0,3300,1151,5302,2925,17096
"06031981800",0,0,0,0,0,0,0,0,0
"06033000100",1993,518,0,0,424,220,237,199,3591
"06033000300",2183,333,0,0,424,158,430,188,3716
"06033000400",3713,649,70,0,444,231,315,300,5722
"06033000501",1645,766,32,7,333,521,409,194,3907
"06033000502",1354,473,45,11,137,102,194,27,2343
"06033000600",2339,1042,0,49,169,128,117,82,3926
"06033000701",2932,749,377,232,159,208,293,269,5219
"06033000702",1870,1053,16,18,417,365,514,337,4590
"06033000801",995,561,89,59,273,606,281,583,3447
"06033000802",1419,1276,100,61,786,459,725,687,5513
"06033000900",4252,1292,0,18,808,46,952,63,7431
"06033001000",3760,389,55,47,1353,947,1536,896,8983
"06033001100",2694,470,25,23,286,97,214,129,3938
"06033001200",2539,360,0,0,535,82,430,44,3990
"06033001300",5870,943,0,0,752,28,922,110,8625
"06035040100",1044,166,0,0,12,20,28,17,1287
"06035040200",1965,507,0,2,94,67,39,121,2795
"06035040302",3270,532,73,7,334,44,238,57,4555
"06035040303",1611,693,3,33,100,63,27,58,2588
"06035040304",688,335,21,22,188,12,106,8,1380
"06035040305",2518,357,16,0,319,96,190,58,3554
"06035040400",872,124,13,0,87,25,112,38,1271
"06035040500",3118,280,11,0,93,9,71,11,3593
"06035040600",1477,152,59,17,241,0,90,2,2038
"06037101110",2966,396,33,11,1035,275,1258,318,6292
"06037101122",2485,71,15,0,696,17,397,7,3688
"06037101210",3035,855,120,77,1314,481,2031,838,8751
"06037101220",1592,271,49,11,848,131,680,72,3654
"06037101300",3519,262,20,0,503,57,449,9,4819
"06037101400",2719,355,35,0,877,123,863,136,5108
"06037102103",1614,117,0,0,115,4,341,49,2240
"06037102104",2484,221,13,0,534,0,403,25,3680
"06037102105",1166,208,24,29,409,106,1008,290,3240
"06037102107",2546,286,9,15,689,232,769,210,4756
"06037103101",2160,200,6,3,364,65,604,151,3553
"06037103102",3266,421,34,0,1074,55,1139,80,6069
"06037103200",4147,840,224,10,735,155,1910,561,8582
"06037103300",2375,574,0,9,305,30,137,362,3792
"06037103400",4363,687,246,35,1152,118,995,440,8036
"06037104103",2446,99,401,110,820,51,2744,123,6794
"06037104105",2765,1063,234,83,1277,408,3234,1445,10509
"06037104108",2662,382,435,163,892,373,3209,643,8759
"06037104124",2254,322,315,47,1019,83,1924,278,6242
"06037104201",2511,515,528,94,572,476,3092,991,8779
"06037104203",2030,981,171,72,1516,20,3266,958,9014
"06037104204",1313,536,76,121,723,197,1689,629,5284
"06037104310",2135,799,244,16,1585,269,3650,1046,9744
"06037104320",2409,659,190,48,1632,383,3840,943,10104
"06037104401",1878,783,7,0,928,93,2766,872,7327
"06037104403",1290,654,11,0,688,259,1890,856,5648
"06037104404",1433,559,158,0,523,96,1856,643,5268
"06037104500",1326,601,0,0,946,134,2254,722,5983
"06037104610",1652,640,0,0,751,323,2389,931,6686
"06037104620",1953,500,0,0,740,229,2645,723,6790
"06037104701",1569,1070,212,89,517,458,2102,1562,7579
"06037104703",1010,621,18,48,496,76,1455,675,4399
"06037104704",2093,570,361,115,892,408,2517,970,7926
"06037104810",3122,1114,12,13,1422,79,4305,1158,11225
"06037104821",1963,494,107,22,582,107,2267,608,6150
"06037104822",1055,558,24,5,710,198,1541,699,4790
"06037106010",1639,565,61,7,576,133,1552,528,5061
"06037106020",3737,452,83,2,1839,126,4634,492,11365
"06037106111",2837,377,76,3,1343,180,2700,432,7948
"06037106112",3700,604,33,0,1177,340,3397,829,10080
"06037106113",2277,38,78,0,646,265,2322,167,5793
"06037106114",2930,995,144,189,1436,98,3854,1045,10691
"06037106403",2593,127,0,2,758,60,2972,165,6677
"06037106405",1741,898,99,84,711,273,2040,866,6712
"06037106406",3276,371,248,0,1557,43,3276,318,9089
"06037106407",1458,501,208,69,336,114,1408,426,4520
"06037106408",1875,760,62,18,766,402,2459,1046,7388
"06037106510",3047,426,117,48,1138,9,2957,374,8116
"06037106520",3854,1047,22,2,772,211,3963,1170,11041
"06037106603",2034,35,109,2,1031,27,510,13,3761
"06037106604",2584,1086,37,0,781,126,2775,1085,8474
"06037106641",1480,48,26,3,575,13,230,1,2376
"06037106642",2129,88,92,0,1102,4,814,24,4253
"06037106643",2802,46,340,0,1539,26,466,10,5229
"06037106645",2487,179,65,0,533,74,277,59,3674
"06037106646",2301,179,99,19,982,11,1136,34,4761
"06037106648",2018,1017,25,5,708,209,2591,1200,7773
"06037106649",1507,213,28,0,841,68,1397,197,4251
"06037107010",1869,326,0,0,601,291,2302,580,5969
"06037107020",3388,688,35,0,1045,384,3816,1034,10390
"06037108101",1670,37,44,1,617,24,333,16,2742
"06037108102",2193,76,83,29,1169,150,364,44,4108
"06037108103",2364,20,13,0,885,25,360,0,3667
"06037108104",1145,167,30,0,616,16,134,14,2122
"06037108201",2321,7,364,0,3057,97,362,34,6242
"06037108202",2608,225,152,20,3346,213,783,21,7368
"06037109100",1545,70,0,0,811,34,1524,62,4046
"06037109200",1575,179,7,12,935,20,807,153,3688
"06037109300",1682,82,280,10,1299,98,1515,93,5059
"06037109400",1633,52,124,4,1183,410,2229,417,6052
"06037109500",2833,462,5,59,1132,177,3677,578,8923
"06037109601",2675,191,124,3,1552,386,3045,457,8433
"06037109603",2276,80,62,7,1432,279,2410,283,6829
"06037109604",1410,106,28,16,1397,137,1917,194,5205
"06037109700",1695,202,201,4,2404,149,2004,190,6849
"06037109800",2661,321,93,18,1706,312,2519,427,8057
"06037111100",1587,198,183,10,1226,29,1123,110,4466
"06037111201",2162,128,12,1,838,197,913,151,4402
"06037111202",2934,152,126,1,2020,249,1405,203,7090
"06037111204",3817,164,227,0,1848,123,951,0,7130
"06037111205",1714,88,535,67,1523,63,958,9,4957
"06037111206",2933,156,37,12,1533,61,974,57,5763
"06037111301",3162,782,557,87,2985,344,2641,279,10837
"06037111302",2727,443,202,98,1306,140,886,238,6040
"06037111400",3830,612,442,24,2514,385,2399,375,10581
"06037113101",2872,124,37,8,745,30,641,0,4457
"06037113102",2120,130,41,7,652,49,352,74,3425
"06037113211",2420,140,98,8,1152,37,548,0,4403
"06037113212",1886,100,83,0,1027,40,734,18,3888
"06037113213",2403,300,117,34,1443,284,1018,373,5972
"06037113231",1407,61,128,0,599,45,280,36,2556
"06037113232",2975,178,7,16,1195,75,745,66,5257
"06037113233",2021,764,91,11,4069,885,4040,1227,13108
"06037113234",1504,245,206,71,1733,862,1314,929,6864
"06037113235",1097,179,76,11,271,91,337,68,2130
"06037113237",2460,153,161,11,1232,149,910,149,5225
"06037113301",1488,64,85,1,704,7,497,30,2876
"06037113303",2645,77,67,21,1215,93,1158,56,5332
"06037113321",2222,296,346,77,2185,454,1288,469,7337
"06037113322",2739,89,42,29,881,113,641,82,4616
"06037113401",2907,215,182,37,1965,225,2247,195,7973
"06037113421",1908,350,310,31,2932,1375,2660,1397,10963
"06037113422",3046,162,182,76,2656,577,2888,316,9903
"06037115101",3540,88,252,0,1258,41,1007,4,6190
"06037115103",55,104,0,0,6,13,15,47,240
"06037115104",1549,474,405,256,1090,500,940,351,5565
"06037115201",2489,980,324,119,2287,445,1788,320,8752
"06037115202",2511,232,276,39,1168,328,1118,174,5846
"06037115301",2098,277,193,33,1232,223,788,101,4945
"06037115302",1090,540,185,69,1991,540,2301,956,7672
"06037115401",3178,524,415,10,1328,525,1870,736,8586
"06037115403",1358,399,223,14,1045,455,1266,695,5455
"06037115404",1014,277,75,104,865,551,943,557,4386
"06037117101",1665,429,150,10,3066,111,2181,475,8087
"06037117102",1348,172,9,4,1085,111,1444,218,4391
"06037117201",1565,656,78,16,1302,892,1718,1366,7593
"06037117202",1172,65,92,0,1081,16,879,15,3320
"06037117301",2362,75,200,47,1070,127,1096,138,5115
"06037117302",3148,183,152,81,1305,182,1055,139,6245
"06037117303",2145,148,263,0,1069,74,1660,36,5395
"06037117404",2007,240,57,69,1542,269,1666,376,6226
"06037117405",902,652,10,1,1280,916,1971,1518,7250
"06037117407",954,751,45,0,1162,858,1994,1577,7341
"06037117408",655,640,150,169,825,717,1262,1332,5750
"06037117510",779,565,75,15,1458,1032,2020,1474,7418
"06037117520",997,476,145,44,1452,832,2142,1277,7365
"06037117530",1602,1138,162,0,2374,1126,2920,2084,11406
"06037119001",2002,318,0,2,1579,40,2483,263,6687
"06037119002",4009,650,89,2,1773,460,4867,924,12774
"06037119201",2856,179,0,2,735,185,3176,308,7441
"06037119202",1665,359,104,0,1876,391,2950,601,7946
"06037119310",2102,660,51,39,711,126,1962,616,6267
"06037119320",988,1084,166,52,1782,772,1788,1771,8403
"06037119340",1127,1100,10,27,1074,399,2090,1504,7331
"06037119341",1129,391,30,17,1004,205,1167,413,4356
"06037119342",1071,586,30,27,1211,533,1900,957,6315
"06037119400",3530,383,49,14,1223,230,4111,515,10055
"06037119700",2382,363,61,0,1785,148,1817,321,6877
"06037119800",3737,257,24,2,2199,218,4953,230,11620
"06037119900",3085,230,8,0,1747,109,3422,219,8820
"06037120010",1198,238,23,58,1015,257,1573,461,4823
"06037120020",1527,280,7,22,2243,701,2800,884,8464
"06037120030",649,609,26,92,670,467,1163,1046,4722
"06037120103",700,630,60,64,815,999,1459,1644,6371
"06037120104",503,794,81,60,907,329,876,998,4548
"06037120105",979,248,83,10,1019,559,1350,688,4936
"06037120106",1628,773,70,18,1215,866,2419,1388,8377
"06037120107",939,840,87,116,1202,702,1985,1432,7303
"06037120108",2039,866,42,73,985,823,2664,1421,8913
"06037120300",2437,149,0,23,2358,630,2877,480,8954
"06037120400",1989,1038,188,16,3006,763,2983,1137,11120
"06037121010",2060,924,26,2,1427,157,1825,800,7221
"06037121020",1732,319,15,32,1367,246,1687,444,5842
"06037121101",1495,722,74,0,710,138,1382,529,5050
"06037121102",1982,342,0,0,256,16,1347,179,4122
"06037121210",1559,383,47,0,865,202,1773,447,5276
"06037121221",1524,120,73,12,495,80,1813,144,4261
"06037121222",3002,1150,140,40,551,227,3266,1173,9549
"06037121600",1502,101,117,5,871,69,845,51,3561
"06037121801",1530,408,72,112,812,387,1506,681,5508
"06037121802",1782,536,41,148,782,198,1835,239,5561
"06037121900",2017,640,71,34,1401,65,2750,547,7525
"06037122000",3798,596,142,1,1443,158,2536,264,8938
"06037122120",3412,591,47,3,599,124,3414,637,8827
"06037122121",1616,535,42,16,549,26,1720,480,4984
"06037122122",1521,463,46,44,278,67,1732,348,4499
"06037122200",2900,286,9,0,856,124,3023,389,7587
"06037122410",1318,473,101,24,1045,778,1951,1071,6761
"06037122420",1725,845,89,19,1578,385,2600,1195,8436
"06037123010",2214,1039,74,48,593,331,2346,1283,7928
"06037123020",1829,630,17,4,941,110,2314,660,6505
"06037123103",2479,334,99,73,941,301,2032,500,6759
"06037123104",1865,129,28,25,1544,675,2542,619,7427
"06037123203",1200,477,223,72,1062,643,1809,1027,6513
"06037123204",1286,466,78,8,979,503,1614,852,5786
"06037123205",816,471,121,31,1108,167,1492,587,4793
"06037123206",901,298,24,6,1014,626,1573,866,5308
"06037123301",2036,496,311,62,1431,151,1496,317,6300
"06037123303",1597,445,33,13,854,303,1406,327,4978
"06037123304",1999,912,89,266,1001,229,1167,797,6460
"06037123410",1639,939,236,28,1001,198,1392,893,6326
"06037123420",2107,910,56,41,990,222,1489,921,6736
"06037123510",1880,398,116,61,1753,702,1718,703,7331
"06037123520",1179,298,125,158,578,154,913,222,3627
"06037123601",2960,431,78,33,1555,154,1865,180,7256
"06037123602",2050,389,152,133,705,156,1006,219,4810
"06037123700",2461,429,148,13,633,37,374,45,4140
"06037123800",3177,505,575,407,826,109,1194,156,6949
"06037123901",2241,394,41,82,1235,334,1903,482,6712
"06037123902",1740,145,90,0,527,213,598,146,3459
"06037124000",3856,184,146,47,776,84,726,101,5920
"06037124102",1651,373,466,56,833,351,1303,386,5419
"06037124103",526,451,69,6,872,279,944,726,3873
"06037124104",987,211,118,69,851,491,1129,488,4344
"06037124105",1144,740,106,13,489,202,943,688,4325
"06037124201",1706,253,77,32,952,96,1640,226,4982
"06037124203",1226,512,148,17,572,218,1396,515,4604
"06037124204",1203,692,181,42,657,307,947,646,4675
"06037124300",2401,343,63,12,777,118,2328,255,6297
"06037124400",2763,705,203,14,370,133,553,269,5010
"06037124500",2007,167,139,19,838,31,840,47,4088
"06037124600",2435,157,189,0,563,11,361,24,3740
"06037124700",3677,251,276,1,606,102,659,52,5624
"06037124902",1644,568,202,29,522,16,625,286,3892
"06037124903",1894,671,114,101,196,9,551,160,3696
"06037125100",4169,374,505,118,854,109,1472,54,7655
"06037125200",2292,236,84,23,778,390,1004,372,5179
"06037125310",2220,757,427,222,862,333,1372,497,6690
"06037125320",2769,1250,286,109,837,289,1308,493,7341
"06037125401",1937,405,623,76,670,127,827,224,4889
"06037125402",2584,297,309,33,686,121,901,125,5056
"06037125501",1954,369,189,11,708,51,893,197,4372
"06037125502",1777,533,328,56,479,370,421,408,4372
"06037125600",1749,149,87,10,370,18,268,17,2668
"06037127102",1839,552,63,30,2218,461,2594,586,8343
"06037127103",855,392,22,61,1253,760,1499,760,5602
"06037127104",1338,84,170,27,1369,892,1379,866,6125
"06037127210",1832,380,392,63,2486,744,2598,929,9424
"06037127220",1060,574,82,99,1984,890,2211,1167,8067
"06037127300",1526,307,396,95,1609,503,1583,380,6399
"06037127400",1370,581,199,76,2527,1277,2863,1532,10425
"06037127520",439,210,83,55,2033,1148,1996,1176,7140
"06037127603",812,200,62,35,1285,623,1647,746,5410
"06037127604",948,370,330,34,665,435,1002,345,4129
"06037127605",681,265,176,37,2519,415,2399,599,7091
"06037127606",1378,420,142,31,1503,359,1797,658,6288
"06037127711",2023,339,173,0,837,365,1495,584,5816
"06037127712",851,439,96,0,1125,372,1393,422,4698
"06037127803",1158,542,99,0,1826,408,1911,624,6568
"06037127804",1606,227,239,16,1506,553,1489,635,6271
"06037127805",1103,627,85,35,1602,475,1638,922,6487
"06037127806",1588,553,117,59,711,176,1566,492,5262
"06037127910",1345,282,247,84,2016,1086,2032,1069,8161
"06037127920",1670,529,49,6,1342,369,1609,653,6227
"06037128101",1811,362,71,56,863,148,1273,331,4915
"06037128102",1040,705,283,56,1695,884,1874,1263,7800
"06037128210",1168,352,278,61,1790,1773,2561,2012,9995
"06037128220",1107,252,118,99,1062,246,1035,321,4240
"06037128302",2539,1047,126,99,809,582,2732,1284,9218
"06037128303",1351,1202,114,95,388,242,1420,1348,6160
"06037128400",2995,266,79,0,778,37,1168,27,5350
"06037128500",2797,403,366,18,769,81,956,133,5523
"06037128601",1828,610,42,116,1222,689,1225,1067,6799
"06037128602",2432,196,116,10,333,17,353,101,3558
"06037128702",3979,322,457,0,906,89,627,113,6493
"06037128801",2049,263,205,27,676,92,501,119,3932
"06037128802",3610,188,150,0,788,42,899,12,5689
"06037128910",2971,192,215,77,573,24,240,22,4314
"06037131010",3135,1297,90,1,1482,296,2416,1292,10009
"06037131020",3203,711,49,73,1292,297,2890,709,9224
"06037131100",1833,258,96,0,1058,193,1137,97,4672
"06037131200",1525,222,165,0,1074,102,1121,81,4290
"06037131300",2917,526,20,12,1245,195,2485,359,7759
"06037131400",3173,662,386,100,1583,177,2182,498,8761
"06037131600",2909,427,78,2,1758,123,2418,305,8020
"06037131701",2129,406,219,67,1091,562,1254,309,6037
"06037131702",1532,967,299,61,733,27,1101,811,5531
"06037131800",3480,870,260,9,826,281,2625,951,9302
"06037131900",2708,160,105,0,1426,290,2099,327,7115
"06037132001",1843,255,68,13,1018,90,888,131,4306
"06037132002",1963,158,71,0,951,256,972,347,4718
"06037132101",1983,198,245,11,1641,361,1804,419,6662
"06037132102",2176,718,143,8,1938,393,1772,592,7740
"06037132300",3435,1716,55,59,1791,319,2906,1506,11787
"06037132501",2453,248,69,24,572,334,1805,163,5668
"06037132502",2041,533,218,0,656,419,1248,543,5658
"06037132700",3076,1240,0,1,948,217,2333,934,8749
"06037132900",2809,293,41,5,653,126,878,263,5068
"06037133000",2735,624,23,122,903,22,1910,567,6906
"06037133100",3708,847,107,12,856,75,1936,423,7964
"06037134001",1565,841,52,36,1062,350,2185,1136,7227
"06037134002",1521,444,87,17,1821,256,2075,493,6714
"06037134101",1545,402,128,102,2979,719,1885,770,8530
"06037134103",1685,387,222,49,1765,257,1740,512,6617
"06037134104",1251,150,259,39,2102,330,1276,231,5638
"06037134201",1918,195,44,10,1828,154,1876,168,6193
"06037134302",2599,122,80,6,1000,27,871,3,4708
"06037134303",3821,425,230,0,1289,146,2567,367,8845
"06037134304",1246,129,55,54,905,469,558,407,3823
"06037134305",562,458,10,23,2446,1078,2406,1382,8365
"06037134306",1383,252,135,36,1371,354,882,323,4736
"06037134421",2820,176,50,0,628,16,320,34,4044
"06037134422",3255,257,146,17,1215,103,455,62,5510
"06037134423",2278,210,226,7,633,24,309,62,3749
"06037134424",2007,25,100,0,593,0,173,0,2898
"06037134520",2609,910,232,0,1240,428,3043,1119,9581
"06037134521",1462,454,73,31,660,345,1791,774,5590
"06037134522",1385,579,68,23,1581,211,2214,620,6681
"06037134710",1228,213,83,67,2805,1570,2961,1600,10527
"06037134720",1713,271,96,51,2392,336,2231,156,7246
"06037134800",2548,523,260,0,2786,276,2934,613,9940
"06037134901",2664,357,167,18,144,30,909,130,4419
"06037134903",2829,485,293,173,1768,294,2457,320,8619
"06037134904",1965,168,201,0,2015,285,2261,291,7186
"06037134905",2149,233,138,17,837,99,507,20,4000
"06037135102",2773,211,91,0,848,199,480,82,4684
"06037135111",1968,108,192,43,730,44,589,30,3704
"06037135113",1445,87,279,31,1118,37,270,15,3282
"06037135114",1864,627,77,104,1899,147,365,105,5188
"06037135201",1802,137,61,83,685,15,402,13,3198
"06037135202",3178,202,30,10,1094,50,620,18,5202
"06037135203",4741,483,94,193,1592,107,1349,25,8584
"06037137000",3873,112,142,25,555,61,344,12,5124
"06037137103",2923,266,173,36,1298,0,749,0,5445
"06037137104",2206,146,182,0,165,173,245,19,3136
"06037137201",3089,386,342,43,1798,122,987,57,6824
"06037137301",1602,46,35,2,542,49,221,35,2532
"06037137302",3655,214,98,0,553,0,236,9,4765
"06037137401",2942,232,276,18,754,114,406,17,4759
"06037137402",3841,480,398,54,842,17,858,17,6507
"06037137501",2660,280,114,25,871,73,744,43,4810
"06037137502",3062,171,271,27,571,15,629,50,4796
"06037137504",1830,67,21,0,109,0,45,7,2079
"06037138000",3629,406,154,0,517,18,365,11,5100
"06037139001",3480,331,126,0,807,166,813,207,5930
"06037139200",3833,589,135,14,904,121,1161,454,7211
"06037139301",3636,271,34,52,889,20,692,0,5594
"06037139302",2139,615,283,163,1286,180,1276,237,6179
"06037139303",2015,594,221,66,1230,153,1061,219,5559
"06037139401",1465,290,57,63,1123,66,1195,131,4390
"06037139402",2295,219,134,9,213,4,163,31,3068
"06037139502",2244,178,0,5,480,127,328,41,3403
"06037139503",2955,1237,329,124,991,176,404,88,6304
"06037139504",2597,431,113,0,233,157,312,0,3843
"06037139600",3607,572,195,13,170,79,235,102,4973
"06037139701",4272,156,24,7,404,12,213,3,5091
"06037139702",5072,320,30,74,411,32,232,0,6171
"06037139703",2137,216,0,12,383,7,72,45,2872
"06037139801",2895,95,34,0,401,0,250,0,3675
"06037139802",3076,120,0,0,648,33,203,21,4101
"06037141101",3426,388,251,0,680,42,577,95,5459
"06037141102",2158,162,253,0,388,36,208,60,3265
"06037141201",2915,325,120,0,628,196,854,166,5204
"06037141202",2300,234,51,0,275,0,214,25,3099
"06037141302",3857,599,381,0,864,36,637,24,6398
"06037141303",2234,396,54,0,458,26,134,84,3386
"06037141304",2265,240,129,24,478,93,234,52,3515
"06037141400",3308,595,155,0,440,35,174,60,4767
"06037141500",2589,74,0,31,274,0,229,0,3197
"06037141600",3471,71,79,77,453,7,227,21,4406
"06037141700",2576,57,63,0,401,6,146,6,3255
"06037143100",3441,182,201,59,429,64,463,52,4891
"06037143200",2437,365,319,9,757,49,696,26,4658
"06037143300",4933,367,724,43,749,16,1053,0,7885
"06037143400",5099,275,199,53,783,15,645,52,7121
"06037143500",3455,318,447,86,386,16,373,129,5210
"06037143602",3366,327,174,0,423,150,427,0,4867
"06037143603",1488,216,95,23,417,8,221,43,2511
"06037143604",2133,248,256,20,696,69,354,53,3829
"06037143700",2604,225,160,0,637,0,151,0,3777
"06037143800",4332,178,281,20,650,50,745,35,6291
"06037143901",3478,170,0,3,392,95,199,7,4344
"06037143902",2528,99,25,0,351,0,223,0,3226
"06037181000",3388,506,50,3,2063,110,1939,157,8216
"06037181300",1772,210,63,0,1743,118,1276,150,5332
"06037181400",1797,519,61,0,2010,138,1540,401,6466
"06037181500",2008,169,25,0,1659,21,1765,134,5781
"06037181600",1509,85,7,0,1383,148,1470,134,4736
"06037183101",1760,278,34,29,1384,152,2175,297,6109
"06037183103",1317,440,199,22,1947,503,2401,807,7636
"06037183104",1227,120,32,10,885,130,1060,225,3689
"06037183220",1673,360,32,0,1860,452,2404,737,7518
"06037183221",1400,236,6,0,1013,406,1472,572,5105
"06037183222",1498,437,142,16,1312,49,1433,284,5171
"06037183300",1475,176,28,10,1343,333,1682,374,5421
"06037183401",823,102,20,15,1324,104,1533,81,4002
"06037183402",1094,295,4,1,1183,348,1074,371,4370
"06037183510",1194,169,12,0,991,149,1644,288,4447
"06037183520",1555,466,49,87,1128,471,2034,888,6678
"06037183610",1256,528,20,18,1154,518,1880,973,6347
"06037183620",1244,187,17,24,1296,529,1805,653,5755
"06037183701",1585,430,155,63,986,599,2184,982,6984
"06037183702",1108,285,118,0,1453,248,1589,448,5249
"06037183810",1563,582,8,27,1320,705,2325,1136,7666
"06037183820",987,416,49,27,1547,974,2346,1237,7583
"06037185100",2956,890,106,63,1886,465,2295,973,9634
"06037185202",1599,134,157,51,1229,908,1816,923,6817
"06037185203",1330,371,16,0,1293,234,2222,497,5963
"06037185204",774,123,56,0,869,71,588,122,2603
"06037185310",1391,290,60,0,1107,361,2138,611,5958
"06037185320",1071,389,0,1,1106,239,2013,496,5315
"06037186100",2083,342,88,0,1968,151,1219,216,6067
"06037186201",1305,193,25,0,1387,383,1166,144,4603
"06037186202",633,158,24,0,1106,106,498,129,2654
"06037186203",1670,285,10,0,717,266,896,209,4053
"06037186301",904,504,104,6,1037,541,1355,919,5370
"06037186302",1923,498,137,73,1662,453,1589,771,7106
"06037186401",1229,417,19,5,1210,716,1865,998,6459
"06037186403",1115,162,2,28,1310,381,1825,267,5090
"06037186404",976,177,6,6,972,478,1496,599,4710
"06037187101",1219,271,29,2,1348,27,686,184,3766
"06037187102",1191,51,0,0,1743,343,1519,364,5211
"06037187200",886,221,27,0,1221,428,1561,591,4935
"06037187300",1839,149,83,2,1016,63,568,30,3750
"06037188100",1503,206,89,2,1739,212,1957,293,6001
"06037188201",2255,180,75,0,933,47,419,36,3945
"06037188202",1412,104,67,0,679,49,201,66,2578
"06037188300",1486,63,9,0,1981,59,1165,43,4806
"06037189101",1573,374,11,0,498,60,310,81,2907
"06037189102",2113,209,58,0,581,235,504,164,3864
"06037189201",2165,414,86,50,467,103,328,71,3684
"06037189202",2019,166,36,21,292,37,153,56,2780
"06037189300",2049,144,36,0,664,50,146,34,3123
"06037189400",2544,297,175,0,360,122,123,0,3621
"06037189500",2699,584,103,0,545,75,445,85,4536
"06037189600",2096,226,363,14,735,131,571,110,4246
"06037189701",2567,396,128,0,667,72,348,102,4280
"06037189702",1443,160,34,10,188,70,115,14,2034
"06037189800",2614,292,132,102,649,184,611,129,4713
"06037189902",3402,603,162,0,780,271,634,251,6103
"06037189903",1206,327,103,60,432,19,188,15,2350
"06037189904",1575,355,75,61,349,96,101,33,2645
"06037189905",1622,272,117,0,355,18,197,15,2596
"06037190100",2769,711,453,60,464,344,549,252,5602
"06037190201",952,501,0,21,393,327,376,268,2838
"06037190202",1380,535,125,167,393,411,316,256,3583
"06037190301",2947,462,72,133,1161,279,1055,264,6373
"06037190401",1736,702,72,24,813,61,496,75,3979
"06037190402",1148,727,103,7,238,125,254,165,2767
"06037190510",1051,815,120,74,2179,775,1576,687,7277
"06037190520",1311,622,86,54,1457,438,1277,407,5652
"06037190700",1265,604,100,8,1090,263,1148,321,4799
"06037190801",663,402,40,165,779,399,617,420,3485
"06037190802",1081,188,26,61,978,366,1045,352,4097
"06037190901",847,412,256,125,1757,1055,2029,1139,7620
"06037190902",1189,473,116,97,1692,712,1767,689,6735
"06037191000",1293,288,71,279,1526,327,1438,362,5584
"06037191110",1757,442,99,0,657,267,719,254,4195
"06037191120",1455,712,53,80,1605,488,1736,755,6884
"06037191201",1622,743,156,61,1052,462,734,772,5602
"06037191203",711,379,78,22,1143,420,667,524,3944
"06037191204",929,197,52,31,760,99,818,135,3021
"06037191301",691,130,76,56,1241,311,1053,314,3872
"06037191302",604,280,64,6,995,456,627,434,3466
"06037191410",1002,530,90,111,2070,1162,2000,1401,8366
"06037191420",1078,324,180,26,1396,783,1577,791,6155
"06037191500",1626,779,24,25,2336,886,1880,1401,8957
"06037191610",1531,275,93,17,1659,799,2032,885,7291
"06037191620",543,267,40,18,1547,551,1543,558,5067
"06037191710",545,568,53,45,1204,509,1254,759,4937
"06037191720",891,471,49,94,1346,1028,1539,1379,6797
"06037191810",823,283,158,24,1396,817,1260,872,5633
"06037191820",1114,220,161,0,953,257,885,262,3852
"06037191901",2050,362,150,26,645,289,689,368,4579
"06037191902",1947,354,97,2,588,17,497,8,3510
"06037192001",1482,239,110,19,301,137,193,31,2512
"06037192002",1920,169,86,68,310,33,256,19,2861
"06037192300",1796,92,38,26,742,115,371,55,3235
"06037192410",1750,110,154,81,1611,235,844,187,4972
"06037192420",815,334,168,71,2184,670,1015,898,6155
"06037192510",768,355,17,21,2092,403,1534,471,5661
"06037192520",1265,331,70,16,2067,1215,2468,1254,8686
"06037192610",1373,564,86,143,1913,709,2562,975,8325
"06037192620",837,368,38,11,1681,675,1594,802,6006
"06037192700",1008,426,28,86,1455,716,1646,716,6081
"06037194101",2336,213,119,12,441,27,270,35,3453
"06037194102",2945,249,92,0,511,0,230,0,4027
"06037194200",2944,117,117,9,409,51,199,0,3846
"06037194300",2913,315,40,0,389,75,482,50,4264
"06037194401",1633,58,99,12,459,39,366,12,2678
"06037194402",2208,383,31,6,518,150,147,88,3531
"06037194500",1357,190,31,0,272,51,46,0,1947
"06037195100",3400,267,147,3,815,95,551,67,5345
"06037195201",1753,192,23,0,964,83,481,69,3565
"06037195202",2604,168,105,0,529,17,335,13,3771
"06037195300",1796,206,11,2,1488,297,1146,237,5183
"06037195400",2976,311,47,41,929,113,675,121,5213
"06037195500",2737,721,225,19,1095,70,1412,509,6788
"06037195600",1753,645,39,2,734,120,1318,690,5301
"06037195710",2270,800,128,41,671,730,2097,1385,8122
"06037195720",1415,149,4,12,551,92,1392,137,3752
"06037195802",946,343,60,30,1110,258,1150,453,4350
"06037195803",1319,409,124,10,853,268,842,463,4288
"06037195804",1177,459,117,9,492,188,966,417,3825
"06037195901",1143,252,31,65,591,168,650,327,3227
"06037195902",1103,213,42,0,375,284,160,361,2538
"06037195903",1122,193,118,37,672,174,581,154,3051
"06037197200",1127,125,0,13,2424,186,2239,79,6193
"06037197300",2253,528,43,29,831,230,1325,412,5651
"06037197410",2664,350,46,9,1024,189,951,404,5637
"06037197420",1551,375,27,40,994,268,1425,415,5095
"06037197500",2149,492,171,0,1022,96,1659,432,6021
"06037197600",1037,181,5,0,980,224,839,226,3492
"06037197700",1070,451,192,10,2130,1314,1103,458,6728
"06037199000",1699,647,20,0,2017,1155,2541,995,9074
"06037199110",1050,251,120,28,788,263,1659,489,4648
"06037199120",1120,721,0,0,1030,1285,1571,1647,7374
"06037199201",1242,176,0,0,1712,982,1930,679,6721
"06037199202",1161,335,6,0,1159,384,1768,687,5500
"06037199300",1370,349,85,0,1295,429,1759,542,5829
"06037199400",944,336,8,42,2291,885,2221,962,7689
"06037199700",1129,531,26,14,974,623,1454,923,5674
"06037199800",646,579,1,0,2845,924,2096,1048,8139
"06037199900",737,212,7,27,980,756,1354,777,4850
"06037201110",1257,232,11,0,1006,151,1935,254,4846
"06037201120",1079,507,101,51,1851,587,2447,1015,7638
"06037201200",1524,316,7,0,534,253,1874,569,5077
"06037201301",1248,283,100,0,1376,281,2218,465,5971
"06037201302",1065,144,421,0,1685,318,860,186,4679
"06037201401",1651,385,32,116,1746,1162,2797,1450,9339
"06037201402",2210,156,55,10,1772,481,2799,551,8034
"06037201501",2074,415,10,0,1953,939,3405,1175,9971
"06037201503",1298,436,0,2,1128,413,2292,738,6307
"06037201504",487,160,25,0,898,474,1037,598,3679
"06037201601",765,86,25,0,1030,334,1413,344,3997
"06037201602",987,176,32,3,1462,228,1865,344,5097
"06037201700",1999,585,9,88,1403,556,2465,922,8027
"06037203100",2001,989,0,1,796,889,2758,1682,9116
"06037203200",2205,1128,11,20,1185,327,3329,1416,9621
"06037203300",437,292,53,6,369,139,615,372,2283
"06037203500",1024,612,19,0,1119,350,1612,851,5587
"06037203600",1790,1132,0,0,1455,458,3132,1539,9506
"06037203710",1518,788,40,32,668,394,2137,1169,6746
"06037203720",1528,1455,48,0,704,404,2210,1847,8196
"06037203800",1824,1074,36,0,1901,198,3599,1261,9893
"06037203900",1381,600,0,0,808,280,2167,844,6080
"06037204110",1045,552,45,10,1147,315,2189,861,6164
"06037204120",936,429,0,4,1078,273,1986,700,5406
"06037204200",1204,949,0,0,911,309,1958,1175,6506
"06037204300",1842,1134,0,0,1313,429,3089,1479,9286
"06037204410",707,427,0,0,567,376,1241,792,4110
"06037204420",847,725,88,63,540,646,1391,1278,5578
"06037204600",1651,707,30,21,1589,626,3153,1325,9102
"06037204700",2000,756,9,90,1622,318,3318,1155,9268
"06037204810",2022,666,76,15,1308,709,3263,1359,9418
"06037204820",1083,340,0,0,842,181,1918,485,4849
"06037204910",1104,585,0,0,766,566,1797,1077,5895
"06037204920",1258,662,0,0,430,196,1621,832,4999
"06037205110",1550,854,11,60,593,753,2116,1545,7482
"06037205120",1304,620,21,20,749,574,1969,1151,6408
"06037206010",495,320,0,134,1234,974,744,1053,4954
"06037206020",199,15,49,0,149,38,48,27,525
"06037206031",1189,220,106,23,1438,148,158,49,3331
"06037206032",1727,1270,28,14,1520,545,2353,1592,9049
"06037206050",777,539,14,38,327,498,866,965,4024
"06037206200",352,377,141,484,1306,625,376,405,4066
"06037206300",399,1202,435,2279,183,766,153,932,6349
"06037207101",778,230,153,0,1156,806,344,329,3796
"06037207102",164,31,50,41,1214,739,225,50,2514
"06037207103",103,27,40,1,1009,1059,153,15,2407
"06037207301",1999,538,278,556,892,423,449,440,5575
"06037207302",1712,205,699,247,1068,308,527,103,4869
"06037207400",1,9,2,0,1,36,1,7,57
"06037207501",790,119,7,0,1067,145,211,25,2364
"06037207502",549,102,71,13,947,822,123,56,2683
"06037207710",1406,197,153,53,750,625,263,282,3729
"06037207900",1138,517,448,124,1876,524,477,410,5514
"06037208000",2659,690,62,299,2080,1395,3303,1610,12098
"06037208301",1082,535,6,0,320,270,1317,768,4298
"06037208302",2246,655,95,183,748,490,2349,1059,7825
"06037208401",667,262,83,38,2549,804,2464,831,7698
"06037208402",1210,420,11,8,1014,187,1431,580,4861
"06037208501",885,197,2,4,1315,116,989,197,3705
"06037208502",658,324,123,14,1672,771,1525,999,6086
"06037208610",584,220,36,85,2614,698,1149,532,5918
"06037208620",553,243,119,270,2620,725,1650,357,6537
"06037208710",444,227,227,0,2876,560,1083,236,5653
"06037208720",536,584,146,106,1859,1335,1850,1718,8134
"06037208801",328,375,109,86,1666,688,1243,816,5311
"06037208802",470,129,132,39,1602,687,1314,442,4815
"06037208902",424,248,2,0,876,940,1262,1174,4926
"06037208903",551,599,25,91,1554,827,1832,1277,6756
"06037208904",346,409,64,0,809,1902,1027,2080,6637
"06037209102",629,594,71,127,1505,1796,1701,2036,8459
"06037209103",475,740,52,11,1072,1236,1417,1958,6961
"06037209104",279,534,67,53,817,681,935,1074,4440
"06037209200",678,410,71,153,1268,696,597,667,4540
"06037209300",730,571,174,239,1697,865,1515,1150,6941
"06037209401",426,421,162,184,1426,1238,1373,1437,6667
"06037209402",292,648,35,31,1538,1151,1703,1712,7110
"06037209403",323,180,116,117,1189,1537,916,1395,5773
"06037209510",408,231,19,36,1222,692,1058,739,4405
"06037209520",209,120,42,19,1336,833,1241,868,4668
"06037209810",336,220,96,11,1072,634,1175,726,4270
"06037209820",405,579,32,15,1145,839,1388,1349,5752
"06037210010",642,259,45,63,1491,1033,1651,1085,6269
"06037211000",2745,133,87,18,1592,96,259,63,4993
"06037211120",641,173,201,79,3256,789,897,378,6414
"06037211121",698,57,108,24,1044,359,790,240,3320
"06037211122",558,502,73,18,1641,335,921,447,4495
"06037211201",763,380,61,21,1378,393,1690,662,5348
"06037211202",718,395,77,15,1022,380,1018,662,4287
"06037211310",745,604,153,22,1894,868,1791,1223,7300
"06037211320",656,347,129,56,1755,362,1585,631,5521
"06037211410",405,321,104,30,1514,342,585,369,3670
"06037211420",861,256,99,104,1663,373,1120,396,4872
"06037211500",1717,78,65,55,2382,397,764,115,5573
"06037211701",793,78,110,1,1882,143,75,50,3132
"06037211703",1309,141,240,30,2711,558,1719,401,7109
"06037211704",497,133,160,21,1628,476,521,115,3551
"06037211802",679,276,204,11,2479,555,803,461,5468
"06037211803",414,158,223,29,2241,730,390,253,4438
"06037211804",370,255,134,18,1718,590,217,243,3545
"06037211910",1144,554,175,26,2255,587,2305,812,7858
"06037211921",288,381,97,12,1198,226,446,436,3084
"06037211922",1072,269,133,22,1987,211,1914,281,5889
"06037212101",564,355,314,24,1268,350,410,341,3626
"06037212102",430,91,130,25,1023,616,490,434,3239
"06037212202",253,245,36,14,2330,806,1876,995,6555
"06037212203",340,125,31,14,1250,1299,1383,1045,5487
"06037212204",390,347,106,163,1581,1072,1574,1220,6453
"06037212303",355,293,56,163,1409,936,1200,1047,5459
"06037212304",371,181,51,7,797,460,784,535,3186
"06037212305",317,230,63,30,1528,849,1420,910,5347
"06037212306",137,215,6,16,2218,494,803,489,4378
"06037212410",572,221,263,34,2459,586,1312,481,5928
"06037212420",185,162,94,94,2019,800,1173,712,5239
"06037212501",713,185,92,53,910,205,798,253,3209
"06037212502",612,70,149,36,1615,307,797,223,3809
"06037212610",539,40,156,18,2245,873,581,367,4819
"06037212620",443,222,182,63,2675,1024,1245,956,6810
"06037212701",548,165,50,16,1376,199,639,182,3175
"06037212702",839,55,141,6,2338,282,177,132,3970
"06037212800",1201,604,528,43,1392,335,1358,712,6173
"06037212900",1329,663,371,155,1821,567,2195,955,8056
"06037213100",478,239,175,33,1435,450,535,508,3853
"06037213201",282,119,44,28,2977,1104,1545,754,6853
"06037213202",389,140,80,15,2189,1174,1516,978,6481
"06037213310",306,107,0,27,2603,784,2181,838,6846
"06037213320",375,28,102,44,1172,430,979,265,3395
"06037213401",364,108,110,16,4061,944,3603,815,10021
"06037213402",242,245,103,144,2763,1046,2146,1177,7866
"06037214000",3307,161,24,0,319,42,117,12,3982
"06037214100",3572,278,41,0,280,19,269,0,4459
"06037214400",1996,390,51,8,528,55,320,82,3430
"06037214501",1653,166,139,15,793,181,96,0,3043
"06037214502",2131,1035,143,0,1383,266,346,303,5607
"06037214503",1468,185,92,9,1460,125,151,7,3497
"06037214600",1859,203,23,10,571,23,276,6,2971
"06037214700",2071,109,0,0,261,56,235,9,2741
"06037214800",2153,160,213,0,377,63,203,38,3207
"06037214901",1894,363,15,2,621,79,176,16,3166
"06037214902",1867,123,43,50,628,158,178,0,3047
"06037215101",1387,386,37,12,718,86,360,45,3031
"06037215102",1649,352,125,0,901,146,241,108,3522
"06037216100",1230,117,488,23,854,89,190,89,3080
"06037216200",1502,482,1045,118,1493,157,460,248,5505
"06037216300",3074,202,471,5,1227,53,405,20,5457
"06037216401",2868,597,137,0,860,180,245,118,5005
"06037216402",2020,319,43,0,512,127,228,22,3271
"06037216700",1227,212,1027,206,989,173,759,108,4701
"06037216800",2121,296,263,11,535,52,402,143,3823
"06037216900",1974,67,1037,108,1628,264,1258,256,6592
"06037217001",1998,378,24,17,269,65,66,10,2827
"06037217002",3124,547,568,112,992,17,663,44,6067
"06037217100",2253,285,1726,331,974,116,1432,269,7386
"06037217200",1186,436,852,89,1267,157,982,503,5472
"06037218110",729,117,721,64,1354,481,1341,496,5303
"06037218120",1516,499,321,268,1688,808,2348,1065,8513
"06037218210",1526,451,506,143,674,436,1937,852,6525
"06037218220",1210,475,1034,268,1195,383,1780,732,7077
"06037218300",1744,277,1542,640,1211,367,2206,581,8568
"06037218400",1130,542,882,390,1059,287,2065,735,7090
"06037218500",503,151,742,279,753,371,1111,442,4352
"06037218600",634,169,807,340,1054,315,1590,414,5323
"06037218701",320,71,1148,95,469,356,454,395,3308
"06037218702",325,56,623,301,568,285,691,315,3164
"06037218800",411,187,620,119,1160,202,1245,322,4266
"06037218900",585,374,1744,466,2098,543,2221,720,8751
"06037219010",543,196,736,262,560,385,1050,537,4269
"06037219020",783,348,1319,80,1399,313,1923,505,6670
"06037219300",546,234,897,536,1710,483,1833,662,6901
"06037219500",356,40,602,78,613,38,508,7,2242
"06037219700",1239,86,872,235,1517,189,2536,246,6920
"06037219800",949,314,355,352,667,379,1543,673,5232
"06037219901",1212,678,489,425,1090,600,2132,1346,7972
"06037219902",1244,401,780,119,1262,224,2197,518,6745
"06037220000",1029,771,1945,480,1338,191,1986,901,8641
"06037220100",410,33,1015,310,235,294,318,253,2868
"06037221110",492,213,47,0,1794,1111,2025,1130,6812
"06037221120",640,273,33,19,1375,699,1932,962,5933
"06037221210",519,143,102,111,1594,541,1803,627,5440
"06037221220",619,329,33,16,2197,588,2446,687,6915
"06037221302",638,975,434,178,2488,702,2631,1477,9523
"06037221303",254,263,90,130,1127,690,978,855,4387
"06037221304",990,407,225,192,1396,444,1627,738,6019
"06037221401",374,47,945,555,379,595,610,528,4033
"06037221402",349,175,411,260,1075,446,1010,411,4137
"06037221500",592,38,701,524,1088,923,1578,969,6413
"06037221601",456,124,305,121,1566,914,1769,966,6221
"06037221602",711,273,14,45,1337,784,1908,950,6022
"06037221710",316,179,215,82,1187,638,1248,521,4386
"06037221810",220,432,153,162,700,1094,576,605,3942
"06037221820",530,437,53,269,533,1178,201,110,3311
"06037221900",259,277,101,96,465,1117,489,449,3253
"06037222001",705,67,670,208,1117,254,1506,274,4801
"06037222002",938,33,1123,169,1842,583,2608,615,7911
"06037222100",489,285,599,458,1374,362,1566,584,5717
"06037222200",471,451,495,324,1617,787,1836,1012,6993
"06037222500",399,373,832,390,2300,1130,2426,1360,9210
"06037222600",485,439,866,420,1817,1388,1995,826,8236
"06037222700",50,204,0,33,17,267,12,10,593
"06037224010",376,285,233,186,485,518,616,590,3289
"06037224020",344,404,19,103,1023,609,1244,940,4686
"06037224200",450,467,39,12,1144,312,1521,759,4704
"06037224310",426,237,56,0,758,685,1030,860,4052
"06037224320",450,549,39,127,1782,465,2100,1003,6515
"06037224410",403,447,41,15,1414,937,1225,684,5166
"06037224420",342,171,19,52,771,891,999,1030,4275
"06037224600",717,343,47,54,939,1116,1595,1424,6235
"06037224700",327,1133,11,94,223,1214,69,223,3294
"06037226001",579,238,121,88,784,448,1411,686,4355
"06037226002",438,240,93,108,435,280,439,413,2446
"06037226410",825,735,13,24,1175,878,1940,1511,7101
"06037226420",1763,808,158,177,1360,907,2868,1674,9715
"06037226700",1432,964,63,73,2206,1748,3604,2686,12776
"06037227010",1338,653,207,168,1293,923,2631,1576,8789
"06037227020",1045,635,74,83,1010,739,2013,1354,6953
"06037228100",774,772,301,122,2324,1247,3092,2004,10636
"06037228210",648,234,345,245,1097,1174,1672,1458,6873
"06037228220",1218,490,333,220,1121,787,2292,1222,7683
"06037228310",1005,673,122,74,1644,1095,2593,1705,8911
"06037228320",721,413,170,138,725,779,1432,1190,5568
"06037228410",756,410,24,27,1196,852,1861,1252,6378
"06037228420",763,530,161,235,843,839,1580,1370,6321
"06037228500",898,372,324,401,1289,1335,2169,1701,8489
"06037228600",728,593,125,128,1546,1722,2062,2312,9216
"06037228710",975,528,201,125,853,1294,1785,1809,7570
"06037228720",1067,573,203,192,1346,949,2392,1527,8249
"06037228800",1476,461,398,239,1567,1361,3104,1730,10336
"06037228900",574,317,148,166,769,1080,1215,1410,5679
"06037229100",1115,499,156,145,1759,1097,2853,1568,9192
"06037229200",833,790,246,290,1187,689,2020,1481,7536
"06037229300",1229,735,376,260,1382,1757,2583,2510,10832
"06037229410",555,563,123,334,1008,1031,1560,1547,6721
"06037229420",780,338,372,176,1428,1521,2190,1847,8652
"06037231100",596,570,407,583,571,710,1075,1127,5639
"06037231210",366,232,523,346,1497,528,1800,760,6052
"06037231220",370,249,350,445,1816,1186,1994,1280,7690
"06037231300",575,501,631,618,1750,1154,2152,1604,8985
"06037231400",504,635,853,299,2430,236,2846,847,8650
"06037231500",783,43,1525,386,1681,340,2185,328,7271
"06037231600",508,591,1401,554,2768,1035,2998,1306,11161
"06037231710",631,289,446,353,902,1732,1523,1972,7848
"06037231720",693,334,352,409,2300,1338,2868,1516,9810
"06037231800",817,393,315,119,1086,1908,1879,2274,8791
"06037231900",857,556,563,195,1624,1620,2396,2121,9932
"06037232110",684,152,382,306,925,530,1589,679,5247
"06037232120",742,536,628,641,1917,1124,2591,1651,9830
"06037232200",358,183,628,411,619,565,912,726,4402
"06037232300",510,661,769,311,1359,583,1711,1233,7137
"06037232400",822,200,1816,1193,2464,400,3006,609,10510
"06037232500",941,146,1373,442,983,1108,1858,1221,8072
"06037232600",970,236,1130,547,2108,1231,2961,1466,10649
"06037232700",1045,447,874,669,2288,888,3264,1304,10779
"06037232800",671,428,423,136,1369,1011,2034,1415,7487
"06037234000",805,83,2825,631,1287,51,1821,170,7673
"06037234200",140,21,1499,208,339,27,80,18,2332
"06037234300",68,0,2451,837,417,29,189,0,3991
"06037234501",455,116,1217,263,206,82,625,177,3141
"06037234502",371,58,1038,422,221,110,493,171,2884
"06037234600",720,125,2151,727,769,562,1151,680,6885
"06037234700",719,152,1399,481,569,342,1291,465,5418
"06037234800",650,35,1268,421,756,86,1262,41,4519
"06037234901",219,44,792,491,509,718,728,762,4263
"06037234902",440,95,1035,830,1028,331,1317,424,5500
"06037235100",225,0,3277,299,876,39,667,0,5383
"06037235201",229,200,1403,332,309,83,414,255,3225
"06037235202",503,67,1562,959,921,144,1236,164,5556
"06037236000",916,17,2499,179,736,43,684,0,5074
"06037236100",406,76,2232,1156,957,312,567,281,5987
"06037236202",1223,355,1258,740,1080,914,1952,1216,8738
"06037236203",478,374,1988,449,364,66,689,409,4817
"06037236204",190,535,1228,473,371,91,428,626,3942
"06037236400",320,65,3187,393,248,120,265,75,4673
"06037237101",991,366,539,327,620,788,1595,1149,6375
"06037237102",594,225,570,140,690,673,1304,874,5070
"06037237201",803,239,628,243,1131,354,1885,575,5858
"06037237202",1102,217,730,704,1935,90,2947,317,8042
"06037237300",1014,49,2263,939,562,273,1375,315,6790
"06037237401",851,305,515,319,1139,425,1968,718,6240
"06037237402",1132,185,953,382,566,225,1679,403,5525
"06037237500",568,216,604,76,667,691,1217,896,4935
"06037237600",969,203,560,391,1095,562,2024,735,6539
"06037237710",700,449,377,264,639,589,1257,942,5217
"06037237720",460,301,394,176,604,1054,1060,1348,5397
"06037237800",517,140,1935,424,677,114,1210,194,5211
"06037237900",315,48,2642,707,245,31,447,79,4514
"06037238000",322,312,3666,577,543,32,793,316,6561
"06037238100",608,132,2534,642,619,43,1027,129,5734
"06037238200",308,43,3512,830,673,70,605,49,6090
"06037238310",540,850,413,663,1146,1114,1604,1957,8287
"06037238320",590,570,745,440,709,819,1299,1389,6561
"06037238400",265,225,3595,625,484,37,590,209,6030
"06037239201",483,243,551,120,1160,1166,1621,1403,6747
"06037239202",928,79,470,408,2136,987,2999,1032,9039
"06037239310",1098,254,341,266,1380,902,2379,1328,7948
"06037239320",506,445,364,333,1643,532,2110,969,6902
"06037239330",459,248,238,269,1316,587,1775,835,5727
"06037239501",848,645,511,334,1083,244,1888,862,6415
"06037239502",546,290,493,288,773,1111,1316,1448,6265
"06037239601",651,325,331,244,990,1138,1618,1436,6733
"06037239602",858,163,157,406,915,954,1741,1124,6318
"06037239701",924,782,469,539,1237,968,2128,1750,8797
"06037239702",331,86,722,691,1242,541,1566,635,5814
"06037239801",565,400,253,317,1331,623,1952,1057,6498
"06037239802",1390,279,617,225,1331,922,2636,1189,8589
"06037240010",701,547,457,545,849,594,1539,1141,6373
"06037240020",1235,553,998,355,1633,741,2842,1283,9640
"06037240200",621,341,778,659,1964,951,2484,1301,9099
"06037240300",1352,308,849,339,1384,734,2727,943,8636
"06037240401",378,751,1164,330,1385,1264,1772,2015,9059
"06037240402",590,187,819,431,1148,593,1649,769,6186
"06037240500",1495,332,708,1069,1963,899,3505,1199,11170
"06037240600",776,141,785,548,1953,872,2720,1003,8798
"06037240700",2030,555,1310,583,1310,362,3289,771,10210
"06037240800",1301,453,1066,686,815,561,2064,923,7869
"06037240900",1424,841,733,637,973,1354,2426,2186,10574
"06037241001",871,476,658,995,774,574,1596,1022,6966
"06037241002",836,541,1029,257,1269,239,2059,735,6965
"06037241110",572,313,542,469,881,338,1441,651,5207
"06037241120",762,527,869,679,1228,1141,1912,1537,8655
"06037241201",631,262,742,329,686,249,1262,511,4672
"06037241202",806,431,1243,533,830,1082,1554,1510,7989
"06037241300",343,102,690,352,454,249,722,388,3300
"06037241400",1251,395,418,377,784,150,1990,533,5898
"06037242000",1096,1009,885,530,442,96,1520,1089,6667
"06037242100",374,926,284,484,181,538,561,1454,4802
"06037242200",1421,617,688,554,1110,1165,2511,1815,9881
"06037242300",1113,536,420,498,1494,768,2588,1203,8620
"06037242600",828,886,430,1255,346,1187,1170,2059,8161
"06037242700",1589,668,866,562,774,618,2346,1231,8654
"06037243000",2940,876,480,809,1104,647,3910,1322,12088
"06037243100",1771,1582,602,730,790,854,2533,2440,11302
"06037261101",3235,229,73,11,300,20,180,14,4062
"06037261102",3009,234,63,0,725,0,302,0,4333
"06037261200",3214,175,42,8,549,11,189,47,4235
"06037262100",2460,144,35,0,370,19,153,0,3181
"06037262200",3641,85,157,27,646,38,341,10,4945
"06037262301",1916,153,14,0,348,41,50,22,2544
"06037262302",2780,64,20,0,209,7,182,15,3277
"06037262303",2478,153,0,0,335,6,128,25,3125
"06037262400",2553,49,0,20,333,47,123,38,3163
"06037262501",3687,118,46,0,201,9,180,0,4241
"06037262601",2978,160,31,0,551,39,288,10,4057
"06037262604",5235,197,0,28,1040,30,28,16,6574
"06037262704",2865,180,20,2,444,5,331,12,3859
"06037262706",3068,216,132,0,323,0,185,58,3982
"06037262802",3176,37,53,0,272,0,246,9,3793
"06037264000",2772,179,0,0,162,11,164,0,3288
"06037264102",2147,198,40,0,215,108,117,47,2872
"06037264103",1821,281,8,0,365,19,209,0,2703
"06037264301",3887,196,64,0,880,97,262,11,5397
"06037264302",4314,233,94,0,725,155,252,102,5875
"06037265100",2127,225,46,0,210,16,47,0,2671
"06037265201",1341,307,23,0,323,249,69,0,2312
"06037265202",2235,314,78,0,547,370,94,21,3659
"06037265301",0,0,0,0,0,0,0,0,0
"06037265303",655,1487,50,71,366,2294,185,794,5902
"06037265304",380,1209,0,0,214,1017,25,439,3284
"06037265305",865,1128,15,99,695,971,102,215,4090
"06037265410",1108,47,59,23,175,6,69,2,1489
"06037265420",1446,142,118,0,305,130,78,0,2219
"06037265510",1742,446,23,1,831,1095,168,96,4402
"06037265520",2880,286,102,0,857,300,132,49,4606
"06037265601",2035,179,55,0,672,8,79,8,3036
"06037265602",2222,229,48,0,386,42,104,0,3031
"06037265700",3304,416,96,0,1326,23,223,32,5420
"06037267100",4327,431,100,83,1591,181,670,121,7504
"06037267200",3845,278,34,0,1389,112,355,19,6032
"06037267300",1963,524,191,0,1358,251,354,113,4754
"06037267402",2613,326,161,22,1278,129,322,25,4876
"06037267403",1487,296,107,0,795,374,308,10,3377
"06037267404",1940,343,41,0,712,201,341,158,3736
"06037267501",3073,679,34,20,2613,114,2387,258,9178
"06037267502",1925,418,52,0,884,76,604,37,3996
"06037267600",1540,207,49,0,1128,71,747,154,3896
"06037267700",1615,204,60,12,1397,107,652,50,4097
"06037267800",2065,56,55,29,744,26,192,8,3175
"06037267901",1652,134,0,0,523,21,8,8,2346
"06037267902",2560,196,88,0,515,115,96,11,3581
"06037269000",4519,152,139,92,627,43,354,25,5951
"06037269100",2988,275,54,0,691,0,268,28,4304
"06037269300",3514,171,106,0,602,0,174,0,4567
"06037269500",3363,97,80,0,448,19,97,0,4104
"06037269601",1466,416,696,134,367,50,1383,411,4923
"06037269602",1193,378,366,199,485,124,709,321,3775
"06037269700",2218,211,298,37,980,78,1320,185,5327
"06037269800",1542,422,225,5,817,282,457,198,3948
"06037269903",1756,327,283,57,1185,119,816,239,4782
"06037269904",1608,371,481,96,1069,302,703,125,4755
"06037269905",1952,112,206,4,751,167,1553,18,4763
"06037269906",1468,161,94,67,944,155,404,49,3342
"06037269907",1610,284,254,39,590,74,834,113,3798
"06037270100",2336,401,257,15,1224,394,796,312,5735
"06037270200",2102,511,292,0,801,151,1819,495,6171
"06037270300",609,87,672,97,877,146,724,208,3420
"06037271100",1410,151,17,0,727,70,406,29,2810
"06037271200",1349,154,114,0,935,273,747,193,3765
"06037271300",2624,277,234,0,1281,55,738,137,5346
"06037271400",2607,384,18,0,620,31,409,57,4126
"06037271500",2141,209,35,37,625,38,439,89,3613
"06037271600",2161,274,185,48,1275,579,348,66,4936
"06037271701",3604,518,124,1,1391,217,747,48,6650
"06037271702",1766,295,101,0,1642,540,476,111,4931
"06037271801",1606,724,145,17,800,266,766,462,4786
"06037271802",2919,851,588,14,1651,385,987,495,7890
"06037271901",1758,145,233,55,991,195,1044,170,4591
"06037271902",2600,317,152,4,803,31,802,86,4795
"06037272100",3084,314,16,0,841,167,907,158,5487
"06037272201",1138,152,208,15,809,196,866,204,3588
"06037272202",2094,284,209,87,1030,36,1158,135,5033
"06037272301",1483,215,217,0,1079,167,858,226,4245
"06037272302",2042,342,280,9,1466,375,1941,436,6891
"06037273100",1856,131,9,0,163,0,431,6,2596
"06037273200",2177,311,205,117,503,204,795,391,4703
"06037273300",2313,322,376,36,401,55,788,139,4430
"06037273402",2080,183,105,0,313,95,177,26,2979
"06037273502",2096,283,152,7,339,81,233,7,3198
"06037273600",1776,309,40,35,222,0,161,151,2694
"06037273700",2032,174,101,0,476,13,509,121,3426
"06037273800",2205,245,167,31,582,98,370,153,3851
"06037273902",2911,221,66,53,262,155,370,93,4131
"06037274100",2486,482,524,142,613,35,369,39,4690
"06037274202",3224,272,40,44,387,51,262,38,4318
"06037275101",711,37,81,0,432,11,340,12,1624
"06037275102",2510,230,32,63,893,159,2258,206,6351
"06037275200",1640,380,80,0,1618,404,1746,556,6424
"06037275302",3298,282,59,202,842,118,565,39,5405
"06037275311",3229,274,135,0,1925,195,1232,199,7189
"06037275400",2283,29,126,38,863,62,735,7,4143
"06037275500",2472,1077,125,106,1109,373,2415,1258,8935
"06037275602",3548,432,759,307,2605,283,777,309,9020
"06037275603",1718,271,50,0,789,125,900,207,4060
"06037276000",3575,73,216,36,1645,37,1231,47,6860
"06037276100",1334,287,2593,283,1420,145,431,91,6584
"06037276400",2696,476,29,83,768,124,506,19,4701
"06037276500",1245,164,13,30,279,12,220,24,1987
"06037276601",2267,390,118,15,1082,155,463,7,4497
"06037276603",3356,255,292,16,1217,157,867,43,6203
"06037276604",2128,326,600,91,579,435,299,11,4469
"06037277000",4292,172,115,0,962,22,806,0,6369
"06037277100",2037,152,75,3,907,26,773,109,4082
"06037277200",720,146,775,46,493,345,608,346,3479
"06037277400",245,68,678,167,447,105,467,57,2234
"06037278001",1647,359,99,23,305,81,458,145,3117
"06037278102",2448,33,104,0,468,47,333,22,3455
"06037291110",131,282,1620,436,665,436,665,751,4986
"06037291120",385,130,432,128,809,407,1154,529,3974
"06037291130",694,85,473,175,1892,253,2021,321,5914
"06037291210",1461,595,830,97,1943,832,2228,1305,9291
"06037291220",1300,515,267,49,1096,567,1615,1035,6444
"06037291300",826,30,34,16,1362,133,564,22,2987
"06037292000",1375,481,388,440,2657,1377,2207,1550,10475
"06037293201",2014,208,495,224,3384,264,2504,235,9328
"06037293202",1206,535,313,209,2637,1435,2228,1724,10287
"06037293301",1295,179,35,28,1252,99,553,16,3457
"06037293302",2344,562,321,65,1864,331,1984,747,8218
"06037293304",1430,271,232,58,1998,372,2209,473,7043
"06037293306",1206,201,217,0,706,49,777,174,3330
"06037293307",982,85,356,156,701,403,1203,389,4275
"06037294110",2420,701,13,0,1182,213,3005,856,8390
"06037294120",999,290,73,16,787,179,1713,385,4442
"06037294200",3257,503,15,0,1207,542,4007,1007,10538
"06037294301",1684,130,23,0,745,98,2016,192,4888
"06037294302",2392,689,86,0,1371,461,3417,1069,9485
"06037294410",1652,310,433,368,1332,825,1296,642,6858
"06037294421",823,432,212,38,1234,286,1527,702,5254
"06037294510",2040,1133,24,0,1325,286,3112,1366,9286
"06037294520",1939,686,17,1,712,299,2483,971,7108
"06037294610",1727,1056,64,32,1000,432,2624,1474,8409
"06037294620",1930,725,136,1,1352,364,3146,1062,8716
"06037294701",1373,705,33,71,674,371,1936,994,6157
"06037294810",1525,1512,77,31,798,521,2291,2006,8761
"06037294820",1531,1133,11,18,797,355,2249,1435,7529
"06037294830",1380,1024,76,0,807,503,2067,1512,7369
"06037294900",1511,1286,65,20,619,181,1932,1418,7032
"06037295103",3443,113,97,0,1163,50,934,69,5869
"06037296210",1291,466,129,183,389,283,1459,629,4829
"06037296220",1243,883,363,234,839,1040,1382,1541,7525
"06037296300",2805,114,124,0,1332,151,1466,152,6144
"06037296401",2308,134,55,8,770,142,638,30,4085
"06037296402",1983,376,135,11,502,30,1171,213,4421
"06037296500",1646,571,256,193,921,413,2160,873,7033
"06037296600",2101,810,276,56,1033,808,2396,1197,8677
"06037296901",1768,310,71,128,1602,388,2373,561,7201
"06037296902",2508,352,102,41,743,222,1779,381,6128
"06037297000",3863,75,127,0,922,219,1435,255,6896
"06037297110",2123,911,527,245,784,696,2008,1254,8548
"06037297120",1999,654,153,55,734,186,2101,670,6552
"06037297201",1867,447,390,37,832,69,1777,248,5667
"06037297202",2475,78,80,2,860,391,1087,350,5323
"06037297300",1603,103,85,0,366,77,669,28,2931
"06037297400",2842,224,77,1,575,42,798,143,4702
"06037297500",3379,232,381,0,884,224,1346,263,6709
"06037297601",1879,190,176,0,289,0,473,96,3103
"06037297602",2481,369,167,47,753,188,994,395,5394
"06037300100",4175,140,83,0,1480,53,552,25,6508
"06037300200",2938,199,15,0,2294,230,533,126,6335
"06037300301",4346,295,0,2,1794,106,466,20,7029
"06037300400",3329,218,14,3,1929,101,1072,1,6667
"06037300501",1856,184,0,0,871,127,444,38,3520
"06037300502",3014,376,41,1,2334,195,883,215,7059
"06037300600",5024,170,33,0,3068,446,783,42,9566
"06037300701",5444,219,0,22,876,0,844,46,7451
"06037300702",4116,447,0,0,752,0,104,174,5593
"06037300800",4655,841,69,0,1721,237,511,147,8181
"06037300901",4104,108,26,0,1946,123,349,16,6672
"06037300902",1403,83,0,0,539,32,296,25,2378
"06037301000",3140,332,72,0,1257,143,764,143,5851
"06037301100",4583,481,0,7,1374,162,718,44,7369
"06037301203",2969,253,35,0,1101,69,482,53,4962
"06037301204",2995,746,112,0,1049,191,639,52,5784
"06037301205",1657,42,45,10,466,24,323,0,2567
"06037301206",3145,809,0,1,1164,196,465,10,5790
"06037301300",1643,35,8,0,277,36,166,0,2165
"06037301400",3153,182,0,8,367,0,42,0,3752
"06037301501",1655,47,0,0,155,3,165,8,2033
"06037301502",4477,1283,28,0,1020,158,726,152,7844
"06037301601",3962,879,206,0,1311,81,1123,93,7655
"06037301602",2223,208,89,0,1134,337,1441,339,5771
"06037301701",1758,276,55,0,685,127,793,108,3802
"06037301702",3809,443,58,49,1215,195,1024,68,6861
"06037301801",2615,371,19,0,1421,73,1019,148,5666
"06037301802",1779,632,20,0,987,61,410,20,3909
"06037301900",4683,1338,183,18,1434,251,939,181,9027
"06037302002",2415,639,45,0,577,276,442,120,4514
"06037302003",2533,666,13,0,582,40,368,40,4242
"06037302004",2386,644,9,18,1301,47,755,56,5216
"06037302102",3569,653,24,0,1339,136,857,286,6864
"06037302103",3185,1188,34,1,1325,129,1210,102,7174
"06037302104",1809,319,121,35,1439,180,872,153,4928
"06037302201",2284,1047,142,50,449,114,316,109,4511
"06037302202",2799,1149,0,11,997,150,820,308,6234
"06037302301",2176,536,12,0,1333,183,592,130,4962
"06037302302",2687,658,100,25,1446,107,2120,294,7437
"06037302401",2912,963,90,26,1307,391,1452,321,7462
"06037302503",2294,817,20,0,1230,212,597,239,5409
"06037302504",2060,1285,102,41,851,70,925,633,5967
"06037302505",2073,808,224,0,1211,187,1722,132,6357
"06037302506",1864,632,120,28,756,24,826,137,4387
"06037310100",4581,275,98,0,847,0,627,25,6453
"06037310201",4098,413,171,0,1044,71,1204,22,7023
"06037310202",3393,424,124,12,845,202,549,223,5772
"06037310300",2254,64,0,0,520,15,277,0,3130
"06037310400",2301,94,11,8,623,128,462,117,3744
"06037310501",2151,200,103,15,926,79,1766,63,5303
"06037310601",2966,482,57,15,2618,364,2015,304,8821
"06037310602",1608,90,33,0,696,92,641,23,3183
"06037310701",1402,613,42,2,393,36,395,85,2968
"06037310702",4480,1046,73,0,1755,100,1247,68,8769
"06037310703",2680,1159,283,0,706,477,519,339,6163
"06037310800",3392,312,93,0,1401,221,1297,268,6984
"06037310900",4163,303,27,3,1675,26,1965,122,8284
"06037311000",2691,124,100,1,1064,57,1450,37,5524
"06037311100",2469,327,66,23,1101,24,1411,164,5585
"06037311200",2487,153,49,0,518,8,955,63,4233
"06037311300",2390,428,147,0,757,127,819,263,4931
"06037311400",1648,129,6,40,378,13,280,30,2524
"06037311500",3954,236,46,6,1091,108,1129,50,6620
"06037311600",4602,416,229,15,1696,266,1248,182,8654
"06037311700",3839,347,78,2,1274,35,880,93,6548
"06037311801",1645,276,51,0,912,94,1267,220,4465
"06037311802",1758,816,152,7,1060,64,1442,711,6010
"06037320000",0,0,0,0,0,0,0,0,0
"06037320100",4635,678,154,9,1788,539,5943,1186,14932
"06037320201",1771,469,27,0,1008,437,2353,900,6965
"06037320202",3011,217,302,0,2109,276,4786,392,11093
"06037320300",3191,1487,34,0,1552,451,4501,1877,13093
"06037400204",4380,198,215,0,1452,50,1215,117,7627
"06037400205",1759,116,104,11,1053,96,188,25,3352
"06037400206",3973,68,28,8,1215,39,1077,12,6420
"06037400207",3922,140,51,14,637,34,942,24,5764
"06037400302",1792,86,81,4,786,259,907,156,4071
"06037400304",4316,201,197,0,1562,611,1838,71,8796
"06037400402",2986,211,73,0,954,0,1008,14,5246
"06037400403",2806,90,71,1,1036,42,1179,34,5259
"06037400404",3870,67,22,2,399,12,545,58,4975
"06037400501",1705,61,33,0,289,0,453,7,2548
"06037400602",1666,244,9,26,1592,703,2003,848,7091
"06037400603",2062,189,294,27,2322,256,2349,309,7808
"06037400604",1339,277,26,14,1177,361,1020,517,4731
"06037400800",1175,314,61,36,687,79,432,32,2816
"06037400900",2741,127,122,4,1052,266,1329,184,5825
"06037401001",2518,58,8,0,592,25,577,25,3803
"06037401002",2639,456,58,174,613,70,946,41,4997
"06037401101",3411,606,62,0,1168,240,1043,350,6880
"06037401102",1799,206,42,0,669,102,711,213,3742
"06037401201",2581,23,44,0,679,0,942,0,4269
"06037401202",2536,319,6,0,1656,126,1707,71,6421
"06037401203",3337,522,271,0,1283,63,1700,394,7570
"06037401303",1466,36,62,0,817,79,578,14,3052
"06037401304",4023,62,48,0,1564,103,1525,51,7376
"06037401311",3821,428,345,25,1598,172,2027,397,8813
"06037401312",3371,347,141,0,1461,0,1933,92,7345
"06037401500",3675,451,344,26,856,97,1984,344,7777
"06037401601",3630,164,68,7,1021,248,1678,104,6920
"06037401602",3866,492,261,11,1093,231,2173,502,8629
"06037401603",2138,172,23,18,206,7,590,0,3154
"06037401701",2870,260,192,21,868,37,939,72,5259
"06037401703",2686,561,357,165,732,146,1632,326,6605
"06037401704",2986,748,282,115,1316,232,2538,586,8803
"06037401800",5602,556,119,4,1054,141,1434,254,9164
"06037401901",238,15,0,0,70,28,129,28,508
"06037401902",3864,153,420,5,1054,69,692,87,6344
"06037402001",1400,358,250,21,1013,242,874,423,4581
"06037402002",2052,346,155,11,1464,224,1473,195,5920
"06037402101",2245,525,513,153,1303,152,3062,587,8540
"06037402102",3230,390,219,135,898,220,3079,431,8602
"06037402200",2710,533,587,79,1757,820,2957,1156,10599
"06037402301",1738,592,177,52,2578,547,3331,964,9979
"06037402303",1758,533,224,77,983,798,2299,1053,7725
"06037402304",981,463,71,108,1540,878,2279,1291,7611
"06037402402",3113,807,414,37,1782,287,3441,667,10548
"06037402403",1893,171,151,0,1611,91,2688,122,6727
"06037402404",12,0,0,0,0,0,0,0,12
"06037402405",1135,318,307,46,983,203,1967,454,5413
"06037402406",1145,238,258,72,2235,772,2877,978,8575
"06037402501",3407,1141,38,165,787,101,3728,1275,10642
"06037402502",4077,1306,31,81,1094,337,4393,1404,12723
"06037402600",4229,1086,183,139,1146,206,3402,1033,11424
"06037402702",2677,2077,317,179,603,634,2976,2583,12046
"06037402703",2719,399,451,167,632,346,2642,508,7864
"06037402705",2270,442,214,54,493,70,1956,422,5921
"06037402706",2379,358,365,85,891,86,2633,359,7156
"06037402801",2882,1093,0,24,638,555,3193,1629,10014
"06037402803",1529,929,21,0,824,94,2013,996,6406
"06037402804",2066,955,90,43,906,214,2384,1019,7677
"06037402902",3057,1326,345,59,1039,412,3330,1510,11078
"06037402903",2588,510,113,7,1001,249,2769,676,7913
"06037402904",2328,463,88,0,586,108,2524,539,6636
"06037403000",3715,1359,273,33,1444,280,3969,1309,12382
"06037403200",81,113,11,22,28,71,9,75,410
"06037403303",919,24,31,6,1611,260,876,22,3749
"06037403304",1250,84,68,0,3256,327,722,54,5761
"06037403305",377,0,18,0,1657,85,204,13,2354
"06037403312",1690,191,401,0,2678,130,1529,120,6739
"06037403316",2098,90,476,12,4087,332,1123,66,8284
"06037403317",1998,47,553,8,1678,216,1215,154,5869
"06037403318",2790,213,536,66,2250,216,1677,80,7828
"06037403319",1254,58,436,33,2460,177,877,19,5314
"06037403320",1139,113,0,56,3877,163,863,50,6261
"06037403321",2029,112,196,77,3496,291,1582,56,7839
"06037403322",1285,85,73,36,2099,397,793,15,4783
"06037403323",1292,150,35,0,3600,356,420,118,5971
"06037403324",1622,134,203,0,4639,86,632,39,7355
"06037403325",1984,28,262,0,2393,177,883,10,5737
"06037403401",1511,112,106,2,3416,390,1329,373,7239
"06037403402",874,13,118,1,2351,242,780,14,4393
"06037403403",853,0,178,0,3730,188,681,12,5642
"06037403404",518,21,72,0,1851,174,241,15,2892
"06037403405",432,2,0,0,1368,10,263,1,2076
"06037403406",964,67,89,0,1520,264,596,50,3550
"06037403407",490,0,12,0,1351,251,304,0,2408
"06037403408",1087,29,297,0,4749,233,1117,32,7544
"06037403500",937,44,22,0,853,23,569,12,2460
"06037403600",3895,392,237,2,2346,207,3069,269,10417
"06037403702",2061,143,190,0,1304,17,1689,144,5548
"06037403703",2817,248,138,1,1616,73,2205,198,7296
"06037403721",2764,197,150,8,1666,136,2196,255,7372
"06037403722",1948,389,83,116,2546,723,3067,918,9790
"06037403801",2877,443,404,0,2213,322,2669,443,9371
"06037403802",2586,292,96,44,2601,353,3040,375,9387
"06037403901",2031,168,123,13,1005,93,1593,110,5136
"06037403902",2908,520,154,22,853,175,1637,418,6687
"06037404000",1829,315,25,70,2470,186,2711,362,7968
"06037404100",2178,548,132,0,3194,238,4429,701,11420
"06037404201",1107,340,22,39,1258,967,1680,1087,6500
"06037404202",680,184,47,21,1373,553,1455,456,4769
"06037404301",1555,289,66,13,3359,510,4239,744,10775
"06037404302",715,135,47,0,1070,87,1367,182,3603
"06037404401",1371,306,17,11,1728,374,2688,607,7102
"06037404402",1625,99,0,8,2370,407,2925,475,7909
"06037404501",829,107,98,9,1363,170,1820,273,4669
"06037404503",1058,19,12,23,1690,216,2049,232,5299
"06037404504",1454,159,32,108,2706,571,3514,663,9207
"06037404600",625,141,8,0,614,37,1189,177,2791
"06037404701",1512,591,0,0,3079,424,3654,951,10211
"06037404702",1075,542,67,82,3255,1226,3143,1367,10757
"06037404703",850,390,83,0,1678,490,2284,828,6603
"06037404801",2074,427,178,1,4218,820,4609,1062,13389
"06037404802",1115,486,239,8,2493,288,2437,651,7717
"06037404803",366,79,0,0,955,171,1145,195,2911
"06037404901",1808,110,88,2,3514,291,3644,325,9782
"06037404902",1582,410,10,0,1786,660,2201,941,7590
"06037404903",1362,236,17,10,1043,316,1879,326,5189
"06037405001",2135,309,23,2,3559,208,4960,461,11657
"06037405002",1473,211,0,0,1493,187,2619,377,6360
"06037405101",1840,418,10,18,2134,308,2981,567,8276
"06037405102",1011,287,180,0,2094,586,1958,597,6713
"06037405201",1274,284,111,27,2919,704,3244,870,9433
"06037405202",1806,224,23,63,2916,253,3846,404,9535
"06037405203",1324,130,16,0,1952,311,2452,237,6422
"06037405301",1288,175,81,12,1593,337,1888,468,5842
"06037405302",1777,106,161,19,3592,393,3745,410,10203
"06037405400",2480,39,0,0,2607,389,3666,373,9554
"06037405500",2898,335,186,58,3164,206,3837,248,10932
"06037405600",2263,137,131,0,3169,95,3622,95,9512
"06037405701",1639,143,30,12,1761,38,2406,181,6210
"06037405702",1598,400,106,10,2367,415,2819,512,8227
"06037405800",2913,452,52,0,2217,177,3496,510,9817
"06037405900",1759,99,178,57,1508,232,2149,261,6243
"06037406000",2507,274,81,50,1812,363,2767,485,8339
"06037406101",1233,113,235,17,1761,95,2103,80,5637
"06037406102",2867,335,213,8,1820,287,2772,352,8654
"06037406200",1806,501,211,130,2395,623,2531,889,9086
"06037406300",2125,430,154,17,2625,224,1954,358,7887
"06037406402",1357,13,13,4,850,6,1314,0,3557
"06037406411",960,115,6,0,853,69,1096,66,3165
"06037406412",1142,66,130,0,1210,5,1317,11,3881
"06037406500",2541,204,240,36,3156,190,3860,204,10431
"06037406601",2384,119,288,162,2593,94,3153,45,8838
"06037406602",1944,157,76,0,3054,455,3345,502,9533
"06037406701",1171,52,89,6,2094,56,1915,49,5432
"06037406702",1911,516,127,39,3046,265,2780,544,9228
"06037406800",1707,44,123,0,2084,655,2008,663,7284
"06037406901",2003,284,40,0,1968,414,3462,525,8696
"06037406902",1570,140,92,0,1764,69,2817,192,6644
"06037407001",2070,352,29,47,3204,168,4632,432,10934
"06037407002",1348,122,79,2,1879,292,2723,378,6823
"06037407101",2067,171,50,1,1717,765,3217,916,8904
"06037407102",1776,336,39,21,3085,169,4178,462,10066
"06037407200",2982,254,13,60,3228,537,5668,704,13446
"06037407301",2547,202,30,1,1790,199,3763,258,8790
"06037407302",1907,106,117,0,1543,185,2975,222,7055
"06037407400",595,119,42,10,1208,117,1010,166,3267
"06037407501",2275,352,173,2,1432,266,3087,548,8135
"06037407502",1852,157,0,0,1788,282,3003,384,7466
"06037407601",1650,224,27,11,2122,426,3163,591,8214
"06037407602",2196,201,12,18,1296,197,3013,276,7209
"06037407701",1659,709,59,148,2171,464,3363,1082,9655
"06037407702",3015,195,52,0,3099,476,4681,599,12117
"06037407801",2438,244,34,7,2093,409,3487,411,9123
"06037407802",1948,148,51,7,1658,56,3000,145,7013
"06037407900",2214,256,132,17,3324,480,3707,532,10662
"06037408003",1918,237,238,0,2200,192,2398,352,7535
"06037408004",807,95,85,26,1080,175,763,245,3276
"06037408005",1529,66,183,6,2770,232,1929,198,6913
"06037408006",838,210,236,39,2318,209,1400,221,5471
"06037408133",1030,577,152,20,3524,508,2114,1020,8945
"06037408134",561,178,264,25,1619,52,681,157,3537
"06037408135",581,77,404,14,2467,377,866,339,5125
"06037408136",1281,155,118,0,1986,178,1828,182,5728
"06037408137",1149,205,219,43,2338,264,1627,342,6187
"06037408138",2649,1285,157,0,1359,873,3521,2034,11878
"06037408139",2180,346,5,0,1836,176,3856,488,8887
"06037408140",1211,419,32,0,1788,221,2738,631,7040
"06037408141",2274,223,45,1,2293,544,3776,739,9895
"06037408202",783,30,13,0,857,279,1269,285,3516
"06037408211",1459,415,21,2,3197,816,1566,615,8091
"06037408212",1153,190,54,10,3309,328,1415,67,6526
"06037408301",2079,399,12,0,2388,732,3698,1037,10345
"06037408302",1848,132,0,46,1962,72,3056,188,7304
"06037408303",2073,139,13,0,1925,207,3272,299,7928
"06037408401",2465,170,19,0,1803,84,2814,214,7569
"06037408402",2487,154,90,88,2283,248,2397,318,8065
"06037408501",1353,233,51,0,1462,67,2113,231,5510
"06037408503",2685,17,35,0,3422,290,2144,0,8593
"06037408504",2378,162,5,14,2312,268,2697,213,8049
"06037408505",1420,53,8,19,1336,40,1268,16,4160
"06037408623",952,9,43,0,2087,247,979,53,4370
"06037408624",1086,4,37,0,1994,240,1105,4,4470
"06037408625",1842,10,0,0,2366,77,1630,10,5935
"06037408626",899,21,0,4,3114,564,978,56,5636
"06037408627",721,86,18,25,2011,150,615,39,3665
"06037408628",1137,20,61,9,3526,663,958,30,6404
"06037408629",816,30,22,0,1646,235,461,89,3299
"06037408630",1444,291,0,0,935,31,1788,291,4780
"06037408631",2493,119,21,0,2348,430,2927,180,8518
"06037408703",935,37,0,0,5247,294,382,8,6903
"06037408704",599,44,26,120,1823,536,799,71,4018
"06037408705",1081,94,34,18,3972,326,1265,116,6906
"06037408706",451,10,4,0,1305,127,216,5,2118
"06037408722",1654,134,13,2,2422,387,1630,165,6407
"06037408723",630,119,0,0,1989,159,698,85,3680
"06037408724",1189,151,7,22,3476,689,2864,606,9004
"06037408800",1733,728,179,49,497,575,1592,948,6301
"06037430002",3494,519,562,42,1649,758,1978,744,9746
"06037430003",2364,219,204,0,1605,34,1125,93,5644
"06037430101",2561,329,174,291,1188,234,1910,276,6963
"06037430102",2139,526,238,2,1920,359,3136,760,9080
"06037430200",590,63,21,0,290,32,93,39,1128
"06037430301",3520,120,111,0,666,42,691,33,5183
"06037430302",4310,119,173,0,1223,123,1536,113,7597
"06037430400",1807,36,0,0,2537,190,533,10,5113
"06037430501",3229,157,48,15,774,13,651,12,4899
"06037430502",4842,402,126,0,1429,49,935,12,7795
"06037430600",1725,57,14,0,2217,272,743,35,5063
"06037430701",1865,62,233,0,2629,236,523,28,5576
"06037430721",1037,82,16,2,2131,136,399,22,3825
"06037430723",1065,104,216,0,2964,336,395,82,5162
"06037430724",965,251,135,1,3336,353,531,146,5718
"06037430801",1368,354,79,0,4721,391,896,205,8014
"06037430802",1099,34,0,0,2566,377,123,0,4199
"06037430803",1680,37,22,13,3143,337,635,173,6040
"06037430901",2107,89,447,77,1347,330,1820,179,6396
"06037430902",2147,243,321,44,1627,218,1382,221,6203
"06037431001",4307,693,165,245,1443,426,2686,935,10900
"06037431002",1783,246,151,39,1051,53,824,136,4283
"06037431100",3390,209,448,105,2461,344,3652,371,10980
"06037431200",2776,664,365,93,1846,228,3729,688,10389
"06037431300",1611,35,37,6,1010,64,762,23,3548
"06037431400",1080,54,7,0,2306,284,1238,131,5100
"06037431501",1320,247,244,0,1952,764,1234,393,6154
"06037431502",1666,231,14,0,2098,315,980,355,5659
"06037431600",1101,23,0,0,2596,203,222,12,4157
"06037431700",1881,32,0,0,4017,739,277,0,6946
"06037431800",1410,251,234,50,3058,690,1004,163,6860
"06037431900",816,110,7,0,2708,631,605,349,5226
"06037432000",2043,43,0,0,5523,124,1446,25,9204
"06037432101",1044,130,0,0,2889,269,867,163,5362
"06037432102",1357,149,6,0,3587,266,933,59,6357
"06037432201",904,42,30,0,2562,561,642,63,4804
"06037432202",732,229,0,0,2632,866,897,535,5891
"06037432300",1639,212,0,0,2184,270,2108,194,6607
"06037432401",1214,732,21,0,1699,221,1429,770,6086
"06037432402",2623,814,107,0,2567,801,3062,949,10923
"06037432500",3619,648,106,0,3363,689,3599,838,12862
"06037432601",2130,1174,4,14,2526,778,2468,1289,10383
"06037432602",1097,294,0,15,2958,207,1944,343,6858
"06037432700",2230,911,0,0,1615,523,2790,1398,9467
"06037432801",1193,289,5,0,1148,359,1519,354,4867
"06037432802",1523,823,17,17,2183,698,2265,1006,8532
"06037432901",687,64,0,6,3462,590,1056,135,6000
"06037432902",903,137,0,0,2237,270,1276,267,5090
"06037433101",852,193,0,4,1371,77,889,191,3577
"06037433102",1304,774,0,0,2020,692,1776,1129,7695
"06037433200",2875,933,23,0,2091,481,3392,1149,10944
"06037433302",496,384,0,0,667,312,837,649,3345
"06037433304",1275,553,23,0,2316,338,2183,667,7355
"06037433305",1835,1027,0,4,1698,611,2231,1587,8993
"06037433306",1057,522,0,0,1110,394,1200,626,4909
"06037433307",1405,558,30,0,997,192,1427,609,5218
"06037433401",1696,281,0,0,815,386,1861,430,5469
"06037433402",1002,1007,0,0,1838,410,1462,1098,6817
"06037433403",1775,1150,0,0,1048,606,2361,1616,8556
"06037433501",817,567,0,0,332,199,1073,719,3707
"06037433503",1616,312,0,0,727,213,1896,434,5198
"06037433504",2443,532,0,4,1138,484,2765,794,8160
"06037433601",752,353,0,0,3178,510,978,587,6358
"06037433602",218,80,0,0,1644,743,545,301,3531
"06037433700",2439,203,17,0,932,200,2780,327,6898
"06037433801",3194,1613,0,1,1090,475,3872,1979,12224
"06037433802",1682,275,28,14,1101,13,2175,85,5373
"06037433901",1991,1212,13,28,1591,859,2151,1699,9544
"06037433902",1923,528,0,14,1072,136,2390,562,6625
"06037434001",2878,772,16,0,1018,161,3288,900,9033
"06037434003",2727,683,0,5,765,266,2770,798,8014
"06037434004",1703,552,6,0,555,96,2056,648,5616
"06037460000",3187,368,129,0,1025,37,760,43,5549
"06037460100",4001,378,510,65,918,64,729,118,6783
"06037460200",2586,121,2048,147,827,15,759,53,6556
"06037460301",1968,161,1375,72,828,27,801,137,5369
"06037460302",1897,135,1087,612,656,55,1531,96,6069
"06037460401",346,6,276,32,207,81,155,29,1132
"06037460501",3730,33,0,0,1764,21,323,0,5871
"06037460502",2653,116,0,2,1740,2,488,1,5002
"06037460600",3151,0,0,0,1220,210,329,56,4966
"06037460700",3598,43,44,0,1284,76,333,9,5387
"06037460800",2408,98,131,11,496,21,254,0,3419
"06037460900",2473,472,1653,468,1275,403,2873,797,10414
"06037461000",2635,353,1662,139,1331,423,3210,674,10427
"06037461100",1960,471,1038,171,1043,286,1282,548,6799
"06037461200",3409,208,479,54,428,29,728,69,5404
"06037461300",4271,543,486,0,1421,176,884,135,7916
"06037461400",1929,152,370,16,447,135,646,109,3804
"06037461501",2380,256,557,153,622,214,1657,297,6136
"06037461502",2786,787,1106,413,1087,569,2957,1014,10719
"06037461600",2042,427,1068,429,1577,635,2422,1003,9603
"06037461700",954,64,181,4,261,5,316,5,1790
"06037461901",2186,737,620,119,1196,344,2617,876,8695
"06037461902",737,134,160,88,231,223,255,122,1950
"06037462001",1651,239,269,144,1026,564,2129,614,6636
"06037462002",1417,441,410,34,1497,375,2381,705,7260
"06037462100",2648,832,627,111,1057,360,2207,1041,8883
"06037462201",1648,533,198,168,627,356,937,391,4858
"06037462202",1269,359,261,0,608,410,100,30,3037
"06037462301",1893,619,290,141,1239,281,1778,488,6729
"06037462302",1019,181,169,59,1013,326,637,77,3481
"06037462400",3044,360,106,37,719,92,1366,155,5879
"06037462500",3864,641,183,0,1414,74,872,51,7099
"06037462600",1643,38,106,10,345,50,376,5,2573
"06037462700",2323,380,386,77,2163,95,2131,167,7722
"06037462800",1147,162,201,85,823,77,605,7,3107
"06037462900",2401,138,287,12,885,80,868,63,4734
"06037463000",1463,23,164,0,486,22,360,0,2518
"06037463101",1239,83,48,0,818,211,823,122,3344
"06037463102",1626,356,13,13,1563,77,929,281,4858
"06037463200",1800,277,236,7,951,104,785,135,4295
"06037463300",1345,43,139,0,464,9,313,4,2317
"06037463400",2683,242,353,29,2093,276,1045,71,6792
"06037463500",2621,255,275,47,1880,408,637,58,6181
"06037463601",2674,210,234,97,2601,140,924,16,6896
"06037463602",2349,578,232,4,1380,419,550,131,5643
"06037463700",1528,215,170,50,699,97,368,134,3261
"06037463800",2577,36,146,10,942,71,439,71,4292
"06037463900",2132,111,161,2,575,203,445,143,3772
"06037464000",3650,117,213,0,1699,449,929,0,7057
"06037464100",3330,144,0,35,3843,215,928,0,8495
"06037464200",1899,33,95,0,3446,313,188,24,5998
"06037480002",1130,79,64,0,2044,75,577,18,3987
"06037480011",1475,103,95,0,3123,754,1334,345,7229
"06037480012",1363,44,19,0,3428,300,795,20,5969
"06037480101",910,83,1,0,3019,379,866,77,5335
"06037480102",1010,97,0,1,2838,536,983,113,5578
"06037480201",1920,11,0,7,1871,69,1110,0,4988
"06037480202",1214,0,36,0,1316,60,824,0,3450
"06037480302",1456,134,341,60,2147,322,1145,107,5712
"06037480303",651,88,120,33,2390,755,1352,434,5823
"06037480304",554,113,59,11,2417,780,864,351,5149
"06037480400",1796,125,54,0,3007,458,1461,289,7190
"06037480500",2802,54,59,0,2075,197,749,42,5978
"06037480600",4449,283,194,0,2431,471,1274,436,9538
"06037480702",2159,111,54,23,2087,108,1066,55,5663
"06037480703",1786,160,70,0,1246,26,543,0,3831
"06037480704",1983,295,28,26,2367,271,874,206,6050
"06037480802",911,49,39,0,2034,370,1319,89,4811
"06037480803",1573,128,8,0,1943,217,1761,221,5851
"06037480804",1010,115,53,7,3311,674,1935,429,7534
"06037480901",1095,102,94,0,2993,594,1733,210,6821
"06037480902",553,226,35,0,2788,597,1392,320,5911
"06037480903",446,19,33,0,1670,787,834,107,3896
"06037481001",638,41,34,0,2536,528,1171,131,5079
"06037481002",868,80,11,9,4077,640,2325,274,8284
"06037481101",756,111,8,0,2584,365,1571,140,5535
"06037481102",524,26,21,0,2685,351,752,18,4377
"06037481103",658,46,16,0,3604,601,1703,156,6784
"06037481201",572,41,21,0,2780,316,538,56,4324
"06037481202",1117,112,19,0,3765,735,1740,378,7866
"06037481300",511,98,0,1,2292,428,784,116,4230
"06037481401",570,162,0,0,4399,1163,797,168,7259
"06037481402",1173,143,45,5,4967,907,1169,80,8489
"06037481500",818,71,0,0,2533,909,840,34,5205
"06037481603",485,121,91,27,2486,570,715,109,4604
"06037481604",906,17,85,0,2466,722,1117,51,5364
"06037481605",553,41,0,0,1984,461,692,85,3816
"06037481606",800,115,29,0,3054,999,1086,312,6395
"06037481711",155,0,0,0,3025,1083,228,0,4491
"06037481712",338,232,0,8,3272,1364,580,476,6270
"06037481713",81,0,0,0,2188,590,335,118,3312
"06037481714",145,44,52,0,1565,656,218,77,2757
"06037481800",760,25,12,0,1754,325,664,60,3600
"06037481901",1571,236,41,15,3537,233,2207,172,8012
"06037481902",840,19,0,0,2258,305,1728,111,5261
"06037482001",388,77,0,0,2104,160,253,0,2982
"06037482002",1064,46,0,0,4994,912,1966,567,9549
"06037482101",799,17,0,0,3318,738,1365,134,6371
"06037482102",626,35,68,0,1818,407,801,161,3916
"06037482201",307,63,0,0,2948,557,953,66,4894
"06037482202",634,73,28,0,3261,798,859,145,5798
"06037482301",866,273,0,0,3155,944,897,349,6484
"06037482303",855,303,0,0,4029,1014,1773,512,8486
"06037482304",403,406,0,0,2241,590,1410,527,5577
"06037482401",669,70,0,0,2922,456,1750,120,5987
"06037482402",1447,248,0,0,5100,425,2216,269,9705
"06037482502",297,133,0,0,1816,894,431,251,3822
"06037482503",484,253,0,15,2527,802,916,327,5324
"06037482521",1538,184,61,20,3154,555,2099,183,7794
"06037482522",1816,77,23,4,2344,382,1429,190,6265
"06037482600",1250,450,28,0,4709,170,1501,445,8553
"06037482701",1030,225,19,0,2962,587,2423,532,7778
"06037482702",702,114,0,0,1384,224,967,131,3522
"06037482800",826,207,14,0,2938,436,1909,391,6721
"06037500100",2649,70,30,5,893,11,835,13,4506
"06037500201",3800,87,0,0,1749,38,1990,38,7702
"06037500202",3193,29,37,0,1440,158,2213,128,7198
"06037500300",1827,234,7,6,1049,123,1737,209,5192
"06037500402",1770,432,30,13,1810,341,3399,776,8571
"06037500403",2415,427,67,0,1127,379,3112,671,8198
"06037500404",2044,199,114,0,2167,301,3574,476,8875
"06037500500",1297,195,51,0,1086,199,2097,347,5272
"06037500600",2025,611,33,0,2372,984,4141,1577,11743
"06037500700",3727,336,0,0,2108,222,5532,500,12425
"06037500800",2202,469,214,33,2443,259,4299,608,10527
"06037500900",2232,351,89,45,2555,639,4395,906,11212
"06037501001",1105,69,0,0,1723,248,2725,309,6179
"06037501002",2092,277,142,0,2334,46,3740,249,8880
"06037501200",2371,306,105,8,2292,266,3713,400,9461
"06037501300",3928,169,21,8,3263,239,5362,276,13266
"06037501400",1310,395,9,0,1832,349,2694,673,7262
"06037501501",1400,125,47,0,770,24,1078,36,3480
"06037501503",1814,407,229,10,1838,419,2627,769,8113
"06037501504",1387,303,0,35,1278,592,1989,675,6259
"06037501600",4085,146,45,10,2015,630,3158,701,10790
"06037501700",2846,320,32,2,448,69,1967,350,6034
"06037501802",1637,112,7,11,1666,99,2621,142,6295
"06037501803",1294,639,111,57,1550,1045,2562,1574,8832
"06037501804",784,312,15,0,730,170,1233,424,3668
"06037501900",2169,172,29,0,1731,91,2811,161,7164
"06037502003",1272,60,8,20,1232,294,2201,350,5437
"06037502004",1261,186,125,16,1747,577,2633,732,7277
"06037502005",2333,199,65,0,2018,339,3228,369,8551
"06037502100",2897,208,15,0,1808,210,3952,361,9451
"06037502200",3078,301,0,11,2651,306,4852,548,11747
"06037502301",2131,273,38,1,3583,190,5270,462,11948
"06037502302",832,406,27,10,1697,335,2437,664,6408
"06037502401",1983,476,65,0,2289,126,4040,602,9581
"06037502402",1395,195,0,5,1902,124,3037,295,6953
"06037502500",1880,251,37,6,1323,471,2941,722,7631
"06037502601",3661,315,2,0,3137,81,6362,335,13893
"06037502602",1907,58,0,0,2311,289,3726,293,8584
"06037502700",3509,443,89,14,2386,60,5206,402,12109
"06037502801",4351,609,237,3,1472,240,4549,769,12230
"06037502802",887,145,64,18,907,270,1226,273,3790
"06037502901",2563,123,116,0,2396,284,3749,200,9431
"06037502902",1563,658,14,12,1397,661,2570,1236,8111
"06037503000",2569,724,0,0,1973,547,4152,1244,11209
"06037503103",2518,341,29,0,2364,192,3999,491,9934
"06037503104",1087,239,92,0,847,267,1627,461,4620
"06037503105",1986,262,6,0,1569,343,2638,492,7296
"06037503106",1975,112,0,8,1222,73,2366,123,5879
"06037503201",2688,281,58,0,1116,7,2739,58,6947
"06037503202",2291,354,68,0,1719,454,2994,678,8558
"06037503301",1731,289,0,0,981,60,1727,139,4927
"06037503302",3172,311,25,8,2735,369,4323,560,11503
"06037503401",4218,294,37,8,2146,265,3419,275,10662
"06037503402",2907,148,39,0,1189,47,2447,87,6864
"06037503501",3682,662,57,6,1828,452,3904,852,11443
"06037503502",2439,233,0,0,1262,209,2379,257,6779
"06037503601",2689,79,123,0,1072,38,1802,59,5862
"06037503602",2274,232,107,2,1196,39,1378,94,5322
"06037503701",3615,220,15,0,1307,110,2822,141,8230
"06037503702",3309,377,2,3,1255,200,2296,473,7915
"06037503703",2855,134,265,0,4223,360,1622,22,9481
"06037503801",2332,281,26,0,1510,61,1796,157,6163
"06037503802",2489,212,129,15,1918,318,1851,337,7269
"06037503901",1471,63,62,0,1279,52,1285,57,4269
"06037503902",2494,101,72,0,1682,56,1990,55,6450
"06037504001",2030,313,38,0,1317,32,1353,64,5147
"06037504002",3234,74,146,0,1332,228,1999,79,7092
"06037504101",2187,245,121,27,2169,491,2936,532,8708
"06037504102",0,0,0,0,0,0,0,0,0
"06037530003",1933,75,7,37,1079,101,1819,85,5136
"06037530004",2300,534,0,0,1165,46,2221,522,6788
"06037530005",1610,201,36,0,2670,193,1336,181,6227
"06037530006",2371,339,23,0,1179,79,2154,376,6521
"06037530101",2378,719,72,2,1868,317,3729,799,9884
"06037530102",3264,626,11,15,988,231,3236,622,8993
"06037530202",2301,140,44,0,1829,191,3776,257,8538
"06037530203",1717,98,6,1,793,140,1952,238,4945
"06037530204",2165,720,31,0,898,133,2557,803,7307
"06037530301",1365,343,0,0,507,150,1758,479,4602
"06037530302",3388,811,0,20,2232,343,5330,1160,13284
"06037530400",1334,877,10,106,1458,192,2007,995,6979
"06037530500",1858,690,0,2,941,672,2680,1342,8185
"06037530601",1344,296,0,0,1547,565,2758,849,7359
"06037530602",450,47,0,0,722,138,1090,185,2632
"06037530700",711,139,0,0,1051,377,1699,516,4493
"06037530801",1122,774,0,0,2596,1063,3454,1778,10787
"06037530802",722,453,27,1,1846,352,2519,797,6717
"06037530901",1178,143,0,0,1717,831,2850,962,7681
"06037530902",797,346,9,0,1898,1145,2584,1404,8183
"06037531000",1787,478,0,0,2526,545,4251,945,10532
"06037531101",1316,364,34,0,1753,940,3008,1281,8696
"06037531102",878,269,0,0,1383,696,2191,953,6370
"06037531201",2028,580,69,0,1798,949,3826,1529,10779
"06037531202",1591,526,29,10,1648,436,3258,932,8430
"06037531301",1705,948,0,8,1721,1055,3407,1973,10817
"06037531302",2180,1404,54,0,2413,687,4574,2081,13393
"06037531502",1437,694,0,0,1164,81,2543,763,6682
"06037531503",1165,374,0,46,924,627,2083,1003,6222
"06037531504",1748,631,0,0,1173,857,2865,1488,8762
"06037531602",2276,1016,56,0,1178,459,3462,1435,9882
"06037531603",1624,460,0,14,983,264,2531,695,6571
"06037531604",1780,771,0,0,1100,338,2819,1109,7917
"06037531701",2707,997,31,0,1072,481,3704,1478,10470
"06037531702",2586,885,0,0,695,559,3202,1436,9363
"06037531800",2547,1138,0,0,1144,250,3650,1327,10056
"06037531901",4061,1331,47,0,1103,334,5039,1665,13580
"06037531902",2537,654,0,0,652,70,3099,671,7683
"06037532001",2059,440,198,28,395,97,2255,493,5965
"06037532002",1815,295,0,0,778,195,2341,410,5834
"06037532101",3634,995,0,0,1363,392,4701,1339,12424
"06037532102",2356,189,40,1,1044,75,2917,212,6834
"06037532200",3884,704,77,94,1462,192,4753,907,12073
"06037532302",2658,620,0,0,1018,211,3597,822,8926
"06037532303",2859,327,36,0,867,285,3365,587,8326
"06037532304",2545,706,136,161,778,203,3114,749,8392
"06037532400",15,0,0,0,25,1,27,1,69
"06037532500",1834,740,74,0,950,458,2728,952,7736
"06037532603",1496,446,13,21,882,447,2364,903,6572
"06037532604",1179,329,36,0,758,451,1945,771,5469
"06037532605",1857,884,45,0,750,476,2589,1299,7900
"06037532606",2431,1436,23,0,728,252,3079,1630,9579
"06037532700",1043,389,51,0,1060,406,2064,795,5808
"06037532800",1530,762,126,88,1191,684,2686,1444,8511
"06037532900",1991,1431,375,128,1914,1135,3922,2597,13493
"06037533001",941,388,63,14,1935,815,2849,1170,8175
"06037533002",1312,289,0,0,815,265,2094,541,5316
"06037533103",1082,760,0,0,1072,570,2094,1280,6858
"06037533104",1385,1067,9,9,1299,778,2598,1844,8989
"06037533105",1104,589,0,0,382,288,1462,860,4685
"06037533106",1093,434,6,0,83,72,1178,506,3372
"06037533107",1854,868,81,11,474,209,2316,1088,6901
"06037533201",1533,556,0,0,528,298,2026,807,5748
"06037533202",1389,518,0,0,629,52,1996,550,5134
"06037533203",919,315,0,0,489,96,1325,410,3554
"06037533300",1838,824,0,0,416,305,2175,1112,6670
"06037533401",3747,1074,9,0,439,42,4155,1116,10582
"06037533402",2410,1014,0,0,502,293,2912,1307,8438
"06037533403",1409,928,0,0,412,70,1783,977,5579
"06037533501",1724,751,0,0,458,369,2177,1105,6584
"06037533502",1263,284,0,0,474,98,1717,382,4218
"06037533503",1179,438,20,0,353,207,1540,638,4375
"06037533601",2790,1142,0,18,559,300,3228,1409,9446
"06037533602",2978,1121,9,0,1007,284,3732,1390,10521
"06037533603",3522,854,19,52,1522,694,4706,1468,12837
"06037533701",1979,1132,22,42,468,207,2366,1333,7549
"06037533702",1834,785,11,0,635,385,2456,1165,7271
"06037533703",2709,979,9,26,371,178,3037,1154,8463
"06037533803",3353,1510,74,0,1313,249,4274,1421,12194
"06037533804",2515,534,11,0,804,377,3007,889,8137
"06037533805",2031,758,0,0,741,272,2647,1019,7468
"06037533806",2274,1005,0,0,298,316,2505,1321,7719
"06037533901",3744,1222,13,0,720,509,4420,1731,12359
"06037533902",2299,794,0,6,795,245,2973,1040,8152
"06037534001",2885,1266,0,8,777,233,3515,1458,10142
"06037534002",2321,624,60,0,1210,52,3398,668,8333
"06037534101",1096,325,37,29,318,211,1329,515,3860
"06037534102",3238,1504,9,98,1155,562,4293,1983,12842
"06037534201",2397,1164,29,0,656,333,3034,1393,9006
"06037534202",2761,1740,0,26,1050,318,3661,1962,11518
"06037534203",2447,535,0,47,451,84,2796,645,7005
"06037534301",1451,1575,0,28,1085,474,2391,2000,9004
"06037534302",2089,881,0,0,588,400,2570,1281,7809
"06037534403",1786,419,31,44,599,109,2314,554,5856
"06037534404",1639,1009,20,10,548,184,1958,1186,6554
"06037534405",1928,789,19,4,1089,150,2978,938,7895
"06037534406",2936,1219,13,0,683,232,3523,1413,10019
"06037534501",2800,581,5,2,1107,228,3805,751,9279
"06037534502",2628,698,0,0,853,276,3459,974,8888
"06037534700",3499,399,9,0,681,204,4105,539,9436
"06037534802",1448,224,0,0,1162,256,2470,462,6022
"06037534803",1706,849,0,0,1358,389,2920,1207,8429
"06037534804",1968,598,5,0,1118,133,3046,727,7595
"06037534900",2114,751,18,13,2297,1100,4395,1837,12525
"06037535001",1071,355,206,160,1689,804,2760,1159,8204
"06037535002",1386,565,143,126,640,639,2013,1144,6656
"06037535101",1947,887,836,309,2283,1468,4087,2358,14175
"06037535102",1247,607,636,501,1076,788,2278,1337,8470
"06037535200",2171,634,560,296,1574,638,3740,1227,10840
"06037535300",2237,1177,151,74,1710,612,3911,1780,11652
"06037535400",1275,841,101,156,629,400,1844,1220,6466
"06037535501",1762,621,32,0,1154,467,2879,1084,7999
"06037535502",2084,408,0,25,1772,523,3766,915,9493
"06037535503",1180,304,0,0,512,430,1668,710,4804
"06037535603",1357,328,31,10,1181,334,2527,662,6430
"06037535604",1480,566,0,0,1797,531,3265,1097,8736
"06037535605",1650,408,50,19,1567,660,3189,1065,8608
"06037535606",559,187,9,0,755,396,1248,583,3737
"06037535607",2026,302,39,13,1759,454,3752,763,9108
"06037535701",3232,835,0,0,1796,338,4908,1173,12282
"06037535702",1675,802,81,0,1373,561,2828,1354,8674
"06037535802",3171,527,58,0,2519,509,5455,1019,13258
"06037535803",1855,580,0,0,1808,274,3573,854,8944
"06037535804",1794,760,44,18,2325,425,3941,1185,10492
"06037535901",2377,468,100,0,2200,508,4615,950,11218
"06037535902",3941,124,0,0,3667,240,7293,364,15629
"06037536000",1554,323,15,4,1519,498,3012,809,7734
"06037536102",1949,382,63,0,771,125,2337,384,6011
"06037536103",2751,422,14,0,1694,499,4318,921,10619
"06037536104",1863,729,63,74,1133,341,2805,1048,8056
"06037536200",3249,768,193,8,2529,856,4999,1545,14147
"06037540000",2521,722,144,194,3219,581,5657,1326,14364
"06037540101",3008,729,447,30,2272,307,5112,1013,12918
"06037540102",2923,562,454,111,2402,221,5222,766,12661
"06037540201",577,439,19,28,551,406,1102,843,3965
"06037540202",2667,1244,152,172,1578,1063,4157,2089,13122
"06037540203",2059,729,167,19,1637,929,3597,1628,10765
"06037540300",2299,586,0,30,1568,515,3784,1101,9883
"06037540400",1025,329,141,326,482,260,1525,579,4667
"06037540501",1535,310,381,12,2204,1072,3584,1378,10476
"06037540502",1927,914,554,211,2220,1004,4096,1772,12698
"06037540600",1046,340,1154,395,895,429,1874,662,6795
"06037540700",882,128,1104,251,519,289,1352,377,4902
"06037540800",751,168,3087,314,1148,226,1756,376,7826
"06037540901",1017,679,880,531,1109,235,2055,841,7347
"06037540902",1223,319,2368,552,428,141,1555,460,7046
"06037541001",181,53,406,87,219,66,305,103,1420
"06037541002",810,46,1323,79,508,87,612,84,3549
"06037541100",853,0,976,293,629,210,1389,160,4510
"06037541200",1109,664,3258,552,486,76,1463,725,8333
"06037541300",1801,475,1457,641,1174,367,2905,825,9645
"06037541400",1474,713,492,651,2645,1110,3905,1823,12813
"06037541500",2279,695,317,101,1254,833,3465,1497,10441
"06037541603",1010,510,302,190,581,653,1564,1213,6023
"06037541604",1711,929,598,585,1289,1136,2859,2093,11200
"06037541605",1685,598,1011,211,1688,435,3239,1018,9885
"06037541606",749,356,189,106,829,190,1469,541,4429
"06037541700",1983,474,833,117,1964,844,3910,1313,11438
"06037541801",1150,879,354,586,2104,443,3238,1322,10076
"06037541802",1579,500,618,83,2076,333,3640,844,9673
"06037542000",1275,729,1239,270,1590,569,2828,1154,9654
"06037542103",1324,633,369,197,1204,388,2530,1009,7654
"06037542104",1231,342,383,37,1216,284,2409,602,6504
"06037542105",1685,870,168,244,1188,521,2699,1381,8756
"06037542106",1186,389,261,145,922,534,2081,858,6376
"06037542200",1812,1038,1195,297,2279,431,4079,1430,12561
"06037542401",1442,510,1732,318,857,246,2147,766,8018
"06037542402",1156,188,982,60,723,194,1846,381,5530
"06037542501",922,289,1533,745,652,629,1437,782,6989
"06037542502",1044,377,938,724,642,578,1641,955,6899
"06037542601",849,453,192,153,933,477,1647,895,5599
"06037542602",1587,856,908,442,1574,251,3122,1056,9796
"06037542700",1822,912,1182,201,1189,390,2836,1290,9822
"06037542800",760,210,1372,246,528,44,1099,267,4526
"06037542900",826,263,581,153,834,192,1646,438,4933
"06037543000",821,161,2173,58,1149,83,1765,242,6452
"06037543100",1789,296,3105,297,904,423,2542,699,10055
"06037543201",892,331,1117,422,886,168,1665,476,5957
"06037543202",1614,508,672,218,1205,626,2522,1005,8370
"06037543304",443,74,3915,491,1092,134,775,97,7021
"06037543305",1037,431,771,9,812,87,848,338,4333
"06037543306",1953,119,885,41,3637,577,1960,14,9186
"06037543321",715,231,2987,217,1246,109,575,256,6336
"06037543322",440,41,4609,303,1657,39,662,43,7794
"06037543400",1813,97,673,66,1514,257,2160,208,6788
"06037543501",1552,460,269,64,3624,463,1911,386,8729
"06037543502",1633,61,74,33,1865,316,1746,181,5909
"06037543503",1399,19,542,67,2988,135,1432,19,6601
"06037543601",1371,83,193,0,2401,83,1630,88,5849
"06037543602",1720,360,684,12,4346,525,2222,566,10435
"06037543603",1521,124,996,36,1171,4,622,28,4502
"06037543604",1572,412,180,0,3604,160,2379,381,8688
"06037543701",947,47,4,0,1785,205,1253,149,4390
"06037543702",2422,325,245,17,3457,798,3264,651,11179
"06037543703",1587,36,142,2,1605,105,1934,75,5486
"06037543801",1469,331,84,10,3421,274,2324,326,8239
"06037543802",1031,339,766,75,4498,328,1747,456,9240
"06037543903",1270,151,106,47,2064,89,1544,134,5405
"06037543905",1504,563,405,307,1358,325,2311,820,7593
"06037544001",1850,450,159,0,1519,349,2365,656,7348
"06037544002",1704,63,119,0,1037,14,1819,3,4759
"06037550000",286,313,123,79,157,135,198,159,1450
"06037550100",4354,450,458,13,2468,198,5807,511,14259
"06037550201",1974,110,47,0,638,166,1928,208,5071
"06037550202",3465,718,204,11,1280,24,3441,660,9803
"06037550300",3551,716,35,0,3145,247,5087,613,13394
"06037550400",920,68,0,0,452,34,793,86,2353
"06037550500",6025,288,314,0,1651,23,5757,81,14139
"06037550601",3349,341,159,0,1564,401,3645,679,10138
"06037550602",3138,59,15,0,1472,57,3262,57,8060
"06037550700",5101,123,42,4,1353,104,4772,144,11643
"06037550800",3899,305,165,2,2585,189,4998,419,12562
"06037550901",2717,323,170,26,668,249,2632,447,7232
"06037550902",3469,527,159,7,1545,197,3888,543,10335
"06037551000",4424,283,79,0,2039,111,4158,309,11403
"06037551101",1478,552,206,138,1027,586,2133,947,7067
"06037551102",2117,891,364,57,1113,495,2748,1243,9028
"06037551201",2591,97,134,35,1012,9,2861,127,6866
"06037551202",4468,751,309,245,1332,287,4602,819,12813
"06037551300",3175,587,204,49,891,76,3303,495,8780
"06037551401",2980,492,93,37,737,414,2793,831,8377
"06037551402",2936,68,117,1,1302,141,3114,32,7711
"06037551501",2431,249,362,25,1640,194,3206,274,8381
"06037551502",2310,523,0,19,1224,77,2401,299,6853
"06037551600",0,0,0,0,0,0,0,0,0
"06037551700",3510,331,214,0,1913,351,4486,603,11408
"06037551800",3044,493,317,38,3571,256,4818,670,13207
"06037551900",2249,551,254,117,1933,157,2892,696,8849
"06037552001",1789,305,99,2,1586,121,2362,381,6645
"06037552002",1510,128,265,17,1454,495,2212,522,6603
"06037552100",2538,242,265,35,2691,349,3795,187,10102
"06037552200",1960,450,302,111,2475,760,3896,1183,11137
"06037552301",1888,536,298,20,1892,27,2489,552,7702
"06037552302",1137,139,325,56,1921,181,1616,244,5619
"06037552400",1499,63,46,0,889,109,2100,144,4850
"06037552601",3016,504,0,3,1752,190,4308,564,10337
"06037552602",1190,716,85,0,2234,442,1527,1029,7223
"06037552700",3702,512,123,23,2066,594,4223,873,12116
"06037552800",2938,672,113,0,1970,335,3687,781,10496
"06037552900",2816,438,140,240,2682,412,3510,604,10842
"06037553000",2696,87,340,0,1430,188,2796,198,7735
"06037553100",2990,307,712,97,2243,301,2626,464,9740
"06037553200",2674,448,430,126,3587,384,4198,655,12502
"06037553300",1217,146,86,4,1419,477,1760,544,5653
"06037553400",1816,196,95,14,1155,342,2508,307,6433
"06037553502",1905,379,418,39,851,414,2487,761,7254
"06037553503",1102,206,190,165,937,84,1720,279,4683
"06037553504",2791,944,207,162,1680,545,3956,1402,11687
"06037553601",1979,305,334,107,1601,392,3255,520,8493
"06037553602",1762,436,780,197,1613,434,2894,798,8914
"06037553701",1830,503,42,0,1140,413,2913,883,7724
"06037553702",1414,756,176,52,2095,524,3422,1270,9709
"06037553801",1590,454,498,117,857,648,2251,1152,7567
"06037553802",1858,819,608,329,1428,815,2610,1481,9948
"06037553901",3115,549,300,85,2478,407,4782,891,12607
"06037553902",1931,402,349,247,2067,693,3241,1077,10007
"06037554001",1368,105,160,33,1752,359,1838,426,6041
"06037554002",1375,370,492,12,3002,627,2891,636,9405
"06037554101",1483,618,34,4,1347,739,2017,1269,7511
"06037554103",635,16,148,25,675,107,731,99,2436
"06037554104",958,207,506,131,520,331,819,512,3984
"06037554105",875,526,860,475,1257,251,1687,433,6364
"06037554201",1509,184,437,43,1556,214,1843,379,6165
"06037554203",1533,456,404,28,1189,139,1361,504,5614
"06037554204",1173,395,728,47,1520,358,1893,466,6580
"06037554301",1366,135,150,131,1522,416,2395,384,6499
"06037554302",464,188,1323,95,1271,425,1022,533,5321
"06037554403",1003,348,1144,262,2186,927,1942,938,8750
"06037554404",798,234,769,119,1564,588,1316,519,5907
"06037554405",713,217,865,91,988,208,1152,206,4440
"06037554406",1997,151,476,19,1799,185,1263,123,6013
"06037554511",722,54,275,0,2885,86,254,11,4287
"06037554512",1137,26,276,18,4431,101,358,3,6350
"06037554513",354,2,168,31,1896,89,184,0,2724
"06037554514",1407,12,474,160,2606,171,914,15,5759
"06037554515",1044,17,216,133,2467,86,468,0,4431
"06037554516",763,47,416,0,2389,95,530,21,4261
"06037554517",658,44,65,2,3314,250,315,43,4691
"06037554518",1065,43,283,0,3903,152,681,18,6145
"06037554519",626,81,191,7,2469,132,350,0,3856
"06037554521",1981,139,655,5,3162,128,986,29,7085
"06037554522",1253,150,338,27,3321,68,901,123,6181
"06037554600",1762,678,103,191,1770,100,1516,665,6785
"06037554700",2325,511,154,0,1742,315,3251,688,8986
"06037554801",1604,219,78,3,1187,233,2220,411,5955
"06037554802",1959,91,30,114,3066,487,1444,186,7377
"06037554900",2307,137,50,16,4021,719,1596,151,8997
"06037555001",1503,886,470,4,2257,297,1755,877,8049
"06037555002",1463,234,280,45,895,182,1097,231,4427
"06037555102",1566,344,496,78,3286,1117,2405,1002,10294
"06037555103",1332,51,256,61,2550,255,1452,56,6013
"06037555104",1591,298,255,0,1601,252,1379,431,5807
"06037555202",2489,135,116,2,499,74,859,2,4176
"06037555211",2319,1005,66,0,1416,740,3376,1615,10537
"06037555212",1646,1009,132,25,1414,509,2177,1365,8277
"06037570001",2338,158,131,60,1644,89,1100,74,5594
"06037570002",1395,197,167,22,1329,4,1309,48,4471
"06037570003",2191,294,433,0,1728,114,1328,94,6182
"06037570100",914,185,688,223,737,328,609,234,3918
"06037570202",1623,404,655,145,2502,839,3113,852,10133
"06037570203",771,196,613,402,1751,136,2148,290,6307
"06037570204",952,202,601,85,1201,662,1521,629,5853
"06037570301",2332,977,514,116,2975,973,4013,1453,13353
"06037570303",811,205,434,262,1812,645,1874,644,6687
"06037570304",943,587,708,416,1815,569,2130,1043,8211
"06037570402",692,133,1171,127,971,274,1222,376,4966
"06037570403",806,674,820,50,2275,838,2903,1390,9756
"06037570404",894,220,647,210,1145,231,1798,395,5540
"06037570501",2849,374,727,164,2703,120,3560,391,10888
"06037570502",2116,520,380,64,2931,466,3379,513,10369
"06037570601",1575,307,820,370,1998,580,2572,625,8847
"06037570602",1632,562,534,264,3157,777,2723,935,10584
"06037570603",742,220,1361,974,1159,578,1372,469,6875
"06037570701",2007,100,1082,45,2758,232,1560,210,7994
"06037570702",1272,81,175,34,758,52,823,67,3262
"06037570800",3434,182,174,0,1950,14,2068,11,7833
"06037570901",3898,114,215,23,1558,94,1560,43,7505
"06037570902",2416,41,190,8,978,92,1158,16,4899
"06037571000",4173,187,203,14,1091,61,1482,78,7289
"06037571101",2975,88,146,7,1244,280,1046,280,6066
"06037571102",2450,97,0,0,1445,60,820,34,4906
"06037571200",4665,164,760,0,2497,93,2499,50,10728
"06037571300",2699,195,287,8,1253,19,1109,12,5582
"06037571400",2919,96,492,32,1152,46,1655,56,6448
"06037571502",1255,114,749,221,1997,127,1122,114,5699
"06037571503",1094,131,887,38,1572,478,876,572,5648
"06037571504",1362,108,796,171,2167,113,1450,155,6322
"06037571600",203,123,258,828,153,389,242,401,2597
"06037571701",1329,239,655,568,3027,449,3043,728,10038
"06037571703",635,333,775,81,1533,398,1562,605,5922
"06037571704",814,285,326,467,1224,628,1197,479,5420
"06037571800",1836,43,224,29,960,20,551,0,3663
"06037571900",2758,458,964,27,1566,38,1582,215,7608
"06037572001",3116,167,269,0,1815,41,1620,116,7144
"06037572002",1931,172,1221,152,1679,92,883,19,6149
"06037572100",455,0,138,5,453,26,372,19,1468
"06037572201",1890,196,1057,47,3418,116,2314,165,9203
"06037572202",963,148,414,106,1785,92,1048,113,4669
"06037572301",1364,345,247,89,1515,263,1862,462,6147
"06037572302",959,323,273,21,1817,316,1237,374,5320
"06037572400",271,10,197,88,490,162,276,0,1494
"06037572500",389,281,467,448,996,416,245,259,3501
"06037572600",1648,157,489,112,3071,140,2169,196,7982
"06037572700",1332,302,473,253,2871,417,1451,470,7569
"06037572800",85,142,129,260,247,157,82,51,1153
"06037572900",1729,1237,526,167,1571,250,2248,1338,9066
"06037573002",1154,1338,236,175,599,240,1362,1458,6562
"06037573003",824,187,261,35,358,351,555,384,2955
"06037573004",1353,881,514,422,1003,298,1420,978,6869
"06037573100",2377,503,1746,80,2372,457,3126,801,11462
"06037573201",1630,821,772,197,1196,318,2154,839,7927
"06037573202",2475,608,466,317,1889,881,2852,1092,10580
"06037573300",619,435,275,89,1775,1129,1269,560,6151
"06037573401",567,164,104,24,564,15,390,129,1957
"06037573402",2648,294,719,271,1761,879,1677,746,8995
"06037573403",1712,297,226,35,1022,62,595,211,4160
"06037573601",4462,237,355,14,955,60,1261,97,7441
"06037573700",3633,106,215,16,867,90,1144,39,6110
"06037573800",3117,267,91,8,837,56,836,66,5278
"06037573902",1459,24,238,0,403,18,262,14,2418
"06037574000",4239,172,93,2,1038,30,1220,66,6860
"06037574100",3910,266,87,0,993,2,1005,14,6277
"06037574201",2175,98,33,9,715,19,753,36,3838
"06037574202",1316,154,61,33,247,28,454,52,2345
"06037574300",4113,342,132,185,1311,16,943,1,7043
"06037574400",4272,151,101,0,754,30,1052,19,6379
"06037574500",4458,489,123,4,963,103,808,0,6948
"06037574601",0,0,0,0,0,0,0,0,0
"06037574602",926,25,53,5,257,11,262,11,1550
"06037574700",0,0,0,0,0,0,0,0,0
"06037574800",1935,219,211,14,523,14,284,0,3200
"06037574901",2921,245,0,0,542,46,553,115,4422
"06037574902",1944,935,383,125,657,516,746,273,5579
"06037575001",2172,252,269,69,780,141,788,80,4551
"06037575002",2813,308,133,47,870,235,1159,153,5718
"06037575101",1667,801,366,38,818,602,1632,761,6685
"06037575102",1421,912,83,175,1002,646,1514,839,6592
"06037575103",2192,781,824,289,575,335,1342,673,7011
"06037575201",1223,403,556,231,1631,488,1552,663,6747
"06037575202",1706,970,81,187,1449,604,2002,1143,8142
"06037575300",1338,664,432,289,1785,664,2198,886,8256
"06037575401",1803,1280,237,178,1003,591,2509,1649,9250
"06037575402",1936,1039,263,67,566,309,2120,1286,7586
"06037575500",12,0,0,0,25,0,33,0,70
"06037575801",909,580,135,39,170,427,911,891,4062
"06037575802",1691,1362,277,66,1198,681,2215,1650,9140
"06037575803",965,676,246,106,462,398,1032,767,4652
"06037575901",1046,556,478,309,509,467,879,854,5098
"06037575902",1743,938,766,264,599,389,841,702,6242
"06037576001",2501,389,517,178,1648,90,706,185,6214
"06037576200",1966,1170,354,454,1101,504,1800,1100,8449
"06037576301",1736,628,484,392,887,509,1613,840,7089
"06037576302",1130,695,516,86,1592,387,1756,965,7127
"06037576401",912,1043,415,130,1137,1111,1313,1864,7925
"06037576402",1450,848,270,125,1714,405,2262,961,8035
"06037576403",1829,939,651,275,1145,739,2023,1115,8716
"06037576501",1488,264,351,236,525,274,1212,324,4674
"06037576502",1764,535,672,464,745,527,1285,703,6695
"06037576503",1805,635,526,55,691,302,988,725,5727
"06037576601",2717,280,664,94,608,101,1065,129,5658
"06037576602",2291,635,483,60,721,39,809,183,5221
"06037576700",2742,318,305,0,541,61,741,59,4767
"06037576801",1827,871,282,220,957,63,1090,718,6028
"06037576802",2285,236,238,147,631,193,776,238,4744
"06037576901",2003,1759,242,307,1622,702,2805,1900,11340
"06037576903",1617,686,619,205,1025,317,1756,668,6893
"06037576904",1799,295,259,334,406,38,1139,118,4388
"06037577000",4292,708,340,135,1347,246,2121,393,9582
"06037577100",5245,416,353,40,974,120,1565,171,8884
"06037577200",3912,373,304,0,665,25,1104,44,6427
"06037577300",4321,521,86,22,460,95,823,45,6373
"06037577400",2371,192,20,1,330,59,413,81,3467
"06037577501",2796,221,18,0,374,125,255,37,3826
"06037577504",1175,76,47,0,137,12,184,0,1631
"06037577602",2479,224,42,64,565,49,277,39,3739
"06037577603",6198,594,146,70,814,251,777,224,9074
"06037577604",1075,70,55,0,97,17,222,13,1549
"06037599000",2556,393,0,0,471,136,2060,447,6063
"06037599100",249,9,0,0,34,10,112,0,414
"06037600100",1137,869,1819,1163,850,1212,1953,1840,10843
"06037600201",1051,498,936,566,975,413,2026,873,7338
"06037600202",682,345,2069,1541,1299,687,1973,975,9571
"06037600302",318,181,1283,619,343,95,495,255,3589
"06037600303",314,254,1155,742,984,587,1291,826,6153
"06037600304",655,349,763,897,551,280,1238,506,5239
"06037600400",552,53,2537,664,168,0,588,24,4586
"06037600501",206,68,1842,176,358,117,393,156,3316
"06037600502",446,15,972,46,645,97,963,97,3281
"06037600601",77,39,2025,289,223,23,159,0,2835
"06037600602",400,282,623,202,363,560,751,749,3930
"06037600702",475,219,3136,350,365,138,424,280,5387
"06037600703",47,15,1582,99,142,5,23,0,1913
"06037600704",179,8,2419,403,284,28,311,37,3669
"06037600801",585,27,2441,101,121,81,601,81,4038
"06037600802",85,0,1761,305,278,54,292,30,2805
"06037600902",857,688,2442,677,1256,395,1758,1113,9186
"06037600911",1479,208,726,47,558,405,1856,560,5839
"06037600912",2092,672,1061,10,1195,523,2993,1164,9710
"06037601001",281,215,1039,212,139,18,251,210,2365
"06037601002",588,159,2149,800,1239,423,1741,579,7678
"06037601100",1157,662,1336,464,1628,676,2456,1121,9500
"06037601202",1560,860,144,12,1137,202,2492,1062,7469
"06037601211",575,47,1163,240,696,296,1170,334,4521
"06037601212",1619,284,1495,268,1852,899,3293,1134,10844
"06037601301",410,54,1197,51,222,30,348,11,2323
"06037601302",1120,235,4482,680,698,388,1053,585,9241
"06037601303",934,288,1915,720,771,198,1191,326,6343
"06037601401",1509,373,1328,221,1263,448,2402,646,8190
"06037601402",1961,421,219,44,1925,439,3666,789,9464
"06037601501",1161,480,124,322,1439,434,2448,851,7259
"06037601502",1457,379,27,119,1356,775,2573,1135,7821
"06037601600",1152,609,30,8,1630,718,2701,1262,8110
"06037601700",1225,582,128,221,1979,1434,3032,1909,10510
"06037601801",1233,773,111,4,955,582,2190,1355,7203
"06037601802",1196,628,398,26,1305,522,2840,1120,8035
"06037601900",1380,485,610,310,1472,969,2726,1411,9363
"06037602002",1384,274,156,40,879,332,1885,532,5482
"06037602003",1632,912,469,82,1253,648,2813,1542,9351
"06037602004",1208,138,608,205,1097,854,2213,1050,7373
"06037602103",1719,447,631,150,2558,757,3744,956,10962
"06037602104",1890,333,1024,594,1466,586,2790,815,9498
"06037602105",1615,669,668,231,1106,168,2359,707,7523
"06037602106",2217,193,640,358,1958,174,3301,211,9052
"06037602200",3799,863,874,213,2000,607,3242,1100,12698
"06037602301",3604,305,154,18,2077,201,3073,286,9718
"06037602302",2779,80,92,0,856,12,638,43,4500
"06037602402",2834,698,730,64,1680,369,2967,851,10193
"06037602403",1884,524,705,251,1879,251,2673,633,8800
"06037602404",2156,581,1119,248,1795,230,2939,665,9733
"06037602504",892,313,1059,323,1280,263,1368,448,5946
"06037602505",486,544,924,376,1043,748,1171,1092,6384
"06037602506",914,187,1347,624,1063,241,1608,282,6266
"06037602507",477,412,1409,575,936,238,777,575,5399
"06037602508",2146,424,1504,589,1981,302,2679,536,10161
"06037602509",1461,196,302,270,1499,309,2252,315,6604
"06037602600",613,63,4677,518,2043,401,1558,348,10221
"06037602700",328,35,2267,217,503,412,528,354,4644
"06037602801",537,173,670,422,1304,723,1674,659,6162
"06037602802",475,41,1949,183,689,483,1019,523,5362
"06037602900",1008,153,484,24,2059,458,2532,570,7288
"06037603001",886,75,1656,409,2783,1061,1898,1080,9848
"06037603004",91,35,325,16,776,174,236,165,1818
"06037603005",692,181,1649,244,1983,881,1633,851,8114
"06037603006",301,105,333,17,1030,285,284,209,2564
"06037603101",1094,290,887,61,1301,415,977,216,5241
"06037603102",674,182,332,202,1999,349,1086,431,5255
"06037603200",489,33,618,0,1897,175,884,71,4167
"06037603301",388,24,88,29,2614,243,667,56,4109
"06037603302",1279,74,162,43,2284,617,1736,457,6652
"06037603400",1089,362,594,54,2276,111,1403,393,6282
"06037603500",962,50,272,58,1529,152,1232,115,4370
"06037603600",1815,58,271,0,1833,196,1357,85,5615
"06037603702",2263,321,212,0,1941,325,1425,330,6817
"06037603703",1462,49,100,0,1046,8,1318,19,4002
"06037603704",1035,219,1277,507,2409,1016,2675,990,10128
"06037603801",1217,429,658,142,1965,373,2289,631,7704
"06037603802",1731,464,82,193,1455,183,2368,540,7016
"06037603900",3550,439,483,99,2236,557,3995,807,12166
"06037604001",2441,557,239,23,1324,330,2945,620,8479
"06037604002",2005,333,486,1,1621,194,2376,357,7373
"06037604100",3006,897,277,56,2490,645,3683,1239,12293
"06037609900",1309,190,84,12,285,76,1129,175,3260
"06037620001",3206,201,72,17,533,51,741,40,4861
"06037620002",2610,153,81,0,448,13,565,79,3949
"06037620101",3691,562,44,0,1240,78,1163,35,6813
"06037620102",2993,46,8,9,731,94,555,38,4474
"06037620201",1110,121,45,11,153,6,176,0,1622
"06037620301",3946,52,20,0,929,76,775,44,5842
"06037620303",3680,85,41,0,542,24,237,3,4612
"06037620305",4881,240,0,0,596,0,482,0,6199
"06037620400",3811,133,15,0,1148,91,349,107,5654
"06037620501",4186,75,499,1,1451,36,1026,1,7275
"06037620521",2315,284,154,0,1091,8,887,44,4783
"06037620522",2908,165,256,0,1293,78,697,13,5410
"06037620601",3381,267,235,0,1403,282,1065,206,6839
"06037620602",3916,148,18,0,1377,0,1268,26,6753
"06037620701",4918,164,101,16,1537,0,1175,0,7911
"06037620702",4805,114,31,0,1833,67,795,39,7684
"06037620800",5675,242,122,0,2290,22,801,27,9179
"06037620901",2202,136,29,2,409,14,187,67,3046
"06037620904",2282,149,0,0,176,12,49,0,2668
"06037621001",3810,48,20,0,639,24,482,0,5023
"06037621002",798,53,31,0,111,6,28,0,1027
"06037621004",3827,318,0,0,339,15,249,19,4767
"06037621102",2563,182,82,0,228,53,246,47,3401
"06037621104",5570,67,134,0,791,17,572,35,7186
"06037621201",4703,83,156,21,1117,101,1192,31,7404
"06037621204",1921,167,31,8,892,51,662,19,3751
"06037621301",5332,260,223,4,1432,57,1026,12,8346
"06037621324",2972,235,275,4,487,40,482,29,4524
"06037621326",2327,99,27,0,570,16,313,30,3382
"06037621400",3420,245,11,0,736,98,495,55,5060
"06037650001",1716,344,82,0,3493,408,985,182,7210
"06037650003",1191,70,84,39,1371,348,840,95,4038
"06037650004",1069,216,450,57,1722,314,386,78,4292
"06037650101",1360,191,176,8,4137,109,675,51,6707
"06037650102",1103,63,18,0,965,87,417,38,2691
"06037650200",3064,116,44,22,2802,100,1658,60,7866
"06037650300",2802,252,397,11,3154,134,1858,49,8657
"06037650401",2147,260,14,0,2156,39,564,84,5264
"06037650501",1905,122,12,2,983,79,418,18,3539
"06037650502",2334,231,171,0,1490,156,427,165,4974
"06037650602",2674,181,128,0,3738,637,749,25,8132
"06037650603",1764,175,38,0,1767,124,467,6,4341
"06037650604",2044,371,572,0,2406,470,1147,16,7026
"06037650605",1131,214,120,4,1325,143,192,23,3152
"06037650701",1415,91,5,8,903,29,248,8,2707
"06037650702",3094,17,31,0,1470,67,509,52,5240
"06037650800",1559,42,51,45,4986,171,365,0,7219
"06037650901",4003,162,111,0,1714,112,1830,81,8013
"06037650902",2707,87,145,0,2895,319,1748,160,8061
"06037651001",2991,415,191,0,2288,261,1724,398,8268
"06037651002",2304,40,109,18,2319,100,1056,27,5973
"06037651101",2460,193,20,0,2467,107,742,30,6019
"06037651102",1904,90,122,0,1597,224,603,83,4623
"06037651201",3494,67,10,0,1086,33,307,14,5011
"06037651221",1086,299,82,11,1632,81,277,25,3493
"06037651222",2957,97,64,32,2895,170,1018,0,7233
"06037651302",4755,139,150,2,1362,0,510,0,6918
"06037651304",3559,248,82,0,537,26,273,57,4782
"06037651401",1580,131,45,0,640,117,156,10,2679
"06037651402",3120,122,77,0,3057,63,484,0,6923
"06037670001",1961,237,15,12,1072,153,1169,200,4819
"06037670002",2330,396,27,27,1159,126,1250,160,5475
"06037670003",3019,299,17,51,1863,345,1642,235,7471
"06037670100",3051,637,252,58,2195,575,1239,650,8657
"06037670201",2512,37,54,0,1125,71,356,0,4155
"06037670202",1715,109,52,20,777,37,353,30,3093
"06037670324",3996,187,118,3,891,30,197,19,5441
"06037670326",2169,49,51,2,1204,13,209,5,3702
"06037670328",3477,85,33,1,1191,114,246,1,5148
"06037670403",1416,85,23,2,1057,80,143,14,2820
"06037670405",1544,19,254,0,1076,107,154,19,3173
"06037670406",912,29,16,0,869,54,62,0,1942
"06037670407",2962,81,198,0,2322,431,453,0,6447
"06037670411",2712,122,67,0,1442,55,178,17,4593
"06037670413",2383,135,66,10,2182,126,423,19,5344
"06037670416",2126,125,293,2,1502,89,126,28,4291
"06037670500",1314,29,6,7,461,0,89,3,1909
"06037670602",4643,208,340,17,2111,91,366,1,7777
"06037670701",4357,80,126,45,2411,48,1661,48,8776
"06037670702",4090,97,0,25,1170,0,783,12,6177
"06037700101",3612,927,90,99,704,254,437,378,6501
"06037700102",1883,818,220,24,676,65,569,74,4329
"06037700200",4879,826,0,82,839,159,535,227,7547
"06037700300",4287,477,272,0,582,61,526,0,6205
"06037700400",3878,454,221,18,634,117,512,157,5991
"06037700501",2491,312,201,68,811,48,759,0,4690
"06037700502",2707,539,193,2,731,58,439,84,4753
"06037700600",4263,267,39,0,420,9,404,11,5413
"06037700700",2948,107,37,1,485,0,152,2,3732
"06037700801",4267,781,102,0,879,165,316,74,6584
"06037700802",2575,163,0,18,522,140,138,85,3641
"06037700901",2636,423,94,0,609,9,208,0,3979
"06037700902",5119,388,214,0,1193,239,507,59,7719
"06037701000",4238,321,70,0,853,69,283,56,5890
"06037701100",183,167,120,236,33,79,33,105,956
"06037701201",3279,256,19,0,414,26,151,48,4193
"06037701202",2616,193,143,8,271,31,372,23,3657
"06037701302",3733,372,53,2,549,59,374,58,5200
"06037701304",4987,368,79,24,788,54,373,27,6700
"06037701402",4369,633,359,11,569,159,276,105,6481
"06037701501",3732,302,74,14,638,82,343,50,5235
"06037701502",2591,253,39,2,642,114,495,63,4199
"06037701601",3618,82,19,10,872,55,349,26,5031
"06037701602",2896,482,150,0,675,58,598,160,5019
"06037701701",2700,181,103,2,528,64,779,28,4385
"06037701702",2135,322,62,48,468,165,748,253,4201
"06037701801",3309,601,539,73,1182,255,1810,436,8205
"06037701802",2148,504,377,201,824,238,900,261,5453
"06037701902",2703,522,317,181,425,65,403,109,4725
"06037702002",4151,679,453,0,567,151,771,245,7017
"06037702102",4641,529,242,18,708,13,582,149,6882
"06037702201",3575,509,52,15,707,110,906,45,5919
"06037702202",3118,207,23,0,471,121,601,73,4614
"06037702300",4899,550,144,106,1119,271,865,77,8031
"06037702400",2822,168,205,28,846,86,1112,114,5381
"06037702501",2941,259,203,80,941,0,675,26,5125
"06037702502",2530,177,630,38,820,61,388,49,4693
"06037702600",3275,163,713,13,1582,139,990,81,6956
"06037702700",2731,29,37,34,944,22,776,8,4581
"06037702801",3532,715,113,14,1133,117,1529,446,7599
"06037702802",1292,150,65,12,793,52,972,90,3426
"06037702803",1646,308,115,11,861,166,927,321,4355
"06037702901",6162,1049,361,0,1557,154,878,0,10161
"06037703001",2632,179,991,136,1613,334,559,13,6457
"06037703002",1007,31,5282,591,805,31,253,32,8032
"06037703100",411,178,3976,275,606,8,276,162,5892
"06037703200",548,112,4360,375,573,47,510,0,6525
"06037800101",4755,68,31,0,786,0,129,14,5783
"06037800102",5937,334,131,0,331,141,507,76,7457
"06037800202",4272,685,312,0,810,35,279,117,6510
"06037800203",4327,284,0,0,567,197,434,25,5834
"06037800204",3451,363,93,4,826,17,323,0,5077
"06037800324",4808,199,312,1,967,35,375,17,6714
"06037800325",2832,276,2,11,310,3,222,24,3680
"06037800326",4013,316,55,24,676,1,518,28,5631
"06037800327",4034,359,32,9,774,384,1029,437,7058
"06037800328",2085,176,47,26,530,24,255,0,3143
"06037800329",5455,312,52,45,797,55,726,0,7442
"06037800330",912,97,1,10,49,2,133,33,1237
"06037800331",639,3,20,0,159,25,55,20,921
"06037800332",5697,97,27,0,717,21,416,21,6996
"06037800406",1986,169,0,0,160,35,163,49,2562
"06037800408",5722,637,95,28,652,86,635,47,7902
"06037800410",1376,46,23,16,236,15,211,8,1931
"06037800504",1893,182,39,20,101,39,77,13,2364
"06037800506",2663,117,17,14,355,106,82,63,3417
"06037900102",265,229,15,17,32,133,116,239,1046
"06037900103",3032,1438,187,299,765,161,2054,1272,9208
"06037900104",1998,752,667,155,1786,852,2386,1098,9694
"06037900201",627,348,5,0,66,12,234,122,1414
"06037900300",2033,245,608,28,421,138,1437,180,5090
"06037900501",2891,725,1312,516,661,264,2132,798,9299
"06037900504",3708,302,961,279,888,124,2678,380,9320
"06037900505",1863,545,503,547,419,157,1427,447,5908
"06037900506",1815,780,935,818,387,87,1358,570,6750
"06037900507",3627,1355,1364,540,773,134,2657,685,11135
"06037900508",1965,532,395,300,248,47,1334,391,5212
"06037900602",2860,1326,250,289,678,261,2386,1189,9239
"06037900605",4001,1927,801,287,774,113,2557,932,11392
"06037900606",1190,712,1105,617,208,318,734,843,5727
"06037900607",1266,466,309,1150,94,340,788,443,4856
"06037900608",1785,328,493,522,284,121,1401,324,5258
"06037900609",2652,821,325,940,672,153,2348,618,8529
"06037900701",1991,864,371,385,514,141,1010,569,5845
"06037900703",1549,631,279,309,437,435,643,698,4981
"06037900704",1045,516,618,196,273,192,661,215,3716
"06037900705",2797,439,230,141,396,42,849,167,5061
"06037900803",4449,1413,1118,412,1680,433,2801,1230,13536
"06037900804",1337,553,413,430,412,51,1292,490,4978
"06037900805",2397,233,272,378,604,98,1242,132,5356
"06037900806",1560,728,963,641,180,261,836,493,5662
"06037900900",2486,359,164,163,407,24,559,30,4192
"06037901003",0,0,0,0,0,0,0,0,0
"06037901004",7458,560,1767,554,1859,208,3349,328,16083
"06037901007",1731,196,59,0,50,32,668,70,2806
"06037901008",1614,181,329,53,694,63,874,125,3933
"06037901009",3545,690,1156,46,294,35,1261,264,7291
"06037901010",2825,1121,787,454,558,237,1470,643,8095
"06037901011",3153,349,390,315,733,84,1023,91,6138
"06037901101",3317,634,347,122,407,147,1215,231,6420
"06037901102",3572,762,421,74,443,162,1169,712,7315
"06037901205",7120,678,1340,394,1855,79,2211,151,13828
"06037901209",899,159,66,1,61,1,205,2,1394
"06037901210",1322,129,0,0,99,4,220,0,1774
"06037901213",2968,99,227,0,335,23,493,10,4155
"06037910001",2391,531,464,51,2107,297,3518,529,9888
"06037910002",2810,681,453,42,2310,833,3338,1281,11748
"06037910101",293,188,215,0,606,379,662,495,2838
"06037910201",1568,261,393,89,811,511,1226,541,5400
"06037910202",3684,243,465,17,1018,64,1313,79,6883
"06037910205",652,166,0,0,446,98,310,184,1856
"06037910206",1444,243,526,20,1142,83,1261,75,4794
"06037910207",2445,305,473,66,2224,419,2177,81,8190
"06037910208",2763,559,583,21,2393,171,3155,377,10022
"06037910209",2450,59,338,100,1289,49,814,78,5177
"06037910210",3849,84,1131,120,1910,18,1912,33,9057
"06037910301",2873,383,59,106,774,19,917,174,5305
"06037910302",4231,178,189,0,1105,0,1153,29,6885
"06037910401",3588,339,664,59,2038,60,2677,58,9483
"06037910402",457,475,290,281,1100,971,1317,1199,6090
"06037910403",165,101,80,0,553,1522,573,1524,4518
"06037910404",1327,469,349,74,1177,287,1808,691,6182
"06037910501",582,682,496,1140,729,2087,646,2418,8780
"06037910502",869,497,421,312,1255,381,1650,567,5952
"06037910504",793,633,217,201,1867,1037,2279,1417,8444
"06037910505",1037,192,134,113,1198,362,1442,513,4991
"06037910601",1705,1114,739,170,2255,1144,3106,1640,11873
"06037910602",1023,575,281,651,1000,436,1435,831,6232
"06037910603",2171,526,347,222,2273,1167,3430,1474,11610
"06037910605",1543,344,545,137,1475,705,2081,959,7789
"06037910606",1066,256,389,96,1232,316,1769,499,5623
"06037910705",4608,390,1950,212,4511,929,7037,1153,20790
"06037910706",1638,211,550,233,3138,365,4049,521,10705
"06037910707",1836,300,482,253,1252,371,2165,544,7203
"06037910709",850,5,204,0,458,168,512,154,2351
"06037910711",3029,471,583,342,3180,1392,5057,1300,15354
"06037910712",982,173,283,338,687,103,1141,253,3960
"06037910713",1821,199,768,138,2258,862,3408,963,10417
"06037910714",1314,219,314,46,1828,390,2660,587,7358
"06037910715",2496,205,553,568,2379,192,3860,358,10611
"06037910716",2126,223,484,290,2083,457,2458,649,8770
"06037910804",2222,218,42,13,331,53,507,31,3417
"06037910805",3474,215,77,21,694,210,889,46,5626
"06037910807",4262,244,342,37,1189,134,1885,153,8246
"06037910808",2798,10,50,0,586,34,715,1,4194
"06037910809",1714,50,30,0,232,169,242,125,2562
"06037910810",2001,145,103,8,591,30,568,88,3534
"06037910811",129,14,0,0,0,0,0,0,143
"06037910812",373,57,0,0,39,6,80,6,561
"06037910813",2902,248,0,0,593,26,706,8,4483
"06037911001",2583,305,98,1,722,370,951,370,5400
"06037920011",138,44,0,0,9,0,30,4,225
"06037920012",769,67,0,0,139,13,53,25,1066
"06037920013",3412,111,119,22,1183,54,1403,36,6340
"06037920015",4528,183,151,1,1337,24,1276,129,7629
"06037920016",3744,212,135,0,1052,10,903,0,6056
"06037920017",3733,110,4,20,794,137,1805,67,6670
"06037920018",1749,98,42,34,405,13,535,14,2890
"06037920020",5269,410,102,6,1279,75,1747,117,9005
"06037920023",1948,205,1,9,734,111,1689,163,4860
"06037920026",288,40,0,0,30,17,37,11,423
"06037920028",4427,241,332,69,1259,40,1780,89,8237
"06037920029",2320,137,85,29,839,17,1176,14,4617
"06037920030",3271,486,334,40,1723,197,1740,378,8169
"06037920031",3800,153,204,50,985,87,881,4,6164
"06037920032",2077,63,45,0,875,30,570,29,3689
"06037920033",463,93,9,7,140,26,257,47,1042
"06037920034",1955,649,142,17,872,105,914,244,4898
"06037920035",5704,710,0,0,1539,135,3605,589,12282
"06037920036",2270,284,48,9,492,241,1495,396,5235
"06037920037",3152,1654,457,17,1841,584,3310,1867,12882
"06037920038",2002,751,329,15,1330,113,2007,543,7090
"06037920039",1541,46,57,0,415,10,598,40,2707
"06037920040",1681,172,258,0,1188,209,550,206,4264
"06037920041",1481,288,323,54,871,53,911,240,4221
"06037920042",4138,588,503,54,1579,127,1778,424,9191
"06037920043",3477,68,193,0,2486,9,1522,37,7792
"06037920044",1911,59,22,4,893,5,633,19,3546
"06037920045",3444,309,159,0,1020,0,1122,18,6072
"06037920102",3392,812,233,28,835,196,1339,564,7399
"06037920104",2223,247,22,0,461,5,464,123,3545
"06037920106",1884,462,153,0,673,99,1624,377,5272
"06037920107",2528,49,584,32,1468,55,573,10,5299
"06037920108",2626,57,121,0,1601,29,599,0,5033
"06037920109",3555,121,339,0,1476,26,952,10,6479
"06037920110",2582,115,7,0,787,43,451,9,3994
"06037920111",2285,59,218,14,538,76,698,4,3892
"06037920112",3294,151,125,12,356,40,603,41,4622
"06037920114",4036,377,480,30,1845,46,1360,38,8212
"06037920115",3028,88,59,10,792,13,845,8,4843
"06037920116",3590,91,317,0,1088,0,979,0,6065
"06037920118",4337,154,59,0,1664,54,1872,58,8198
"06037920119",1479,51,23,0,451,38,443,11,2496
"06037920200",0,0,0,0,0,0,0,0,0
"06037920303",735,88,43,35,418,88,244,94,1745
"06037920312",3786,228,81,106,1128,92,1449,171,7041
"06037920313",3934,600,41,9,876,111,1454,436,7461
"06037920314",2177,40,3,0,698,21,699,26,3664
"06037920322",2346,20,203,11,356,40,650,0,3626
"06037920326",3868,286,270,23,2090,92,882,103,7614
"06037920328",1343,220,10,0,476,40,192,7,2288
"06037920329",3926,151,40,41,1539,85,1284,38,7104
"06037920330",3915,291,0,0,1530,33,1312,136,7217
"06037920331",3355,157,84,0,489,86,787,18,4976
"06037920332",1348,87,20,0,295,6,433,46,2235
"06037920334",4115,456,32,4,840,305,1065,219,7036
"06037920336",3360,895,119,16,1576,382,3785,1036,11169
"06037920337",2909,1791,441,24,1939,445,3213,2146,12908
"06037920338",4456,261,150,87,1305,126,899,191,7475
"06037920339",4777,231,203,0,1988,0,1000,0,8199
"06037930101",114,0,0,0,43,0,43,0,200
"06037930200",325,63,21,5,13,14,107,10,558
"06037930301",445,69,0,3,90,16,32,16,671
"06037980001",0,0,0,0,0,0,0,0,0
"06037980002",0,0,0,0,0,0,0,0,0
"06037980003",0,0,0,0,0,0,0,0,0
"06037980004",0,0,0,0,0,11,0,11,22
"06037980005",0,0,0,0,0,0,0,0,0
"06037980006",0,0,0,0,0,0,0,0,0
"06037980007",0,0,0,0,0,0,0,0,0
"06037980008",34,44,0,0,38,8,38,32,194
"06037980009",0,0,0,0,0,0,0,0,0
"06037980010",39,16,0,2,18,64,19,40,198
"06037980013",0,0,0,0,0,0,0,0,0
"06037980014",38,32,0,0,0,0,0,0,70
"06037980015",82,11,92,36,62,17,19,9,328
"06037980018",0,0,0,0,0,0,0,0,0
"06037980019",183,0,8,0,23,0,40,0,254
"06037980020",0,0,0,0,0,0,0,0,0
"06037980021",0,0,0,0,0,0,0,0,0
"06037980022",0,0,0,0,0,0,0,0,0
"06037980023",0,0,0,0,10,0,10,0,20
"06037980024",123,4,12,0,107,0,14,0,260
"06037980025",0,0,0,0,0,0,0,0,0
"06037980026",4,0,4,0,8,0,4,0,20
"06037980028",0,0,0,0,0,0,0,0,0
"06037980030",0,0,0,0,0,0,0,0,0
"06037980031",0,0,51,0,0,0,0,0,51
"06037980033",0,0,0,0,0,0,0,0,0
"06037990100",0,0,0,0,0,0,0,0,0
"06037990200",0,0,0,0,0,0,0,0,0
"06037990300",0,0,0,0,0,0,0,0,0
"06039000102",2623,546,22,0,622,131,404,54,4402
"06039000103",3574,1236,0,0,134,0,145,466,5555
"06039000104",3268,371,0,0,316,93,152,1,4201
"06039000106",4239,606,15,0,195,23,569,110,5757
"06039000108",4733,1205,75,0,277,10,93,65,6458
"06039000109",1609,107,10,4,265,23,290,16,2324
"06039000201",964,479,50,48,52,153,690,407,2843
"06039000202",3858,862,78,13,790,108,1878,579,8166
"06039000300",4221,2575,108,265,996,233,1913,1995,12306
"06039000400",993,257,0,0,155,5,682,252,2344
"06039000502",6834,2515,81,95,1821,396,6830,2677,21249
"06039000503",5633,743,225,0,1992,68,4439,485,13585
"06039000506",4530,978,149,117,734,23,3657,952,11140
"06039000507",7845,1601,281,473,1043,379,5993,1651,19266
"06039000508",4223,1712,28,0,944,200,3155,1332,11594
"06039000509",4582,756,130,0,452,10,1434,327,7691
"06039000602",2990,1462,0,28,391,161,3132,1517,9681
"06039000603",2646,1975,118,10,585,44,2805,1933,10116
"06039000604",3000,2068,11,61,349,327,3074,2379,11269
"06039000700",8209,931,617,77,1632,231,5670,1053,18420
"06039000800",3890,1879,17,35,241,679,3370,2273,12384
"06039000900",4421,2658,163,21,1014,988,4905,3303,17473
"06039001000",3889,746,0,19,357,149,2063,820,8043
"06041101100",2454,47,0,0,113,11,38,0,2663
"06041101200",2163,298,0,0,581,14,811,59,3926
"06041102100",1826,94,11,3,271,40,154,36,2435
"06041102202",4844,357,72,0,1187,55,1553,227,8295
"06041102203",3264,203,134,28,1250,480,1497,280,7136
"06041103100",6544,338,0,87,654,16,454,24,8117
"06041103200",4511,269,110,11,1382,60,978,86,7407
"06041104101",6090,1018,189,0,1049,107,1027,484,9964
"06041104102",3502,196,102,0,1322,173,1260,176,6731
"06041104200",4062,302,33,30,1020,48,979,48,6522
"06041104300",1339,57,23,0,196,14,94,0,1723
"06041105000",4418,227,244,9,956,424,921,429,7628
"06041106001",2421,230,213,18,796,62,342,9,4091
"06041106002",3714,392,25,64,1644,286,1162,449,7736
"06041107000",5209,224,10,19,699,177,337,171,6846
"06041108100",5663,150,38,0,833,120,495,144,7443
"06041108200",4612,244,106,10,1470,252,884,151,7729
"06041109001",2449,309,62,0,896,218,768,308,5010
"06041109002",3488,389,16,0,158,17,165,17,4250
"06041110100",4027,215,239,16,780,39,578,48,5942
"06041110200",4455,148,14,0,591,0,294,43,5545
"06041111000",4019,402,292,55,979,259,1183,241,7430
"06041112100",3027,411,53,0,1108,517,1299,593,7008
"06041112201",1124,786,220,336,3350,1476,4157,2146,13595
"06041112202",1631,265,43,0,2273,418,2380,571,7581
"06041113000",3303,127,97,12,160,8,183,0,3890
"06041114100",4597,322,26,0,203,41,174,12,5375
"06041114200",2675,163,7,0,269,37,203,36,3390
"06041115000",6151,137,61,0,801,12,477,12,7651
"06041116000",2624,167,0,4,183,124,76,0,3178
"06041117000",4045,163,20,12,373,53,155,53,4874
"06041118100",1998,117,0,0,179,0,142,0,2436
"06041119100",4428,253,8,0,290,11,149,0,5139
"06041119201",2509,105,84,7,600,18,381,23,3727
"06041119202",3063,147,56,10,184,22,155,0,3637
"06041120000",5328,134,70,0,647,17,341,0,6537
"06041121100",4087,228,24,0,850,0,692,0,5881
"06041121200",4461,94,93,0,520,342,140,71,5721
"06041122000",0,0,0,0,0,0,0,0,0
"06041123000",1747,52,0,0,180,18,62,0,2059
"06041124100",4472,215,33,0,594,142,430,20,5906
"06041124200",5300,265,33,44,350,0,381,50,6423
"06041125000",3026,277,47,0,661,222,150,17,4400
"06041126100",5170,151,0,0,574,15,201,0,6111
"06041126200",3553,252,16,19,452,44,557,41,4934
"06041127000",4200,48,0,0,377,12,438,0,5075
"06041128100",5214,184,135,0,860,121,295,0,6809
"06041128200",3833,149,143,0,418,12,196,0,4751
"06041129000",668,148,470,325,478,540,306,507,3442
"06041130201",3275,160,17,3,161,3,254,22,3895
"06041130202",3288,298,122,0,366,9,317,0,4400
"06041131100",884,31,21,0,83,5,0,0,1024
"06041132100",1447,232,108,0,105,9,43,33,1977
"06041132200",1267,154,0,10,128,38,170,45,1812
"06041133000",2082,295,10,2,479,33,499,53,3453
"06041990100",0,0,0,0,0,0,0,0,0
"06043000101",2460,509,24,0,267,337,155,410,4162
"06043000102",1962,450,15,0,119,0,78,60,2684
"06043000200",2603,275,11,0,194,0,387,26,3496
"06043000301",2778,450,0,0,584,11,249,1,4073
"06043000302",2146,181,9,0,80,88,120,88,2712
"06043000400",1446,228,63,24,197,98,115,87,2258
"06045010100",1025,382,6,0,625,365,202,183,2788
"06045010200",2173,595,0,3,340,321,291,108,3831
"06045010300",3136,553,0,0,223,113,374,120,4519
"06045010400",2026,508,8,29,311,339,626,392,4239
"06045010500",3184,667,4,0,410,93,1339,198,5895
"06045010600",5006,814,0,0,330,45,609,0,6804
"06045010700",3680,1653,4,0,799,245,666,534,7581
"06045010801",4824,539,51,4,877,350,1134,314,8093
"06045010802",1675,398,0,4,49,18,399,134,2677
"06045010900",3382,457,19,2,821,256,1401,298,6636
"06045011001",1304,199,0,2,101,22,81,23,1732
"06045011002",4273,599,0,0,417,126,426,130,5971
"06045011102",2585,315,41,1,408,133,511,138,4132
"06045011200",1932,453,33,0,60,76,597,367,3518
"06045011300",3166,1349,51,17,862,555,1097,1088,8185
"06045011400",3269,228,7,0,458,191,326,21,4500
"06045011500",3581,1892,18,46,850,109,1132,823,8451
"06045011600",3499,1074,12,27,800,570,1831,924,8737
"06045011700",3143,335,35,13,877,46,1064,12,5525
"06045011800",1379,212,0,0,316,184,342,89,2522
"06045990100",0,0,0,0,0,0,0,0,0
"06047000201",1735,411,35,3,847,385,1402,687,5505
"06047000202",944,179,0,0,570,148,1016,200,3057
"06047000203",4090,677,264,0,2968,792,5709,1045,15545
"06047000301",1207,472,65,22,2695,520,2689,815,8485
"06047000303",1268,257,26,0,367,83,708,245,2954
"06047000304",2655,958,9,0,4865,1181,5293,1697,16658
"06047000401",1133,293,0,0,200,167,550,226,2569
"06047000402",6361,569,15,0,979,50,1591,141,9706
"06047000503",1182,289,0,0,330,163,557,217,2738
"06047000504",2004,819,25,0,2954,951,4031,1298,12082
"06047000505",2577,473,278,0,2534,827,3033,810,10532
"06047000601",2290,619,156,28,1258,711,2050,967,8079
"06047000602",1765,795,98,61,577,628,1026,802,5752
"06047000603",2656,1392,236,18,1219,935,1789,1636,9881
"06047000701",1312,638,57,18,680,434,1229,798,5166
"06047000702",3269,105,28,0,1462,198,1442,190,6694
"06047000801",2683,650,355,27,1476,131,2428,318,8068
"06047000802",1903,426,137,1,1428,241,1408,470,6014
"06047000901",1978,501,5,37,710,161,1139,487,5018
"06047000902",3532,1436,223,0,3143,1407,3302,1431,14474
"06047001002",7070,1735,529,364,4130,946,3695,1321,19790
"06047001003",919,433,157,142,1817,676,1779,560,6483
"06047001004",1842,647,184,94,614,368,1072,558,5379
"06047001005",676,245,177,128,630,310,746,332,3244
"06047001101",2823,1080,16,58,1321,351,1385,597,7631
"06047001200",2974,361,215,61,1070,567,1595,555,7398
"06047001301",1420,568,81,82,344,334,969,634,4432
"06047001302",1098,802,28,34,311,442,425,751,3891
"06047001401",1730,886,65,50,1025,612,1415,586,6369
"06047001402",2344,348,214,173,1156,775,1608,634,7252
"06047001501",941,502,65,0,854,578,966,782,4688
"06047001502",588,628,144,4,984,445,1414,768,4975
"06047001503",924,601,66,234,1447,1366,1655,1631,7924
"06047001601",292,714,155,90,804,1470,1044,1969,6538
"06047001602",2111,1043,247,248,2747,1458,3527,1550,12931
"06047001700",2262,946,57,125,1546,1532,2086,1655,10209
"06047001801",2164,54,17,0,471,142,516,56,3420
"06047001901",2489,1149,66,0,1191,546,3283,1581,10305
"06047001902",1290,531,0,6,422,205,1183,655,4292
"06047002000",5425,1942,6,28,654,79,3503,1171,12808
"06047002100",2228,806,52,24,497,219,1572,635,6033
"06047002201",2802,1837,21,21,377,488,2145,2120,9811
"06047002202",5876,1721,118,0,1625,506,5595,1934,17375
"06047002301",4473,786,46,0,1093,206,2659,626,9889
"06047002302",7937,2775,250,351,2729,891,7556,3347,25836
"06047002401",1019,310,10,5,102,0,495,214,2155
"06047002402",4477,1871,208,155,1152,483,4319,2004,14669
"06047002500",1256,228,29,2,442,144,410,154,2665
"06047002600",3010,597,150,0,1357,366,1655,757,7892
"06049000100",2459,714,0,0,174,83,232,159,3821
"06049000200",1411,181,0,0,27,28,195,28,1870
"06049000300",2045,442,0,0,258,42,307,262,3356
"06049000400",775,88,0,7,94,88,42,13,1107
"06051000101",2545,179,0,3,252,48,338,5,3370
"06051000102",2030,145,25,0,721,3,465,72,3461
"06051000200",6779,140,0,35,1000,131,2860,112,11057
"06053000101",1567,118,16,2,404,53,1351,98,3609
"06053000102",5693,459,215,17,3369,215,6420,550,16938
"06053000103",1412,383,191,28,1528,100,1863,440,5945
"06053000104",2274,311,99,0,1194,29,2441,291,6639
"06053000200",3850,904,105,8,2334,415,4979,1182,13777
"06053000300",2607,264,32,0,1507,150,2831,292,7683
"06053000400",3497,1420,83,5,1841,856,3745,1829,13276
"06053000501",2042,1210,0,0,619,569,2545,1759,8744
"06053000502",2524,499,0,0,927,175,2999,641,7765
"06053000600",3943,1400,0,0,1290,437,4912,1724,13706
"06053000701",2941,1782,10,0,715,545,3458,2306,11757
"06053000702",2803,1490,0,0,1529,323,4285,1805,12235
"06053000800",2822,946,0,11,1041,391,3810,1324,10345
"06053000900",2911,1805,0,0,577,101,3307,1843,10544
"06053001200",2195,355,36,0,389,139,871,266,4251
"06053001300",894,1016,97,0,482,238,1169,1177,5073
"06053001400",1786,321,78,8,341,34,808,296,3672
"06053001500",4460,285,0,0,709,264,2083,342,8143
"06053001600",2025,192,64,0,413,20,846,138,3698
"06053001700",2301,579,52,29,719,29,2106,245,6060
"06053001801",1868,580,107,37,1184,208,1737,531,6252
"06053001802",2347,820,6,31,1406,314,2575,980,8479
"06053010101",2469,1079,12,8,1025,350,3180,1315,9438
"06053010102",3034,183,0,0,629,12,1714,162,5734
"06053010202",3099,450,7,0,1186,186,2291,473,7692
"06053010305",3288,82,27,0,1033,109,1426,138,6103
"06053010306",1023,179,0,0,150,56,561,67,2036
"06053010400",3418,1102,40,3,1561,583,4520,1612,12839
"06053010501",4025,846,20,0,920,94,2005,623,8533
"06053010504",2841,740,22,45,1081,303,2770,563,8365
"06053010505",3242,675,115,0,1584,101,3633,722,10072
"06053010506",3175,984,31,0,550,364,3029,1182,9315
"06053010603",3639,0,54,303,2354,359,3293,147,10149
"06053010604",3428,621,30,27,1813,82,4341,648,10990
"06053010605",2685,765,28,0,1050,173,3265,934,8900
"06053010606",4802,670,68,1,1581,144,4962,670,12898
"06053010607",2517,1070,0,0,720,205,3046,1271,8829
"06053010608",1735,333,10,0,475,27,1998,344,4922
"06053010701",4853,113,118,0,720,63,937,14,6818
"06053010702",3307,110,0,0,297,9,358,9,4090
"06053010804",3708,1557,18,0,305,62,3743,1597,10990
"06053010900",15,0,0,0,39,0,23,0,77
"06053011000",5051,478,33,0,559,0,740,299,7160
"06053011101",2987,1214,6,13,590,276,3141,1450,9677
"06053011102",6646,1668,126,6,2734,228,7764,1890,21062
"06053011202",4076,1332,7,1,1303,501,4694,1793,13707
"06053011203",4051,1530,63,0,1054,139,4612,1480,12929
"06053011204",1974,692,37,0,691,159,2214,801,6568
"06053011302",3184,1516,0,0,433,178,3114,1629,10054
"06053011303",2601,688,56,0,866,258,2076,828,7373
"06053011304",4384,1041,0,44,1305,242,5096,1306,13418
"06053011400",2497,600,11,1,209,101,712,395,4526
"06053011502",1159,160,16,21,60,39,332,23,1810
"06053011602",5395,189,19,0,237,57,349,7,6253
"06053011604",1624,88,0,0,71,0,38,0,1821
"06053011700",3299,272,8,67,340,38,273,6,4303
"06053011801",1523,169,0,1,352,1,119,16,2181
"06053011802",1448,138,0,0,182,0,252,27,2047
"06053011900",3402,311,19,11,385,69,379,4,4580
"06053012000",2741,323,30,33,581,62,395,34,4199
"06053012100",1817,69,8,0,258,6,311,9,2478
"06053012200",2267,116,14,0,203,0,163,21,2784
"06053012302",1551,135,34,0,108,17,237,27,2109
"06053012401",1467,94,15,54,176,0,202,11,2019
"06053012402",2599,236,38,0,362,24,405,20,3684
"06053012502",3416,325,58,59,726,47,716,42,5389
"06053012600",123,0,0,0,38,4,41,0,206
"06053012700",2552,341,294,15,394,158,377,45,4176
"06053012800",4300,215,0,0,642,38,506,59,5760
"06053013000",2404,237,253,0,503,95,519,22,4033
"06053013100",1387,61,51,0,315,34,230,0,2078
"06053013200",3318,168,0,0,487,0,315,41,4329
"06053013300",3537,552,150,9,1685,128,1577,265,7903
"06053013400",1274,62,11,4,270,52,227,37,1937
"06053013500",1681,978,490,142,1155,370,608,1074,6498
"06053013600",1858,502,77,45,1538,192,1826,648,6686
"06053013700",1720,927,149,307,1548,349,2100,1079,8179
"06053013800",2476,375,611,171,1992,247,2077,218,8167
"06053013900",1256,277,191,23,958,170,1042,255,4172
"06053014000",1500,302,65,4,721,96,1210,252,4150
"06053014102",704,430,290,13,423,232,440,191,2723
"06053014104",0,0,0,0,0,0,0,0,0
"06053014105",1619,481,207,20,363,192,478,179,3539
"06053014107",4583,280,325,87,1779,388,1397,169,9008
"06053014201",2611,320,185,79,2275,402,1817,320,8009
"06053014202",1219,402,379,64,1690,325,739,231,5049
"06053014301",2020,59,283,10,992,22,771,33,4190
"06053014302",1687,311,240,20,1780,339,1246,52,5675
"06053014500",3003,550,23,0,701,76,1764,532,6649
"06053014601",2897,801,0,0,1578,76,3593,782,9727
"06053014700",4542,713,120,0,1440,115,3525,680,11135
"06053014800",4453,675,4,0,951,19,4581,650,11333
"06053980000",0,0,0,0,0,39,0,39,78
"06053990000",0,0,0,0,0,0,0,0,0
"06055200201",2651,163,0,7,394,0,1372,0,4587
"06055200202",1962,356,73,0,461,114,1270,216,4452
"06055200203",1755,113,23,11,292,10,805,39,3048
"06055200301",3247,565,61,0,900,196,2278,485,7732
"06055200302",1746,201,76,0,698,15,940,107,3783
"06055200400",3084,247,6,1,540,19,879,22,4798
"06055200501",3588,176,52,0,1187,200,2505,250,7958
"06055200503",1084,104,31,0,209,116,608,163,2315
"06055200504",4578,256,31,1,1263,163,2805,286,9383
"06055200505",1984,136,0,5,478,185,1128,180,4096
"06055200601",3581,212,0,0,1118,206,1628,252,6997
"06055200602",3258,135,26,0,693,35,1059,40,5246
"06055200703",2540,59,0,1,115,0,229,9,2953
"06055200704",3411,347,0,8,1148,259,2221,256,7650
"06055200705",1994,538,0,0,544,123,1021,545,4765
"06055200706",2436,311,0,0,584,39,662,107,4139
"06055200707",2571,78,36,0,414,11,711,15,3836
"06055200802",3621,190,20,4,1162,123,1209,25,6354
"06055200803",1643,163,10,2,194,109,394,215,2730
"06055200804",3004,577,33,31,1991,299,3476,496,9907
"06055200900",22,279,0,62,22,28,23,25,461
"06055201003",1150,431,223,9,2835,241,769,285,5943
"06055201004",2017,326,411,207,3243,244,1612,138,8198
"06055201005",1049,103,25,0,877,110,462,139,2765
"06055201006",1418,387,220,39,1073,95,825,119,4176
"06055201007",2038,89,435,22,1578,226,1165,183,5736
"06055201101",1830,12,16,0,322,9,236,0,2425
"06055201102",1703,168,0,0,48,0,117,20,2056
"06055201200",3763,435,0,0,573,118,1395,219,6503
"06055201300",2088,160,47,11,138,5,233,12,2694
"06055201401",2829,150,0,0,78,171,169,43,3440
"06055201402",2365,226,2,0,454,7,249,107,3410
"06055201403",658,11,0,0,120,0,203,0,992
"06055201500",1631,155,0,0,274,48,495,109,2712
"06055201601",1464,354,0,0,588,16,861,132,3415
"06055201602",2825,219,50,0,223,75,525,141,4058
"06055201700",3267,334,180,38,725,91,823,66,5524
"06055201800",1512,91,0,0,171,18,423,2,2217
"06055201900",881,110,3,11,268,8,307,0,1588
"06055202000",3716,728,59,0,584,123,1717,566,7493
"06057000102",5994,168,0,0,321,0,245,0,6728
"06057000103",6659,542,0,0,225,0,560,0,7986
"06057000104",2697,270,0,0,176,0,65,40,3248
"06057000105",2103,261,0,3,106,112,210,112,2907
"06057000200",2306,245,0,0,177,4,132,0,2864
"06057000300",1946,192,9,0,46,28,100,40,2361
"06057000401",4959,456,40,0,600,5,612,43,6715
"06057000402",5135,1401,116,0,723,71,425,309,8180
"06057000501",3866,1305,0,0,515,25,482,101,6294
"06057000502",3541,887,0,0,292,266,435,209,5630
"06057000600",4233,1898,0,3,161,97,242,300,6934
"06057000701",6159,512,7,4,359,153,204,35,7433
"06057000702",3452,267,43,0,223,45,115,0,4145
"06057000801",4255,516,0,0,152,33,158,72,5186
"06057000802",5228,615,24,2,402,2,642,4,6919
"06057000900",2563,710,26,80,312,131,62,25,3909
"06057001203",2607,370,0,0,172,0,157,28,3334
"06057001204",1871,271,0,0,33,10,211,10,2406
"06057001205",4782,187,0,0,104,0,178,0,5251
"06057001206",4786,219,76,1,793,0,2125,47,8047
"06059001101",2990,321,29,0,1111,174,1866,406,6897
"06059001102",1700,46,31,0,938,287,1172,285,4459
"06059001103",1866,717,125,0,1255,160,1965,601,6689
"06059001201",2930,751,10,19,1330,369,3198,931,9538
"06059001202",1825,207,17,0,1383,417,2660,578,7087
"06059001301",3739,531,47,0,2385,97,2735,427,9961
"06059001303",3407,354,32,7,1717,218,3160,304,9199
"06059001304",1686,266,0,0,1638,242,2449,431,6712
"06059001401",2789,376,119,22,1755,425,3032,535,9053
"06059001402",4126,589,23,2,1025,143,3156,438,9502
"06059001403",2607,50,33,0,365,102,1150,102,4409
"06059001404",1963,202,52,0,1827,122,3192,285,7643
"06059001501",4189,343,29,0,1836,39,1219,122,7777
"06059001503",3655,692,27,0,968,211,1090,628,7271
"06059001504",3547,138,74,0,1047,16,1743,67,6632
"06059001505",3906,423,149,87,2429,82,1302,304,8682
"06059001506",2770,241,8,0,1016,180,1068,97,5380
"06059001507",3235,135,14,0,1102,50,1129,21,5686
"06059001601",3714,559,74,0,3406,0,1076,359,9188
"06059001602",2896,97,111,0,1467,42,496,1,5110
"06059001704",1912,120,65,1,4827,702,525,41,8193
"06059001705",2205,554,97,0,1460,297,1589,685,6887
"06059001706",2368,196,26,0,965,47,465,18,4085
"06059001707",1773,10,305,0,5045,446,1079,0,8658
"06059001708",1837,65,37,1,1359,175,658,37,4169
"06059001801",1763,906,96,142,1256,919,1791,1470,8343
"06059001802",2085,1328,444,113,2622,1576,2887,2398,13453
"06059001901",1938,96,35,0,974,0,1553,35,4631
"06059001902",1507,275,58,29,1021,93,1306,174,4463
"06059001903",1763,144,19,0,1345,219,1659,296,5445
"06059011000",3829,232,66,0,1698,233,1673,116,7847
"06059011101",1964,273,1,0,1546,696,1953,886,7319
"06059011102",2619,441,142,0,1195,133,2064,391,6985
"06059011200",2341,233,19,26,1004,255,1202,220,5300
"06059011300",3113,445,74,18,894,154,1060,128,5886
"06059011401",1544,59,10,0,265,22,276,43,2219
"06059011402",1900,87,16,0,372,14,455,6,2850
"06059011403",3389,755,33,0,1183,913,2249,1055,9577
"06059011502",2161,464,30,22,834,219,1382,460,5572
"06059011503",1054,74,39,0,401,30,169,25,1792
"06059011504",1900,945,17,18,1111,777,847,575,6190
"06059011601",2591,1093,274,212,2437,1062,3424,2006,13099
"06059011602",2804,1057,65,0,1279,108,3197,992,9502
"06059011707",3386,399,119,0,2186,171,1049,166,7476
"06059011708",2067,612,134,41,808,350,758,249,5019
"06059011709",3428,55,54,0,694,73,969,25,5298
"06059011710",2820,73,10,0,720,31,742,1,4397
"06059011711",4230,1026,115,104,1893,778,2186,1091,11423
"06059011712",2776,312,141,6,1391,121,1878,172,6797
"06059011714",724,57,4,0,189,27,548,33,1582
"06059011715",4675,324,127,21,1210,84,1618,83,8142
"06059011716",2437,382,7,0,2501,200,1060,337,6924
"06059011717",2312,177,58,3,596,0,722,110,3978
"06059011718",2458,106,0,2,627,31,664,2,3890
"06059011720",4024,2188,66,35,580,91,4185,2056,13225
"06059011721",3055,1013,43,0,910,206,2832,1050,9109
"06059011722",1778,252,72,0,507,12,849,118,3588
"06059021802",5398,687,0,0,966,75,1432,326,8884
"06059021807",3021,269,32,0,458,103,889,217,4989
"06059021809",2378,94,10,0,561,22,591,2,3658
"06059021810",3034,252,49,0,574,11,1219,176,5315
"06059021812",5158,143,90,15,774,12,1434,0,7626
"06059021813",40,0,0,0,57,0,55,0,152
"06059021814",4838,167,28,0,1838,15,1627,60,8573
"06059021815",4728,240,202,0,2961,272,1446,110,9959
"06059021816",4088,166,0,0,790,30,901,42,6017
"06059021817",3143,162,0,0,487,76,949,90,4907
"06059021820",2883,86,19,0,1456,73,811,7,5335
"06059021821",4187,502,0,2,1698,323,2067,318,9097
"06059021822",5073,54,310,0,3299,100,800,33,9669
"06059021823",2720,70,0,0,848,28,598,0,4264
"06059021824",2158,86,16,0,396,20,332,12,3020
"06059021825",2599,65,0,0,566,23,506,22,3781
"06059021826",2015,61,170,0,545,0,633,1,3425
"06059021827",1893,121,28,0,1013,154,530,98,3837
"06059021828",2908,0,60,0,1373,12,630,0,4983
"06059021829",3744,144,93,0,1433,41,534,31,6020
"06059021830",4466,20,14,0,1471,0,1049,0,7020
"06059021903",2651,243,115,4,862,58,980,141,5054
"06059021905",4219,153,72,0,1265,8,1223,0,6940
"06059021912",2949,106,40,0,1390,0,622,0,5107
"06059021913",4774,313,51,122,2592,1094,4665,1311,14922
"06059021914",2551,330,36,0,1089,14,1058,213,5291
"06059021915",2767,153,0,49,984,17,697,71,4738
"06059021916",2484,61,50,0,818,0,287,0,3700
"06059021917",2424,107,0,3,498,26,376,0,3434
"06059021918",2950,294,0,0,1111,275,842,257,5729
"06059021919",2066,40,27,0,599,81,765,4,3582
"06059021920",4480,69,37,0,2292,101,824,50,7853
"06059021921",3469,16,25,0,1188,0,630,0,5328
"06059021922",3270,133,14,0,1307,89,869,43,5725
"06059021923",4207,166,209,0,2087,37,838,15,7559
"06059021924",2493,144,20,0,1437,0,801,132,5027
"06059032002",4790,256,153,19,1182,40,1439,76,7955
"06059032003",4015,238,0,0,703,0,561,64,5581
"06059032011",1451,34,0,3,107,7,181,1,1784
"06059032012",3238,126,49,0,423,133,644,157,4770
"06059032013",4180,289,146,0,604,83,438,16,5756
"06059032014",2774,273,237,0,1735,886,2281,916,9102
"06059032015",4510,596,33,7,1380,30,1106,77,7739
"06059032020",4900,18,0,0,762,28,727,6,6441
"06059032022",4700,557,0,122,1337,64,2664,499,9943
"06059032023",11061,391,115,0,1887,312,1314,311,15391
"06059032027",3188,371,236,8,3061,262,2918,392,10436
"06059032028",2469,111,0,0,551,94,898,30,4153
"06059032029",3006,213,49,0,1215,45,1063,0,5591
"06059032030",3100,145,0,0,492,3,702,45,4487
"06059032031",2395,376,0,0,803,16,625,1,4216
"06059032032",2481,89,11,0,458,41,544,46,3670
"06059032033",2563,64,97,0,808,237,524,215,4508
"06059032034",4778,88,122,0,926,9,639,0,6562
"06059032035",1909,74,8,19,404,9,273,11,2707
"06059032036",2984,297,86,0,580,9,872,119,4947
"06059032037",4371,148,129,0,389,66,291,0,5394
"06059032038",4715,214,0,0,1458,27,456,192,7062
"06059032039",4816,299,251,0,1513,56,1378,59,8372
"06059032040",2291,58,51,0,291,4,261,0,2956
"06059032041",712,68,11,0,166,3,55,0,1015
"06059032042",5586,114,57,0,436,0,757,52,7002
"06059032043",3308,11,92,0,593,0,368,0,4372
"06059032044",4742,138,30,12,735,27,471,94,6249
"06059032045",2542,111,7,0,317,0,350,6,3333
"06059032046",4909,218,80,0,668,12,359,0,6246
"06059032047",2455,213,68,10,1130,21,730,25,4652
"06059032048",3773,194,227,0,1082,57,700,32,6065
"06059032049",7101,396,76,3,1739,94,1183,155,10747
"06059032050",4050,75,25,0,870,0,850,0,5870
"06059032051",2988,316,51,0,1172,24,1548,72,6171
"06059032053",6290,224,269,0,1355,179,966,78,9361
"06059032054",4181,261,40,0,494,58,678,64,5776
"06059032055",2499,143,0,15,1086,84,1471,142,5440
"06059032056",5913,237,142,0,1565,0,1495,0,9352
"06059032057",6239,198,26,0,1532,18,1215,0,9228
"06059032058",5483,30,212,0,1563,68,1145,0,8501
"06059032059",8610,102,110,0,1872,0,1882,0,12576
"06059032061",3359,67,15,0,91,0,285,0,3817
"06059042103",6263,270,17,30,1263,155,1251,0,9249
"06059042106",1127,166,0,0,22,8,53,0,1376
"06059042107",2213,459,0,0,614,855,1084,1021,6246
"06059042108",3986,723,0,0,859,0,1658,175,7401
"06059042109",3576,283,48,21,881,111,784,66,5770
"06059042111",5124,258,113,0,590,15,653,21,6774
"06059042112",5029,201,47,0,1205,0,833,0,7315
"06059042113",3360,372,0,0,476,34,483,95,4820
"06059042114",3813,53,7,0,632,49,943,39,5536
"06059042201",4147,354,117,0,407,320,527,345,6217
"06059042203",5774,831,0,0,642,111,692,97,8147
"06059042205",5492,194,0,0,1267,68,1080,125,8226
"06059042206",2694,203,24,0,155,0,362,7,3445
"06059042305",3063,160,0,0,200,40,181,10,3654
"06059042307",4144,749,168,0,1819,224,1266,58,8428
"06059042310",5725,979,0,0,1902,239,2541,633,12019
"06059042311",4231,315,0,0,1080,366,833,348,7173
"06059042312",3019,595,0,103,4431,1825,5186,1983,17142
"06059042313",4819,451,53,39,1268,586,1642,558,9416
"06059042315",4817,278,0,6,591,20,1134,0,6846
"06059042317",2699,121,37,0,285,52,199,25,3418
"06059042319",2794,70,0,0,541,0,675,0,4080
"06059042320",3489,349,289,18,1211,185,1202,114,6857
"06059042323",3671,147,0,0,259,24,117,0,4218
"06059042324",3259,508,39,0,434,76,276,62,4654
"06059042325",2602,165,161,0,666,49,518,9,4170
"06059042326",3545,178,230,0,680,152,725,126,5636
"06059042327",3581,201,10,0,744,30,445,48,5059
"06059042328",2040,80,0,0,167,0,251,0,2538
"06059042329",2965,134,5,0,764,0,468,30,4366
"06059042330",3538,520,358,0,2185,90,2059,346,9096
"06059042331",3790,308,21,0,1122,102,1134,59,6536
"06059042332",4324,292,39,0,666,114,438,13,5886
"06059042333",2653,93,24,0,1078,5,139,0,3992
"06059042334",3645,221,122,0,972,213,847,92,6112
"06059042335",3851,383,9,0,2198,152,1299,0,7892
"06059042336",3967,55,57,23,652,92,390,16,5252
"06059042337",2793,191,74,0,444,143,237,0,3882
"06059042338",3774,219,0,0,687,49,507,8,5244
"06059042339",2675,123,69,0,700,34,749,21,4371
"06059052404",44,0,0,0,256,0,0,0,300
"06059052408",4798,263,0,23,1016,16,479,46,6641
"06059052410",2831,325,187,0,2006,97,1507,189,7142
"06059052411",2687,131,110,54,2070,91,1764,88,6995
"06059052415",3183,64,270,0,632,39,479,3,4670
"06059052416",2608,43,128,5,1105,150,1500,109,5648
"06059052417",3591,224,105,18,5118,258,815,9,10138
"06059052418",5102,519,153,23,8866,1169,1752,90,17674
"06059052419",1937,83,0,0,1412,10,195,38,3675
"06059052420",7366,166,315,0,13139,1199,1966,0,24151
"06059052421",2683,370,77,0,2153,108,442,15,5848
"06059052422",3067,57,0,0,1349,9,751,18,5251
"06059052423",3207,724,73,0,1832,283,1240,565,7924
"06059052424",2762,262,12,0,1542,139,867,111,5695
"06059052425",4027,234,112,0,993,360,853,364,6943
"06059052426",5384,329,17,45,3951,603,652,54,11035
"06059052427",3442,26,87,11,1636,9,591,9,5811
"06059052428",4795,114,87,0,1585,48,800,48,7477
"06059052502",4048,180,23,0,2179,82,1500,53,8065
"06059052505",2693,40,20,0,1850,388,795,64,5850
"06059052506",1583,97,25,0,790,56,265,76,2892
"06059052511",3588,166,69,35,1816,269,319,56,6318
"06059052513",3887,202,45,15,1749,315,407,62,6682
"06059052514",3298,653,0,25,1722,122,569,36,6425
"06059052515",3483,353,198,12,4582,611,896,140,10275
"06059052517",5220,647,666,0,4389,400,535,25,11882
"06059052518",2447,483,99,9,1436,135,308,17,4934
"06059052519",2371,366,116,0,1405,75,215,26,4574
"06059052520",2176,89,0,0,1008,290,268,0,3831
"06059052521",2214,525,71,0,2318,341,688,254,6411
"06059052522",1637,116,72,18,2098,379,338,20,4678
"06059052523",1987,290,42,0,1728,119,267,45,4478
"06059052524",4394,240,116,16,3120,1231,2201,738,12056
"06059052525",6375,503,507,45,9138,402,1434,230,18634
"06059052526",2161,124,120,0,2029,153,544,64,5195
"06059052527",3534,362,753,185,4357,358,725,44,10318
"06059052528",1844,80,59,0,1594,307,642,157,4683
"06059062604",9467,354,21,0,5252,48,938,0,16080
"06059062605",2573,299,26,0,228,29,297,21,3473
"06059062610",4013,535,193,0,2211,848,714,66,8580
"06059062611",1566,697,225,185,1223,744,417,129,5186
"06059062612",4996,509,0,0,2154,614,511,17,8801
"06059062614",3617,1709,64,40,2335,2752,1027,442,11986
"06059062619",3426,247,55,8,137,41,299,23,4236
"06059062620",4210,316,34,0,539,0,325,15,5439
"06059062621",3883,285,47,0,2004,160,1002,13,7394
"06059062622",3063,373,19,0,653,83,137,69,4397
"06059062625",2210,317,25,19,1377,543,1281,688,6460
"06059062626",804,466,65,10,408,1451,151,233,3588
"06059062627",1250,298,25,0,895,990,237,232,3927
"06059062628",1246,25,0,0,1303,209,180,15,2978
"06059062629",1765,71,21,0,828,88,84,39,2896
"06059062630",1168,38,11,0,448,43,23,0,1731
"06059062631",2197,64,32,0,917,11,109,0,3330
"06059062632",3165,108,0,8,471,43,207,18,4020
"06059062633",4356,255,0,0,1499,63,511,92,6776
"06059062634",3547,75,270,0,1439,51,673,16,6071
"06059062635",3001,185,50,0,1160,9,761,26,5192
"06059062636",2315,61,94,21,1365,0,671,0,4527
"06059062637",2950,99,58,0,1142,85,786,0,5120
"06059062638",4098,192,13,0,1964,0,1102,0,7369
"06059062639",5383,148,313,121,1757,64,850,16,8652
"06059062640",2631,154,120,6,767,97,672,55,4502
"06059062641",3434,156,52,0,1328,179,1024,262,6435
"06059062642",2216,69,0,0,228,179,57,122,2871
"06059062643",4712,141,0,0,2193,74,211,49,7380
"06059062644",6769,721,0,0,1059,165,529,54,9297
"06059062645",5113,126,0,0,1301,201,400,0,7141
"06059062646",2629,410,45,0,579,66,87,13,3829
"06059062647",2118,259,17,0,1606,57,745,42,4844
"06059062648",2159,201,0,0,266,9,86,9,2730
"06059062649",2267,317,88,0,566,50,299,47,3634
"06059062701",2300,165,0,0,261,17,259,74,3076
"06059062702",3928,270,0,0,573,0,511,15,5297
"06059062800",2822,521,0,7,251,124,207,45,3977
"06059062900",1402,39,0,0,71,12,67,9,1600
"06059063004",5287,338,55,39,477,77,307,85,6665
"06059063005",1069,37,20,0,133,21,45,0,1325
"06059063006",2732,84,18,0,60,0,162,0,3056
"06059063007",4922,140,0,0,1053,174,470,48,6807
"06059063008",687,87,0,0,86,13,40,0,913
"06059063009",1447,54,0,0,145,27,188,0,1861
"06059063010",6507,304,96,0,487,71,378,3,7846
"06059063101",2235,191,66,5,324,199,481,243,3744
"06059063102",5028,390,22,2,881,226,844,203,7596
"06059063103",1950,392,10,0,137,49,214,24,2776
"06059063201",2636,366,17,0,719,79,577,108,4502
"06059063202",3091,183,11,0,369,25,605,42,4326
"06059063301",2122,302,0,10,435,147,348,134,3498
"06059063302",3443,296,38,0,346,14,436,34,4607
"06059063400",3764,145,0,0,704,13,277,0,4903
"06059063500",5485,574,0,0,891,26,578,11,7565
"06059063601",2559,162,24,0,1069,187,1133,179,5313
"06059063603",4361,475,25,0,1241,70,1106,73,7351
"06059063604",1693,165,0,0,1321,743,1535,748,6205
"06059063605",1534,356,16,17,1907,1407,2365,1502,9104
"06059063701",1423,627,62,0,2745,1105,3276,1586,10824
"06059063702",2081,417,25,9,1763,949,1780,1075,8099
"06059063802",2496,93,34,0,314,0,835,12,3784
"06059063803",3016,355,20,14,1048,114,1209,181,5957
"06059063805",2063,174,0,0,141,47,261,10,2696
"06059063806",3323,116,147,0,353,40,869,32,4880
"06059063807",2744,547,106,54,1105,130,947,165,5798
"06059063808",2157,372,25,0,2209,1094,2905,1355,10117
"06059063902",4515,634,101,167,1345,201,1982,123,9068
"06059063903",2563,238,119,0,871,63,1310,181,5345
"06059063904",3301,477,16,0,1119,440,2030,700,8083
"06059063905",3250,352,80,0,773,164,728,107,5454
"06059063906",2926,296,56,0,2097,322,2533,429,8659
"06059063907",4839,389,285,86,2991,257,822,171,9840
"06059063908",3338,211,151,21,1548,199,1304,31,6803
"06059074003",1311,373,20,14,1863,316,2118,414,6429
"06059074004",3624,261,434,0,4258,361,4886,523,14347
"06059074005",3349,590,48,0,2988,296,5087,673,13031
"06059074006",2571,468,205,16,2132,371,3186,708,9657
"06059074102",3056,201,44,9,2773,547,4961,648,12239
"06059074103",2321,176,13,0,1973,700,3908,738,9829
"06059074106",3451,532,81,0,1903,395,3312,764,10438
"06059074107",3346,416,189,0,1761,70,1909,250,7941
"06059074108",2229,544,160,46,1770,153,3607,664,9173
"06059074109",1832,284,9,7,1320,244,2778,443,6917
"06059074110",1696,231,34,44,1785,282,1416,317,5805
"06059074111",3469,335,56,0,1839,113,3349,294,9455
"06059074200",3975,648,0,0,3575,872,6942,1431,17443
"06059074300",1406,413,26,1,1784,796,3056,1148,8630
"06059074403",2049,1275,0,0,1880,719,3690,1994,11607
"06059074405",2643,1603,28,43,970,383,3220,1927,10817
"06059074406",1958,570,5,25,463,259,2289,720,6289
"06059074407",2589,1240,124,82,1557,812,3586,1987,11977
"06059074408",2163,362,105,11,2472,632,3908,829,10482
"06059074501",2781,2162,110,0,1071,723,3493,2844,13184
"06059074502",2237,652,0,0,2065,903,4044,1475,11376
"06059074601",3992,851,0,0,2216,499,5746,1276,14580
"06059074602",3578,1383,0,0,2690,1045,6015,2428,17139
"06059074701",3796,947,41,0,2660,907,5938,1656,15945
"06059074702",2650,623,0,0,2196,652,4410,1225,11756
"06059074801",1517,492,152,7,2842,821,4162,1288,11281
"06059074802",3072,1027,57,21,1973,739,4535,1445,12869
"06059074803",3331,245,201,188,4179,947,5650,1008,15749
"06059074805",1885,1264,33,47,1978,491,3685,1721,11104
"06059074806",1726,928,43,0,1682,875,3117,1770,10141
"06059074901",2749,1018,9,0,4367,1638,6970,2413,19164
"06059074902",1931,1041,4,0,2369,977,4176,1990,12488
"06059075002",3207,1692,51,0,1634,1344,4232,2636,14796
"06059075003",1887,1412,0,0,2613,1440,4294,2820,14466
"06059075004",1411,1428,91,0,1226,1030,2477,2362,10025
"06059075100",1718,362,20,0,4308,1374,5047,1545,14374
"06059075201",1316,507,0,0,3592,939,4450,1357,12161
"06059075202",1487,429,33,0,3205,671,4381,947,11153
"06059075301",2084,522,77,0,2936,519,3074,830,10042
"06059075302",1602,323,12,0,1645,671,2535,911,7699
"06059075303",1799,124,0,10,968,251,1074,292,4518
"06059075401",1850,463,23,11,1377,90,1659,382,5855
"06059075403",4370,779,78,0,1987,171,4009,851,12245
"06059075404",3669,372,206,0,1115,611,3149,811,9933
"06059075405",1919,171,51,0,865,39,1534,135,4714
"06059075504",3232,261,137,0,670,14,1221,88,5623
"06059075505",2006,151,107,0,1282,87,1265,99,4997
"06059075506",2293,79,66,0,954,57,873,58,4380
"06059075507",2382,466,249,0,2112,383,1686,432,7710
"06059075512",1381,262,177,176,1643,265,1691,375,5970
"06059075513",1932,313,150,82,3018,202,2878,395,8970
"06059075514",1000,348,40,93,1778,620,1969,755,6603
"06059075515",5251,946,230,85,8245,2073,4429,2117,23376
"06059075603",2957,192,12,0,800,36,726,49,4772
"06059075604",5965,148,0,5,1353,151,910,21,8553
"06059075605",3482,237,110,0,1531,108,482,19,5969
"06059075606",4997,75,0,10,2165,92,625,25,7989
"06059075607",3377,445,145,0,2099,98,708,52,6924
"06059075701",5383,375,56,177,1419,147,3052,58,10667
"06059075702",2737,92,5,0,423,19,467,27,3770
"06059075703",3127,75,27,26,802,8,360,0,4425
"06059075805",2303,1024,13,7,696,182,1012,920,6157
"06059075806",3441,769,40,0,2078,320,3083,269,10000
"06059075807",2505,447,22,8,652,152,1008,447,5241
"06059075808",2873,281,58,0,292,19,890,69,4482
"06059075809",2286,94,61,0,548,24,207,10,3230
"06059075810",2265,110,74,0,611,33,242,72,3407
"06059075811",1705,555,36,0,580,305,1004,723,4908
"06059075812",3790,1162,103,0,1309,207,2102,1200,9873
"06059075813",3266,387,62,0,1112,49,1049,158,6083
"06059075814",1955,120,30,0,876,41,380,0,3402
"06059075815",3179,429,283,0,1206,126,1776,261,7260
"06059075816",2065,406,0,0,1241,129,1453,393,5687
"06059075901",2551,639,33,0,567,307,1010,262,5369
"06059075902",4246,490,53,0,1118,575,2195,604,9281
"06059076000",3421,484,88,8,3934,507,3724,526,12692
"06059076101",4377,505,98,34,4568,463,4395,351,14791
"06059076102",1634,428,36,33,1825,411,1722,441,6530
"06059076103",3854,434,149,0,3383,706,4457,667,13650
"06059076201",4504,573,137,33,1921,101,1851,240,9360
"06059076202",4295,606,112,0,1036,68,1679,385,8181
"06059076204",1874,487,21,0,1475,703,2257,908,7725
"06059076205",3179,437,24,0,946,271,1719,186,6762
"06059076206",3490,258,0,10,585,93,1511,126,6073
"06059076208",3553,521,71,24,1135,166,1438,370,7278
"06059086301",4614,950,41,12,1318,106,4179,959,12179
"06059086303",3384,477,281,14,2414,137,2614,286,9607
"06059086304",2746,512,102,19,1423,172,2272,501,7747
"06059086305",3147,345,90,0,843,134,1971,68,6598
"06059086306",2898,288,102,20,1049,77,2095,260,6789
"06059086402",3461,844,85,8,1054,104,2925,777,9258
"06059086404",4805,492,4,7,1049,557,4560,831,12305
"06059086405",4297,2058,219,109,811,112,4422,2015,14043
"06059086406",2791,411,69,15,1022,161,2344,510,7323
"06059086407",4144,516,96,36,1555,193,3200,469,10209
"06059086501",2989,878,64,18,593,47,2900,859,8348
"06059086502",3789,1529,0,179,768,110,4197,1555,12127
"06059086601",3589,2124,339,0,3148,656,5321,2690,17867
"06059086602",2930,1309,154,29,1559,484,3002,1441,10908
"06059086701",4829,741,56,17,3318,238,3828,828,13855
"06059086702",2926,978,141,0,2126,678,3282,1371,11502
"06059086801",2179,100,38,0,1031,160,1408,160,5076
"06059086802",2998,682,212,44,1546,379,2646,760,9267
"06059086803",4395,605,77,0,3038,1139,2562,628,12444
"06059086901",3148,989,302,291,2347,1097,2675,1368,12217
"06059086902",2596,321,173,32,1714,634,1358,307,7135
"06059086903",3439,798,21,10,2730,370,3739,724,11831
"06059087001",1980,539,202,151,1910,355,2099,632,7868
"06059087002",3335,670,61,10,3472,378,3419,579,11924
"06059087101",1836,237,253,33,2177,323,1686,166,6711
"06059087102",2680,835,134,211,1689,196,2537,802,9084
"06059087103",4227,197,153,0,2114,683,2730,37,10141
"06059087105",2188,335,16,0,1316,280,1659,180,5974
"06059087106",3335,584,14,7,919,98,2840,360,8157
"06059087200",4846,1153,195,40,1493,349,3686,951,12713
"06059087300",6260,1667,145,0,1363,393,5530,1561,16919
"06059087401",2869,138,52,15,1076,74,2363,101,6688
"06059087403",1644,871,26,0,368,233,1841,960,5943
"06059087404",2716,726,0,33,329,196,2776,879,7655
"06059087405",3364,1750,45,0,728,188,3663,1753,11491
"06059087503",4359,864,47,35,1105,158,3118,896,10582
"06059087504",4331,2003,84,8,882,378,4004,2200,13890
"06059087505",3138,623,133,148,1137,242,2902,589,8912
"06059087601",2442,917,98,19,1474,226,1773,807,7756
"06059087602",3718,1039,113,120,1998,155,2720,1000,10863
"06059087701",3468,196,33,11,1643,296,2462,109,8218
"06059087703",1952,841,54,0,2599,495,2190,723,8854
"06059087704",2257,247,0,0,2005,227,1530,252,6518
"06059087801",2322,719,223,2,1637,358,1516,521,7298
"06059087802",3167,1101,399,0,2743,259,2888,1065,11622
"06059087803",1898,1495,84,13,1692,521,2293,1667,9663
"06059087805",2384,655,198,46,2790,495,3038,747,10353
"06059087806",1979,558,83,0,1981,447,2105,397,7550
"06059087901",1196,489,40,14,1519,336,927,690,5211
"06059087902",1983,853,77,11,2173,828,2330,1120,9375
"06059088001",1541,543,21,27,1962,369,1251,479,6193
"06059088002",1638,330,82,4,1448,227,822,190,4741
"06059088101",1314,30,61,5,730,102,788,70,3100
"06059088104",1981,368,29,0,2113,433,1470,485,6879
"06059088105",1492,345,31,0,2264,285,1214,109,5740
"06059088106",2018,399,93,0,2069,505,1467,407,6958
"06059088107",1423,672,5,0,3305,675,1152,552,7784
"06059088201",1557,978,40,0,1290,443,1192,733,6233
"06059088202",1341,176,15,0,1391,315,603,212,4053
"06059088203",2481,448,19,33,1832,554,1565,536,7468
"06059088301",2898,408,25,0,2868,715,2239,693,9846
"06059088302",3305,242,34,0,2578,307,1518,128,8112
"06059088401",2607,108,13,4,2282,559,2027,299,7899
"06059088402",2360,369,176,4,1302,708,2242,788,7949
"06059088403",3664,466,123,55,2991,388,3756,542,11985
"06059088501",2488,842,24,11,2723,772,2772,1098,10730
"06059088502",1450,549,25,36,2471,367,1569,585,7052
"06059088601",2436,244,74,27,3260,615,1810,204,8670
"06059088602",1275,212,135,0,2514,295,1321,120,5872
"06059088701",1570,423,0,0,2888,1343,1641,725,8590
"06059088702",1372,400,6,0,3519,854,1299,500,7950
"06059088801",1494,588,109,0,4782,966,1672,576,10187
"06059088802",1207,758,90,0,2947,636,1166,896,7700
"06059088901",1169,260,31,7,3856,1578,487,573,7961
"06059088902",918,383,0,0,2439,788,737,431,5696
"06059088903",1688,190,29,0,5727,1123,1851,136,10744
"06059088904",752,333,0,0,3451,1082,255,265,6138
"06059088905",1374,58,2,0,3378,959,1085,75,6931
"06059089001",1417,130,7,0,4462,1641,2560,506,10723
"06059089003",945,443,7,0,1880,647,1562,763,6247
"06059089004",2234,628,17,11,3560,1271,3237,1464,12422
"06059089102",1711,242,9,0,4103,501,4079,473,11118
"06059089104",1086,674,15,13,2832,1167,3250,1143,10180
"06059089105",1701,250,55,0,2915,1455,4178,1559,12113
"06059089106",1113,403,5,0,1836,422,1927,612,6318
"06059089107",1885,84,0,10,2635,458,2662,137,7871
"06059099202",2878,504,54,13,3373,1380,3363,1155,12720
"06059099203",1693,107,10,0,3928,734,1614,158,8244
"06059099204",1133,104,8,0,2874,290,389,98,4896
"06059099212",2847,658,47,0,1045,405,907,469,6378
"06059099214",2608,286,0,0,476,0,343,23,3736
"06059099215",3396,166,45,0,1291,106,833,110,5947
"06059099216",3096,102,102,0,752,43,521,16,4632
"06059099217",2082,51,25,27,260,12,294,10,2761
"06059099220",4270,217,0,0,819,81,704,86,6177
"06059099222",1573,255,42,0,2870,747,865,189,6541
"06059099223",1460,291,16,0,2509,652,765,139,5832
"06059099224",1304,38,10,0,1961,85,387,20,3805
"06059099225",1581,65,0,9,1480,132,181,17,3465
"06059099226",1468,215,0,0,2453,202,566,42,4946
"06059099227",2316,238,6,0,2887,780,1415,602,8244
"06059099229",3069,140,212,0,2536,328,985,255,7525
"06059099230",3025,160,42,0,1396,117,621,0,5361
"06059099231",3642,78,78,0,1502,202,508,12,6022
"06059099232",3385,365,14,0,1488,94,565,133,6044
"06059099233",1626,117,0,0,1505,58,267,0,3573
"06059099234",1909,81,30,0,1357,58,552,0,3987
"06059099235",3072,459,54,20,818,149,894,87,5553
"06059099237",2788,147,27,0,770,42,373,8,4155
"06059099238",2920,135,0,0,943,66,411,42,4517
"06059099239",2622,197,11,0,884,40,233,42,4029
"06059099240",4294,227,0,0,828,11,637,3,6000
"06059099241",2405,313,87,31,1352,243,974,162,5567
"06059099242",2344,194,11,0,1155,18,1229,46,4997
"06059099243",3222,171,27,0,1034,0,631,0,5085
"06059099244",2810,112,0,0,493,0,222,17,3654
"06059099245",2448,104,0,0,456,0,268,0,3276
"06059099246",2774,72,0,0,696,2,334,1,3879
"06059099247",543,134,0,0,2239,443,1173,239,4771
"06059099248",1508,486,62,19,2344,1039,2452,1238,9148
"06059099249",968,607,0,0,2188,734,2532,1214,8243
"06059099250",1482,106,11,0,1172,232,680,12,3695
"06059099251",1862,646,138,0,3085,150,1678,24,7583
"06059099305",5157,546,42,15,1789,322,2258,458,10587
"06059099306",4858,247,209,0,655,324,685,328,7306
"06059099307",1836,121,0,0,503,77,305,0,2842
"06059099308",4731,42,24,0,1186,68,574,16,6641
"06059099309",3908,333,290,0,862,27,665,46,6131
"06059099310",3267,458,0,0,736,73,422,52,5008
"06059099311",3040,254,36,0,290,15,396,64,4095
"06059099402",3110,1539,35,0,2309,2333,3775,3594,16695
"06059099404",3554,128,83,0,605,103,414,53,4940
"06059099405",3195,349,34,40,721,70,375,80,4864
"06059099406",3204,238,103,19,951,107,573,55,5250
"06059099407",1589,160,8,20,678,36,395,23,2909
"06059099408",3028,334,68,0,937,52,607,103,5129
"06059099410",2600,625,152,0,1083,157,877,462,5956
"06059099411",3216,514,72,0,1291,255,1481,264,7093
"06059099412",3564,269,36,0,959,114,669,122,5733
"06059099413",5080,882,0,0,1718,162,856,365,9063
"06059099415",4659,122,26,0,879,15,557,10,6268
"06059099416",3621,368,24,0,589,62,745,167,5576
"06059099417",3288,112,15,0,740,155,476,38,4824
"06059099502",341,4,86,0,129,0,173,0,733
"06059099504",2236,102,0,0,410,8,277,37,3070
"06059099506",793,37,0,0,93,48,144,28,1143
"06059099508",2910,567,51,0,1075,157,582,375,5717
"06059099509",2573,228,0,0,488,94,209,34,3626
"06059099510",3108,532,71,1,587,114,293,46,4752
"06059099511",2418,209,0,0,465,19,595,23,3729
"06059099512",2215,341,66,0,380,61,393,32,3488
"06059099513",1717,125,21,0,453,30,280,0,2626
"06059099514",3680,107,21,0,1080,0,357,19,5264
"06059099601",1738,398,104,16,3195,1493,1187,661,8792
"06059099602",2259,230,0,11,625,207,535,17,3884
"06059099603",4367,205,46,0,2001,74,1081,0,7774
"06059099604",2893,90,0,0,767,77,900,23,4750
"06059099605",2651,108,0,0,948,1,599,0,4307
"06059099701",1284,119,0,0,4286,940,970,234,7833
"06059099702",2646,378,0,5,3678,1444,1832,299,10282
"06059099703",2111,228,22,0,2758,162,506,48,5835
"06059099801",1646,509,35,0,2824,1029,1377,767,8187
"06059099802",1379,194,14,0,1996,1088,1105,329,6105
"06059099803",1712,326,10,0,2778,716,1175,177,6894
"06059099902",2230,300,141,0,1655,204,938,186,5654
"06059099903",1782,445,90,13,2838,777,1491,629,8065
"06059099904",2040,311,17,0,3272,1169,1961,603,9373
"06059099905",2144,362,18,0,1406,160,1244,362,5696
"06059099906",2852,147,212,0,1822,76,863,2,5974
"06059110001",3277,282,105,0,780,69,545,137,5195
"06059110003",2355,119,42,0,804,28,865,8,4221
"06059110004",3651,86,259,0,1056,12,603,12,5679
"06059110005",2381,73,0,0,619,29,510,6,3618
"06059110006",2186,104,122,0,710,14,337,14,3487
"06059110007",3779,163,0,0,730,13,383,42,5110
"06059110008",3374,44,9,0,873,9,584,7,4900
"06059110010",2894,137,143,0,1886,49,989,7,6105
"06059110011",1736,14,71,0,864,251,456,28,3420
"06059110012",3710,137,20,8,1181,21,662,0,5739
"06059110014",2382,258,71,134,1598,388,1215,345,6391
"06059110015",2744,160,32,0,549,20,512,25,4042
"06059110102",2368,174,131,0,2798,195,734,54,6454
"06059110104",2862,168,76,44,2242,269,1086,92,6839
"06059110106",2250,136,225,0,1264,28,769,36,4708
"06059110108",1582,178,105,26,809,99,581,14,3394
"06059110109",2714,255,267,0,1897,51,676,92,5952
"06059110110",3139,392,105,0,1716,399,1577,121,7449
"06059110111",2991,146,389,0,2417,164,1292,27,7426
"06059110113",1188,153,60,36,822,72,362,37,2730
"06059110114",3127,224,82,0,1206,68,851,38,5596
"06059110115",1204,0,460,0,1805,63,512,0,4044
"06059110116",2013,66,224,85,2233,362,778,53,5814
"06059110117",3286,175,301,0,1940,424,708,127,6961
"06059110118",928,6,124,0,1495,58,227,6,2844
"06059110201",3395,587,461,0,2645,557,1511,364,9520
"06059110202",3223,396,74,122,2790,635,1720,261,9221
"06059110203",3282,173,90,41,1309,186,1066,217,6364
"06059110301",3897,599,280,0,2730,114,1742,526,9888
"06059110302",3292,313,9,24,1794,189,2377,190,8188
"06059110303",3104,63,69,0,1473,136,1783,111,6739
"06059110304",2471,69,159,0,1657,100,1028,42,5526
"06059110401",3438,58,48,27,1790,25,2230,26,7642
"06059110402",2872,967,26,12,1489,82,2088,829,8365
"06059110500",4195,988,365,331,1533,954,3313,1088,12767
"06059110603",4342,1283,1066,0,1956,507,4045,1105,14304
"06059110604",2568,175,86,28,4314,465,951,198,8785
"06059110605",1618,54,4,10,3756,1004,532,55,7033
"06059110606",1599,981,276,198,1510,74,1598,1034,7270
"06059110607",2014,130,67,0,2065,193,1110,1,5580
"06059980000",0,0,0,0,0,0,0,0,0
"06059990100",0,0,0,0,0,0,0,0,0
"06061020104",996,160,36,0,6,0,126,27,1351
"06061020105",1038,86,0,0,0,0,240,17,1381
"06061020106",1431,195,0,0,59,18,376,47,2126
"06061020107",2175,562,8,0,503,22,1389,380,5039
"06061020200",4914,694,0,28,277,15,180,94,6202
"06061020300",3133,525,0,23,683,99,639,114,5216
"06061020401",1208,395,69,48,194,90,128,48,2180
"06061020402",3176,275,0,0,207,17,87,32,3794
"06061020501",2494,279,21,2,155,34,247,19,3251
"06061020502",3530,276,11,33,240,19,109,20,4238
"06061020601",6595,108,93,2,664,85,406,24,7977
"06061020602",6328,230,41,40,605,164,519,60,7987
"06061020604",5266,186,49,29,786,49,446,0,6811
"06061020605",4818,140,62,0,967,8,367,2,6364
"06061020606",3146,177,30,0,847,0,210,11,4421
"06061020710",3655,190,78,5,400,7,422,0,4757
"06061020711",3415,288,46,0,706,62,604,32,5153
"06061020712",2897,449,60,16,349,0,698,160,4629
"06061020713",2117,378,0,87,365,9,379,160,3495
"06061020714",2992,235,198,0,480,19,336,17,4277
"06061020715",2331,251,14,4,324,64,221,59,3268
"06061020717",2282,109,0,0,630,38,434,0,3493
"06061020805",3202,331,94,0,771,108,667,143,5316
"06061020806",2653,217,34,0,511,272,623,301,4611
"06061020901",1238,338,33,52,505,347,740,340,3593
"06061020908",4417,620,36,5,1087,530,1704,660,9059
"06061021003",4307,683,0,38,939,113,647,417,7144
"06061021034",3166,123,0,16,979,85,534,0,4903
"06061021035",5294,176,161,0,1613,123,916,63,8346
"06061021037",1584,68,26,5,467,15,194,0,2359
"06061021038",6024,160,22,0,791,271,931,231,8430
"06061021039",1535,35,20,0,128,0,79,0,1797
"06061021040",2765,271,0,0,72,28,187,0,3323
"06061021043",2762,29,65,0,505,42,359,9,3771
"06061021044",4746,406,177,0,1020,70,756,0,7175
"06061021045",2079,309,105,0,695,0,686,57,3931
"06061021046",3390,359,0,0,659,47,459,159,5073
"06061021103",2402,560,56,10,370,28,502,48,3976
"06061021106",1692,152,0,0,142,10,78,28,2102
"06061021108",2091,373,0,0,181,50,356,35,3086
"06061021109",4078,329,57,64,502,0,386,11,5427
"06061021122",2911,100,63,8,358,15,317,9,3781
"06061021123",6832,171,0,4,956,39,807,11,8820
"06061021128",2073,169,211,16,565,23,304,23,3384
"06061021129",2319,304,31,0,341,221,282,217,3715
"06061021130",2081,224,0,13,496,177,551,50,3592
"06061021131",3693,310,117,21,769,108,461,12,5491
"06061021203",6077,141,30,3,510,4,314,0,7079
"06061021204",1989,320,0,0,191,0,170,5,2675
"06061021304",4437,679,53,0,326,111,670,135,6411
"06061021309",7942,267,92,0,2079,417,1220,472,12489
"06061021322",8550,1157,162,122,3321,375,1371,323,15381
"06061021401",1807,276,4,0,171,38,448,131,2875
"06061021403",4451,1644,0,37,1504,193,2582,1166,11577
"06061021501",4482,519,0,0,782,42,462,365,6652
"06061021502",3189,266,9,0,222,60,255,65,4066
"06061021603",3389,814,0,0,232,164,694,623,5916
"06061021604",3188,335,0,46,210,13,345,13,4150
"06061021801",4190,251,0,0,245,63,249,56,5054
"06061021802",5014,536,162,0,448,127,731,23,7041
"06061021901",2110,214,39,1,189,22,137,29,2741
"06061021902",4155,243,0,0,103,0,327,16,4844
"06061022002",6015,895,42,44,313,27,573,12,7921
"06061022011",1471,137,0,0,11,0,77,59,1755
"06061022013",2017,376,0,0,71,31,36,24,2555
"06061022014",1065,75,0,0,17,23,43,23,1246
"06061022100",579,55,0,0,61,0,22,0,717
"06061022200",879,30,3,0,0,38,198,26,1174
"06061022300",567,77,0,0,11,0,2,0,657
"06061022400",3076,385,28,0,797,33,538,8,4865
"06061022500",2929,121,284,0,1029,25,341,25,4754
"06061022600",3525,376,105,50,955,72,565,34,5682
"06061022800",2597,91,26,30,1207,113,354,43,4461
"06061022900",3372,329,52,0,1705,54,784,270,6566
"06061023000",2417,182,50,93,569,52,206,134,3703
"06061023100",5871,141,251,0,1547,16,590,0,8416
"06061023200",3732,313,122,1,1410,120,860,118,6676
"06061023300",3436,178,83,23,752,126,653,73,5324
"06061023400",3812,96,157,2,454,10,640,18,5189
"06061023500",4321,152,29,0,996,27,814,8,6347
"06061023600",4063,224,0,0,190,0,214,17,4708
"06061023700",2908,199,21,0,193,27,78,0,3426
"06061023800",2951,87,56,0,94,7,168,0,3363
"06061023900",2393,223,30,26,525,0,535,39,3771
"06061990000",0,0,0,0,0,0,0,0,0
"06063000100",4052,820,47,32,324,120,148,54,5597
"06063000201",1201,73,0,3,98,12,102,13,1502
"06063000202",620,192,0,0,32,0,65,0,909
"06063000300",3057,511,23,0,328,102,639,93,4753
"06063000400",2166,330,0,0,145,95,185,29,2950
"06063000501",1565,273,0,2,187,0,52,67,2146
"06063000502",1916,86,0,0,123,36,42,18,2221
"06065030101",737,85,37,22,145,68,652,126,1872
"06065030103",1207,468,62,27,207,389,970,515,3845
"06065030104",3736,647,489,104,1456,1266,3537,1313,12548
"06065030200",2631,515,208,52,897,149,1297,334,6083
"06065030300",1588,772,206,101,539,277,1105,526,5114
"06065030400",2362,1732,400,213,1469,503,3468,2039,12186
"06065030501",1290,1214,666,76,929,495,1837,1383,7890
"06065030502",1089,651,24,45,651,52,1632,590,4734
"06065030503",1742,930,73,119,512,307,2083,1099,6865
"06065030601",4226,71,220,49,952,7,1035,3,6563
"06065030602",2698,72,106,18,480,21,667,21,4083
"06065030603",2510,233,71,91,173,43,485,69,3675
"06065030700",3487,1351,173,75,450,235,1168,1101,8040
"06065030800",5380,607,169,33,1181,427,2737,712,11246
"06065030900",2421,355,318,6,359,26,1978,303,5766
"06065031001",3522,392,240,111,1251,94,2127,214,7951
"06065031002",2492,904,277,42,503,525,2177,1377,8297
"06065031100",2941,563,65,241,448,222,1371,247,6098
"06065031200",4564,661,301,0,880,114,2563,273,9356
"06065031300",1457,675,5,106,364,137,1771,806,5321
"06065031401",4142,1069,178,480,780,468,2620,1268,11005
"06065031402",5102,402,372,183,811,191,3260,360,10681
"06065031501",2531,654,159,3,1662,249,2557,566,8381
"06065031502",4188,1140,169,41,2704,323,3738,1286,13589
"06065031601",1830,548,78,55,1822,555,2335,744,7967
"06065031602",2233,951,198,97,2163,252,2960,1136,9990
"06065031701",1475,314,118,41,480,177,975,400,3980
"06065031702",1555,50,109,0,710,5,1014,41,3484
"06065031703",2562,183,45,14,963,133,1795,186,5881
"06065031704",3227,262,95,38,1163,92,2147,120,7144
"06065040101",1729,485,348,57,1229,386,2432,838,7504
"06065040102",2033,264,14,0,1529,532,2235,638,7245
"06065040201",2330,558,173,112,2535,408,3080,847,10043
"06065040202",1907,375,177,0,946,153,1565,431,5554
"06065040203",952,738,12,11,1472,600,2250,1231,7266
"06065040204",1188,215,125,11,1594,601,2555,764,7053
"06065040301",2612,939,117,46,3037,1223,4641,1889,14504
"06065040302",5359,247,106,36,1883,135,2366,233,10365
"06065040303",1506,284,53,0,1294,279,2066,480,5962
"06065040402",2038,144,0,0,1378,585,2412,643,7200
"06065040403",3076,421,149,0,1814,152,3605,430,9647
"06065040404",1744,286,113,0,1111,10,1902,38,5204
"06065040405",3389,254,121,4,1534,0,2291,53,7646
"06065040501",3463,785,72,8,2419,783,4065,1324,12919
"06065040502",2421,783,258,53,2150,907,3891,1560,12023
"06065040503",2176,208,413,76,934,210,1992,294,6303
"06065040603",1604,138,20,0,753,85,1609,192,4401
"06065040604",4170,605,0,0,827,169,2632,540,8943
"06065040605",1269,305,0,19,1146,322,2022,471,5554
"06065040606",1261,377,53,0,1182,187,2035,442,5537
"06065040607",4271,268,408,164,3308,374,4155,380,13328
"06065040609",4678,394,700,55,5659,241,3774,368,15869
"06065040611",3465,37,532,99,2914,282,2567,115,10011
"06065040613",5480,267,996,47,5846,191,4999,271,18097
"06065040615",4303,413,757,72,3077,156,3228,282,12288
"06065040616",2418,149,1065,0,4205,91,2496,51,10475
"06065040701",1386,55,142,0,411,0,404,22,2420
"06065040702",2325,166,21,2,334,27,907,60,3842
"06065040703",2425,178,8,5,347,27,859,79,3928
"06065040806",1894,74,208,0,706,57,938,51,3928
"06065040807",2261,169,61,20,769,10,1339,63,4692
"06065040808",4462,652,351,233,1475,349,3636,370,11528
"06065040809",1655,316,381,8,1103,30,1600,264,5357
"06065040812",2944,436,17,0,347,6,902,274,4926
"06065040813",4521,185,433,10,1406,60,2183,66,8864
"06065040814",2689,418,213,159,1249,111,1561,260,6660
"06065040815",1712,99,248,8,1656,28,1251,48,5050
"06065040816",2043,59,278,86,794,20,850,0,4130
"06065040821",2851,332,268,112,1637,156,2031,278,7665
"06065040901",4103,413,563,44,1761,296,2994,538,10712
"06065040902",2883,781,109,0,857,482,1366,873,7351
"06065040903",1645,577,73,11,374,150,1177,583,4590
"06065040904",2313,779,100,0,703,202,2077,804,6978
"06065041001",1298,508,59,71,534,429,1449,835,5183
"06065041002",1513,537,100,0,1259,69,2086,518,6082
"06065041003",1921,265,35,68,486,15,1379,206,4375
"06065041004",1996,640,163,0,1996,263,2478,658,8194
"06065041101",2424,1110,11,227,1167,651,3305,1678,10573
"06065041102",2084,527,5,36,850,385,2116,809,6812
"06065041201",2013,554,114,29,1222,297,2068,617,6914
"06065041202",2482,670,39,0,1319,226,3459,827,9022
"06065041203",1209,303,141,7,1414,592,2292,705,6663
"06065041301",2339,334,4,0,643,115,2464,363,6262
"06065041302",2031,1330,120,0,1111,252,2589,1513,8946
"06065041403",1508,87,163,30,937,118,1315,127,4285
"06065041404",1981,276,170,0,1808,160,2364,376,7135
"06065041405",2350,421,15,0,1614,4,1976,258,6638
"06065041406",3923,506,542,67,875,90,2774,330,9107
"06065041407",3257,711,173,66,888,217,2890,677,8879
"06065041408",2237,190,197,136,1087,54,1874,152,5927
"06065041409",11135,594,886,330,4784,728,5329,533,24319
"06065041410",1333,781,0,0,525,333,1719,1073,5764
"06065041411",1937,579,51,6,417,33,1834,486,5343
"06065041412",2016,631,206,0,1577,347,1895,709,7381
"06065041500",1289,633,105,12,402,173,1423,761,4798
"06065041600",3294,1406,193,33,751,396,3273,1493,10839
"06065041702",3454,714,0,0,852,0,2266,568,7854
"06065041703",2889,1812,147,64,718,147,2553,1603,9933
"06065041704",2395,719,0,24,549,427,2555,1055,7724
"06065041803",4680,72,161,0,1988,2,1915,3,8821
"06065041804",2597,209,237,0,1026,13,1287,71,5440
"06065041805",3822,555,100,51,1486,115,2487,328,8944
"06065041806",3095,158,349,0,948,69,1334,115,6068
"06065041807",1904,203,46,9,377,0,1186,168,3893
"06065041808",3587,295,314,102,1859,161,1514,160,7992
"06065041809",3511,482,665,54,947,74,1860,138,7731
"06065041810",4225,67,409,5,1081,66,1458,17,7328
"06065041812",2049,126,161,0,393,160,701,98,3688
"06065041813",4832,1764,29,69,877,216,3484,1700,12971
"06065041904",3555,249,33,19,1221,158,1735,159,7129
"06065041905",1846,396,235,0,480,49,1408,310,4724
"06065041906",3946,850,375,23,1100,67,3293,648,10302
"06065041909",4044,235,134,0,1007,176,2476,303,8375
"06065041910",4116,920,455,0,1443,148,2200,460,9742
"06065041911",7004,444,1100,66,2916,90,2921,223,14764
"06065041912",3621,191,10,176,1795,88,1207,54,7142
"06065041913",3874,375,62,47,1271,83,1765,230,7707
"06065042003",4057,529,208,0,1022,150,1673,211,7850
"06065042004",2503,273,65,0,369,32,815,221,4278
"06065042005",3749,107,369,0,1051,81,1416,91,6864
"06065042007",3126,202,36,0,449,211,676,301,5001
"06065042008",4969,193,480,24,2037,34,2921,35,10693
"06065042009",3749,694,671,50,2137,1232,3698,1596,13827
"06065042010",2212,733,443,74,1619,1437,3144,1896,11558
"06065042012",3261,1195,671,114,1580,149,1950,133,9053
"06065042013",4942,371,657,0,2494,64,2304,326,11158
"06065042014",7421,176,701,40,2008,195,3235,28,13804
"06065042206",2428,785,576,224,1210,528,993,805,7549
"06065042207",2583,103,44,0,497,25,790,43,4085
"06065042208",2152,89,69,1,390,0,453,5,3159
"06065042209",1498,770,155,30,532,775,1274,705,5739
"06065042210",1541,726,264,55,753,770,921,772,5802
"06065042212",3819,370,837,157,1323,346,2514,598,9964
"06065042213",2350,330,112,6,756,556,592,215,4917
"06065042214",3612,646,619,67,1272,304,2304,696,9520
"06065042217",3806,245,294,0,1209,245,1162,139,7100
"06065042300",3663,1252,73,4,1882,265,3764,1076,11979
"06065042401",1239,30,32,4,511,35,861,38,2750
"06065042402",2130,436,736,11,1061,569,1648,789,7380
"06065042403",2401,552,418,74,942,136,1973,537,7033
"06065042404",707,491,207,184,486,190,790,626,3681
"06065042405",1603,630,740,1046,1084,226,1911,592,7832
"06065042406",1959,248,493,138,1106,235,1967,399,6545
"06065042407",1455,152,75,121,1098,140,1530,190,4761
"06065042408",1715,291,271,0,951,142,1757,388,5515
"06065042409",1305,130,392,280,695,286,1327,291,4706
"06065042410",2634,250,1053,22,982,199,2124,401,7665
"06065042411",1402,213,497,17,418,4,988,194,3733
"06065042412",3350,243,710,82,979,22,1591,211,7188
"06065042505",1070,954,55,176,1053,383,1736,1304,6731
"06065042506",3396,435,1775,879,2258,417,3207,578,12945
"06065042507",1995,253,543,550,1375,77,2315,256,7364
"06065042508",1958,571,471,107,1566,522,3038,1034,9267
"06065042509",1378,417,291,81,1034,133,1862,398,5594
"06065042510",2402,559,131,475,1406,354,2870,672,8869
"06065042511",1144,392,229,167,1145,509,2025,731,6342
"06065042512",1122,328,314,197,789,379,1676,522,5327
"06065042513",1636,334,457,42,621,345,1672,592,5699
"06065042514",1119,389,104,112,726,521,1183,708,4862
"06065042515",1422,907,376,231,746,566,1879,1456,7583
"06065042516",1646,427,253,91,1471,356,2851,650,7745
"06065042517",1479,519,271,9,794,231,1820,343,5466
"06065042518",1348,311,399,209,923,376,1693,636,5895
"06065042519",640,209,114,175,357,44,766,183,2488
"06065042520",1717,932,327,176,977,514,2029,1273,7945
"06065042521",1545,564,491,340,1476,283,2169,719,7587
"06065042617",2720,1156,679,584,4268,1716,5999,2778,19900
"06065042618",3236,1030,360,146,3453,609,5850,1130,15814
"06065042619",3992,273,1367,187,5164,643,6542,638,18806
"06065042620",2642,961,1220,467,5366,1067,5764,1783,19270
"06065042621",2596,255,1157,186,2047,176,3247,318,9982
"06065042622",1634,261,675,59,1267,130,1546,320,5892
"06065042623",2198,53,532,22,765,233,1393,209,5405
"06065042624",1924,94,792,32,1102,341,1625,265,6175
"06065042706",1762,749,661,482,3188,1480,4359,2106,14787
"06065042708",2889,504,200,23,1093,201,1608,246,6764
"06065042709",3102,357,171,22,342,262,1155,286,5697
"06065042711",3501,362,209,2,427,154,558,237,5450
"06065042714",2998,353,22,0,16,20,212,103,3724
"06065042715",8178,355,765,41,4101,1051,4018,727,19236
"06065042716",4616,334,0,0,345,272,1070,553,7190
"06065042717",2616,506,190,61,1500,643,2075,551,8142
"06065042719",3266,1197,118,122,811,300,2082,1352,9248
"06065042720",3257,947,0,1,677,69,2135,739,7825
"06065042723",2830,1782,134,0,714,306,1320,1628,8714
"06065042724",2582,136,98,36,506,23,754,61,4196
"06065042726",4482,372,686,6,1748,118,2133,275,9820
"06065042728",1317,421,34,0,244,120,743,102,2981
"06065042729",6888,1404,381,29,1380,213,2606,649,13550
"06065042730",3204,718,36,0,1193,282,2485,886,8804
"06065042731",3811,380,320,116,1264,423,2710,754,9778
"06065042732",3810,132,408,20,1512,44,2442,66,8434
"06065042733",3600,356,326,0,1018,32,1328,245,6905
"06065042737",1496,93,185,56,490,75,428,81,2904
"06065042738",4288,564,461,30,1729,41,1654,146,8913
"06065042739",4576,466,659,44,1863,163,2811,265,10847
"06065042740",1614,144,67,0,80,22,93,21,2041
"06065042741",1544,323,102,27,122,68,180,102,2468
"06065042742",3296,31,319,4,898,75,1524,4,6151
"06065042743",1740,93,39,0,504,70,728,56,3230
"06065042744",2450,289,13,0,1094,354,1953,445,6598
"06065042745",3367,502,261,0,839,168,1184,382,6703
"06065042800",1968,1239,373,200,2770,1672,4024,2844,15090
"06065042901",2882,678,639,205,2604,1481,4511,1921,14921
"06065042902",1753,629,122,53,1226,443,1896,917,7039
"06065042903",1907,821,356,73,1696,1164,2577,1668,10262
"06065042904",1994,1868,427,395,2713,1884,3974,3355,16610
"06065043001",2029,778,128,48,2286,427,3159,742,9597
"06065043003",2872,822,16,196,2281,837,3683,1104,11811
"06065043005",2276,578,18,56,2309,354,2910,616,9117
"06065043006",1483,528,99,90,2298,924,2876,1204,9502
"06065043007",4780,231,468,6,1285,75,1845,76,8766
"06065043008",3218,868,163,64,1533,565,1906,1080,9397
"06065043009",2975,250,96,0,1516,117,2161,203,7318
"06065043010",3919,154,180,15,1585,112,3238,172,9375
"06065043206",4328,539,489,17,1908,477,1308,626,9692
"06065043211",3688,355,354,0,685,157,1527,149,6915
"06065043216",4512,875,149,106,1173,92,2044,372,9323
"06065043217",2604,68,173,0,450,123,1123,24,4565
"06065043218",4641,248,124,23,986,6,1435,50,7513
"06065043220",2541,366,190,39,619,189,1193,266,5403
"06065043222",2988,236,139,0,631,25,761,76,4856
"06065043227",3753,302,1089,0,1884,328,2141,295,9792
"06065043228",2311,258,186,107,1037,21,1217,172,5309
"06065043229",4437,198,373,0,414,0,709,46,6177
"06065043235",3412,164,451,32,1626,57,956,171,6869
"06065043239",5333,529,4,0,841,0,1056,275,8038
"06065043240",6845,273,666,0,2243,48,2260,143,12478
"06065043242",5341,438,252,46,3026,171,2316,256,11846
"06065043244",5490,202,280,0,1813,99,1853,115,9852
"06065043246",4646,375,134,0,784,33,1088,56,7116
"06065043247",5290,506,584,47,2432,32,2206,238,11335
"06065043248",3294,12,66,0,868,178,952,38,5408
"06065043250",5340,333,445,0,2389,275,1357,288,10427
"06065043252",5344,133,361,0,2575,285,1236,32,9966
"06065043254",3454,325,171,0,1095,67,1549,109,6770
"06065043256",2013,93,218,0,1199,156,1319,41,5039
"06065043257",5482,91,578,4,1393,159,972,77,8756
"06065043262",4197,135,38,0,911,37,1094,45,6457
"06065043264",6180,258,107,0,1322,11,1714,53,9645
"06065043265",5001,134,99,0,1406,72,1578,76,8366
"06065043266",2705,495,427,50,1520,251,1806,280,7534
"06065043267",5315,218,90,0,924,0,1052,0,7599
"06065043270",3599,321,417,14,705,512,1057,42,6667
"06065043271",3052,200,121,0,427,163,1417,319,5699
"06065043272",4165,234,147,2,486,70,1030,99,6233
"06065043274",1399,151,39,5,713,207,712,277,3503
"06065043276",1945,256,444,26,859,46,751,95,4422
"06065043278",4811,500,251,56,1007,85,1390,0,8100
"06065043279",3872,213,240,0,534,5,1590,30,6484
"06065043291",5189,335,178,0,2256,119,1837,69,9983
"06065043304",5690,835,2,0,680,89,1601,88,8985
"06065043306",3105,601,255,155,536,65,1237,423,6377
"06065043307",2852,1173,395,441,747,712,1522,969,8811
"06065043308",1181,337,244,134,465,145,733,229,3468
"06065043309",1343,585,169,60,464,228,764,514,4127
"06065043310",1717,598,120,72,480,513,942,600,5042
"06065043311",1453,377,17,0,264,182,616,344,3253
"06065043312",2593,566,165,213,674,179,1824,625,6839
"06065043313",2091,405,112,192,650,192,1503,353,5498
"06065043314",2638,745,0,0,461,94,1246,403,5587
"06065043315",1500,159,0,0,460,103,452,132,2806
"06065043316",2085,255,333,0,1018,162,318,186,4357
"06065043317",3876,1007,611,625,1281,357,2235,669,10661
"06065043401",2325,2100,123,146,1144,546,2370,1708,10462
"06065043403",1042,769,63,107,582,220,846,532,4161
"06065043404",1835,568,47,93,169,83,399,264,3458
"06065043405",1899,1233,166,474,502,176,1233,527,6210
"06065043503",2021,626,23,181,426,101,973,129,4480
"06065043504",5155,947,269,151,1746,194,2645,578,11685
"06065043505",2266,405,76,12,284,124,843,80,4090
"06065043506",3348,927,264,74,970,297,1502,876,8258
"06065043507",2937,1352,456,227,1424,418,2650,1341,10805
"06065043508",3856,941,348,56,1111,301,2053,488,9154
"06065043509",3248,567,12,106,979,208,2029,478,7627
"06065043512",3497,508,731,38,1411,562,2576,471,9794
"06065043513",1520,354,71,117,739,124,1257,265,4447
"06065043517",4075,822,531,163,1739,334,3108,859,11631
"06065043601",1664,1018,257,92,744,543,1802,1155,7275
"06065043602",1094,552,50,174,1450,587,1970,957,6834
"06065043701",2219,937,100,36,112,175,854,344,4777
"06065043702",3180,946,40,0,643,203,890,754,6656
"06065043703",1775,406,8,0,497,466,445,295,3892
"06065043802",3997,726,44,0,429,174,1130,388,6888
"06065043807",3461,655,186,19,1042,439,1739,730,8271
"06065043809",2380,293,0,10,258,31,452,57,3481
"06065043810",3063,292,188,12,1173,63,1285,77,6153
"06065043811",3075,465,33,60,661,62,1370,229,5955
"06065043812",5142,312,141,0,249,0,258,14,6116
"06065043813",2580,856,12,0,1221,490,1740,925,7824
"06065043814",892,14,8,0,41,6,153,0,1114
"06065043818",2479,135,551,20,968,82,1392,111,5738
"06065043820",2290,168,293,144,1385,139,1508,130,6057
"06065043821",1560,332,242,68,800,222,995,448,4667
"06065043822",1683,266,60,7,823,43,901,36,3819
"06065043823",5882,331,846,14,2315,24,2814,192,12418
"06065043900",4017,908,132,30,666,165,2372,524,8814
"06065044000",850,306,47,19,431,187,966,291,3097
"06065044101",1323,745,148,67,507,208,1259,860,5117
"06065044102",1586,360,80,92,711,141,1204,385,4559
"06065044103",3975,524,489,0,548,30,1686,356,7608
"06065044104",1861,511,22,64,315,119,943,390,4225
"06065044200",2041,1027,273,540,1032,947,1959,1157,8976
"06065044300",2067,337,295,95,979,208,1621,262,5864
"06065044402",4141,311,15,0,245,136,1138,162,6148
"06065044403",2263,676,22,10,644,97,761,43,4516
"06065044404",1104,335,0,0,28,21,244,40,1772
"06065044405",1348,139,0,0,1,19,49,18,1574
"06065044505",4872,570,118,2,1289,116,3877,438,11282
"06065044507",2832,2289,39,56,1261,854,2568,2578,12477
"06065044509",1333,1012,72,373,662,590,745,1269,6056
"06065044510",1755,1019,313,443,1532,701,2344,1201,9308
"06065044515",1475,636,375,2,1113,355,1891,603,6450
"06065044516",3196,825,269,59,1864,494,3455,939,11101
"06065044517",1846,258,12,11,266,56,299,77,2825
"06065044518",2661,1176,144,242,959,277,1506,805,7770
"06065044520",881,151,40,0,549,243,645,286,2795
"06065044521",486,188,10,161,31,30,176,47,1129
"06065044522",2441,676,159,38,1366,474,1866,780,7800
"06065044602",1997,760,131,32,317,31,746,320,4334
"06065044604",3129,418,188,0,748,223,1463,184,6353
"06065044605",3230,564,506,384,465,264,1835,350,7598
"06065044606",1451,339,0,0,235,287,404,446,3162
"06065044701",2071,336,140,16,550,145,720,66,4044
"06065044702",1023,373,16,7,340,323,1287,653,4022
"06065044804",1211,699,21,0,926,135,602,686,4280
"06065044805",1182,223,0,115,192,42,185,63,2002
"06065044806",1409,460,16,0,103,69,215,280,2552
"06065044807",1056,158,25,0,180,41,190,69,1719
"06065044904",2981,360,180,174,1331,132,2134,242,7534
"06065044907",2473,1153,125,53,1008,316,3257,1299,9684
"06065044911",3352,341,84,0,1183,148,1143,88,6339
"06065044915",2963,1587,52,85,1396,671,4007,2124,12885
"06065044916",3020,1138,251,45,565,136,1340,1004,7499
"06065044917",3641,544,0,0,220,0,105,87,4597
"06065044918",2751,230,0,17,39,48,57,24,3166
"06065044919",3647,305,88,0,127,28,145,0,4340
"06065044921",1618,131,53,0,282,41,90,17,2232
"06065044922",3602,209,158,0,1069,69,990,60,6157
"06065044923",2414,496,56,145,702,87,1683,439,6022
"06065044924",2676,480,39,5,1235,110,2636,434,7615
"06065044925",1983,436,40,8,672,128,1571,405,5243
"06065044926",2098,1448,169,4,1092,93,1965,1342,8211
"06065044927",2314,392,31,0,602,89,461,85,3974
"06065044928",2815,140,0,0,201,20,223,23,3422
"06065044929",3843,527,83,0,419,0,1063,74,6009
"06065044930",2396,576,0,0,329,63,1137,437,4938
"06065044931",1463,482,91,10,441,132,1141,464,4224
"06065044932",2108,152,35,17,575,11,912,126,3936
"06065045000",1825,918,36,25,358,173,958,754,5047
"06065045103",2932,451,0,0,127,43,552,100,4205
"06065045108",4065,173,173,24,1436,413,3351,326,9961
"06065045109",2364,237,42,0,715,58,1291,85,4792
"06065045110",3173,309,276,0,1575,69,2685,187,8274
"06065045114",1576,268,23,0,46,0,126,32,2071
"06065045115",1673,64,0,0,86,0,65,0,1888
"06065045116",1240,135,0,0,109,0,320,23,1827
"06065045117",2943,433,23,0,307,100,469,146,4421
"06065045118",1219,474,41,0,635,90,482,278,3219
"06065045119",1989,197,0,13,589,67,1051,66,3972
"06065045120",2811,439,108,0,1321,222,2370,410,7681
"06065045121",4610,570,27,40,885,246,1163,530,8071
"06065045122",1361,90,21,0,72,0,19,0,1563
"06065045123",1948,135,10,0,228,14,320,14,2669
"06065045124",1032,104,0,0,38,13,70,11,1268
"06065045125",2624,40,0,0,168,0,304,0,3136
"06065045207",1538,575,148,22,2200,1038,3206,1524,10251
"06065045209",1730,694,105,50,2247,1019,3419,1622,10886
"06065045212",1578,112,235,26,315,0,284,0,2550
"06065045213",2950,179,176,0,1791,896,3663,813,10468
"06065045214",3923,605,2,0,1003,50,968,119,6670
"06065045215",7491,773,178,15,966,250,2456,756,12885
"06065045216",1473,96,5,0,164,67,145,0,1950
"06065045217",3372,441,68,106,2638,848,4732,1195,13400
"06065045222",1177,52,123,11,583,151,478,14,2589
"06065045224",2425,617,0,30,1962,206,2685,310,8235
"06065045226",2534,387,115,0,2937,660,5329,988,12950
"06065045228",3452,130,65,0,1634,101,2322,126,7830
"06065045233",3664,311,475,76,580,31,2313,43,7493
"06065045302",1409,469,7,31,1652,638,2799,1030,8035
"06065045303",609,595,86,0,889,712,1380,1247,5518
"06065045304",4551,202,208,145,3281,557,4833,673,14450
"06065045501",1208,375,236,39,2358,865,3311,1040,9432
"06065045502",1259,519,22,31,1488,866,2483,1231,7899
"06065045604",3224,2597,168,21,5616,3345,8719,5894,29584
"06065045605",2551,1176,0,13,3011,2671,4202,3669,17293
"06065045606",1914,141,0,0,283,187,824,188,3537
"06065045608",2754,92,66,0,53,0,57,0,3022
"06065045609",1676,602,12,8,1591,1559,3063,2140,10651
"06065045703",1044,351,25,0,3644,2043,4672,2354,14133
"06065045704",415,364,96,7,1408,442,1902,813,5447
"06065045705",1066,822,0,0,3725,3972,4770,4794,19149
"06065045706",1489,726,21,91,1504,928,2968,1654,9381
"06065045707",2111,262,29,0,2893,902,4749,1155,12101
"06065045900",537,196,48,5,568,155,714,250,2473
"06065046101",2033,337,358,23,234,299,1023,509,4816
"06065046102",737,250,69,112,388,463,813,599,3431
"06065046103",1778,124,89,0,896,35,1632,35,4589
"06065046200",961,366,157,306,899,645,1429,867,5630
"06065046401",2409,259,141,0,466,320,916,315,4826
"06065046402",2306,702,29,0,1019,472,1352,640,6520
"06065046403",4500,423,176,0,1949,284,3732,362,11426
"06065046404",2964,925,394,56,1474,574,1840,1066,9293
"06065046405",2083,639,9,0,500,147,1137,506,5021
"06065046500",659,476,140,195,531,1030,372,481,3884
"06065046601",505,18,0,0,46,26,193,26,814
"06065046602",2591,271,60,1,751,110,907,143,4834
"06065046700",1270,628,520,277,1133,356,1750,811,6745
"06065046800",3197,414,1145,151,975,544,3046,637,10109
"06065046900",1005,159,41,64,276,104,763,138,2550
"06065047000",895,192,64,59,223,48,253,79,1813
"06065047201",1473,419,0,0,49,229,310,388,2868
"06065047202",963,390,167,0,380,29,691,151,2771
"06065047900",8952,86,720,10,2991,136,3118,98,16111
"06065048100",4735,403,213,0,1602,57,1970,101,9081
"06065048200",2764,126,198,85,1076,30,1406,119,5804
"06065048300",2241,331,1487,308,2151,258,2589,530,9895
"06065048700",2403,56,572,70,1109,5,1991,41,6247
"06065048800",1209,228,737,408,1494,473,1861,640,7050
"06065048901",2373,425,232,9,1032,289,2101,565,7026
"06065048902",2850,818,854,426,2455,706,4408,1047,13564
"06065049000",2878,434,3128,35,2317,789,3259,325,13165
"06065049100",3093,440,2,0,1499,112,1914,281,7341
"06065049400",2316,214,0,0,500,185,1223,280,4718
"06065049500",2890,277,67,14,3114,1575,5614,1580,15131
"06065049600",4618,447,410,90,2250,16,1949,0,9780
"06065049700",6649,520,143,0,1476,19,1738,0,10545
"06065049800",2249,658,113,9,753,255,1120,137,5294
"06065050300",4704,469,1528,166,3845,30,2526,259,13527
"06065050400",7239,426,316,184,2265,218,3567,470,14685
"06065050500",7798,491,750,290,4498,881,4779,644,20131
"06065050600",5556,527,216,0,862,89,1081,175,8506
"06065050700",6390,134,1302,278,4013,187,3630,0,15934
"06065050900",2576,398,276,208,1153,126,1427,267,6431
"06065051100",1904,431,1618,266,1961,117,2664,545,9506
"06065051200",2444,410,71,0,943,133,1392,366,5759
"06065051300",5527,680,281,91,2465,371,3360,611,13386
"06065051400",5874,529,187,0,196,40,141,0,6967
"06065940100",138,6,0,0,18,0,0,0,162
"06065940400",1590,436,19,7,2964,1225,4485,1638,12364
"06065940500",1798,146,19,0,102,6,113,2,2186
"06065940600",2657,108,22,3,281,44,251,35,3401
"06065940700",2073,184,25,9,209,49,316,97,2962
"06065940800",2195,241,31,2,117,20,142,31,2779
"06065940900",1491,224,41,3,86,41,119,53,2058
"06065941000",2736,729,31,14,165,54,220,237,4186
"06065941100",1524,180,3,0,49,10,78,10,1854
"06065941200",1548,163,28,49,255,46,325,31,2445
"06065941300",2284,468,102,75,341,47,509,215,4041
"06065941400",2133,701,141,74,303,233,688,594,4867
"06065941500",2789,533,112,63,1023,172,1091,191,5974
"06065980004",0,0,0,0,0,0,0,0,0
"06065981000",0,0,0,0,0,0,0,0,0
"06067000100",3186,236,0,22,256,47,320,31,4098
"06067000200",3152,104,82,8,387,14,516,16,4279
"06067000300",2328,173,9,0,494,61,302,10,3377
"06067000400",2678,345,236,14,466,121,791,161,4812
"06067000500",1806,850,118,143,405,221,459,343,4345
"06067000600",401,316,114,200,116,41,107,116,1411
"06067000700",119,65,45,48,175,156,26,0,634
"06067000800",880,195,83,0,200,46,130,12,1546
"06067001101",1121,496,62,80,241,177,243,86,2506
"06067001200",1874,404,53,190,389,48,300,27,3285
"06067001300",1852,388,107,66,508,155,354,136,3566
"06067001400",1415,379,76,36,353,54,275,44,2632
"06067001500",4003,196,58,30,333,54,506,2,5182
"06067001600",4720,420,137,0,608,41,478,141,6545
"06067001700",3374,665,25,253,480,646,386,442,6271
"06067001800",2208,447,763,75,669,306,459,218,5145
"06067001900",2148,267,63,72,305,178,540,79,3652
"06067002000",1087,217,29,22,638,320,350,79,2742
"06067002100",1054,245,45,20,712,506,355,298,3235
"06067002200",1601,670,154,886,595,476,680,577,5639
"06067002300",2499,70,57,0,547,75,256,36,3540
"06067002400",3566,174,0,0,471,151,313,33,4708
"06067002500",1349,36,57,5,202,0,184,5,1838
"06067002600",1763,490,134,58,276,20,304,403,3448
"06067002700",1422,389,712,453,593,165,754,340,4828
"06067002800",995,474,492,366,454,628,809,626,4844
"06067002900",3271,622,266,106,776,178,1219,328,6766
"06067003000",4002,638,313,94,1214,285,1779,384,8709
"06067003101",1656,207,96,61,1096,224,1432,224,4996
"06067003102",1469,338,148,185,598,226,869,412,4245
"06067003202",1414,440,662,110,1381,1214,1006,587,6814
"06067003203",389,185,213,90,1790,544,677,253,4141
"06067003204",1473,529,163,266,2006,1181,1356,545,7519
"06067003300",2426,206,176,9,1112,156,482,65,4632
"06067003400",2150,330,296,281,1350,92,827,152,5478
"06067003501",1387,388,76,63,426,205,421,330,3296
"06067003502",1355,67,51,124,762,148,652,68,3227
"06067003600",1489,244,97,61,613,459,1005,517,4485
"06067003700",727,794,534,152,1145,592,1035,947,5926
"06067003800",1505,542,1357,363,1599,253,1076,429,7124
"06067003900",1991,79,127,20,1156,80,657,13,4123
"06067004001",2220,207,523,53,1798,148,766,136,5851
"06067004004",3260,232,344,0,2380,62,877,96,7251
"06067004005",2096,157,584,41,1115,194,573,31,4791
"06067004006",1909,287,1001,74,1616,127,740,221,5975
"06067004008",1968,47,162,11,1269,154,565,48,4224
"06067004009",1562,1,899,75,2027,182,705,0,5451
"06067004010",1510,122,1420,204,1564,146,684,137,5787
"06067004011",998,69,274,8,1555,62,270,0,3236
"06067004012",1560,79,346,0,1426,59,549,68,4087
"06067004100",994,1033,424,168,1609,645,807,800,6480
"06067004201",1961,657,1106,236,1067,384,1499,705,7615
"06067004202",1246,586,944,171,1875,546,1451,576,7395
"06067004203",775,1225,789,393,1578,732,699,1103,7294
"06067004300",1888,558,1442,580,3634,1079,2059,189,11429
"06067004401",993,316,467,355,1184,585,942,430,5272
"06067004402",1277,737,211,282,958,1223,1488,1152,7328
"06067004501",671,410,105,174,993,677,873,465,4368
"06067004502",1067,825,581,353,1150,813,1296,948,7033
"06067004601",2222,905,173,1225,1964,1083,2031,973,10576
"06067004602",1827,1068,216,203,1256,239,1569,1060,7438
"06067004701",755,692,235,204,885,639,715,847,4972
"06067004702",1694,443,598,364,1462,889,2122,568,8140
"06067004801",1118,219,733,95,2354,1189,989,256,6953
"06067004802",1126,530,468,204,1387,1084,852,708,6359
"06067004903",1465,599,880,881,1850,1467,1180,445,8767
"06067004904",2467,380,542,129,1862,407,1501,392,7680
"06067004905",2050,1375,1518,484,1273,534,1468,1452,10154
"06067004906",797,239,538,271,1065,273,704,234,4121
"06067005001",3149,1014,843,636,3169,701,2586,980,13078
"06067005002",2071,559,832,544,1375,1002,1290,274,7947
"06067005101",1531,538,321,365,1025,786,955,366,5887
"06067005102",1855,532,318,163,1778,420,1016,350,6432
"06067005201",428,328,94,87,462,255,468,264,2386
"06067005202",2228,513,110,51,343,202,541,193,4181
"06067005204",3304,139,162,0,464,402,687,307,5465
"06067005205",901,428,88,220,180,190,109,310,2426
"06067005301",126,299,75,199,42,237,57,312,1347
"06067005402",1235,547,160,15,418,228,355,213,3171
"06067005403",1576,135,50,33,115,355,75,227,2566
"06067005404",3926,458,100,10,550,282,413,178,5917
"06067005502",2016,534,129,190,1441,945,1728,759,7742
"06067005505",1586,849,269,508,1183,588,1001,571,6555
"06067005506",840,460,656,96,633,347,675,387,4094
"06067005508",1474,536,137,71,873,118,444,137,3790
"06067005509",554,269,202,80,609,145,362,100,2321
"06067005510",2274,268,523,142,410,467,644,366,5094
"06067005601",2847,583,187,494,288,179,378,55,5011
"06067005605",1557,256,138,74,813,727,757,556,4878
"06067005606",3110,196,104,155,760,66,328,137,4856
"06067005701",1977,123,175,35,657,33,488,34,3522
"06067005702",3640,132,50,0,729,9,509,17,5086
"06067005801",4191,207,148,0,677,130,468,3,5824
"06067005803",3079,104,0,7,566,4,292,2,4054
"06067005804",2046,42,26,0,409,7,135,15,2680
"06067005901",4425,344,239,42,803,39,545,12,6449
"06067005903",1312,441,137,38,364,44,222,39,2597
"06067005904",3167,701,96,0,752,46,353,37,5152
"06067006002",2138,908,133,9,551,158,674,250,4821
"06067006003",2654,815,296,82,414,345,593,382,5581
"06067006004",1822,195,151,19,198,66,133,22,2606
"06067006101",2543,735,145,448,657,296,608,137,5569
"06067006102",1896,411,358,129,635,61,424,61,3975
"06067006201",2148,719,693,804,796,1204,936,1078,8378
"06067006202",1383,725,287,33,348,424,557,539,4296
"06067006300",1612,1449,325,262,1432,445,1473,1032,8030
"06067006400",2377,856,276,103,1005,610,1338,931,7496
"06067006500",1290,1210,934,528,2023,889,1265,965,9104
"06067006600",1846,771,637,827,1689,895,1462,839,8966
"06067006701",2274,665,803,164,3779,1002,2799,659,12145
"06067006702",1258,1165,811,482,1809,1345,1372,1182,9424
"06067006800",1285,1061,316,480,2465,2110,2154,2238,12109
"06067006900",1782,690,560,392,634,436,748,618,5860
"06067007001",1012,765,136,36,1479,753,1525,971,6677
"06067007004",2042,1006,882,308,2091,819,2076,1421,10645
"06067007007",2378,808,373,128,1486,306,2492,687,8658
"06067007010",1719,364,264,62,1001,243,694,197,4544
"06067007011",1847,928,934,86,2074,509,1431,835,8644
"06067007012",1369,280,417,219,720,260,811,372,4448
"06067007013",1499,250,379,142,738,171,991,251,4421
"06067007014",2979,582,1188,341,2140,240,2588,495,10553
"06067007015",1975,426,668,85,1175,324,595,210,5458
"06067007016",1777,254,565,447,2290,320,960,328,6941
"06067007017",1296,142,211,10,1290,85,474,0,3508
"06067007018",1494,188,220,46,2742,198,623,155,5666
"06067007019",235,102,134,104,221,122,178,44,1140
"06067007020",2592,189,397,8,1285,290,1051,59,5871
"06067007101",181,0,7,0,0,0,0,0,188
"06067007102",3559,205,829,24,2984,191,943,11,8746
"06067007103",1427,86,316,30,2195,171,1331,116,5672
"06067007104",3968,103,1158,26,2520,418,1729,130,10052
"06067007105",2739,331,595,54,2693,460,1972,36,8880
"06067007106",4207,69,666,109,3308,89,1985,65,10498
"06067007107",1416,26,669,0,1165,113,613,2,4004
"06067007202",1900,611,88,0,1022,155,609,235,4620
"06067007204",2333,423,302,125,1148,218,1087,196,5832
"06067007206",3139,133,30,53,523,189,430,45,4542
"06067007207",2854,195,56,8,1041,56,761,88,5059
"06067007208",2610,459,163,80,781,265,464,73,4895
"06067007209",2315,691,88,0,448,268,510,235,4555
"06067007301",1977,1002,411,320,955,475,1137,316,6593
"06067007402",3256,1525,497,57,610,406,753,1151,8255
"06067007403",2276,568,750,218,926,273,738,248,5997
"06067007406",4660,1589,467,191,1459,382,1733,1020,11501
"06067007413",3321,1186,475,141,1085,421,1038,752,8419
"06067007414",2263,458,195,235,672,351,640,276,5090
"06067007415",1802,103,196,60,491,454,567,273,3946
"06067007416",2296,262,230,117,1062,129,820,93,5009
"06067007417",2042,130,289,20,693,131,385,115,3805
"06067007421",6514,217,336,87,1916,127,1293,93,10583
"06067007422",1352,538,80,26,490,103,440,221,3250
"06067007423",1518,807,529,520,664,650,852,443,5983
"06067007424",1608,596,256,379,505,270,549,309,4472
"06067007426",1064,282,70,66,462,309,199,87,2539
"06067007427",3762,1358,318,169,1630,202,884,46,8369
"06067007428",2133,298,238,63,637,243,392,215,4219
"06067007429",2431,959,318,219,1057,209,883,187,6263
"06067007430",3977,901,521,214,2004,116,1351,103,9187
"06067007431",1908,321,230,0,1050,36,385,43,3973
"06067007432",3462,430,597,0,659,113,612,125,5998
"06067007433",3776,668,1051,1,2509,151,892,138,9186
"06067007501",3078,780,167,195,1283,754,1308,555,8120
"06067007503",2625,756,472,303,619,402,569,148,5894
"06067007504",1287,213,23,6,239,157,346,63,2334
"06067007601",4858,635,339,133,524,266,728,449,7932
"06067007602",2876,786,125,186,661,201,365,139,5339
"06067007701",3564,1305,239,207,548,470,489,604,7426
"06067007702",2925,227,107,7,658,190,340,67,4521
"06067007801",3971,1016,379,0,401,147,377,207,6498
"06067007802",3402,411,341,103,444,119,309,17,5146
"06067007903",3500,484,81,270,482,201,585,129,5732
"06067007904",4194,397,40,65,341,20,502,25,5584
"06067007905",3397,325,94,7,508,92,341,103,4867
"06067007906",2687,256,13,26,537,54,384,66,4023
"06067008005",3711,325,8,25,313,18,443,29,4872
"06067008006",5041,220,49,26,449,63,623,18,6489
"06067008007",2215,399,67,0,220,293,328,163,3685
"06067008008",3695,394,63,53,507,121,237,178,5248
"06067008009",3470,424,91,86,434,124,516,75,5220
"06067008010",3569,585,25,3,442,268,312,26,5230
"06067008111",4802,418,12,0,915,245,661,129,7182
"06067008113",2862,481,26,0,205,26,542,76,4218
"06067008117",1494,65,130,41,247,0,228,8,2213
"06067008119",4156,511,23,16,612,357,637,569,6881
"06067008120",2982,349,114,65,600,115,625,87,4937
"06067008122",2802,244,58,13,274,38,330,96,3855
"06067008124",3545,533,77,21,257,34,395,35,4897
"06067008125",3414,571,61,9,1073,108,980,127,6343
"06067008127",3582,1191,48,19,645,186,920,298,6889
"06067008128",1715,88,86,0,291,20,451,0,2651
"06067008129",2133,698,77,6,502,224,246,532,4418
"06067008130",2281,508,115,21,589,456,359,221,4550
"06067008131",3218,623,212,15,519,211,548,142,5488
"06067008132",2856,41,75,119,557,31,290,9,3978
"06067008133",1807,671,175,13,91,116,273,92,3238
"06067008134",3200,403,170,330,805,37,439,210,5594
"06067008135",3044,206,163,6,406,393,527,200,4945
"06067008136",1897,87,26,0,225,41,102,25,2403
"06067008137",1767,475,5,27,250,19,243,16,2802
"06067008138",2680,532,106,1,280,80,738,360,4777
"06067008139",2549,391,71,105,248,121,563,301,4349
"06067008140",2035,206,41,36,338,22,350,32,3060
"06067008141",4068,1367,283,252,549,454,1030,629,8632
"06067008142",2403,481,262,18,270,39,504,221,4198
"06067008143",2881,392,157,22,350,152,796,132,4882
"06067008144",2144,185,10,0,367,5,246,5,2962
"06067008145",6614,436,77,12,926,47,787,32,8931
"06067008203",3498,811,91,0,343,43,367,62,5215
"06067008204",3426,378,11,13,492,13,462,52,4847
"06067008206",4785,285,0,4,527,54,426,54,6135
"06067008207",3711,227,18,7,390,58,143,7,4561
"06067008208",3328,643,100,0,392,16,437,206,5122
"06067008209",3436,150,52,28,369,40,368,33,4476
"06067008210",4646,396,197,0,417,82,335,19,6092
"06067008211",2546,68,0,0,206,11,129,9,2969
"06067008402",4238,487,38,0,582,112,682,0,6139
"06067008403",3883,244,37,7,1456,0,524,0,6151
"06067008404",2083,262,0,0,312,118,299,31,3105
"06067008501",4594,97,126,0,1596,0,782,0,7195
"06067008504",3390,172,91,2,890,9,285,3,4842
"06067008505",1596,68,14,0,503,18,113,0,2312
"06067008506",1573,168,8,9,696,104,228,40,2826
"06067008507",2562,303,32,0,861,8,745,95,4606
"06067008508",4659,47,59,0,2865,21,1328,7,8986
"06067008509",3253,79,44,2,1491,1,396,1,5267
"06067008510",3903,85,43,0,700,4,446,35,5216
"06067008512",2914,12,0,0,992,0,277,0,4195
"06067008513",1654,22,69,0,1563,0,226,0,3534
"06067008600",5612,151,253,5,835,75,780,0,7711
"06067008702",2344,0,20,0,467,21,131,13,2996
"06067008703",2991,273,226,0,1335,47,188,70,5130
"06067008704",1861,193,213,7,1427,78,293,193,4265
"06067008705",2956,276,393,0,2500,139,904,65,7233
"06067008801",2388,205,110,220,1249,79,652,97,5000
"06067008905",2783,512,174,34,910,75,606,223,5317
"06067008907",2703,941,301,121,928,210,956,227,6387
"06067008908",3256,511,266,19,735,148,915,120,5970
"06067008909",1153,425,92,169,362,272,312,394,3179
"06067008910",2254,534,168,111,380,117,661,363,4588
"06067008911",731,332,155,362,481,274,302,276,2913
"06067008912",1955,167,235,69,544,89,481,9,3549
"06067008913",3161,279,51,94,483,380,488,212,5148
"06067009004",2131,231,435,9,469,141,490,17,3923
"06067009005",1524,558,266,64,718,279,431,209,4049
"06067009006",2497,687,691,92,1070,149,896,195,6277
"06067009007",1199,359,268,346,591,55,458,66,3342
"06067009008",2296,584,291,140,946,502,908,415,6082
"06067009010",2087,93,405,86,1821,212,996,163,5863
"06067009011",2143,60,321,31,1431,68,426,28,4508
"06067009103",1975,128,257,78,453,258,457,64,3670
"06067009105",1446,382,236,41,422,205,470,29,3231
"06067009106",2344,383,184,198,696,215,754,185,4959
"06067009107",2058,464,111,67,510,112,375,242,3939
"06067009108",2116,281,193,139,782,44,500,165,4220
"06067009109",2801,566,481,61,1042,266,760,192,6169
"06067009110",349,305,203,202,235,215,165,237,1911
"06067009111",3171,557,463,96,1592,144,1063,365,7451
"06067009112",2110,373,306,126,612,192,676,243,4638
"06067009201",1635,363,254,20,746,162,519,145,3844
"06067009307",3428,494,78,0,942,116,475,304,5837
"06067009308",3739,448,58,4,1584,252,1358,165,7608
"06067009309",1904,186,27,6,299,40,405,104,2971
"06067009310",5000,530,256,9,1168,133,1384,374,8854
"06067009311",2499,470,609,37,2434,710,1120,464,8343
"06067009312",2705,127,338,267,2690,709,1333,85,8254
"06067009314",2116,240,535,554,2540,439,543,308,7275
"06067009316",678,71,573,248,2621,330,589,17,5127
"06067009317",1840,213,762,152,2789,370,1312,215,7653
"06067009318",523,18,279,190,1252,247,480,4,2993
"06067009319",1104,421,480,65,2635,684,740,365,6494
"06067009320",1202,325,523,94,1815,759,806,446,5970
"06067009321",2049,202,864,61,2377,513,1296,136,7498
"06067009322",3609,270,1185,502,6765,1322,2227,412,16292
"06067009323",2730,155,215,49,2049,27,616,11,5852
"06067009324",1861,110,34,0,874,6,492,9,3386
"06067009325",808,41,0,0,66,48,160,29,1152
"06067009326",2599,118,305,22,1813,180,463,0,5500
"06067009328",2035,245,361,11,2517,100,828,26,6123
"06067009329",680,82,284,59,882,240,500,54,2781
"06067009330",1559,113,394,0,1666,103,582,29,4446
"06067009331",2768,396,1256,78,2956,132,1136,130,8852
"06067009332",659,32,24,0,398,105,227,8,1453
"06067009403",1612,130,0,0,249,93,489,98,2671
"06067009404",3930,417,106,2,732,210,693,103,6193
"06067009406",2027,96,68,0,129,20,309,42,2691
"06067009407",6144,938,314,12,1966,774,3070,1378,14596
"06067009408",1309,123,32,54,243,15,437,69,2282
"06067009501",1243,524,1,2,500,398,982,732,4382
"06067009502",4974,728,52,291,1303,396,2523,527,10794
"06067009503",2038,220,7,8,438,340,945,383,4379
"06067009504",1020,337,63,0,462,105,674,236,2897
"06067009601",1483,443,981,378,2394,814,1579,529,8601
"06067009606",1160,464,1465,764,2099,1351,853,965,9121
"06067009608",1515,605,639,603,3290,706,954,232,8544
"06067009609",1666,110,938,298,2165,495,1316,156,7144
"06067009610",1162,375,1045,355,2629,410,1375,414,7765
"06067009611",1483,272,198,134,1118,121,596,152,4074
"06067009612",2108,258,437,43,1750,375,718,22,5711
"06067009614",1893,523,768,494,3063,730,898,125,8494
"06067009615",3756,228,861,401,2534,207,1746,111,9844
"06067009616",2975,195,311,89,1708,189,1087,160,6714
"06067009617",2177,83,320,24,795,134,455,87,4075
"06067009618",1980,261,662,38,1657,298,651,157,5704
"06067009619",3071,579,285,224,3629,54,1426,175,9443
"06067009622",3376,78,909,39,3016,82,1089,0,8589
"06067009630",3208,234,1129,156,5135,635,1486,222,12205
"06067009632",2032,139,706,187,3857,187,1095,53,8256
"06067009633",1012,248,562,167,1218,285,916,183,4591
"06067009634",799,641,481,350,1302,627,939,777,5916
"06067009635",2190,201,1033,9,2929,248,1398,0,8008
"06067009636",2680,126,614,517,3661,251,1406,35,9290
"06067009637",2353,55,467,36,3531,111,941,0,7494
"06067009638",1769,123,383,69,2201,143,969,117,5774
"06067009639",1019,308,622,71,1364,463,663,90,4600
"06067009800",1107,324,9,0,109,70,280,163,2062
"06067009900",2333,347,7,46,1009,200,1534,234,5710
"06067988300",45,0,0,0,0,0,9,0,54
"06069000100",4417,330,27,0,398,76,2218,237,7703
"06069000200",4261,1214,0,0,737,33,2058,667,8970
"06069000300",2910,318,12,0,871,50,3266,331,7758
"06069000400",4263,716,68,14,584,262,3644,889,10440
"06069000501",4398,154,39,0,892,0,2799,0,8282
"06069000502",5324,182,76,0,975,219,4919,350,12045
"06069000600",5810,1183,13,4,1098,33,3010,916,12067
"06069000701",2862,734,61,0,691,43,2848,737,7976
"06069000702",3665,247,61,0,711,73,2275,280,7312
"06069000801",3199,71,33,10,244,15,841,26,4439
"06069000802",1987,177,11,0,310,44,718,147,3394
"06071000103",2147,159,105,84,2004,239,1387,39,6164
"06071000104",2309,232,273,0,3014,253,1353,233,7667
"06071000105",2459,232,135,10,3681,73,1350,16,7956
"06071000107",2033,68,132,0,776,83,932,26,4050
"06071000108",2932,75,163,0,1815,279,1276,0,6540
"06071000109",4640,521,155,224,1202,99,1832,355,9028
"06071000111",1733,51,173,0,858,21,753,30,3619
"06071000113",5191,594,351,0,4974,661,5277,997,18045
"06071000115",3421,64,58,0,3518,101,1677,143,8982
"06071000116",5118,260,764,0,5330,145,2317,34,13968
"06071000117",3177,135,177,21,3130,244,1342,29,8255
"06071000118",1780,51,165,0,2208,141,1069,61,5475
"06071000201",1596,137,313,10,1976,461,2950,407,7850
"06071000203",2167,200,105,0,1560,124,2558,114,6828
"06071000205",2304,277,302,132,1426,491,2382,564,7878
"06071000207",1540,314,0,0,2552,355,3102,399,8262
"06071000208",2150,125,19,9,2445,296,3224,317,8585
"06071000301",1145,658,317,10,4488,2257,4164,2692,15731
"06071000303",2563,548,108,22,3312,851,4873,1152,13429
"06071000304",2012,304,247,18,3223,176,3299,329,9608
"06071000401",4025,140,59,0,1814,207,3569,243,10057
"06071000403",2844,185,75,2,972,200,2069,245,6592
"06071000404",2506,210,119,0,1169,394,2218,268,6884
"06071000501",3225,130,89,0,2666,650,3697,675,11132
"06071000503",2608,235,120,81,1354,208,2412,230,7248
"06071000504",2875,464,28,19,1367,90,1906,307,7056
"06071000603",2289,397,69,70,2077,304,2693,444,8343
"06071000604",2745,366,56,11,1454,772,2669,937,9010
"06071000605",2137,276,53,0,1565,333,3437,548,8349
"06071000606",2713,431,53,0,1168,64,3081,460,7970
"06071000804",2098,92,1,0,638,21,530,21,3401
"06071000808",3377,341,155,158,1883,457,2283,385,9039
"06071000812",2460,189,75,21,514,20,993,58,4330
"06071000813",2506,307,99,0,608,9,656,76,4261
"06071000814",3195,89,0,0,673,0,834,3,4794
"06071000815",2301,318,216,0,792,0,862,10,4499
"06071000816",3653,33,134,0,508,27,1143,9,5507
"06071000817",2352,64,159,30,629,245,855,169,4503
"06071000818",3250,449,113,70,1088,165,1419,185,6739
"06071000819",3266,89,246,0,1489,46,1207,2,6345
"06071000820",2790,199,118,29,799,13,940,76,4964
"06071000821",1906,134,175,40,1391,563,1280,264,5753
"06071000823",2155,620,174,33,2095,1629,2151,1367,10224
"06071000824",1878,550,291,156,1584,474,1635,681,7249
"06071000825",1349,148,286,201,1244,920,1723,965,6836
"06071000826",1999,209,267,65,1375,99,1704,158,5876
"06071000901",1780,414,118,25,1288,403,1725,432,6185
"06071000903",1138,381,401,136,1727,462,2220,572,7037
"06071000904",1346,335,63,97,927,427,1262,555,5012
"06071001001",2011,727,357,87,1962,341,2565,756,8806
"06071001002",1624,957,237,7,2539,593,3762,1449,11168
"06071001101",1543,359,0,81,1104,569,1963,742,6361
"06071001103",2767,433,62,0,1273,188,2306,405,7434
"06071001104",2603,414,312,0,1809,475,2998,657,9268
"06071001200",2853,373,102,0,1648,142,2882,411,8411
"06071001305",1447,946,84,0,1433,867,2312,1759,8848
"06071001307",2433,274,89,0,1287,298,3020,499,7900
"06071001308",2316,390,150,8,1471,649,3311,856,9151
"06071001309",2459,125,121,75,993,774,2849,778,8174
"06071001310",3087,463,212,12,1697,506,3826,820,10623
"06071001311",1604,273,425,1,1278,176,1226,354,5337
"06071001312",2031,346,497,103,1599,343,2258,573,7750
"06071001400",1130,174,266,33,690,236,1196,307,4032
"06071001501",1407,609,0,0,1388,484,2505,1030,7423
"06071001503",1169,454,11,81,1100,881,2019,1135,6850
"06071001504",1791,935,266,115,1440,751,2313,1523,9134
"06071001600",1495,1180,9,0,2044,1150,3371,2314,11563
"06071001702",2278,175,329,112,1418,441,2268,541,7562
"06071001703",2740,409,111,5,2025,569,2557,820,9236
"06071001704",1958,596,241,2,1717,624,2363,763,8264
"06071001706",2346,261,253,206,2295,608,3881,738,10588
"06071001707",2783,16,368,20,2315,649,3665,540,10356
"06071001803",1169,102,159,16,1122,142,1643,183,4536
"06071001804",2641,183,173,51,1945,191,2828,351,8363
"06071001806",2601,34,202,253,1910,39,2729,232,8000
"06071001808",2223,24,324,65,1826,21,3092,43,7618
"06071001809",1913,486,154,22,1895,512,2816,981,8779
"06071001810",1802,376,424,0,2522,103,4014,403,9644
"06071001812",1299,193,18,0,1572,771,2455,920,7228
"06071001813",1471,581,78,51,1926,579,3194,852,8732
"06071001901",2466,257,392,11,1714,25,2461,68,7394
"06071001903",2867,189,337,37,3917,501,1959,444,10251
"06071001905",3682,368,349,0,1571,152,2533,302,8957
"06071001906",4649,241,465,287,3005,322,5118,299,14386
"06071002010",5643,163,1278,1,3097,66,3814,142,14204
"06071002011",3129,216,176,1,396,47,857,50,4872
"06071002013",3387,463,70,26,442,89,1106,245,5828
"06071002014",3596,170,111,0,850,3,1497,0,6227
"06071002015",3101,422,322,0,759,256,1359,429,6648
"06071002016",2864,402,67,0,596,55,1175,315,5474
"06071002017",4076,208,72,0,1465,41,1470,117,7449
"06071002018",3552,252,309,32,1026,185,1717,158,7231
"06071002019",2762,133,413,25,1246,266,1616,209,6670
"06071002021",3452,122,679,0,1425,0,1685,35,7398
"06071002022",7297,83,1125,22,4371,101,4423,0,17422
"06071002023",3422,510,591,112,1122,213,1856,322,8148
"06071002025",3854,195,393,0,881,21,1895,24,7263
"06071002027",3167,600,378,158,1024,185,1390,431,7333
"06071002028",3074,129,633,173,982,1,1857,95,6944
"06071002029",3734,263,352,13,1479,301,1906,63,8111
"06071002031",3691,9,524,0,2033,100,1796,59,8212
"06071002033",5414,123,257,66,1736,176,2647,19,10438
"06071002034",7561,197,1781,10,5660,0,5217,138,20564
"06071002035",3641,178,869,30,1967,193,1914,41,8833
"06071002036",6035,868,1439,277,3151,86,2923,594,15373
"06071002037",3356,327,1071,135,2567,228,3323,209,11216
"06071002038",2660,115,1451,60,1939,18,2451,7,8701
"06071002101",1989,384,312,0,1436,258,2252,516,7147
"06071002103",2747,189,422,127,996,133,1576,185,6375
"06071002105",2597,748,322,115,900,385,2186,528,7781
"06071002107",2906,966,402,21,784,100,2098,496,7773
"06071002109",1753,289,1051,57,1409,198,1577,227,6561
"06071002110",3447,180,439,225,2048,918,2418,357,10032
"06071002204",2228,518,225,72,2993,727,4298,970,12031
"06071002206",3614,96,474,62,2315,163,4016,161,10901
"06071002207",932,348,288,94,343,98,780,235,3118
"06071002301",4373,298,898,111,3352,1275,5608,1547,17462
"06071002304",11333,863,3250,25,4531,59,9227,620,29908
"06071002305",5523,888,1086,77,2767,138,5868,958,17305
"06071002306",1836,444,454,5,1326,77,2566,459,7167
"06071002307",2501,508,400,181,1179,459,3050,881,9159
"06071002401",3125,774,284,61,4188,805,6844,1269,17350
"06071002402",3159,1070,223,15,3170,952,5724,1908,16221
"06071002501",2573,420,353,9,1903,1019,4116,1389,11782
"06071002502",3148,740,135,0,4227,422,6026,1123,15821
"06071002601",4907,1012,431,3,3768,598,6644,981,18344
"06071002602",3089,434,714,8,3184,386,5208,789,13812
"06071002604",2394,492,320,15,2528,133,3828,553,10263
"06071002606",2616,353,810,39,3244,443,4850,642,12997
"06071002607",2668,44,1357,30,3510,225,4814,222,12870
"06071002703",3607,132,655,138,1344,119,3368,156,9519
"06071002704",4053,297,1081,52,4446,567,4125,470,15091
"06071002705",3862,142,363,25,1133,62,4335,169,10091
"06071002706",4149,226,1167,50,1301,135,3344,101,10473
"06071002801",2013,972,238,197,1569,424,3274,1038,9725
"06071002803",1423,515,154,55,1303,721,2325,1161,7657
"06071002804",1371,1210,330,221,1477,1193,2659,2296,10757
"06071002901",1700,533,85,12,1352,213,2642,716,7253
"06071002902",3240,373,485,47,1792,739,4166,754,11596
"06071003000",964,534,247,85,928,283,1573,712,5326
"06071003101",1530,236,198,0,1684,1007,2764,1215,8634
"06071003102",2225,826,6,16,1422,1115,3280,1855,10745
"06071003200",3115,1278,184,262,2802,821,4700,1891,15053
"06071003301",1851,679,111,124,1799,586,3233,1124,9507
"06071003302",1999,690,135,36,2501,765,3669,1171,10966
"06071003401",2726,329,252,0,2985,955,4453,1161,12861
"06071003403",1886,441,143,45,1402,398,2275,618,7208
"06071003404",1949,1173,384,109,1138,296,2735,1318,9102
"06071003405",1376,429,559,222,1501,748,2461,1036,8332
"06071003503",2346,397,1081,0,1685,234,3173,546,9462
"06071003505",2987,1217,490,276,991,542,3580,1709,11792
"06071003506",2522,636,834,354,786,192,2808,718,8850
"06071003507",2655,393,368,109,1654,188,2892,547,8806
"06071003509",2952,854,215,10,482,227,2983,1035,8758
"06071003510",1567,743,583,515,642,463,1847,1208,7568
"06071003603",1545,401,280,87,1553,256,2672,525,7319
"06071003605",2429,37,176,96,1420,337,2935,363,7793
"06071003606",2225,327,111,0,2138,1001,3947,1199,10948
"06071003607",3360,814,284,181,788,41,3412,836,9716
"06071003609",2819,817,413,109,788,179,3086,917,9128
"06071003611",1995,508,777,234,1202,129,2729,581,8155
"06071003612",2412,457,182,48,950,257,2984,687,7977
"06071003700",1669,1073,341,263,409,392,1817,1293,7257
"06071003801",2348,224,920,52,657,221,2581,280,7283
"06071003803",2269,657,288,311,1172,205,2937,759,8598
"06071003804",2548,755,699,126,604,28,2418,743,7921
"06071003900",3509,1152,182,54,582,319,3663,1348,10809
"06071004001",2117,501,37,77,1453,414,2943,675,8217
"06071004003",3019,718,87,72,1468,752,4086,1492,11694
"06071004004",3042,431,133,155,1732,421,4070,767,10751
"06071004101",2937,1297,237,132,608,291,2931,1329,9762
"06071004103",2334,1680,250,67,1637,254,3662,1766,11650
"06071004104",3195,992,156,24,693,856,3254,1727,10897
"06071004201",1451,1555,1512,874,1373,430,2200,1846,11241
"06071004202",2304,1160,421,441,1189,537,3281,1489,10822
"06071004301",2024,648,570,240,1450,213,3123,852,9120
"06071004302",1949,870,132,102,1052,122,2603,1029,7859
"06071004401",2819,952,69,134,345,146,2583,973,8021
"06071004403",3500,709,303,52,817,811,3680,1463,11335
"06071004404",1907,1376,498,183,999,248,2307,1505,9023
"06071004503",2698,153,412,0,512,81,1668,83,5607
"06071004504",4312,402,1201,162,1322,365,2868,420,11052
"06071004505",2557,702,323,162,803,273,1638,743,7201
"06071004507",2140,1109,293,517,881,244,1649,1251,8084
"06071004509",2545,666,519,111,1013,142,1895,737,7628
"06071004510",1360,439,471,210,867,485,1483,366,5681
"06071004601",3277,549,472,235,1361,192,2902,197,9185
"06071004603",2387,617,1279,338,955,150,1834,415,7975
"06071004604",2317,1292,391,284,903,468,2568,1500,9723
"06071004700",2181,857,241,118,1279,717,3272,1558,10223
"06071004800",1471,713,108,31,508,657,1977,1355,6820
"06071004900",2770,1804,78,234,1751,1087,4170,2692,14586
"06071005100",4460,1215,1098,90,1460,377,3222,1028,12950
"06071005200",1520,478,311,77,1240,257,1688,267,5838
"06071005300",1585,822,440,185,1982,485,2657,1050,9206
"06071005400",1917,1597,591,505,1234,489,2474,1695,10502
"06071005500",1787,2709,563,712,997,1552,2519,3114,13953
"06071005600",1335,2023,386,397,581,1836,1693,3195,11446
"06071005701",352,617,119,154,397,552,574,830,3595
"06071005800",1063,613,372,422,309,603,1132,1061,5575
"06071006100",3666,674,940,495,2349,1307,3222,1682,14335
"06071006201",1722,367,122,92,1270,222,1923,537,6255
"06071006203",1656,680,603,700,386,554,1539,933,7051
"06071006204",895,606,407,787,736,512,1144,704,5791
"06071006301",1580,954,198,173,941,619,1899,1294,7658
"06071006302",2944,869,616,792,2024,1156,3343,1836,13580
"06071006401",565,922,116,276,634,826,1100,1542,5981
"06071006402",1159,819,283,572,1063,949,1750,1357,7952
"06071006500",1379,1969,348,240,1428,1133,2014,2526,11037
"06071006601",2712,527,26,0,813,619,2984,932,8613
"06071006603",3060,648,316,0,1824,183,4091,707,10829
"06071006604",1830,879,175,269,805,84,2345,832,7219
"06071006700",2433,706,9,34,962,219,2958,868,8189
"06071007000",3044,1449,65,74,1541,550,3631,1774,12128
"06071007104",2991,86,398,3,696,31,1566,64,5835
"06071007105",1658,196,172,91,472,131,729,230,3679
"06071007106",2963,300,187,141,594,149,1686,272,6292
"06071007107",1063,409,330,333,772,387,1257,558,5109
"06071007108",830,267,323,126,643,101,954,277,3521
"06071007109",3060,918,654,32,1833,380,3080,716,10673
"06071007110",2793,608,242,23,1670,128,2121,460,8045
"06071007200",2251,1501,225,242,1855,1069,2186,1891,11220
"06071007302",4487,334,481,74,3600,341,1112,138,10567
"06071007303",1309,945,724,298,529,761,742,613,5921
"06071007305",1765,723,725,187,1269,124,1157,503,6453
"06071007306",1919,210,762,44,2304,68,1064,75,6446
"06071007403",2983,953,1346,214,1913,15,2785,723,10932
"06071007404",2779,142,398,53,750,180,1206,169,5677
"06071007407",630,593,272,368,577,499,873,893,4705
"06071007408",1189,421,453,258,954,414,1712,823,6224
"06071007409",3366,502,716,104,1670,394,3448,690,10890
"06071007410",2186,711,775,195,1208,161,1958,292,7486
"06071007601",2345,1645,494,378,1634,1146,3275,2106,13023
"06071007603",1768,610,420,270,1486,227,1957,617,7355
"06071007604",1720,437,130,58,1794,324,1626,610,6699
"06071007800",1895,1036,736,247,975,154,695,530,6268
"06071007901",5217,279,712,67,1677,174,1849,74,10049
"06071007903",2772,55,695,24,892,112,1179,15,5744
"06071007904",4958,192,69,21,1292,342,2259,171,9304
"06071008001",3746,811,345,139,1703,183,2878,321,10126
"06071008002",2730,1746,519,204,1179,863,2915,1965,12121
"06071008100",2074,172,139,289,869,155,948,232,4878
"06071008200",4041,371,435,41,540,83,749,155,6415
"06071008301",4539,324,36,28,963,76,1011,40,7017
"06071008302",2168,220,188,0,374,9,376,54,3389
"06071008401",5111,842,494,8,1826,437,2532,259,11509
"06071008402",5085,232,100,86,767,0,1467,96,7833
"06071008403",4524,266,82,29,828,26,939,63,6757
"06071008404",1339,312,213,76,360,217,707,300,3524
"06071008500",6577,456,134,0,1067,116,693,134,9177
"06071008601",4622,497,47,71,1137,97,1705,236,8412
"06071008602",2647,260,145,0,589,69,965,144,4819
"06071008703",5974,148,113,0,900,76,1401,119,8731
"06071008704",6088,852,229,14,905,548,2071,930,11637
"06071008705",2765,825,91,23,779,301,1392,572,6748
"06071008706",9272,538,299,18,2292,373,3357,506,16655
"06071008708",2979,846,14,0,505,9,627,548,5528
"06071008709",2849,677,0,105,223,169,855,450,5328
"06071008710",2355,1458,0,0,736,358,1077,970,6954
"06071008800",4343,1316,0,0,346,49,1527,677,8258
"06071008901",1561,347,48,49,98,29,245,67,2444
"06071009107",5374,1258,38,0,241,0,1501,525,8937
"06071009108",4382,1255,94,18,700,320,1562,711,9042
"06071009109",4464,543,511,0,272,157,1128,174,7249
"06071009110",7450,968,2829,626,3556,1593,7250,2169,26441
"06071009112",3651,1863,662,798,925,482,3295,1996,13672
"06071009114",5150,903,1244,760,1385,945,4652,1444,16483
"06071009116",2030,2080,224,1581,768,601,1877,2113,11274
"06071009117",2281,1452,164,567,338,470,1471,1350,8093
"06071009118",14136,2334,2016,1047,3162,827,11263,1846,36631
"06071009119",4440,370,11,50,416,49,1497,138,6971
"06071009201",3706,458,0,0,195,55,487,140,5041
"06071009202",1898,167,25,5,385,33,638,27,3178
"06071009300",819,378,0,67,140,112,477,316,2309
"06071009400",880,1191,645,385,174,587,656,1130,5648
"06071009500",3435,828,267,1147,552,628,2105,733,9695
"06071009707",4484,265,300,181,634,51,1069,76,7060
"06071009708",3033,1471,60,0,388,16,629,459,6056
"06071009709",3832,1138,307,0,523,167,1178,514,7659
"06071009710",3630,1754,430,394,594,66,2251,739,9858
"06071009711",6910,1038,336,46,1239,75,2250,347,12241
"06071009712",3926,1434,260,245,303,328,1966,1292,9754
"06071009713",5046,833,309,173,420,252,1838,432,9303
"06071009714",2138,646,198,49,395,72,556,259,4313
"06071009715",6164,1007,355,249,1169,6,1752,539,11241
"06071009716",3337,2129,550,416,249,285,1053,1473,9492
"06071009717",3533,474,162,3,530,123,1024,405,6254
"06071009800",1682,1144,297,144,448,603,1491,1194,7003
"06071009904",5356,2967,815,872,1220,470,4774,2587,19061
"06071009905",3082,1184,624,920,1099,1437,2587,2234,13167
"06071009906",2288,159,406,185,1557,227,2203,311,7336
"06071009908",2937,450,396,173,571,182,1836,527,7072
"06071009910",2667,874,563,95,824,29,2256,413,7721
"06071009911",3590,1000,836,222,938,183,2940,819,10528
"06071009912",1723,793,558,891,425,23,1127,477,6017
"06071009913",2668,1606,348,108,650,406,2065,1667,9518
"06071010004",6356,578,305,190,249,53,1255,98,9084
"06071010009",2038,218,326,83,518,57,1255,142,4637
"06071010010",4232,930,99,352,917,355,3441,1072,11398
"06071010011",2483,1310,274,200,667,157,1815,1266,8172
"06071010012",2913,796,166,103,359,213,1516,501,6567
"06071010013",3332,1651,250,150,1658,534,2902,1369,11846
"06071010014",2289,1685,295,53,693,331,2143,1544,9033
"06071010015",3157,1530,295,72,540,409,1990,1266,9259
"06071010016",3069,1332,404,165,805,214,2267,1223,9479
"06071010017",10394,1132,705,505,1776,80,6112,616,21320
"06071010018",4082,1152,403,230,1039,412,2529,1121,10968
"06071010019",3181,1076,46,131,735,30,2186,713,8098
"06071010020",3644,1665,1027,373,704,380,2016,1457,11266
"06071010021",4498,774,0,0,832,128,2224,342,8798
"06071010022",2762,957,25,0,363,77,920,609,5713
"06071010023",4313,594,79,29,746,326,2243,538,8868
"06071010024",4275,482,110,18,376,198,1675,279,7413
"06071010025",3633,1002,572,801,1138,481,2378,1238,11243
"06071010026",5607,1069,996,702,966,1715,3069,1428,15552
"06071010300",2060,497,28,24,332,81,641,191,3854
"06071010402",3542,397,315,111,1216,152,1183,264,7180
"06071010409",1796,372,184,41,187,134,410,144,3268
"06071010410",2292,384,67,11,167,108,290,209,3528
"06071010411",4627,802,258,322,446,586,662,508,8211
"06071010412",5008,1312,0,70,849,286,1049,255,8829
"06071010413",4145,475,122,31,981,442,1478,429,8103
"06071010415",3675,802,420,28,873,104,475,320,6697
"06071010416",1777,995,59,0,523,105,531,138,4128
"06071010417",2117,410,2,0,398,11,536,103,3577
"06071010419",2921,911,43,0,301,174,442,483,5275
"06071010420",2676,584,108,0,434,127,588,126,4643
"06071010421",3108,592,151,688,1043,585,1702,467,8336
"06071010422",945,226,12,0,216,0,172,79,1650
"06071010423",1938,1011,32,0,371,238,312,218,4120
"06071010424",1195,322,0,4,72,32,96,44,1765
"06071010700",2507,842,36,26,366,223,479,395,4874
"06071010802",3571,758,67,0,398,50,416,138,5398
"06071010803",1966,362,30,0,97,38,295,101,2889
"06071010804",1849,687,25,0,239,17,594,230,3641
"06071010901",3733,448,17,0,335,586,532,408,6059
"06071010902",2854,234,0,0,295,18,572,38,4011
"06071011001",1509,308,3,0,188,114,522,212,2856
"06071011002",963,129,44,0,284,120,533,181,2254
"06071011101",2988,284,54,0,201,38,647,17,4229
"06071011102",1670,299,54,12,90,39,221,0,2385
"06071011203",1116,87,0,0,119,0,203,27,1552
"06071011204",1013,185,17,58,68,0,101,0,1442
"06071011205",1121,206,7,0,22,165,326,169,2016
"06071011206",743,160,21,20,76,36,205,67,1328
"06071011300",1127,158,0,0,84,0,175,97,1641
"06071011401",3220,1224,0,0,281,22,839,314,5900
"06071011403",2874,603,0,0,112,8,538,142,4277
"06071011404",3284,671,4,0,130,51,511,87,4738
"06071011500",1472,157,0,0,97,0,173,2,1901
"06071011600",5849,1104,621,93,302,82,1131,604,9786
"06071011700",759,403,14,18,277,30,484,239,2224
"06071011800",3386,1633,415,163,1031,398,1891,1493,10410
"06071011900",2392,521,53,22,628,89,1145,264,5114
"06071012001",3127,675,226,229,1590,86,2063,505,8501
"06071012002",2802,968,279,86,877,390,1714,891,8007
"06071012101",3361,194,501,11,940,101,1508,104,6720
"06071012103",2748,678,34,0,357,88,765,68,4738
"06071012104",2888,1108,83,46,807,58,922,475,6387
"06071012200",745,42,225,19,1528,121,515,41,3236
"06071012300",77,831,53,381,67,616,107,556,2688
"06071012400",1631,514,128,10,822,296,2005,685,6091
"06071012500",2015,777,61,222,1269,301,3128,967,8740
"06071012700",2280,71,331,81,1051,260,1763,310,6147
"06071025000",4729,384,972,105,1248,320,1609,172,9539
"06071025100",482,235,21,4,478,146,192,40,1598
"06071940100",899,201,0,0,133,14,131,17,1395
"06071980100",0,0,0,0,0,0,0,0,0
"06071980200",0,0,0,0,0,0,0,0,0
"06073000100",2446,103,0,0,154,13,246,16,2978
"06073000201",1855,128,27,0,206,7,383,0,2606
"06073000202",3886,225,79,0,351,83,598,117,5339
"06073000300",3404,488,128,0,502,205,403,241,5371
"06073000400",2193,253,64,0,726,68,382,12,3698
"06073000500",2147,191,109,13,336,77,390,38,3301
"06073000600",2085,275,182,19,318,25,482,60,3446
"06073000700",3593,377,48,17,499,42,704,0,5280
"06073000800",2779,389,187,135,388,49,696,164,4787
"06073000900",2939,852,455,171,589,178,1006,332,6522
"06073001000",3720,528,123,69,923,50,946,165,6524
"06073001100",2414,359,317,52,339,64,923,120,4588
"06073001200",3608,795,172,203,1172,114,1830,552,8446
"06073001300",4087,477,502,100,973,190,1663,143,8135
"06073001400",2226,309,172,24,555,0,703,139,4128
"06073001500",2651,396,172,48,515,54,1151,248,5235
"06073001600",2251,910,476,296,1068,291,2117,720,8129
"06073001700",2676,569,306,35,784,117,1548,474,6509
"06073001800",2891,601,718,217,880,85,1427,287,7106
"06073001900",2528,223,37,1,326,56,433,143,3747
"06073002001",2879,110,89,0,187,0,207,0,3472
"06073002002",1816,182,174,85,285,48,312,20,2922
"06073002100",2838,326,512,206,803,157,1314,206,6362
"06073002201",1038,668,562,261,467,709,1231,1031,5967
"06073002202",1442,1619,182,171,1318,656,1898,1880,9166
"06073002301",1117,341,283,408,608,373,763,445,4338
"06073002302",2273,988,280,552,1501,963,2468,834,9859
"06073002401",2657,867,260,173,704,163,1825,816,7465
"06073002402",2539,945,363,151,914,324,2817,966,9019
"06073002501",3137,908,561,28,984,351,3141,788,9898
"06073002502",3085,1077,512,303,1405,136,2444,911,9873
"06073002601",1949,1350,151,48,1246,1332,2212,2081,10369
"06073002602",2046,422,515,137,943,160,2141,381,6745
"06073002702",2503,473,1125,182,839,364,1120,298,6904
"06073002703",3180,699,724,285,1796,473,1956,640,9753
"06073002705",1396,264,324,464,2173,218,1362,268,6469
"06073002707",1404,1018,373,256,1824,630,1737,1277,8519
"06073002708",1568,1327,879,510,1003,818,1737,1494,9336
"06073002709",1080,708,257,519,527,509,1117,834,5551
"06073002710",1226,753,521,379,958,343,1037,693,5910
"06073002711",1197,136,613,117,1334,131,915,7,4450
"06073002712",2019,86,762,301,1269,195,1826,54,6512
"06073002801",941,666,47,39,203,448,163,250,2757
"06073002803",2627,800,830,14,832,262,777,421,6563
"06073002804",2219,1030,329,17,374,233,416,127,4745
"06073002902",3732,864,705,189,1137,208,2034,416,9285
"06073002903",2695,395,323,64,649,71,1480,223,5900
"06073002904",2086,2350,177,69,598,756,521,541,7098
"06073002905",2336,269,419,316,739,206,1048,157,5490
"06073003001",676,298,1102,139,1983,224,2185,504,7111
"06073003003",1740,627,979,27,1515,148,1850,483,7369
"06073003004",1297,426,769,66,2225,592,2932,938,9245
"06073003101",642,129,1139,314,1359,127,1719,204,5633
"06073003103",1203,169,2006,368,2209,708,1792,677,9132
"06073003105",1132,214,490,3,2584,224,2888,394,7929
"06073003107",1769,207,710,236,3095,129,1839,228,8213
"06073003108",2067,351,258,20,828,177,1718,349,5768
"06073003109",307,47,91,88,2671,264,280,115,3863
"06073003111",836,292,1216,292,3002,1578,2238,1649,11103
"06073003112",573,184,633,157,2011,701,756,644,5659
"06073003113",633,94,616,103,3841,361,812,200,6660
"06073003114",260,85,585,82,2444,139,431,110,4136
"06073003115",1063,550,354,261,4222,581,1691,735,9457
"06073003201",1998,536,541,72,2016,402,1042,499,7106
"06073003202",2859,671,148,10,1246,59,2849,641,8483
"06073003204",2182,426,110,0,662,154,1706,361,5601
"06073003207",4187,904,446,0,917,102,3064,873,10493
"06073003208",1387,895,998,107,2753,370,1712,840,9062
"06073003209",1547,263,585,307,2645,145,1689,279,7460
"06073003211",1875,117,184,61,1125,68,1805,82,5317
"06073003212",1877,134,208,0,1167,85,1612,8,5091
"06073003213",935,274,423,12,2663,13,872,239,5431
"06073003214",2183,195,783,334,1654,48,1659,145,7001
"06073003301",538,90,768,254,905,852,1254,960,5621
"06073003303",907,389,274,185,1329,1385,1761,1403,7633
"06073003304",1371,1225,286,212,971,348,1618,1314,7345
"06073003305",624,396,1148,502,1871,1349,1803,1671,9364
"06073003401",2467,306,1876,148,1363,190,1801,137,8288
"06073003403",1758,803,458,65,596,200,1921,963,6764
"06073003404",2057,856,533,145,718,518,2350,1060,8237
"06073003501",1052,835,196,131,1636,892,2415,1662,8819
"06073003502",710,471,340,222,1803,1353,2292,1764,8955
"06073003601",587,171,138,11,1018,1084,1491,1234,5734
"06073003602",936,203,249,103,1259,600,1976,740,6066
"06073003603",966,519,218,14,1904,1074,2590,1407,8692
"06073003800",35,0,0,0,52,0,0,0,87
"06073003901",696,475,110,227,1400,1536,1967,1957,8368
"06073003902",1039,307,280,39,1331,1455,2200,1722,8373
"06073004000",2848,1374,322,142,339,201,2905,1490,9621
"06073004100",3685,1630,393,134,962,242,2835,1096,10977
"06073004200",5036,247,218,23,292,176,1330,197,7519
"06073004300",2885,182,76,37,452,39,944,44,4659
"06073004400",2808,405,64,5,588,154,964,244,5232
"06073004501",1719,415,38,0,340,266,1111,442,4331
"06073004600",904,292,134,38,465,42,290,111,2276
"06073004700",825,645,76,36,160,105,753,718,3318
"06073004800",1754,1151,125,141,403,358,1855,1449,7236
"06073004900",1129,684,109,206,1504,1797,2402,2425,10256
"06073005000",708,349,101,0,613,678,1216,963,4628
"06073005100",2495,2239,460,558,584,587,927,1563,9413
"06073005200",2646,1043,367,267,597,291,805,473,6489
"06073005300",2139,470,380,45,374,179,194,149,3930
"06073005400",5067,494,226,102,1295,319,1295,78,8876
"06073005500",0,0,0,0,0,0,0,0,0
"06073005600",2738,340,164,0,619,51,452,53,4417
"06073005700",897,371,59,100,142,154,206,150,2079
"06073005800",2331,285,17,10,162,83,327,42,3257
"06073005900",2105,245,94,39,231,28,567,68,3377
"06073006000",3204,232,46,0,215,99,435,21,4252
"06073006100",1647,187,243,35,346,15,459,83,3015
"06073006200",0,0,0,0,0,0,0,0,0
"06073006300",51,0,0,0,0,0,0,0,51
"06073006500",1703,455,111,123,415,52,615,151,3625
"06073006600",1064,46,198,23,490,68,464,8,2361
"06073006801",1896,188,130,0,217,0,217,27,2675
"06073006802",3777,807,144,106,752,40,1031,412,7069
"06073006900",4120,619,147,0,411,62,637,256,6252
"06073007002",2722,66,0,0,378,0,375,0,3541
"06073007100",3881,172,0,0,203,58,399,15,4728
"06073007200",3626,155,22,0,179,45,129,5,4161
"06073007301",3963,304,0,0,247,0,451,12,4977
"06073007302",1815,158,0,0,96,0,104,0,2173
"06073007400",5040,729,82,0,606,150,766,232,7605
"06073007501",2919,583,107,0,215,16,376,214,4430
"06073007502",2389,247,62,0,244,24,467,24,3457
"06073007600",3164,960,18,0,82,114,217,86,4641
"06073007701",3390,354,0,0,74,80,359,92,4349
"06073007702",3102,362,0,0,81,148,449,133,4275
"06073007800",4537,576,211,0,722,105,1250,71,7472
"06073007903",3618,607,67,0,248,131,372,58,5101
"06073007905",1736,757,1,0,107,12,128,50,2791
"06073007907",2334,560,17,0,222,19,358,137,3647
"06073007908",2350,423,0,0,132,89,360,122,3476
"06073007910",2274,410,21,0,238,47,227,29,3246
"06073008002",2277,171,15,0,214,10,157,10,2854
"06073008003",3045,279,62,0,376,9,491,34,4296
"06073008006",3528,278,41,0,182,70,220,99,4418
"06073008101",3024,443,0,0,232,52,216,43,4010
"06073008102",2853,97,0,0,265,11,333,11,3570
"06073008200",2176,126,6,17,183,14,86,33,2641
"06073008301",2458,227,0,2,227,9,159,9,3091
"06073008303",3043,183,0,0,170,15,140,17,3568
"06073008305",1001,142,45,17,528,342,288,98,2461
"06073008306",2751,100,0,23,400,56,177,0,3507
"06073008307",2909,121,17,15,519,82,308,59,4030
"06073008310",4557,371,2,0,707,0,331,150,6118
"06073008311",2508,33,0,4,390,30,173,3,3141
"06073008312",2932,354,0,0,360,59,262,39,4006
"06073008313",1760,72,0,0,316,0,180,5,2333
"06073008324",5953,106,36,0,831,36,539,0,7501
"06073008327",4527,139,78,0,1341,44,328,82,6539
"06073008328",3067,191,125,0,1679,152,217,58,5489
"06073008329",3835,716,59,129,1770,351,657,217,7734
"06073008330",3302,43,435,0,1817,218,514,0,6329
"06073008331",1830,55,6,13,500,21,91,16,2532
"06073008333",7857,777,107,0,5554,388,1298,43,16024
"06073008335",6394,189,223,58,4255,105,985,0,12209
"06073008336",1645,0,16,0,567,22,303,0,2553
"06073008337",2854,20,94,0,1591,42,316,0,4917
"06073008339",687,379,7,26,563,472,254,111,2499
"06073008340",3661,1004,617,0,3150,592,597,126,9747
"06073008341",2853,1083,111,0,1841,1600,635,102,8225
"06073008343",1894,593,29,20,1278,1437,541,276,6068
"06073008344",2584,170,0,0,487,142,362,56,3801
"06073008345",2888,256,100,37,672,233,549,153,4888
"06073008346",2188,40,64,0,2899,36,536,10,5773
"06073008347",2525,192,220,47,3480,192,758,251,7665
"06073008348",1939,39,24,4,3495,146,612,0,6259
"06073008349",1153,191,127,0,2114,127,313,54,4079
"06073008350",2060,119,46,0,3747,119,476,0,6567
"06073008351",1320,147,119,92,2339,218,481,114,4830
"06073008352",901,103,129,5,2614,225,470,49,4496
"06073008353",1889,264,73,9,2471,384,583,106,5779
"06073008354",2029,64,636,0,4140,19,946,34,7868
"06073008355",894,69,345,110,2411,28,499,36,4392
"06073008356",1253,69,49,11,2450,215,432,20,4499
"06073008357",1084,79,89,134,3283,398,456,12,5535
"06073008358",2556,414,455,15,3831,477,1433,16,9197
"06073008359",1990,195,85,0,2037,209,971,150,5637
"06073008360",1948,293,873,0,3192,459,728,222,7715
"06073008361",1271,340,5,42,482,188,145,98,2571
"06073008362",1971,413,114,31,483,230,173,99,3514
"06073008363",1628,264,142,0,1885,1427,403,54,5803
"06073008364",2921,414,16,0,1300,736,316,156,5859
"06073008365",1635,42,55,0,1274,66,167,0,3239
"06073008366",3244,160,148,1,2449,47,519,2,6570
"06073008501",4318,411,4,3,377,118,793,125,6149
"06073008502",4426,226,75,14,1309,59,1403,38,7550
"06073008503",5180,334,48,23,847,57,1430,122,8041
"06073008504",4089,499,11,19,1275,8,1003,123,7027
"06073008505",3533,661,149,0,1481,266,1073,389,7552
"06073008506",3006,316,23,8,1120,89,1321,14,5897
"06073008507",4458,697,381,73,2184,631,1203,317,9944
"06073008509",4730,239,341,143,1691,455,1310,21,8930
"06073008510",3751,506,267,10,1895,567,1501,82,8579
"06073008511",1695,192,212,0,1086,346,510,284,4325
"06073008512",3644,128,49,1,998,61,968,44,5893
"06073008513",2442,176,0,0,411,42,462,34,3567
"06073008600",3082,1419,346,126,1906,420,2360,1330,10989
"06073008701",1970,113,266,46,748,135,657,49,3984
"06073008702",2198,355,361,46,1147,242,789,79,5217
"06073008800",1740,710,115,320,2921,1101,871,894,8672
"06073008901",3021,563,394,17,948,214,1425,488,7070
"06073008902",1722,143,101,14,202,130,195,86,2593
"06073009000",1822,579,41,105,885,311,1300,649,5692
"06073009101",4312,225,106,18,975,37,795,2,6470
"06073009102",1878,629,132,17,665,235,783,283,4622
"06073009103",2744,277,35,0,396,39,510,30,4031
"06073009104",2403,217,21,0,336,13,338,0,3328
"06073009106",1464,186,0,6,249,70,352,62,2389
"06073009107",2470,848,118,60,716,114,642,80,5048
"06073009201",2682,370,779,66,1456,79,1049,237,6718
"06073009202",3412,309,164,0,949,166,612,22,5634
"06073009301",2602,226,287,123,1576,217,1214,106,6351
"06073009304",5070,1066,533,35,1344,394,1212,370,10024
"06073009305",3159,430,65,43,1319,242,1373,216,6847
"06073009306",3484,181,514,138,1206,419,865,112,6919
"06073009400",1424,56,207,0,285,73,539,73,2657
"06073009502",2446,81,324,16,890,46,477,0,4280
"06073009504",4530,68,272,0,1722,7,443,0,7042
"06073009505",4457,164,336,16,1733,68,746,67,7587
"06073009506",2893,180,207,0,768,131,544,59,4782
"06073009507",2684,193,143,2,615,25,654,0,4316
"06073009509",2288,148,74,19,907,40,739,0,4215
"06073009510",2989,212,519,104,819,167,952,155,5917
"06073009511",3204,222,204,148,505,41,880,0,5204
"06073009602",2980,80,229,12,565,10,699,0,4575
"06073009603",2870,363,387,170,1159,167,1135,38,6289
"06073009604",2529,167,152,0,627,103,909,36,4523
"06073009703",3019,226,133,0,192,10,499,46,4125
"06073009704",4510,164,434,35,592,105,541,3,6384
"06073009705",2699,296,117,51,456,37,423,133,4212
"06073009706",5890,202,137,8,648,70,1128,39,8122
"06073009801",3669,332,107,10,637,38,581,32,5406
"06073009802",4396,558,27,354,1218,56,1011,293,7913
"06073009804",4291,71,105,15,378,0,1087,14,5961
"06073009805",4064,152,164,0,533,178,550,20,5661
"06073009901",31,0,0,0,0,0,15,0,46
"06073009902",0,0,0,0,0,0,0,0,0
"06073010001",1852,348,18,0,1440,66,2125,318,6167
"06073010003",3629,635,134,112,1868,78,3618,672,10746
"06073010004",2935,576,217,22,797,40,2868,515,7970
"06073010005",4630,2251,16,0,1034,183,5154,2377,15645
"06073010009",4317,1379,48,30,914,276,4991,1614,13569
"06073010010",3069,1323,224,11,1130,204,3011,1260,10232
"06073010011",2485,431,135,142,900,183,2518,438,7232
"06073010012",3394,1348,12,0,431,10,3753,1351,10299
"06073010013",3667,1886,19,9,341,201,3961,1983,12067
"06073010014",8759,267,498,491,6404,187,8611,270,25487
"06073010015",1747,293,182,0,611,46,2159,332,5370
"06073010103",3994,1192,348,63,1291,120,4056,1233,12297
"06073010104",2453,166,158,1,881,87,2034,36,5816
"06073010106",3479,977,71,0,1028,343,3928,1237,11063
"06073010107",4266,615,349,0,1429,301,4333,611,11904
"06073010109",2899,457,110,9,1154,88,3162,451,8330
"06073010110",5094,1246,32,7,1456,335,4368,1413,13951
"06073010111",2118,786,79,0,336,54,2160,754,6287
"06073010112",2825,1337,127,71,586,98,2921,1415,9380
"06073010200",4107,807,34,95,1032,192,1748,437,8452
"06073010300",2846,659,90,15,1013,104,1520,549,6796
"06073010401",1331,263,101,63,394,135,964,371,3622
"06073010402",3515,763,106,216,1348,427,2998,1014,10387
"06073010501",1020,157,0,0,260,14,290,116,1857
"06073010502",3255,623,140,95,1242,451,2803,685,9294
"06073010601",2071,145,24,0,114,78,558,72,3062
"06073010800",2468,93,0,0,225,0,84,13,2883
"06073010900",1809,119,12,0,116,0,196,19,2271
"06073011000",2778,100,48,0,180,10,503,31,3650
"06073011100",3742,191,27,0,342,45,488,29,4864
"06073011300",87,17,0,0,29,0,5,0,138
"06073011601",2798,1014,108,118,1238,511,3349,1345,10481
"06073011602",1720,611,126,46,675,317,1961,824,6280
"06073011700",2062,1009,67,75,2040,795,2206,1420,9674
"06073011801",1593,758,73,7,697,474,1750,1003,6355
"06073011802",2969,1430,372,181,1549,1017,3649,2156,13323
"06073011902",2956,431,121,74,1957,201,2937,473,9150
"06073012002",1073,349,109,57,1949,400,1113,405,5455
"06073012003",1247,381,73,4,1534,272,1509,515,5535
"06073012101",1611,258,15,0,418,215,1462,401,4380
"06073012102",1707,508,88,42,1070,361,2167,798,6741
"06073012200",1712,449,186,41,915,132,1835,547,5817
"06073012302",897,298,11,0,285,208,782,357,2838
"06073012303",2096,494,88,76,580,99,1563,431,5427
"06073012304",2622,226,38,19,368,106,1690,275,5344
"06073012401",1613,995,23,155,649,348,1394,1132,6309
"06073012402",2546,1077,332,91,803,226,2494,1014,8583
"06073012501",1687,755,74,54,377,139,1494,725,5305
"06073012502",2287,1095,151,44,455,167,2232,1208,7639
"06073012600",2805,919,21,11,849,22,2830,859,8316
"06073012700",3312,964,197,21,699,150,3358,912,9613
"06073012800",2508,442,181,9,733,148,2057,427,6505
"06073012900",2247,107,29,0,623,162,1583,174,4925
"06073013000",4048,723,182,0,1124,129,3954,649,10809
"06073013102",4430,823,204,27,879,149,4550,777,11839
"06073013103",1726,359,42,15,418,70,1841,334,4805
"06073013104",3563,1075,207,43,620,176,3499,1125,10308
"06073013203",3862,2012,181,79,406,424,3797,2230,12991
"06073013204",2584,619,45,0,691,167,2960,639,7705
"06073013205",1603,502,2,40,270,58,1746,521,4742
"06073013206",4436,1133,75,29,1224,322,4442,1336,12997
"06073013301",3458,477,31,0,1390,62,3001,235,8654
"06073013302",3424,645,93,0,631,77,2713,562,8145
"06073013303",3754,361,194,2,959,199,3890,454,9813
"06073013306",2558,400,151,110,971,43,2269,362,6864
"06073013307",2878,414,193,24,636,7,2787,264,7203
"06073013308",2573,335,116,0,809,74,2879,304,7090
"06073013309",4932,305,174,60,1892,112,3733,246,11454
"06073013310",11413,2489,1655,69,11727,491,10382,2473,40699
"06073013311",6077,416,643,0,3337,170,4104,456,15203
"06073013312",1988,116,132,17,595,49,1768,124,4789
"06073013313",5128,645,1251,0,5720,302,3955,574,17575
"06073013314",10048,893,1109,0,4889,171,7526,893,25529
"06073013401",3462,203,61,7,800,22,2481,145,7181
"06073013409",3732,361,128,41,1293,85,2797,303,8740
"06073013410",4407,275,478,0,2818,0,3178,43,11199
"06073013411",3528,156,8,10,1678,65,2032,93,7570
"06073013412",3363,167,87,0,1372,41,2243,139,7412
"06073013414",5017,527,208,0,1995,286,3095,271,11399
"06073013415",1169,77,100,0,249,0,711,24,2330
"06073013416",2183,154,375,14,1027,17,1669,21,5460
"06073013417",1539,47,107,6,521,4,939,35,3198
"06073013418",3299,526,397,86,1817,72,3017,446,9660
"06073013419",4835,233,631,0,2413,247,3636,310,12305
"06073013420",1324,247,550,0,1687,69,1558,150,5585
"06073013421",2595,211,187,0,1667,44,2142,116,6962
"06073013503",3421,635,357,64,867,264,1282,187,7077
"06073013504",2450,137,443,0,551,108,1161,0,4850
"06073013505",2986,399,547,39,741,73,989,228,6002
"06073013506",2789,406,503,12,560,81,1311,260,5922
"06073013601",3548,591,362,12,425,47,1119,300,6404
"06073013604",4380,553,178,161,953,27,1132,97,7481
"06073013605",5351,605,61,25,420,61,1490,41,8054
"06073013606",4034,825,204,1,1757,0,1772,152,8745
"06073013701",1782,150,57,0,238,22,460,66,2775
"06073013702",3593,602,541,333,861,234,2105,445,8714
"06073013801",3478,274,255,38,905,38,1748,214,6950
"06073013802",1420,461,331,69,367,126,1035,336,4145
"06073013903",2500,318,299,54,1037,97,1721,195,6221
"06073013905",2571,122,619,217,887,65,1583,83,6147
"06073013906",2555,410,693,376,975,274,1515,263,7061
"06073013907",2660,594,197,103,655,310,2807,730,8056
"06073013908",2586,326,273,38,1084,101,2318,332,7058
"06073013909",2787,443,204,29,767,77,2199,270,6776
"06073014001",2484,564,478,46,719,365,1287,510,6453
"06073014002",2371,287,558,47,1214,166,1763,189,6595
"06073014101",2593,207,344,11,549,420,1476,432,6032
"06073014102",710,195,749,283,1888,146,1394,94,5459
"06073014200",3182,266,387,102,1749,298,2119,338,8441
"06073014300",2472,204,270,9,852,207,1971,334,6319
"06073014400",1259,348,654,263,743,257,1427,329,5280
"06073014500",1644,271,523,170,1119,119,1039,179,5064
"06073014601",3075,539,170,22,893,397,1213,366,6675
"06073014602",3060,158,294,26,912,153,893,110,5606
"06073014700",5760,439,328,179,1399,69,1693,174,10041
"06073014803",3258,286,60,11,978,174,1639,233,6639
"06073014804",2806,305,26,152,261,38,379,94,4061
"06073014805",2648,342,172,15,949,205,907,269,5507
"06073014806",1534,240,106,232,250,234,543,276,3415
"06073014901",3330,313,421,0,469,144,1018,261,5956
"06073014902",2128,271,252,9,393,38,815,84,3990
"06073015000",4260,372,192,48,1388,486,1712,59,8517
"06073015100",3531,331,440,67,708,140,904,208,6329
"06073015200",3282,227,33,4,262,49,554,8,4419
"06073015301",1299,705,288,11,687,129,429,84,3632
"06073015302",2877,121,43,5,571,32,614,24,4287
"06073015403",2119,166,79,0,183,68,218,8,2841
"06073015404",5082,1758,202,93,985,530,1080,41,9771
"06073015405",4981,206,59,0,594,112,1247,113,7312
"06073015406",1933,68,114,0,385,36,176,46,2758
"06073015501",4008,392,0,0,515,88,748,67,5818
"06073015502",2163,171,8,0,418,97,708,117,3682
"06073015601",3735,979,152,0,1278,272,2101,90,8607
"06073015602",1896,75,0,0,182,8,340,27,2528
"06073015701",2866,1886,627,39,907,416,2337,1142,10220
"06073015703",3420,2063,143,182,834,520,1646,465,9273
"06073015704",1899,808,91,196,985,234,1023,567,5803
"06073015801",1249,1235,210,18,700,309,1115,574,5410
"06073015802",2093,1055,159,101,863,446,1164,670,6551
"06073015901",1286,778,296,76,736,414,1149,657,5392
"06073015902",2611,1084,208,216,744,265,1430,149,6707
"06073016000",1747,134,30,34,409,48,511,130,3043
"06073016100",4423,347,243,2,933,132,550,226,6856
"06073016201",4345,226,152,7,782,0,550,32,6094
"06073016202",2031,411,318,30,400,46,613,122,3971
"06073016301",2621,1193,333,88,685,161,1377,407,6865
"06073016302",2942,1077,272,115,927,200,1420,565,7518
"06073016401",3834,445,0,34,582,96,1051,92,6134
"06073016402",5177,1042,190,59,905,334,1591,634,9932
"06073016502",3930,1177,196,0,1140,772,1772,425,9412
"06073016503",1631,387,385,131,443,107,687,287,4058
"06073016504",4225,780,346,253,897,367,2495,555,9918
"06073016605",5773,482,165,0,877,123,1110,51,8581
"06073016606",2965,92,0,0,932,9,907,10,4915
"06073016607",4871,477,39,0,525,10,703,132,6757
"06073016608",2334,70,9,3,280,0,291,0,2987
"06073016609",4099,407,100,95,560,11,836,96,6204
"06073016610",3086,207,51,0,660,50,557,41,4652
"06073016612",5130,182,63,1,522,191,1139,216,7444
"06073016613",1538,32,6,8,338,36,153,13,2124
"06073016614",3087,168,48,0,832,0,421,12,4568
"06073016615",1869,129,2,0,401,33,400,16,2850
"06073016616",2864,864,72,4,423,68,681,36,5012
"06073016617",2454,276,60,7,423,79,581,22,3902
"06073016701",7519,1150,156,0,1261,110,1351,212,11759
"06073016702",5245,631,101,20,682,17,1521,170,8387
"06073016802",6192,726,50,0,455,116,550,83,8172
"06073016804",5160,1365,17,115,549,211,1330,668,9415
"06073016806",2994,703,90,15,509,23,861,257,5452
"06073016807",6157,571,8,0,429,7,1082,34,8288
"06073016809",4071,290,26,12,529,65,930,166,6089
"06073016810",2411,158,20,9,258,26,317,17,3216
"06073016811",3701,302,45,9,256,7,1034,168,5522
"06073016901",4976,149,468,0,907,20,827,0,7347
"06073016902",1708,198,35,0,573,139,298,68,3019
"06073017006",2094,112,0,0,439,34,125,36,2840
"06073017009",2874,143,80,0,905,23,831,68,4924
"06073017010",2387,114,82,0,477,0,403,35,3498
"06073017014",1991,162,0,0,144,19,94,18,2428
"06073017015",5682,251,272,33,1732,125,1285,17,9397
"06073017018",1937,79,173,1,2211,82,547,0,5030
"06073017019",4665,194,128,0,1024,0,434,12,6457
"06073017020",3289,144,94,11,156,39,213,85,4031
"06073017021",2352,106,24,0,306,39,116,57,3000
"06073017022",4301,329,205,0,707,52,603,0,6197
"06073017029",7242,407,23,0,1395,0,1040,124,10231
"06073017030",10988,502,362,0,7540,22,1256,11,20681
"06073017031",2678,194,9,0,872,101,515,53,4422
"06073017032",6319,188,460,2,6497,13,941,60,14480
"06073017033",2565,45,26,2,2038,35,498,31,5240
"06073017034",3439,89,43,0,1467,216,623,105,5982
"06073017035",1656,150,82,217,652,222,200,7,3186
"06073017036",1965,44,109,0,1196,135,362,44,3855
"06073017037",3519,181,19,90,1601,505,859,210,6984
"06073017039",4015,112,24,0,3002,97,873,0,8123
"06073017040",2916,169,127,0,1389,78,802,7,5488
"06073017041",5112,294,55,0,843,7,1170,52,7533
"06073017042",4489,172,121,0,3361,137,550,64,8894
"06073017043",3484,245,73,0,2442,93,722,19,7078
"06073017044",3265,22,127,56,2191,119,482,0,6262
"06073017045",1706,19,20,0,969,28,154,0,2896
"06073017046",2439,88,0,0,1084,25,139,0,3775
"06073017047",2924,65,24,0,802,68,447,15,4345
"06073017048",4479,367,29,0,2305,226,1977,344,9727
"06073017049",2081,300,42,1,606,66,610,228,3934
"06073017050",2197,105,111,0,732,13,924,10,4092
"06073017051",2762,144,222,0,1076,205,252,43,4704
"06073017052",2959,246,86,0,1399,204,476,91,5461
"06073017053",2797,135,57,1,320,3,305,5,3623
"06073017054",4125,334,112,21,907,96,642,69,6306
"06073017055",3342,63,53,0,1748,29,509,0,5744
"06073017056",2334,133,102,0,1223,23,356,10,4181
"06073017104",3309,320,10,2,249,18,312,105,4325
"06073017106",3981,520,0,0,268,63,558,0,5390
"06073017107",2246,136,26,0,313,0,201,0,2922
"06073017108",4153,85,32,14,487,30,493,59,5353
"06073017109",5283,389,9,0,742,15,471,33,6942
"06073017110",8357,997,381,35,1386,89,1264,373,12882
"06073017200",3962,126,0,0,142,23,541,0,4794
"06073017303",2505,141,22,0,215,0,253,7,3143
"06073017304",4474,303,24,18,1185,277,1331,204,7816
"06073017305",2317,107,0,0,335,10,65,0,2834
"06073017306",2244,72,28,0,415,0,203,0,2962
"06073017401",5262,379,0,0,437,50,366,0,6494
"06073017403",4508,196,35,0,545,0,629,70,5983
"06073017404",5815,503,53,41,622,131,794,287,8246
"06073017501",2862,113,0,0,206,22,279,9,3491
"06073017502",2380,633,0,0,341,67,690,415,4526
"06073017601",4451,156,0,21,739,105,350,0,5822
"06073017603",1886,194,19,6,324,9,398,71,2907
"06073017604",4839,481,49,149,1102,67,911,51,7649
"06073017701",4126,731,11,0,170,44,316,188,5586
"06073017702",2582,213,0,0,96,63,251,0,3205
"06073017801",4900,362,0,0,1047,0,1191,33,7533
"06073017808",4763,679,0,0,593,53,566,0,6654
"06073017809",1755,310,1,1,287,9,296,111,2770
"06073017810",4408,325,46,3,252,0,292,203,5529
"06073017811",5842,716,89,0,886,57,885,117,8592
"06073017813",3574,260,12,0,453,13,322,26,4660
"06073017900",5101,1152,36,2,750,99,2255,345,9740
"06073018000",2638,215,136,0,138,7,215,7,3356
"06073018100",4687,545,115,12,851,234,1403,282,8129
"06073018200",4561,1211,147,168,1842,235,3399,969,12532
"06073018300",1823,289,0,0,256,25,383,25,2801
"06073018400",1615,377,31,112,540,316,913,252,4156
"06073018504",4917,439,451,3,784,339,1424,106,8463
"06073018507",4619,859,143,28,3081,607,3431,670,13438
"06073018509",2284,557,289,66,1125,293,1956,606,7176
"06073018510",1727,573,43,1,857,26,1415,290,4932
"06073018511",2690,427,103,94,1030,181,1128,397,6050
"06073018512",2462,362,276,20,269,50,633,149,4221
"06073018513",6080,677,483,220,1535,133,1730,218,11076
"06073018514",4751,750,661,79,1680,397,1785,328,10431
"06073018515",3792,154,305,0,698,105,926,123,6103
"06073018516",1963,504,109,51,1033,175,966,307,5108
"06073018517",2634,724,500,0,1116,67,1379,224,6644
"06073018518",1791,251,18,12,1010,148,1658,286,5174
"06073018519",3064,674,115,109,1319,441,2989,1050,9761
"06073018601",3245,367,97,27,940,32,1121,51,5880
"06073018603",3335,547,482,64,1255,692,2784,796,9955
"06073018608",2302,201,79,19,661,25,1077,98,4462
"06073018609",2931,664,408,55,1684,169,2173,526,8610
"06073018610",3743,728,265,164,2494,267,3606,686,11953
"06073018611",4082,1236,406,64,2054,120,1317,749,10028
"06073018612",2310,227,82,172,674,35,987,179,4666
"06073018613",1836,222,339,0,956,70,1108,42,4573
"06073018614",3487,471,503,13,1369,473,1872,477,8665
"06073018700",14621,1696,2232,120,3419,330,4698,688,27804
"06073018801",3207,376,21,11,163,23,411,58,4270
"06073018802",6355,611,150,5,878,131,869,96,9095
"06073018803",3089,285,55,6,923,35,751,41,5185
"06073018903",3163,996,39,0,601,5,1579,518,6901
"06073018904",3762,903,144,0,1041,375,2723,798,9746
"06073018905",3885,985,131,43,945,656,2671,1149,10465
"06073018906",3764,660,202,63,842,542,1839,749,8661
"06073019001",4361,717,31,16,1535,271,1137,428,8496
"06073019002",1112,123,0,0,155,21,468,80,1959
"06073019101",4054,700,28,41,1835,393,1266,592,8909
"06073019103",4276,782,0,0,524,0,518,258,6358
"06073019105",5157,452,19,35,785,0,686,7,7141
"06073019106",6177,556,23,14,1700,693,1978,553,11694
"06073019107",1289,205,0,37,267,75,300,73,2246
"06073019203",1945,175,72,0,359,47,580,45,3223
"06073019205",4332,934,368,0,941,103,3062,684,10424
"06073019206",3976,671,67,54,629,247,3394,784,9822
"06073019207",5941,1871,432,12,1154,86,3331,1299,14126
"06073019208",2818,183,4,0,270,15,787,55,4132
"06073019301",4602,399,333,2,1275,158,1265,29,8063
"06073019302",5039,709,247,124,1223,141,1869,158,9510
"06073019303",4815,961,68,0,1676,224,2618,459,10821
"06073019403",3935,550,237,16,812,159,2512,360,8581
"06073019404",2377,447,43,0,492,41,2292,332,6024
"06073019405",2362,687,191,0,539,34,1466,490,5769
"06073019406",3114,577,144,7,860,70,1805,202,6779
"06073019501",2324,499,62,43,397,45,2372,462,6204
"06073019502",3295,1277,14,0,655,302,3535,1387,10465
"06073019503",2770,926,140,0,935,220,2755,493,8239
"06073019601",4531,783,64,31,668,39,1637,319,8072
"06073019602",3202,958,279,42,447,180,1222,671,7001
"06073019701",3416,629,196,18,1113,247,1413,171,7203
"06073019702",3778,641,129,11,532,63,1578,364,7096
"06073019803",3499,291,20,0,718,7,759,29,5323
"06073019804",3966,208,0,0,448,91,634,26,5373
"06073019805",2003,801,98,44,946,178,1250,657,5977
"06073019806",8817,1578,76,0,1751,220,1393,513,14348
"06073019808",3369,440,33,0,1011,0,461,21,5335
"06073019809",3558,191,18,13,541,36,430,55,4842
"06073019902",2985,691,14,0,256,24,1169,355,5494
"06073019903",3202,304,167,0,760,88,1329,111,5961
"06073019904",4191,803,371,44,1452,194,1279,119,8453
"06073019905",2949,645,18,8,431,150,503,292,4996
"06073020013",9312,622,492,0,2611,451,1943,0,15431
"06073020014",5468,589,45,0,1232,158,695,128,8315
"06073020015",3300,320,33,0,570,41,137,32,4433
"06073020016",7402,960,36,4,970,42,663,16,10093
"06073020017",2155,775,241,19,144,30,1131,263,4758
"06073020018",4804,1096,305,3,1647,517,4698,1189,14259
"06073020019",4978,784,12,47,1020,81,1676,360,8958
"06073020020",4380,569,149,0,2083,600,1649,193,9623
"06073020021",3297,829,82,38,1676,396,3049,838,10205
"06073020022",4189,1383,162,47,1856,107,1646,690,10080
"06073020023",3315,356,46,0,609,0,1534,60,5920
"06073020024",2662,328,118,23,1092,35,1415,88,5761
"06073020025",2959,459,187,42,995,180,1191,189,6202
"06073020026",2693,331,78,0,1224,33,839,17,5215
"06073020027",10790,1266,216,0,2654,130,2274,195,17525
"06073020028",1910,1036,32,0,701,321,2114,1315,7429
"06073020029",2952,617,277,0,674,832,2386,1030,8768
"06073020103",7486,1084,23,7,2091,66,2662,115,13534
"06073020105",2601,897,102,0,524,256,920,368,5668
"06073020106",2861,268,0,118,688,115,1857,231,6138
"06073020107",2839,426,76,0,577,50,1420,326,5714
"06073020108",3838,981,120,43,698,223,3099,833,9835
"06073020109",3665,807,100,4,779,14,2442,608,8419
"06073020202",2922,1874,327,74,1101,243,3358,1956,11855
"06073020206",3695,979,124,128,458,122,3177,807,9490
"06073020207",3165,849,123,24,915,64,2822,727,8689
"06073020208",1961,216,48,0,402,77,1493,250,4447
"06073020209",3017,893,41,47,1062,194,2490,574,8318
"06073020210",2782,708,38,0,1454,158,2080,507,7727
"06073020211",4098,1612,297,0,996,82,3502,1184,11771
"06073020213",2205,1335,44,0,359,37,1973,1207,7160
"06073020214",2485,2145,107,16,401,360,2281,1823,9618
"06073020304",4484,814,21,0,875,0,1099,27,7320
"06073020305",4098,614,319,14,999,206,1124,380,7754
"06073020306",5625,1075,182,56,1350,173,1142,176,9779
"06073020307",5251,1206,98,31,898,59,1954,337,9834
"06073020308",3443,888,150,83,790,150,1610,344,7458
"06073020309",3095,682,35,0,759,89,1753,496,6909
"06073020401",2099,105,40,3,121,4,209,4,2585
"06073020403",2660,233,2,0,1097,61,1132,128,5313
"06073020404",3289,235,231,10,718,149,968,38,5638
"06073020405",2690,158,8,6,357,68,171,23,3481
"06073020500",3465,945,0,0,611,51,2333,449,7854
"06073020601",3268,1327,51,22,1001,214,3147,950,9980
"06073020602",3802,1107,63,13,829,258,1707,929,8708
"06073020705",3341,443,135,0,883,25,1171,228,6226
"06073020706",5091,221,24,62,854,8,1132,16,7408
"06073020707",2642,776,156,0,610,69,1371,636,6260
"06073020708",2644,129,213,0,636,22,736,21,4401
"06073020709",5829,440,273,17,1495,101,2124,132,10411
"06073020710",1364,53,27,0,123,5,259,0,1831
"06073020801",4578,311,41,0,340,0,772,44,6086
"06073020805",2528,441,369,0,277,0,826,222,4663
"06073020806",4436,656,22,0,716,144,1649,282,7905
"06073020807",2108,180,33,0,116,6,328,63,2834
"06073020809",5528,522,11,7,1896,152,2637,172,10925
"06073020810",4660,248,0,0,167,11,657,99,5842
"06073020811",4891,200,172,0,377,2,555,0,6197
"06073020902",1730,189,23,0,114,42,98,23,2219
"06073020903",1715,266,12,4,463,365,328,62,3215
"06073020904",2096,233,0,4,253,5,308,0,2899
"06073021000",2473,617,48,67,288,0,689,152,4334
"06073021100",4472,1138,191,9,730,306,2194,445,9485
"06073021202",2453,385,0,0,283,116,424,90,3751
"06073021204",4978,277,61,0,238,12,591,44,6201
"06073021205",5705,860,33,50,635,37,1446,226,8992
"06073021206",2245,102,30,16,258,0,160,20,2831
"06073021302",3448,629,134,10,128,112,734,544,5739
"06073021303",5710,268,359,0,2277,65,2545,129,11353
"06073021304",2194,130,47,12,207,0,608,48,3246
"06073021400",4379,365,300,0,1394,74,1084,60,7656
"06073021500",5672,110,128,0,3317,206,783,24,10240
"06073021600",2302,225,64,0,245,0,528,34,3398
"06073021800",2146,168,0,11,51,5,82,4,2467
"06073021900",913,304,0,55,415,87,1102,335,3211
"06073022000",1101,231,152,11,2381,359,1459,298,5992
"06073022100",6618,606,0,0,1532,416,1540,368,11080
"06073990100",0,0,0,0,0,0,0,0,0
"06075010100",1846,278,15,38,1329,273,305,143,4227
"06075010200",3368,152,0,0,596,56,133,1,4306
"06075010300",2329,160,0,0,1361,537,329,62,4778
"06075010400",2855,266,0,0,1875,140,401,44,5581
"06075010500",1295,130,51,0,999,114,71,71,2731
"06075010600",1113,131,18,46,1593,703,212,0,3816
"06075010700",983,263,0,0,2940,1116,79,92,5473
"06075010800",2126,211,0,0,2061,667,410,0,5475
"06075010900",2870,237,87,13,1165,163,78,0,4613
"06075011000",2368,50,52,18,2392,205,354,0,5439
"06075011100",2956,175,171,36,1257,336,338,105,5374
"06075011200",1742,103,59,1,1087,289,197,1,3479
"06075011300",549,0,28,48,1606,618,57,0,2906
"06075011700",415,165,13,92,756,142,152,74,1809
"06075011800",99,74,0,3,940,506,83,21,1726
"06075011901",1213,148,110,0,627,180,146,23,2447
"06075011902",1237,313,33,26,983,194,288,102,3176
"06075012000",1605,199,155,58,1165,562,174,61,3979
"06075012100",1788,182,13,61,967,310,511,144,3976
"06075012201",1728,371,144,173,1829,600,1135,28,6008
"06075012202",1162,397,486,160,670,420,607,200,4102
"06075012301",637,353,137,66,369,434,286,268,2550
"06075012302",840,242,99,55,835,356,317,30,2774
"06075012401",1784,519,123,146,1558,653,1264,433,6480
"06075012402",1081,346,87,156,1266,354,274,179,3743
"06075012501",921,336,145,383,1227,637,440,122,4211
"06075012502",675,410,69,294,1407,1074,534,452,4915
"06075012601",1959,47,14,0,314,0,343,0,2677
"06075012602",2442,88,0,0,369,44,126,0,3069
"06075012700",2849,185,142,0,566,18,200,0,3960
"06075012800",4084,171,0,59,744,70,506,84,5718
"06075012901",2005,89,0,0,481,0,91,11,2677
"06075012902",2503,207,33,0,615,97,217,0,3672
"06075013000",3541,348,0,0,696,28,277,0,4890
"06075013101",2780,99,111,1,921,83,190,50,4235
"06075013102",2229,124,8,1,363,57,117,57,2956
"06075013200",3870,85,89,0,677,47,239,0,5007
"06075013300",3145,268,17,69,756,198,314,54,4821
"06075013400",3112,118,10,29,489,100,215,41,4114
"06075013500",1831,78,35,31,506,99,197,12,2789
"06075015100",1207,91,0,0,790,53,177,0,2318
"06075015200",2531,326,158,118,1014,62,156,16,4381
"06075015300",1393,66,155,11,336,54,131,22,2168
"06075015400",3611,268,177,0,1942,72,186,116,6372
"06075015500",1837,221,116,71,914,388,268,4,3819
"06075015600",1513,340,48,0,1253,169,193,135,3651
"06075015700",3105,387,285,31,1920,150,501,0,6379
"06075015801",1520,70,873,617,671,146,311,95,4303
"06075015802",1911,156,215,63,639,85,293,93,3455
"06075015900",1434,204,447,73,1394,448,407,0,4407
"06075016000",1192,144,102,85,941,90,184,48,2786
"06075016100",848,489,1231,588,1642,656,357,60,5871
"06075016200",1763,136,57,60,659,58,350,59,3142
"06075016300",2358,216,777,392,716,146,805,28,5438
"06075016400",2667,268,301,130,460,106,339,116,4387
"06075016500",3372,497,562,95,960,68,587,117,6258
"06075016600",3669,513,77,13,990,206,365,46,5879
"06075016700",3681,300,165,15,471,100,421,28,5181
"06075016801",2142,255,429,31,622,65,299,25,3868
"06075016802",1725,172,110,106,783,115,533,77,3621
"06075016900",2148,161,114,27,461,43,315,33,3302
"06075017000",2918,174,87,0,613,33,242,16,4083
"06075017101",3032,96,112,40,432,21,236,21,3990
"06075017102",2721,259,91,20,552,87,253,86,4069
"06075017601",1581,791,482,495,3118,741,306,288,7802
"06075017700",709,210,45,3,692,104,472,124,2359
"06075017801",746,117,83,57,1133,967,39,46,3188
"06075017802",1547,467,260,361,1711,183,576,126,5231
"06075017902",692,385,233,305,492,835,446,424,3812
"06075018000",1231,243,146,129,773,226,166,159,3073
"06075020100",1943,631,35,195,2000,740,1627,798,7969
"06075020200",3355,408,184,167,1632,179,1191,22,7138
"06075020300",1996,201,63,18,625,127,366,87,3483
"06075020401",2357,50,88,30,564,24,150,0,3263
"06075020402",3220,154,91,23,955,47,572,16,5078
"06075020500",2136,126,65,0,341,38,235,19,2960
"06075020600",3600,205,41,62,630,123,447,16,5124
"06075020700",3430,470,44,23,1406,180,579,172,6304
"06075020800",2968,492,94,61,2268,419,2339,631,9272
"06075020900",2413,478,51,17,1450,345,1966,433,7153
"06075021000",3090,156,0,22,1042,206,776,164,5456
"06075021100",2905,229,62,0,751,19,368,75,4409
"06075021200",2170,147,25,0,447,50,213,9,3061
"06075021300",1994,62,0,0,583,22,218,0,2879
"06075021400",2832,112,14,0,731,8,452,11,4160
"06075021500",4047,225,126,30,717,36,555,20,5756
"06075021600",2331,251,304,84,1412,13,539,0,4934
"06075021700",2211,132,270,128,1045,189,343,159,4477
"06075021800",3098,184,83,39,733,7,493,15,4652
"06075022600",1231,29,182,3,430,14,161,0,2050
"06075022702",1645,66,71,1,475,37,279,1,2575
"06075022704",2229,131,36,0,817,37,206,34,3490
"06075022801",2643,311,77,101,1900,181,1652,125,6990
"06075022802",871,340,55,4,491,174,628,344,2907
"06075022803",2458,425,111,31,1622,155,2163,411,7376
"06075022901",2555,253,48,110,1630,751,2569,761,8677
"06075022902",1512,203,85,56,647,44,1074,76,3697
"06075022903",1410,119,58,35,1211,251,1241,241,4566
"06075023001",574,35,583,28,2919,930,364,4,5437
"06075023003",773,70,1120,227,1802,322,523,133,4970
"06075023102",337,205,1361,1234,946,568,312,386,5349
"06075023103",126,133,905,505,742,511,402,246,3570
"06075023200",904,242,1225,682,1084,218,1182,227,5764
"06075023300",483,0,182,43,2189,311,458,36,3702
"06075023400",411,12,399,226,1457,471,959,72,4007
"06075025100",2069,176,276,11,806,84,686,103,4211
"06075025200",3747,312,68,17,1650,154,1554,189,7691
"06075025300",2576,221,79,20,1355,245,984,170,5650
"06075025401",1650,188,168,56,1135,54,1095,34,4380
"06075025402",1844,131,69,6,987,43,324,125,3529
"06075025403",1903,275,376,85,2238,251,1870,260,7258
"06075025500",3076,186,81,10,5409,467,3374,266,12869
"06075025600",1336,130,169,0,3788,225,1082,78,6808
"06075025701",734,287,173,55,3475,285,1033,113,6155
"06075025702",511,176,29,85,3729,376,1219,83,6208
"06075025800",331,62,104,16,1067,444,367,129,2520
"06075025900",1298,101,254,21,2429,146,873,35,5157
"06075026001",1446,197,178,18,3319,593,2030,470,8251
"06075026002",1009,49,162,0,1882,137,1024,167,4430
"06075026003",1467,131,62,2,3119,187,1873,57,6898
"06075026004",1726,121,43,35,2790,300,1787,62,6864
"06075026100",971,317,106,22,5022,462,1488,398,8786
"06075026200",1180,244,80,10,5788,412,1426,325,9465
"06075026301",1174,76,15,37,2903,528,1157,71,5961
"06075026302",1106,50,113,0,3207,309,1111,62,5958
"06075026303",775,203,95,0,3668,414,1202,204,6561
"06075026401",266,32,187,238,2983,231,430,68,4435
"06075026402",479,13,599,70,2953,239,527,61,4941
"06075026403",299,27,47,0,2667,543,641,6,4230
"06075026404",185,154,397,101,1410,130,304,168,2849
"06075030101",2759,376,80,12,1313,195,381,26,5142
"06075030102",3087,121,50,18,1073,192,321,10,4872
"06075030201",2367,209,23,0,1459,152,172,26,4408
"06075030202",2618,232,89,8,1269,251,647,38,5152
"06075030301",2633,196,158,6,2818,233,311,80,6435
"06075030302",1667,219,5,18,2097,165,293,9,4473
"06075030400",2518,150,128,0,2319,258,168,0,5541
"06075030500",1375,112,72,0,696,19,282,17,2573
"06075030600",1286,45,31,0,871,3,218,4,2458
"06075030700",4049,120,98,11,2407,267,838,123,7913
"06075030800",3280,58,133,40,2030,83,574,33,6231
"06075030900",3073,190,81,67,2973,381,503,28,7296
"06075031000",1856,60,94,11,1525,128,507,41,4222
"06075031100",3338,231,518,0,2293,236,849,70,7535
"06075031201",1135,264,435,33,4484,728,636,171,7886
"06075031202",495,41,480,92,1791,299,406,20,3624
"06075031301",847,104,922,110,2330,281,403,25,5022
"06075031302",1028,457,694,92,3310,753,699,450,7483
"06075031400",1418,172,606,337,3841,551,1525,190,8640
"06075032601",1698,138,15,11,2622,154,155,24,4817
"06075032602",1340,291,22,0,2553,288,235,26,4755
"06075032700",2289,172,2,0,4080,392,342,117,7394
"06075032801",1058,105,28,0,2564,264,249,0,4268
"06075032802",799,38,0,0,2856,350,113,27,4183
"06075032901",1623,118,7,29,3432,324,262,122,5917
"06075032902",886,113,55,0,2705,487,85,40,4371
"06075033000",3037,270,47,0,3990,818,416,125,8703
"06075033100",1453,107,34,1,2802,213,193,1,4804
"06075033201",363,260,88,72,304,444,102,188,1821
"06075033203",1431,491,206,17,1269,521,327,64,4326
"06075033204",1289,360,202,123,1019,940,366,256,4555
"06075035100",2908,234,78,24,4800,591,667,24,9326
"06075035201",1910,310,0,0,3194,335,312,11,6072
"06075035202",1786,255,26,0,2256,248,357,104,5032
"06075035300",1740,142,0,75,5008,408,378,136,7887
"06075035400",2198,309,118,69,3934,383,350,191,7552
"06075040100",2436,271,34,17,1374,290,134,26,4582
"06075040200",2634,251,84,61,2505,155,413,21,6124
"06075042601",1720,275,43,79,1586,324,530,8,4565
"06075042602",1630,45,64,0,1588,48,287,0,3662
"06075042700",2189,177,144,36,2165,338,340,34,5423
"06075042800",1677,80,13,0,619,102,157,8,2656
"06075045100",2349,249,169,71,1548,578,218,141,5323
"06075045200",3680,367,16,0,2364,820,672,113,8032
"06075047600",2154,243,38,1,2881,134,184,12,5647
"06075047701",1578,110,30,0,2299,242,116,36,4411
"06075047702",1518,152,66,2,2142,241,167,10,4298
"06075047801",1425,349,56,13,2130,194,269,57,4493
"06075047802",1165,165,0,0,2346,322,329,20,4347
"06075047901",2838,465,143,25,3273,99,601,105,7549
"06075047902",1515,269,23,21,1683,211,166,47,3935
"06075060100",3048,143,0,0,452,7,214,0,3864
"06075060400",813,191,66,0,408,156,119,57,1810
"06075060502",188,252,125,528,1654,630,661,424,4462
"06075060700",3621,370,267,213,4406,712,934,97,10620
"06075061000",833,26,413,6,3162,147,952,28,5567
"06075061100",105,63,10,19,2768,1562,173,0,4700
"06075061200",643,124,769,109,2143,447,1307,381,5923
"06075061400",3508,171,0,469,1635,357,1299,137,7576
"06075061500",6611,563,68,86,4313,679,1473,189,13982
"06075980200",88,13,0,0,25,0,5,0,131
"06075980300",73,0,0,0,5,0,0,0,78
"06075980401",0,0,0,0,0,0,0,0,0
"06075980501",64,27,78,108,410,193,51,36,967
"06075980600",128,51,137,89,40,42,79,51,617
"06075980900",138,4,5,24,78,22,29,26,326
"06075990100",0,0,0,0,0,0,0,0,0
"06077000100",515,1162,184,540,858,480,771,1055,5565
"06077000300",449,295,191,129,514,400,621,547,3146
"06077000401",1885,217,150,299,544,278,1094,205,4672
"06077000402",1290,797,245,629,598,489,1135,994,6177
"06077000500",728,486,0,26,567,552,1067,888,4314
"06077000600",623,429,25,53,494,413,918,760,3715
"06077000700",835,1125,58,172,1242,1202,1401,2098,8133
"06077000801",2457,883,519,234,2683,1179,3639,1660,13254
"06077000900",2572,888,144,746,1243,595,2065,1134,9387
"06077001000",2771,524,153,51,1029,256,1601,278,6663
"06077001101",2940,481,53,124,1205,492,2070,471,7836
"06077001102",2366,647,178,28,1171,215,1870,465,6940
"06077001200",2307,603,20,28,445,90,609,275,4377
"06077001300",2798,1038,164,80,1039,265,1799,939,8122
"06077001400",2067,348,87,287,1392,433,1550,304,6468
"06077001500",1885,781,302,48,3165,1947,3076,1479,12683
"06077001600",859,655,71,8,529,192,1011,496,3821
"06077001700",1522,837,56,30,1096,650,1869,1341,7401
"06077001800",1578,598,126,0,1022,252,1872,685,6133
"06077001900",1547,1429,407,266,1221,529,2329,1736,9464
"06077002000",1073,665,521,131,975,565,1856,984,6770
"06077002100",2109,959,603,253,1127,563,2702,1240,9556
"06077002201",620,268,273,274,648,461,1167,608,4319
"06077002202",2070,869,160,458,1439,811,3152,1332,10291
"06077002300",1114,717,33,113,1717,1340,2354,1829,9217
"06077002401",648,830,111,126,2287,610,1584,1238,7434
"06077002402",675,236,95,5,690,188,926,410,3225
"06077002503",407,390,157,220,582,597,710,530,3593
"06077002504",945,273,308,142,2218,657,1734,643,6920
"06077002701",2965,1060,57,8,1960,453,3579,1148,11230
"06077002702",2492,428,62,0,1191,595,3337,834,8939
"06077002800",2030,359,780,181,2215,337,3355,393,9650
"06077003106",2381,315,40,34,391,351,573,199,4284
"06077003108",2081,422,279,343,820,374,743,177,5239
"06077003109",3145,316,298,51,1522,242,1100,288,6962
"06077003110",1300,324,257,278,655,636,695,704,4849
"06077003111",1427,312,522,47,954,319,917,234,4732
"06077003112",1740,129,114,100,934,318,862,331,4528
"06077003113",1647,344,488,598,1721,471,1705,325,7299
"06077003114",5631,246,751,68,2949,144,1768,63,11620
"06077003203",2377,323,60,29,907,53,831,69,4649
"06077003205",2099,104,135,243,1097,190,951,51,4870
"06077003208",5182,443,1068,490,5393,444,2817,78,15915
"06077003209",1678,330,332,18,914,79,799,253,4403
"06077003210",1444,337,35,223,752,68,790,252,3901
"06077003213",1456,334,564,64,1624,846,1166,658,6712
"06077003214",1672,145,369,10,1003,97,882,92,4270
"06077003215",1725,357,410,132,918,165,763,218,4688
"06077003216",1198,141,495,95,1028,398,937,261,4553
"06077003217",962,245,407,309,1017,392,1034,262,4628
"06077003305",1778,202,68,210,1134,172,1109,190,4863
"06077003306",1396,550,400,245,2121,225,1572,369,6878
"06077003307",1315,896,367,240,1144,916,765,1266,6909
"06077003308",639,186,99,90,385,107,551,123,2180
"06077003310",1379,535,310,127,1069,552,781,562,5315
"06077003311",1255,250,265,157,814,523,969,176,4409
"06077003312",408,413,193,262,685,770,738,850,4319
"06077003313",390,330,184,190,1165,491,888,383,4021
"06077003403",1164,188,216,306,2341,722,1045,187,6169
"06077003404",1328,275,530,273,2542,1380,1348,319,7995
"06077003405",1011,328,180,67,1842,707,1004,175,5314
"06077003406",898,469,246,308,1201,804,943,908,5777
"06077003407",1053,207,200,194,710,597,1026,319,4306
"06077003409",969,711,259,90,1869,580,1126,777,6381
"06077003410",1604,384,454,414,2539,677,1615,369,8056
"06077003500",6874,542,1040,227,10478,2104,5352,697,27314
"06077003601",2250,397,13,28,764,103,913,332,4800
"06077003602",1980,367,0,0,456,252,801,479,4335
"06077003700",1747,601,0,12,449,521,1068,974,5372
"06077003801",3760,522,1989,347,5470,569,5087,332,18076
"06077003802",2216,294,951,378,2510,304,2301,468,9422
"06077003803",1476,595,290,178,1151,361,1581,669,6301
"06077003900",763,162,26,7,134,112,495,241,1940
"06077004001",1093,438,6,0,261,98,647,393,2936
"06077004002",4080,697,1254,108,4443,1079,2462,587,14710
"06077004102",3191,298,433,0,3351,540,1581,257,9651
"06077004104",2913,123,21,7,581,0,662,30,4337
"06077004105",3732,303,11,0,404,18,1005,196,5669
"06077004106",1434,133,11,0,232,11,508,109,2438
"06077004201",4689,568,34,15,611,56,1061,210,7244
"06077004202",1289,77,0,0,138,14,196,6,1720
"06077004203",1959,748,39,16,794,323,820,633,5332
"06077004204",2427,308,0,0,251,85,482,123,3676
"06077004302",3715,828,52,0,957,11,1426,156,7145
"06077004303",3902,293,26,0,636,44,673,193,5767
"06077004305",4454,676,19,90,1141,41,1339,468,8228
"06077004307",2228,269,10,40,1065,271,953,223,5059
"06077004308",1503,795,7,0,1464,268,1430,905,6372
"06077004402",3107,498,162,19,1221,229,1462,206,6904
"06077004403",854,543,0,7,1693,906,1775,1010,6788
"06077004404",1604,657,35,27,569,490,1297,767,5446
"06077004501",1492,193,123,0,644,150,587,82,3271
"06077004502",1356,735,23,8,1556,586,2066,1173,7503
"06077004600",4091,675,0,0,1409,87,2186,101,8549
"06077004701",1813,479,0,0,375,119,634,345,3765
"06077004703",2463,270,5,0,599,12,639,68,4056
"06077004704",3345,261,0,0,638,407,875,436,5962
"06077004800",3431,398,9,39,1373,246,1959,442,7897
"06077004901",6025,890,0,0,429,205,1606,284,9439
"06077004902",4523,610,14,0,856,212,1522,500,8237
"06077005001",4151,624,10,0,512,18,727,255,6297
"06077005003",4447,177,59,1,733,193,897,289,6796
"06077005004",4643,604,0,0,591,0,1195,238,7271
"06077005106",3680,250,396,18,1512,301,1782,151,8090
"06077005108",2871,490,29,16,1001,321,2201,577,7506
"06077005109",2065,536,128,17,694,440,1382,650,5912
"06077005110",4440,763,162,238,1710,37,2634,328,10312
"06077005113",4128,276,0,0,1378,314,2022,287,8405
"06077005114",5275,444,657,0,2568,269,2827,164,12204
"06077005119",2524,320,648,259,2958,257,1936,317,9219
"06077005122",3604,441,94,16,1284,205,1943,320,7907
"06077005123",2650,195,83,212,1518,172,1821,109,6760
"06077005124",1929,294,43,65,770,152,1097,265,4615
"06077005125",1411,116,57,0,226,90,651,130,2681
"06077005126",2247,685,125,0,1025,479,1455,721,6737
"06077005127",2343,148,441,122,2424,312,2185,177,8152
"06077005129",1933,380,80,19,1149,20,1804,271,5656
"06077005130",1380,479,128,12,1088,326,1105,412,4930
"06077005131",2825,718,0,0,625,230,1414,703,6515
"06077005132",1704,367,27,7,904,97,1362,311,4779
"06077005133",2887,173,39,7,743,74,1501,113,5537
"06077005134",3015,288,211,85,1216,120,1425,299,6659
"06077005135",4571,305,67,8,1342,66,1104,240,7703
"06077005202",5067,322,97,70,2384,109,2254,272,10575
"06077005206",8879,462,1735,40,8841,797,4109,505,25368
"06077005207",6745,411,1178,1,6035,283,3676,343,18672
"06077005208",3582,135,303,16,1877,54,1926,87,7980
"06077005209",3718,244,505,79,2354,47,2234,161,9342
"06077005210",6547,273,800,13,3686,364,3296,422,15401
"06077005302",3967,828,29,0,1679,360,2939,963,10765
"06077005303",2271,517,80,18,1225,120,1930,291,6452
"06077005305",3693,430,483,46,1714,309,2767,320,9762
"06077005307",1315,326,174,4,1321,259,1099,287,4785
"06077005308",2254,176,209,8,1228,99,1347,159,5480
"06077005403",3467,311,489,47,1534,67,1835,162,7912
"06077005405",1930,176,97,0,1151,100,2087,204,5745
"06077005406",1723,483,45,6,852,156,1227,530,5022
"06077005501",1309,116,0,0,163,4,306,13,1911
"06077005502",1325,87,123,10,342,51,517,59,2514
"06079010002",2764,98,27,0,379,23,375,8,3674
"06079010016",3484,628,0,0,919,237,1575,348,7191
"06079010101",1533,185,0,0,54,0,176,81,2029
"06079010102",4424,1289,431,27,890,404,2970,1392,11827
"06079010201",5761,327,55,0,687,10,1600,125,8565
"06079010202",4039,557,191,0,649,175,1756,438,7805
"06079010204",4072,712,0,88,986,109,1868,557,8392
"06079010205",3368,317,74,2,345,94,1242,317,5759
"06079010300",7522,814,193,1,816,16,1723,184,11269
"06079010403",3468,266,0,0,316,28,592,90,4760
"06079010404",1761,129,7,0,295,9,510,79,2790
"06079010503",4279,579,0,167,199,0,473,205,5902
"06079010504",2334,251,0,0,158,15,220,23,3001
"06079010602",3179,395,0,0,362,0,728,66,4730
"06079010603",977,190,0,0,98,0,196,66,1527
"06079010701",4218,380,30,7,486,108,559,76,5864
"06079010703",2310,388,0,0,586,38,434,58,3814
"06079010707",5205,462,0,0,404,67,619,36,6793
"06079010901",201,1144,0,0,17,174,19,217,1772
"06079010902",1086,2447,54,108,125,380,243,487,4930
"06079011001",3626,661,14,19,578,136,404,110,5548
"06079011002",1562,1254,0,0,247,263,237,284,3847
"06079011101",1830,898,46,40,329,219,266,340,3968
"06079011102",3635,892,35,204,375,159,627,235,6162
"06079011103",1735,405,8,0,186,199,408,138,3079
"06079011200",3609,3018,17,157,178,392,232,575,8178
"06079011300",5585,1124,91,108,964,220,1521,305,9918
"06079011400",0,0,0,0,0,0,0,0,0
"06079011501",1082,193,0,11,382,0,358,41,2067
"06079011503",2849,373,133,34,230,12,405,32,4068
"06079011504",728,109,0,2,47,3,72,80,1041
"06079011600",3692,332,9,0,247,2,123,26,4431
"06079011701",4264,142,113,2,120,99,183,40,4963
"06079011704",2611,260,8,0,174,54,185,15,3307
"06079011800",6061,365,0,2,637,45,498,45,7653
"06079011901",2263,309,0,0,374,29,316,88,3379
"06079011902",7071,540,111,20,1118,41,2232,49,11182
"06079012000",4920,791,223,8,1208,262,1525,521,9458
"06079012102",4019,653,44,80,1160,52,1585,359,7952
"06079012200",4310,1078,0,0,1461,475,3495,1005,11824
"06079012302",3931,355,0,0,474,10,608,91,5469
"06079012304",8062,563,57,5,1277,37,1699,20,11720
"06079012401",5179,515,71,32,893,25,2876,224,9815
"06079012402",6465,1155,190,0,1342,270,2457,467,12346
"06079012502",3869,690,32,0,336,185,568,360,6040
"06079012503",4117,731,147,0,470,192,721,321,6699
"06079012505",4500,308,14,5,335,0,465,97,5724
"06079012600",6624,615,21,78,429,26,1135,119,9047
"06079012702",5950,695,0,12,289,78,505,246,7775
"06079012704",7247,549,88,0,723,113,848,116,9684
"06079012800",40,23,18,0,2,29,2,36,150
"06079012900",4433,399,0,0,435,111,839,278,6495
"06079013000",2012,190,0,6,172,37,348,125,2890
"06079990000",0,0,0,0,0,0,0,0,0
"06081600100",2319,126,107,39,2296,171,811,181,6050
"06081600200",451,35,87,85,3046,558,1013,274,5549
"06081600300",762,163,91,0,2911,37,664,121,4749
"06081600401",1014,0,78,0,2186,116,830,20,4244
"06081600402",468,112,90,26,3651,492,903,327,6069
"06081600500",1327,83,72,0,5827,436,2017,303,10065
"06081600600",1503,37,125,0,3873,198,2287,101,8124
"06081600700",1809,186,261,115,4565,501,1994,231,9662
"06081600800",1210,290,494,71,4008,1079,947,362,8461
"06081600900",1718,42,0,0,2147,204,532,25,4668
"06081601000",1447,85,314,14,4622,71,1038,33,7624
"06081601100",1634,83,85,2,3811,361,727,25,6728
"06081601200",1825,53,50,25,4711,204,1678,79,8625
"06081601300",1266,904,138,44,5753,594,3099,558,12356
"06081601400",1077,305,167,9,4828,813,744,654,8597
"06081601501",673,80,56,0,4200,219,264,20,5512
"06081601502",734,75,170,20,3502,739,1272,234,6746
"06081601601",1033,142,38,49,1335,177,892,140,3806
"06081601603",1035,116,123,0,4555,215,559,146,6749
"06081601604",926,215,72,0,1573,36,407,21,3250
"06081601605",537,87,277,0,5172,327,776,36,7212
"06081601700",1617,72,21,5,2666,100,1465,29,5975
"06081601800",3347,263,9,23,2734,307,1729,241,8653
"06081601901",2023,195,41,0,2206,188,1508,184,6345
"06081601902",1677,118,101,0,2976,615,1284,460,7231
"06081602000",2761,85,54,0,5029,379,2579,314,11201
"06081602100",1071,150,104,0,1872,206,1930,321,5654
"06081602200",2998,347,315,70,3285,705,4455,504,12679
"06081602300",1389,184,128,0,1938,130,1607,191,5567
"06081602400",3339,104,61,11,3514,258,1742,96,9125
"06081602500",1121,129,253,0,4107,86,773,19,6488
"06081602600",1212,1,320,18,6202,288,956,207,9204
"06081602700",2099,135,317,91,2932,279,953,190,6996
"06081602800",1454,75,245,8,2632,90,632,24,5160
"06081602900",2163,154,94,14,1143,118,707,163,4556
"06081603000",3245,225,76,9,980,60,681,49,5325
"06081603100",2394,136,39,0,691,166,347,205,3978
"06081603200",2770,230,9,13,703,15,659,0,4399
"06081603300",5174,234,42,0,1423,11,869,159,7912
"06081603400",4134,136,9,20,1471,116,1431,48,7365
"06081603700",2157,99,92,0,3348,168,1100,0,6964
"06081603801",905,121,0,0,1194,91,419,67,2797
"06081603802",2859,203,64,0,1902,46,1324,0,6398
"06081603900",3584,55,103,14,1536,96,1526,17,6931
"06081604000",1782,151,68,0,1280,43,617,78,4019
"06081604101",3281,622,133,14,3673,114,2951,562,11350
"06081604102",1125,57,157,23,1340,143,463,10,3318
"06081604200",2718,187,6,0,1180,73,2253,169,6586
"06081604400",1467,103,0,1,2935,206,1096,20,5828
"06081604500",1737,185,0,0,1613,125,265,63,3988
"06081604600",1196,32,8,0,1520,62,175,0,2993
"06081604700",1172,41,16,4,1372,53,219,24,2901
"06081604800",2009,151,58,1,2488,248,779,34,5768
"06081604900",1274,73,10,0,1802,161,146,37,3503
"06081605000",4101,252,88,36,3275,436,628,230,9046
"06081605100",2100,75,34,0,763,129,311,112,3524
"06081605200",2658,157,69,0,903,51,373,35,4246
"06081605300",3196,233,58,6,1239,48,440,33,5253
"06081605400",3641,143,24,0,1674,135,738,115,6470
"06081605500",3441,237,88,6,1465,97,625,132,6091
"06081605600",3859,64,50,13,1754,121,183,17,6061
"06081605700",3567,44,74,0,1678,29,245,12,5649
"06081605800",1865,71,46,0,592,23,186,35,2818
"06081605900",3798,419,149,40,1479,215,1746,327,8173
"06081606000",3763,61,208,0,1569,81,2836,1,8519
"06081606100",1607,530,84,65,1813,389,1073,552,6113
"06081606200",4187,822,434,0,2950,122,4135,840,13490
"06081606300",2479,225,133,0,1437,206,1344,22,5846
"06081606400",3468,288,89,20,1147,122,739,60,5933
"06081606500",2692,65,0,0,658,23,172,0,3610
"06081606600",2446,65,26,0,1096,81,792,27,4533
"06081606700",1519,50,0,0,748,28,195,0,2540
"06081606800",2008,73,31,2,1259,89,28,13,3503
"06081606900",1369,54,2,2,801,70,163,0,2461
"06081607000",2180,53,7,0,1018,56,247,35,3596
"06081607100",2171,49,12,0,800,30,266,0,3328
"06081607200",1984,180,51,17,1585,128,1029,55,5029
"06081607300",2687,78,0,0,709,18,429,17,3938
"06081607400",2639,152,56,16,1578,205,677,64,5387
"06081607500",2254,42,149,9,1636,55,878,40,5063
"06081607600",1815,317,111,6,1117,29,728,290,4413
"06081607701",1765,219,44,65,1764,544,1251,400,6052
"06081607702",1288,250,76,26,1241,27,938,79,3925
"06081607800",1625,149,29,0,1283,61,684,165,3996
"06081607900",1577,91,56,0,1349,42,134,11,3260
"06081608001",1498,88,69,0,1836,143,225,86,3945
"06081608002",1759,29,44,0,1569,19,200,0,3620
"06081608004",2841,61,274,0,3498,110,262,0,7046
"06081608013",2212,29,21,0,1882,437,204,1,4786
"06081608023",1052,49,12,65,1448,35,68,6,2735
"06081608100",1587,31,102,43,1997,20,167,9,3956
"06081608200",1589,99,29,0,2051,27,158,35,3988
"06081608300",1428,36,54,22,2001,18,139,11,3709
"06081608400",3048,120,0,0,2273,118,1179,33,6771
"06081608501",3009,242,45,0,1492,132,1074,82,6076
"06081608502",1718,43,50,0,765,24,835,0,3435
"06081608600",2124,256,78,10,1692,272,724,248,5404
"06081608700",4598,239,30,31,1953,90,801,3,7745
"06081608800",4247,73,77,0,1487,19,422,0,6325
"06081608900",4097,212,92,14,2066,353,781,48,7663
"06081609000",1613,40,52,0,831,32,279,32,2879
"06081609100",1004,85,8,21,519,46,459,59,2201
"06081609201",2959,49,12,19,580,10,410,0,4039
"06081609202",2571,157,94,35,1069,222,497,204,4849
"06081609300",2906,28,45,0,520,6,325,6,3836
"06081609400",3076,106,8,10,321,0,358,12,3891
"06081609500",4089,7,0,0,954,0,582,0,5632
"06081609601",1998,144,103,0,624,56,129,83,3137
"06081609602",1122,39,4,0,418,31,81,0,1695
"06081609603",4081,127,7,25,1065,17,405,32,5759
"06081609700",3748,135,10,5,514,9,327,11,4759
"06081609800",3764,88,35,12,750,16,764,16,5445
"06081609900",2431,157,2,0,464,4,283,92,3433
"06081610000",3503,79,66,8,871,13,896,22,5458
"06081610100",1638,75,17,0,582,89,986,141,3528
"06081610201",2555,1043,151,215,1954,183,3542,1098,10741
"06081610202",795,141,27,10,289,217,373,263,2115
"06081610203",1602,612,88,30,1398,237,2596,783,7346
"06081610302",1142,146,51,14,806,236,1056,225,3676
"06081610303",3917,115,140,0,3802,37,500,23,8534
"06081610304",2148,97,185,0,1786,14,371,28,4629
"06081610400",3089,457,126,216,2081,329,3786,724,10808
"06081610500",2609,699,23,9,1091,749,2564,969,8713
"06081610601",2583,851,21,0,1885,580,3659,1389,10968
"06081610602",2556,289,33,0,616,128,1268,276,5166
"06081610700",3465,184,37,5,1194,95,1693,9,6682
"06081610800",2627,369,126,0,1794,267,2975,469,8627
"06081610900",3810,237,41,5,2262,821,3053,723,10952
"06081611000",4669,207,196,13,853,126,1924,169,8157
"06081611100",5330,68,0,0,908,57,405,42,6810
"06081611200",2412,108,0,0,497,23,778,35,3853
"06081611300",3804,93,17,2,1136,48,896,25,6021
"06081611400",3304,133,0,0,528,38,110,29,4142
"06081611500",1969,75,0,0,611,7,107,7,2776
"06081611600",1660,73,80,32,335,59,77,0,2316
"06081611700",1838,275,1002,155,1545,558,2778,614,8765
"06081611800",1312,314,759,145,1325,407,1962,552,6776
"06081611900",4290,741,962,165,3168,736,5480,1150,16692
"06081612000",2260,375,740,254,3735,336,4738,526,12964
"06081612100",3131,1141,673,180,2440,596,3113,1460,12734
"06081612500",3293,186,18,0,672,41,275,30,4515
"06081612600",3190,127,10,0,1053,69,100,0,4549
"06081612700",1795,123,1,0,171,12,85,0,2187
"06081612800",2721,39,0,6,465,4,254,21,3510
"06081612900",3473,96,26,13,786,77,206,36,4713
"06081613000",2695,116,2,16,587,63,79,2,3560
"06081613200",5719,180,0,0,859,45,253,2,7058
"06081613300",2237,153,0,0,353,0,180,0,2923
"06081613400",2707,159,0,0,296,65,203,41,3471
"06081613501",3596,131,84,5,945,43,1855,49,6708
"06081613502",4797,242,0,0,975,5,1119,65,7203
"06081613600",5206,87,0,2,1004,198,1309,134,7940
"06081613700",6195,215,0,26,1680,452,2248,420,11236
"06081613800",3062,536,15,0,85,67,543,369,4677
"06081613900",3827,512,257,25,1801,84,801,175,7482
"06081614000",1848,164,244,5,3183,124,837,145,6550
"06081984300",0,0,0,0,0,0,0,0,0
"06081990100",0,0,0,0,0,0,0,0,0
"06083000101",4185,341,69,49,1013,100,1642,215,7614
"06083000102",3639,486,0,2,989,204,1224,232,6776
"06083000103",2636,176,7,0,139,37,220,39,3254
"06083000200",2804,166,0,0,726,49,805,62,4612
"06083000301",1932,184,36,7,582,67,959,114,3881
"06083000302",2214,508,73,13,1201,49,1491,372,5921
"06083000400",3772,156,8,0,284,90,287,71,4668
"06083000501",3009,127,35,0,179,0,183,0,3533
"06083000502",5361,544,55,82,207,51,616,18,6934
"06083000600",3497,301,33,0,641,47,751,83,5353
"06083000700",4201,379,91,0,1051,94,1228,193,7237
"06083000801",1999,266,24,0,1616,258,2934,370,7467
"06083000804",4187,826,97,57,1296,762,4003,1207,12435
"06083000900",1924,538,79,30,587,269,970,381,4778
"06083001000",3914,603,163,41,814,70,2177,228,8010
"06083001101",2907,1038,41,0,745,374,1933,1142,8180
"06083001102",2484,586,70,0,1644,668,3293,860,9605
"06083001203",2209,281,0,0,204,120,572,41,3427
"06083001206",2886,454,34,1,1259,338,2821,480,8273
"06083001208",3241,461,68,31,423,184,626,83,5117
"06083001304",6113,284,69,32,1035,222,1767,198,9720
"06083001306",2644,70,50,5,459,4,490,0,3722
"06083001402",2892,234,0,2,126,5,187,35,3481
"06083001500",2647,221,0,9,267,16,252,36,3448
"06083001601",3849,296,0,0,1008,121,1824,305,7403
"06083001604",3413,552,0,0,972,95,1818,195,7045
"06083001704",2218,182,25,5,640,0,1568,105,4743
"06083001706",3459,158,87,7,736,57,1027,46,5577
"06083001800",819,203,0,0,86,92,448,230,1878
"06083001901",5685,644,93,16,679,117,1831,218,9283
"06083001903",4853,468,3,0,622,188,1338,406,7878
"06083001905",2275,132,3,51,179,26,422,46,3134
"06083001906",4501,288,0,43,966,88,919,98,6903
"06083002005",4121,365,53,21,546,83,767,180,6136
"06083002006",1929,170,0,0,342,23,537,92,3093
"06083002007",7855,632,289,0,1349,0,3179,313,13617
"06083002008",4535,513,177,7,959,0,1592,187,7970
"06083002009",3122,260,24,0,517,12,827,55,4817
"06083002010",3726,152,130,0,530,0,831,23,5392
"06083002011",3496,224,105,21,1271,57,2444,150,7768
"06083002012",2945,215,0,0,182,1,620,1,3964
"06083002013",2459,26,0,0,335,0,401,0,3221
"06083002101",1740,1247,18,7,507,367,1426,1208,6520
"06083002102",1634,87,17,4,438,87,1230,135,3632
"06083002103",1914,630,40,0,921,312,1591,611,6019
"06083002205",2611,929,19,0,1639,210,2948,964,9320
"06083002206",2744,776,54,22,925,376,2507,1047,8451
"06083002209",1721,505,19,44,809,308,1879,753,6038
"06083002210",3393,258,168,29,1565,329,2990,307,9039
"06083002211",3584,411,94,72,1517,0,2430,397,8505
"06083002303",3279,1137,0,8,1452,268,4128,1144,11416
"06083002304",3231,746,0,7,1553,645,4314,1332,11828
"06083002305",4331,1327,189,35,947,526,4974,1654,13983
"06083002306",5885,380,0,0,1908,211,5382,345,14111
"06083002402",6554,2821,281,8,2525,794,6600,3219,22802
"06083002403",2588,1776,0,18,1701,773,4083,2419,13358
"06083002404",4355,1494,7,46,1756,1024,5668,2337,16687
"06083002502",4617,900,10,37,1400,476,5180,1143,13763
"06083002604",80,0,2,0,7,0,8,0,97
"06083002606",1870,135,262,0,626,53,590,63,3599
"06083002702",2724,1450,113,108,2634,846,4215,1824,13914
"06083002703",1945,450,156,0,1055,439,1836,641,6522
"06083002705",1892,890,141,6,824,446,1637,1012,6848
"06083002706",3324,1140,113,209,1196,571,2889,1568,11010
"06083002707",1401,256,96,4,422,125,688,231,3223
"06083002708",1803,197,0,0,424,107,698,93,3322
"06083002802",3976,453,553,0,1772,420,2100,654,9928
"06083002806",1471,287,67,19,444,15,763,146,3212
"06083002808",5200,305,198,21,842,192,1139,230,8127
"06083002809",2946,326,344,8,1204,53,1283,202,6366
"06083002906",3030,195,69,0,686,0,639,75,4694
"06083002907",3335,113,0,0,880,56,951,52,5387
"06083002909",4624,284,41,0,1151,66,2453,91,8710
"06083002913",2999,159,17,0,625,8,651,31,4490
"06083002914",2376,46,2,0,723,43,597,0,3787
"06083002915",167,47,0,0,220,41,83,40,598
"06083002922",1154,88,107,7,714,26,421,35,2552
"06083002924",1339,2838,0,89,136,836,267,798,6303
"06083002926",1471,2715,47,129,409,1126,499,1075,7471
"06083002928",726,2585,95,23,209,956,307,678,5579
"06083002930",3803,551,70,1,2418,497,2677,284,10301
"06083002932",1476,104,13,8,659,93,690,70,3113
"06083003001",3110,174,29,166,1881,362,3328,372,9422
"06083003004",3810,171,158,9,983,10,1610,9,6760
"06083003005",2948,421,93,10,1825,278,1981,221,7777
"06083003007",2990,174,0,0,246,93,319,18,3840
"06083003102",2450,115,203,0,483,26,1135,85,4497
"06083980000",8,0,0,0,0,0,0,0,8
"06083980100",0,0,0,0,0,0,0,0,0
"06083990000",0,0,0,0,0,0,0,0,0
"06085500100",2415,476,31,0,3465,980,3672,1089,12128
"06085500200",2299,335,57,84,1908,391,1518,233,6825
"06085500300",1918,425,156,73,801,253,1002,205,4833
"06085500400",1464,58,32,0,670,194,921,152,3491
"06085500500",3487,186,47,0,1447,115,989,128,6399
"06085500600",2946,116,130,0,1477,184,1150,53,6056
"06085500800",1832,225,228,6,949,207,1058,127,4632
"06085500901",947,515,120,150,1589,569,484,444,4818
"06085500902",280,200,29,112,511,564,275,234,2205
"06085501000",1349,488,96,80,1877,441,1848,553,6732
"06085501101",1501,222,206,158,1953,369,1463,383,6255
"06085501102",2168,332,98,16,2122,147,2789,310,7982
"06085501200",1782,195,113,27,2279,310,2513,319,7538
"06085501300",1704,607,162,100,882,614,951,239,5259
"06085501401",1241,160,145,10,1429,319,1982,355,5641
"06085501402",1234,297,36,13,1313,282,1867,531,5573
"06085501501",1583,294,58,0,2412,645,2793,708,8493
"06085501502",1344,578,0,8,1888,549,2224,959,7550
"06085501600",2376,615,351,184,2357,936,2135,670,9624
"06085501700",1869,687,32,0,2016,420,3243,910,9177
"06085501800",2292,182,25,0,2356,296,2032,417,7600
"06085501900",2501,100,149,2,1965,461,1048,331,6557
"06085502001",2620,401,315,0,2255,317,2489,421,8818
"06085502002",1643,420,76,131,2040,890,2179,1145,8524
"06085502101",3421,182,21,8,1185,157,985,101,6060
"06085502102",3162,739,359,94,2832,639,3542,1060,12427
"06085502201",2903,392,301,147,2427,692,2260,223,9345
"06085502202",2100,157,34,0,845,75,497,101,3809
"06085502301",2415,128,160,0,680,75,408,42,3908
"06085502302",2134,105,12,0,437,125,469,58,3340
"06085502400",5302,216,408,5,792,122,1209,35,8089
"06085502500",4802,147,53,15,1362,75,956,119,7529
"06085502601",2144,151,0,0,537,16,324,50,3222
"06085502603",1940,40,0,0,479,23,339,13,2834
"06085502604",2416,287,394,0,813,16,380,36,4342
"06085502701",2976,292,173,3,1209,163,918,162,5896
"06085502702",4893,456,188,55,1961,145,1064,0,8762
"06085502800",3217,140,0,0,766,64,642,32,4861
"06085502901",4238,140,71,0,1982,36,1463,82,8012
"06085502902",5026,451,36,0,1879,21,1457,175,9045
"06085502903",3901,154,236,3,836,99,838,110,6177
"06085502906",2542,338,187,10,1220,122,1008,30,5457
"06085502907",2651,103,60,8,859,101,593,47,4422
"06085502908",4459,369,57,0,1736,56,763,300,7740
"06085502909",3723,203,92,8,1209,203,1620,168,7226
"06085502910",1947,108,65,0,1113,222,603,196,4254
"06085503001",3468,211,0,26,407,52,478,140,4782
"06085503002",2558,184,132,0,644,20,870,24,4432
"06085503003",3645,53,161,0,1563,27,1126,8,6583
"06085503105",395,66,10,0,1285,692,393,103,2944
"06085503108",2801,524,180,89,4144,206,2234,599,10777
"06085503110",878,506,25,41,2795,998,2321,933,8497
"06085503111",1392,244,80,239,2787,464,1638,397,7241
"06085503112",1333,358,149,14,2117,138,1858,292,6259
"06085503113",1566,564,142,75,1919,910,2784,1440,9400
"06085503115",3501,72,150,0,2679,109,1625,8,8144
"06085503116",2498,273,15,0,2193,177,579,65,5800
"06085503117",623,136,41,0,1452,1103,1278,558,5191
"06085503118",1389,157,278,36,2784,894,2380,593,8511
"06085503121",1189,369,70,122,2240,595,2081,356,7022
"06085503122",407,361,63,103,1677,408,569,473,4061
"06085503123",1498,199,247,70,1477,344,1578,270,5683
"06085503204",3569,408,56,214,4301,630,4476,547,14201
"06085503207",770,39,105,69,2981,363,801,78,5206
"06085503208",2079,308,106,8,1720,167,2317,356,7061
"06085503210",1432,105,51,23,2311,447,1577,317,6263
"06085503211",1166,294,107,0,3292,158,1180,266,6463
"06085503212",1122,78,154,8,2726,230,1146,110,5574
"06085503213",663,532,0,0,2803,254,889,435,5576
"06085503214",1616,1283,34,22,3837,1276,2330,1443,11841
"06085503217",1792,335,94,7,2170,315,2859,432,8004
"06085503218",2388,619,73,0,1528,76,3029,652,8365
"06085503304",1792,489,184,48,3472,906,2425,792,10108
"06085503305",1549,82,166,11,3944,665,2716,340,9473
"06085503306",1496,66,97,4,2370,372,2414,259,7078
"06085503312",1639,68,234,19,1596,169,1463,164,5352
"06085503313",1382,19,110,0,2841,185,952,26,5515
"06085503315",1243,121,359,34,5594,791,2619,172,10933
"06085503321",290,170,82,0,4144,160,422,179,5447
"06085503322",1441,52,190,57,2284,190,1493,55,5762
"06085503323",1033,106,265,0,3025,335,1426,194,6384
"06085503324",451,37,71,0,2956,91,504,24,4134
"06085503325",1261,96,44,5,3286,280,1113,189,6274
"06085503326",802,12,182,0,5826,407,824,176,8229
"06085503327",1457,192,228,126,2925,188,1176,284,6576
"06085503329",838,27,77,11,2506,208,482,64,4213
"06085503330",1111,233,0,19,6825,191,486,323,9188
"06085503331",1879,101,152,8,1279,65,1046,11,4541
"06085503332",3485,188,0,0,1582,46,450,0,5751
"06085503333",1832,333,57,0,2347,38,784,220,5611
"06085503334",2428,63,127,0,5881,89,569,26,9183
"06085503336",627,75,19,36,2647,257,1038,151,4850
"06085503337",927,56,137,14,2353,227,884,50,4648
"06085503401",1393,291,165,0,2472,144,2961,399,7825
"06085503402",1265,538,65,47,2904,1222,2880,1136,10057
"06085503504",2271,421,28,0,2768,470,3739,707,10404
"06085503506",2360,284,87,11,2706,679,3226,735,10088
"06085503507",833,147,40,30,1268,144,1582,226,4270
"06085503508",2002,216,176,21,3513,943,3835,881,11587
"06085503509",1167,256,85,0,2056,385,1893,412,6254
"06085503510",1514,209,116,122,2956,1070,3149,1133,10269
"06085503511",783,89,76,0,2536,322,1272,207,5285
"06085503601",1084,207,7,0,1339,303,1458,239,4637
"06085503602",1515,347,265,33,2563,589,2853,634,8799
"06085503703",929,410,145,0,1942,693,2030,870,7019
"06085503707",760,230,198,29,4126,469,2375,484,8671
"06085503708",270,52,26,19,1959,250,561,92,3229
"06085503709",780,322,50,0,3453,1408,1657,735,8405
"06085503710",514,464,18,0,2318,582,1620,812,6328
"06085503711",1451,410,145,10,2607,469,3054,749,8895
"06085503712",879,189,113,21,2025,587,1173,484,5471
"06085503713",625,162,20,0,1724,483,1265,331,4610
"06085503802",2286,133,258,17,5078,75,2968,82,10897
"06085503803",1083,51,72,1,3412,236,936,55,5846
"06085503804",1368,239,60,13,3689,436,1789,429,8023
"06085503902",1250,266,109,32,2965,870,2897,686,9075
"06085503903",1025,63,32,0,2253,311,1903,245,5832
"06085504001",1986,108,152,1,3443,607,3883,546,10726
"06085504002",1077,412,92,26,4054,603,3024,751,10039
"06085504101",1337,481,37,50,2338,600,2545,717,8105
"06085504102",2025,120,64,0,3458,539,3932,450,10588
"06085504201",2913,130,102,26,2055,89,1828,51,7194
"06085504202",3065,99,14,2,1615,89,2049,18,6951
"06085504307",1121,186,178,14,3695,417,671,24,6306
"06085504308",1589,160,97,0,2342,180,617,13,4998
"06085504311",986,84,20,0,5378,571,433,0,7472
"06085504314",815,25,143,31,2936,923,654,466,5993
"06085504315",1157,66,337,0,5061,224,1053,0,7898
"06085504316",933,76,173,0,3951,235,882,54,6304
"06085504317",681,168,9,0,3831,207,401,221,5518
"06085504318",706,248,21,24,3275,569,1246,355,6444
"06085504319",1465,50,124,25,6148,357,1729,49,9947
"06085504320",578,19,36,6,2091,172,315,43,3260
"06085504321",813,41,71,0,4065,432,802,177,6401
"06085504322",1048,0,336,206,3594,364,255,0,5803
"06085504323",529,72,31,0,5276,306,792,41,7047
"06085504410",574,32,97,11,3468,392,513,28,5115
"06085504411",1395,74,9,0,3567,396,913,56,6410
"06085504412",723,102,138,0,4091,205,1117,110,6486
"06085504413",186,6,34,0,1367,138,47,0,1778
"06085504414",650,84,104,0,4838,250,379,29,6334
"06085504415",1136,45,42,15,4241,91,695,14,6279
"06085504416",610,88,25,14,2728,129,462,166,4222
"06085504417",140,107,0,0,112,0,9,102,470
"06085504418",848,220,64,4,3493,842,977,513,6961
"06085504420",1000,88,49,0,3532,237,465,13,5384
"06085504421",1027,102,22,0,3426,216,664,68,5525
"06085504422",722,62,70,16,2622,331,829,51,4703
"06085504423",821,27,195,0,1311,129,323,39,2845
"06085504504",748,191,137,13,6052,385,502,124,8152
"06085504505",971,125,67,21,4612,246,861,98,7001
"06085504506",1095,65,89,62,4225,470,623,76,6705
"06085504507",1194,113,154,24,4082,456,1080,269,7372
"06085504601",625,38,13,5,185,33,354,32,1285
"06085504602",935,75,26,12,789,120,937,195,3089
"06085504700",529,45,188,0,61,0,182,0,1005
"06085504802",2088,185,57,0,2876,185,1351,180,6922
"06085504803",1515,168,191,0,3889,237,598,68,6666
"06085504805",3609,632,177,35,1786,108,707,269,7323
"06085504806",1235,98,17,49,1312,136,715,62,3624
"06085504901",2031,107,56,159,7207,490,404,48,10502
"06085505001",3075,84,460,21,5464,528,1345,309,11286
"06085505006",1561,112,43,0,3220,128,249,0,5313
"06085505007",1419,84,176,27,2041,78,658,32,4515
"06085505008",1329,244,132,0,3649,196,474,79,6103
"06085505009",2457,225,627,0,4643,365,2498,158,10973
"06085505100",965,113,70,0,1765,355,903,209,4380
"06085505202",2719,582,247,1,2686,357,2033,660,9285
"06085505203",1203,312,172,0,1225,325,609,213,4059
"06085505301",1586,289,322,29,1975,394,1134,333,6062
"06085505302",2338,91,126,1,1320,82,762,53,4773
"06085505303",2671,390,371,0,2513,150,1731,280,8106
"06085505304",1756,92,0,0,1375,55,834,9,4121
"06085505305",2862,49,277,0,2413,299,673,1,6574
"06085505401",1354,137,211,0,4470,111,475,0,6758
"06085505402",1398,116,18,0,1580,14,692,66,3884
"06085505403",2602,112,202,2,3173,101,1125,29,7346
"06085505500",2400,110,172,71,1448,122,930,126,5379
"06085505600",1303,754,81,51,555,297,446,183,3670
"06085505700",3230,732,57,115,2024,527,1541,378,8604
"06085505800",2564,130,21,50,781,212,721,155,4634
"06085505900",4786,339,259,125,1720,74,1085,285,8673
"06085506000",2709,126,118,0,1439,72,799,20,5283
"06085506101",2409,105,291,5,1885,71,648,30,5444
"06085506102",1951,74,100,0,1534,178,468,9,4314
"06085506103",2192,122,24,40,2539,86,497,60,5560
"06085506202",2858,319,117,0,3545,109,262,123,7333
"06085506203",1069,149,98,0,5013,378,826,68,7601
"06085506204",2089,126,58,42,3105,309,592,31,6352
"06085506301",2716,167,340,117,2055,364,676,254,6689
"06085506302",3666,214,289,15,2225,108,1202,39,7758
"06085506304",2434,446,143,0,2172,228,1309,229,6961
"06085506305",3519,520,390,0,2240,425,2551,244,9889
"06085506401",2855,121,322,0,1762,155,1407,65,6687
"06085506402",3251,485,443,35,1560,458,1372,659,8263
"06085506501",3346,996,202,136,2792,530,2879,1103,11984
"06085506502",3054,129,339,0,670,29,612,14,4847
"06085506503",4273,253,65,0,1542,303,1172,214,7822
"06085506601",2362,336,91,23,1863,135,892,139,5841
"06085506603",2713,92,24,0,1224,156,641,36,4886
"06085506604",4383,204,27,0,2789,11,602,32,8048
"06085506605",1843,94,94,0,1910,188,1121,59,5309
"06085506606",2542,204,0,0,1587,67,1001,44,5445
"06085506701",2323,84,0,0,1178,31,597,28,4241
"06085506702",3620,234,39,2,1691,164,782,174,6706
"06085506703",2391,251,118,0,893,77,358,142,4230
"06085506801",4504,203,72,0,1164,129,573,19,6664
"06085506802",3666,258,95,6,1342,47,694,2,6110
"06085506803",4720,143,26,187,2128,84,868,22,8178
"06085506804",2621,62,20,0,874,45,227,0,3849
"06085506900",5885,112,18,0,1454,17,475,22,7983
"06085507001",6011,243,37,0,620,58,353,5,7327
"06085507002",2170,174,52,18,518,19,152,0,3103
"06085507100",2142,231,18,57,312,63,258,50,3131
"06085507203",2386,93,0,0,646,17,126,0,3268
"06085507205",3752,164,0,0,783,0,166,8,4873
"06085507206",2286,61,0,0,416,80,45,6,2894
"06085507301",3442,148,21,0,3155,54,294,35,7149
"06085507302",1743,153,0,0,868,25,80,11,2880
"06085507401",2061,67,37,1,3443,55,73,8,5745
"06085507402",2321,254,19,0,1552,20,261,55,4482
"06085507500",1977,74,0,17,3700,47,46,0,5861
"06085507600",2669,165,87,0,2570,50,136,47,5724
"06085507701",1187,25,0,0,2597,46,192,12,4059
"06085507702",2016,74,0,0,4322,102,167,0,6681
"06085507703",2978,128,0,0,4500,86,93,0,7785
"06085507805",2139,55,127,61,3523,221,323,5,6454
"06085507806",889,37,66,0,4457,121,115,28,5713
"06085507807",582,34,0,0,2442,92,28,0,3178
"06085507808",1319,19,31,0,3980,230,61,0,5640
"06085507903",1100,44,31,0,3585,215,143,41,5159
"06085507904",825,25,33,0,2394,0,35,15,3327
"06085507905",1210,93,0,0,5065,140,200,58,6766
"06085507906",976,137,0,2,3394,112,99,7,4727
"06085508001",2337,171,12,37,5372,141,669,37,8776
"06085508003",851,54,0,0,1376,106,43,8,2438
"06085508004",1958,68,44,0,4204,206,548,51,7079
"06085508101",1862,57,0,0,4586,114,203,0,6822
"06085508102",700,71,0,0,2661,0,118,0,3550
"06085508202",3470,84,169,8,3740,152,814,132,8569
"06085508203",1798,106,86,1,3187,98,294,31,5601
"06085508204",1577,34,26,0,2355,149,349,0,4490
"06085508301",2235,97,25,0,1846,61,100,11,4375
"06085508303",1647,48,9,0,843,38,44,2,2631
"06085508304",2937,151,229,102,4423,622,804,67,9335
"06085508401",3696,96,21,0,3026,51,557,25,7472
"06085508403",1529,13,18,0,1426,10,160,11,3167
"06085508404",3367,65,0,0,2780,148,484,42,6886
"06085508503",1921,212,27,0,4170,377,456,221,7384
"06085508504",2385,738,74,19,4682,476,1155,701,10230
"06085508505",2262,23,41,0,2075,49,404,0,4854
"06085508507",757,73,91,0,1974,276,182,14,3367
"06085508508",2410,251,150,0,2414,374,1065,103,6767
"06085508601",1813,175,101,0,1564,200,541,266,4660
"06085508602",3120,89,144,0,1383,151,974,21,5882
"06085508703",2578,280,222,10,4556,147,869,29,8691
"06085508704",2171,255,71,39,3026,256,846,156,6820
"06085508800",1426,495,90,19,1591,262,966,513,5362
"06085508900",1879,399,139,0,2823,180,1904,343,7667
"06085509000",5116,388,135,154,2502,115,3991,386,12787
"06085509102",1387,76,100,0,3089,61,497,22,5232
"06085509105",3731,347,401,0,2588,141,1332,282,8822
"06085509106",2198,128,104,25,1832,87,896,113,5383
"06085509107",2014,437,56,26,2173,100,791,288,5885
"06085509108",2504,161,31,16,1658,95,1012,112,5589
"06085509109",2307,105,9,0,2109,18,569,0,5117
"06085509201",2754,90,69,0,1497,137,626,0,5173
"06085509202",2503,150,30,13,1681,114,753,45,5289
"06085509302",2244,76,72,0,708,109,374,74,3657
"06085509303",1981,234,153,15,971,126,730,30,4240
"06085509304",1347,124,90,0,1742,32,692,31,4058
"06085509401",1507,65,26,28,1537,133,197,0,3493
"06085509403",2240,696,53,64,1525,214,1289,554,6635
"06085509404",2687,529,119,0,3137,402,1839,109,8822
"06085509500",2974,697,57,22,1538,74,1578,481,7421
"06085509600",2160,34,10,8,749,41,420,10,3432
"06085509700",1842,166,56,0,949,28,503,128,3672
"06085509801",3707,49,108,0,1789,34,723,0,6410
"06085509802",1798,172,119,4,875,19,290,128,3405
"06085509901",1314,12,0,0,486,54,32,21,1919
"06085509902",3108,279,29,0,1405,109,428,8,5366
"06085510001",3913,56,17,0,2174,6,253,6,6425
"06085510002",2386,98,0,8,1252,46,112,9,3911
"06085510100",2059,68,0,0,897,11,128,9,3172
"06085510200",3029,49,165,0,1204,67,158,0,4672
"06085510300",3013,87,0,0,1061,58,88,0,4307
"06085510400",1935,49,0,0,1191,11,102,17,3305
"06085510500",3344,29,0,4,1445,44,126,0,4992
"06085510600",3736,165,0,0,2462,12,884,0,7259
"06085510700",2417,226,269,0,2254,198,477,178,6019
"06085510801",3001,65,0,0,2456,127,254,2,5905
"06085510802",1197,5,23,1,647,0,166,0,2039
"06085510803",1169,78,24,0,1016,68,178,0,2533
"06085510900",3052,221,43,0,2273,68,307,0,5964
"06085511000",3499,260,138,1,2927,77,320,2,7224
"06085511100",3297,126,41,1,1953,168,388,53,6027
"06085511200",3753,8,73,1,1169,20,171,18,5213
"06085511301",2577,339,53,0,635,37,117,70,3828
"06085511302",2545,253,0,0,863,274,292,19,4246
"06085511400",2414,45,99,0,864,65,257,0,3744
"06085511500",4762,115,126,0,1791,266,522,0,7582
"06085511608",50,13,0,0,53,19,0,4,139
"06085511609",1979,138,121,0,732,67,111,47,3195
"06085511701",2985,11,0,1,1170,71,250,1,4489
"06085511702",2044,44,5,0,766,13,123,0,2995
"06085511704",2766,324,0,0,1523,70,79,13,4775
"06085511705",518,36,0,0,357,0,65,0,976
"06085511707",1973,22,0,0,614,160,217,10,2996
"06085511800",3895,240,0,10,531,39,160,11,4886
"06085511905",1741,55,0,0,1225,88,250,44,3403
"06085511907",2373,0,43,0,1606,11,458,0,4491
"06085511909",4001,71,0,0,4057,99,421,27,8676
"06085511910",2194,56,9,0,939,9,19,10,3236
"06085511911",3299,85,265,0,1363,13,473,0,5498
"06085511912",2589,54,40,10,2621,80,228,1,5623
"06085511913",2980,32,6,0,1144,0,584,9,4755
"06085511914",3494,156,8,8,2066,57,498,49,6336
"06085511915",1361,353,216,138,1275,341,1118,379,5181
"06085511916",2913,112,40,64,1436,128,582,37,5312
"06085512001",2900,19,130,17,3714,96,1526,1,8403
"06085512005",3454,123,262,0,2182,560,1251,648,8480
"06085512017",3331,880,177,144,3659,534,3444,734,12903
"06085512019",2214,86,254,21,2001,257,1289,148,6270
"06085512020",2810,145,222,67,3476,233,2205,239,9397
"06085512021",2970,112,158,0,2598,300,1279,91,7508
"06085512022",2554,128,240,43,2314,197,1872,104,7452
"06085512023",2952,241,506,113,1677,408,2311,321,8529
"06085512024",2357,51,247,7,1720,103,1104,14,5603
"06085512025",1822,133,142,0,1018,44,566,9,3734
"06085512026",2024,99,107,65,1349,204,1266,132,5246
"06085512027",2724,192,124,16,1294,155,1146,110,5761
"06085512029",4346,113,91,0,2272,21,1888,31,8762
"06085512030",1814,59,79,0,945,51,577,52,3577
"06085512031",2743,204,58,0,1413,5,883,152,5458
"06085512032",2190,204,106,0,893,53,1157,178,4781
"06085512033",3476,492,157,145,2317,33,1612,365,8597
"06085512034",1856,63,21,0,1224,42,1074,0,4280
"06085512035",2358,223,173,0,1536,30,1266,129,5715
"06085512036",2405,376,205,31,2245,41,1001,256,6560
"06085512037",1896,127,37,5,1112,60,635,56,3928
"06085512038",1229,110,246,42,1263,26,733,60,3709
"06085512039",2050,50,205,19,2292,259,1457,81,6413
"06085512042",750,126,53,47,1590,166,853,171,3756
"06085512043",2229,998,359,0,2685,416,3123,1055,10865
"06085512045",3740,165,243,0,1510,57,1572,80,7367
"06085512047",3504,464,48,0,1423,163,1368,190,7160
"06085512052",2460,262,83,0,1384,109,869,92,5259
"06085512053",2741,168,301,111,1391,306,1649,312,6979
"06085512100",1059,40,0,0,383,76,667,85,2310
"06085512200",3470,214,45,0,738,13,1222,13,5715
"06085512305",2773,104,107,0,1095,52,797,13,4941
"06085512307",4177,434,40,0,1837,27,1514,222,8251
"06085512308",4760,364,138,155,2091,287,1941,24,9760
"06085512309",3810,10,137,9,971,342,1256,285,6820
"06085512310",2121,534,83,0,1384,47,1692,452,6313
"06085512311",2246,51,87,32,840,64,724,65,4109
"06085512312",2054,178,120,0,710,26,959,104,4151
"06085512313",2245,655,32,178,971,62,1578,620,6341
"06085512314",3462,443,95,121,1627,241,2367,336,8692
"06085512401",3247,224,103,0,1036,83,2033,221,6947
"06085512402",3188,105,165,0,1620,60,1899,79,7116
"06085512503",5911,101,185,2,1461,228,2503,117,10508
"06085512505",5623,442,310,0,1306,147,4500,454,12782
"06085512506",3487,823,90,150,1865,624,3814,1277,12130
"06085512508",5446,882,14,25,1568,476,3839,1219,13469
"06085512509",2526,369,38,44,1058,68,2076,378,6557
"06085512510",4048,521,73,17,1427,71,2465,446,9068
"06085512602",1690,244,19,11,555,211,1242,232,4204
"06085512603",1838,952,58,0,827,450,2045,1359,7529
"06085512604",2376,744,10,0,949,695,2868,1371,9013
"06085513000",1675,641,88,0,1221,811,239,55,4730
"06085513500",613,41,11,0,191,0,169,4,1029
"06087100100",1791,103,45,5,239,38,428,66,2715
"06087100200",4386,771,130,124,460,255,1390,201,7717
"06087100300",2280,271,24,20,181,291,178,109,3354
"06087100400",477,163,0,25,403,110,128,89,1395
"06087100500",3970,1879,72,0,401,412,537,155,7426
"06087100600",2740,329,23,0,427,183,518,83,4303
"06087100700",1189,161,43,2,359,2,269,34,2059
"06087100800",4140,1535,136,2,1134,455,1156,1024,9582
"06087100900",3456,401,0,0,425,62,727,2,5073
"06087101000",3497,2087,75,114,797,1272,1047,1208,10097
"06087101100",3901,742,99,0,405,124,471,72,5814
"06087101200",2247,428,20,10,220,165,317,35,3442
"06087110100",4432,983,0,0,2310,82,4771,897,13475
"06087110200",5255,970,21,0,1786,528,5274,1372,15206
"06087110300",2987,1069,28,11,2029,1093,4783,2109,14109
"06087110400",3518,1398,15,12,2441,312,4571,1590,13857
"06087110501",3332,960,0,0,1869,793,3804,1462,12220
"06087110502",4017,415,0,0,1332,334,4551,689,11338
"06087110600",5174,566,0,0,1316,537,5551,954,14098
"06087110700",1303,545,40,0,904,532,1563,909,5796
"06087120200",3267,398,11,104,346,236,383,250,4995
"06087120301",5000,282,19,0,397,35,264,3,6000
"06087120302",2038,210,0,0,327,33,350,36,2994
"06087120400",3827,551,51,0,275,39,300,0,5043
"06087120500",4421,225,26,0,474,27,261,16,5450
"06087120600",4053,484,14,8,316,0,283,61,5219
"06087120700",3445,170,0,0,313,0,235,0,4163
"06087120800",5169,161,76,0,444,103,503,0,6456
"06087120900",6666,503,61,4,1131,95,824,53,9337
"06087121000",2958,168,0,0,340,11,69,11,3557
"06087121100",2472,426,38,0,414,25,645,188,4208
"06087121200",5239,587,10,6,502,7,444,26,6821
"06087121300",3734,244,0,32,704,27,1544,63,6348
"06087121401",1770,290,41,1,293,70,612,157,3234
"06087121402",2953,896,0,0,547,102,1025,596,6119
"06087121403",2745,454,0,52,290,82,580,236,4439
"06087121500",3984,441,67,0,260,355,652,368,6127
"06087121600",4723,682,77,0,568,219,1108,291,7668
"06087121700",5696,560,30,0,1050,74,2019,268,9697
"06087121800",3526,323,42,9,577,75,748,74,5374
"06087122001",4497,493,0,11,364,101,457,174,6097
"06087122002",3120,130,28,0,228,38,138,9,3691
"06087122003",4663,797,76,0,1060,54,1299,86,8035
"06087122100",2573,239,0,0,383,61,646,105,4007
"06087122201",5362,759,48,0,443,96,666,487,7861
"06087122202",1950,133,13,0,309,6,352,17,2780
"06087122203",3087,84,47,12,215,11,193,15,3664
"06087122300",2862,340,17,0,520,0,639,142,4520
"06087122400",5423,454,0,14,1068,81,1401,107,8548
"06087122500",3911,596,69,23,1619,179,4284,699,11380
"06087123100",1603,307,0,0,549,52,1194,287,3992
"06087123300",1149,285,0,5,249,125,780,357,2950
"06087990100",0,0,0,0,0,0,0,0,0
"06089010100",649,293,4,10,68,70,59,29,1182
"06089010200",1499,525,8,54,76,64,97,44,2367
"06089010300",2846,523,116,34,534,179,296,76,4604
"06089010400",2607,865,10,18,249,106,134,44,4033
"06089010500",3070,780,101,67,1041,354,656,114,6183
"06089010601",2278,164,16,18,205,15,70,18,2784
"06089010602",3886,519,82,0,767,189,491,102,6036
"06089010603",1105,99,0,0,276,32,33,0,1545
"06089010702",2911,672,16,0,492,32,86,121,4330
"06089010703",2339,749,24,0,140,15,135,24,3426
"06089010704",2671,1265,35,1,105,228,239,248,4792
"06089010803",3665,350,141,31,426,570,278,95,5556
"06089010804",1866,271,0,0,125,34,121,17,2434
"06089010805",3968,514,36,81,396,62,278,61,5396
"06089010806",2154,403,0,0,254,148,102,109,3170
"06089010807",3501,266,8,0,321,107,294,63,4560
"06089010900",2391,543,41,38,647,216,283,162,4321
"06089011001",1324,154,2,2,139,12,141,0,1774
"06089011002",4122,861,0,0,248,368,170,433,6202
"06089011100",2332,207,32,4,390,60,108,0,3133
"06089011209",2911,1455,52,0,919,259,140,508,6244
"06089011300",3114,625,33,102,785,358,464,299,5780
"06089011401",3129,346,38,2,232,90,204,60,4101
"06089011402",2546,76,0,0,490,0,353,0,3465
"06089011403",2183,218,0,0,273,0,309,7,2990
"06089011500",4703,531,0,0,414,49,80,57,5834
"06089011600",2480,568,0,0,268,238,103,147,3804
"06089011701",1935,280,0,0,218,0,200,19,2652
"06089011702",1811,685,54,1,628,227,363,171,3940
"06089011703",2292,572,40,0,293,136,418,200,3951
"06089011801",2025,319,13,1,105,52,113,100,2728
"06089011802",2110,171,0,2,193,102,64,130,2772
"06089011803",2174,369,0,0,77,12,170,97,2899
"06089011900",3932,222,0,8,332,28,139,30,4691
"06089012000",2737,1222,7,0,443,202,756,152,5519
"06089012101",3413,682,6,0,182,126,330,77,4816
"06089012102",1294,397,16,0,173,59,148,8,2095
"06089012200",4337,1129,0,0,368,346,579,365,7124
"06089012301",1922,713,70,0,268,58,274,412,3717
"06089012302",4275,852,0,0,297,59,290,45,5818
"06089012303",3249,467,0,35,175,10,83,1,4020
"06089012400",2892,625,14,2,247,141,142,4,4067
"06089012500",936,412,0,0,108,77,31,2,1566
"06089012601",3737,558,29,11,447,77,274,43,5176
"06089012603",2938,408,0,0,454,96,223,11,4130
"06089012604",1822,236,0,2,126,67,80,51,2384
"06089012701",3166,859,0,34,97,34,375,8,4573
"06089012702",2603,332,0,0,189,33,340,103,3600
"06091010000",2455,429,0,2,98,7,216,52,3259
"06093000100",944,287,0,0,82,36,424,243,2016
"06093000200",1321,344,15,0,104,106,454,210,2554
"06093000300",3209,758,13,5,270,72,199,204,4730
"06093000400",468,149,0,0,29,11,16,13,686
"06093000500",932,398,8,5,356,257,95,109,2160
"06093000600",1430,266,0,0,90,127,127,32,2072
"06093000701",2716,470,1,0,336,50,124,43,3740
"06093000702",2105,812,3,99,462,534,218,198,4431
"06093000703",2064,833,68,0,360,307,218,141,3991
"06093000800",2320,457,0,17,322,149,147,11,3423
"06093000900",4574,1241,186,79,446,236,650,210,7622
"06093001000",5280,1082,0,0,351,0,361,135,7209
"06093001100",1256,433,50,9,182,52,111,93,2186
"06093001200",1026,319,1,0,67,26,81,77,1597
"06095250103",1171,140,771,336,1690,308,490,134,5040
"06095250104",794,82,160,4,1114,53,126,34,2367
"06095250105",1194,63,928,210,4068,260,381,52,7156
"06095250106",1192,118,573,14,2785,247,521,7,5457
"06095250200",1875,538,560,97,595,202,723,348,4938
"06095250300",1393,226,798,196,615,154,820,62,4264
"06095250400",1204,158,225,185,670,43,620,64,3169
"06095250501",981,275,176,7,506,128,398,126,2597
"06095250502",1599,62,376,170,645,228,718,33,3831
"06095250601",2370,264,1060,332,1070,207,1584,116,7003
"06095250604",1237,307,479,115,1472,41,409,9,4069
"06095250605",1624,80,611,10,1975,47,653,3,5003
"06095250701",1374,320,452,246,840,53,1300,262,4847
"06095250801",1499,355,696,196,593,147,583,104,4173
"06095250900",359,255,220,663,209,225,134,231,2296
"06095251000",1155,77,425,322,434,101,302,59,2875
"06095251100",1198,1371,165,94,726,64,888,1175,5681
"06095251200",1503,264,337,296,635,96,1271,260,4662
"06095251300",1626,132,200,75,261,20,486,20,2820
"06095251400",2509,206,649,254,1233,257,826,290,6224
"06095251500",1561,738,550,344,563,160,980,475,5371
"06095251600",912,408,404,390,247,330,363,297,3351
"06095251701",1239,616,582,113,779,265,452,497,4543
"06095251702",672,142,486,342,903,261,199,227,3232
"06095251802",689,305,163,338,666,332,384,236,3113
"06095251803",1679,353,794,103,2040,244,1544,308,7065
"06095251804",945,164,334,133,1992,71,860,133,4632
"06095251901",2119,762,1026,560,880,150,1640,551,7688
"06095251902",1586,352,1241,350,1988,440,1549,362,7868
"06095251903",1474,131,1447,429,1844,251,1348,334,7258
"06095252000",3217,124,149,102,460,103,644,0,4799
"06095252102",2600,181,206,29,745,27,662,21,4471
"06095252103",1366,127,865,395,2716,79,519,13,6080
"06095252104",3350,13,303,20,1914,233,718,33,6584
"06095252105",2162,99,166,12,931,10,419,22,3821
"06095252106",3123,214,188,0,900,68,957,31,5481
"06095252107",2535,87,175,0,626,36,376,13,3848
"06095252108",2168,76,234,7,543,66,355,25,3474
"06095252201",4828,70,587,172,3157,70,1316,2,10202
"06095252202",4247,20,879,74,5111,131,2096,88,12646
"06095252305",2781,63,435,0,1554,12,899,8,5752
"06095252306",2201,113,358,46,529,104,769,0,4120
"06095252310",1784,122,115,0,931,16,103,1,3072
"06095252311",2086,22,635,115,1516,45,599,8,5026
"06095252312",1523,410,390,15,817,96,463,301,4015
"06095252313",2316,105,497,113,2405,346,1352,0,7134
"06095252314",1747,225,256,24,1457,118,867,117,4811
"06095252315",1900,54,682,0,1665,41,526,0,4868
"06095252316",1626,44,734,52,1014,147,875,168,4660
"06095252317",3168,0,1005,23,2977,51,1180,39,8443
"06095252401",1795,219,357,27,1460,154,1572,106,5690
"06095252402",1462,561,535,206,1676,598,1360,799,7197
"06095252501",791,307,218,33,956,489,875,565,4234
"06095252502",625,259,148,55,465,137,397,70,2156
"06095252604",837,369,472,184,718,366,823,212,3981
"06095252605",1576,601,603,272,1928,816,2030,903,8729
"06095252606",1705,885,716,315,1421,729,1803,1054,8628
"06095252607",1355,391,322,325,1062,728,1616,815,6614
"06095252608",1390,166,717,211,1465,315,1473,374,6111
"06095252610",1561,20,515,164,902,47,911,0,4120
"06095252611",1079,222,564,116,1151,105,1173,209,4619
"06095252702",2135,146,700,304,3005,630,1033,296,8249
"06095252703",1137,135,695,172,1707,217,1013,164,5240
"06095252704",1675,106,1205,120,1241,266,819,244,5676
"06095252705",1925,549,1045,233,1884,528,892,766,7822
"06095252706",1649,25,850,0,1318,31,706,28,4607
"06095252707",1654,317,648,547,1868,167,1324,361,6886
"06095252801",1938,194,248,27,592,59,386,36,3480
"06095252802",623,22,59,0,35,0,41,0,780
"06095252903",3770,119,6,0,663,0,630,33,5221
"06095252904",3304,194,427,6,1976,63,1589,59,7618
"06095252908",2327,206,156,9,880,26,683,42,4329
"06095252909",2293,79,142,10,591,22,785,7,3929
"06095252910",3708,317,389,8,1534,65,1220,47,7288
"06095252911",3646,368,106,0,672,0,340,31,5163
"06095252912",4171,145,260,43,1110,200,711,89,6729
"06095252913",3296,239,374,17,1157,10,1067,0,6160
"06095252914",3533,213,438,36,1424,63,939,85,6731
"06095252915",2105,17,691,0,1082,17,685,24,4621
"06095253000",0,0,0,0,0,0,0,0,0
"06095253101",3706,536,294,0,719,225,1269,410,7159
"06095253105",2854,752,315,219,1229,473,1451,232,7525
"06095253106",2345,179,279,11,517,125,795,97,4348
"06095253107",3222,284,338,71,1624,620,1539,513,8211
"06095253108",2805,227,352,22,877,38,680,148,5149
"06095253201",3808,234,274,0,426,48,680,78,5548
"06095253203",2980,374,97,31,483,156,972,202,5295
"06095253204",3593,777,300,445,1278,241,1721,741,9096
"06095253205",1666,169,55,66,696,839,708,370,4569
"06095253206",2197,82,32,0,723,0,344,0,3378
"06095253300",2212,111,14,13,719,51,939,129,4188
"06095253402",4524,845,96,2,1303,356,2515,739,10380
"06095253403",3516,151,37,0,1433,165,1688,90,7080
"06095253404",3939,770,268,0,1115,335,1876,542,8845
"06095253500",6035,871,528,16,1459,185,1253,94,10441
"06095980000",0,0,0,0,0,0,0,0,0
"06097150100",2186,192,0,0,221,23,282,0,2904
"06097150202",3937,254,0,0,964,9,1096,18,6278
"06097150203",3867,420,0,0,444,208,653,208,5800
"06097150204",2880,446,0,0,270,65,359,53,4073
"06097150303",3928,184,0,25,291,1,455,1,4885
"06097150304",4584,324,51,0,649,326,1889,456,8279
"06097150305",3726,315,12,7,1186,1327,3152,1452,11177
"06097150306",2631,333,2,0,577,278,701,359,4881
"06097150500",3944,802,53,38,342,66,150,174,5569
"06097150601",2834,265,0,0,971,46,1133,176,5425
"06097150602",2985,207,11,0,646,41,512,139,4541
"06097150603",4888,396,0,0,1251,280,1513,292,8620
"06097150607",3996,211,84,0,944,47,566,98,5946
"06097150609",3399,241,8,0,746,62,819,166,5441
"06097150610",3119,194,11,0,723,280,482,228,5037
"06097150611",2641,517,222,0,770,162,749,437,5498
"06097150612",3511,140,0,0,584,17,486,0,4738
"06097150701",3061,510,6,27,1140,281,1240,247,6512
"06097150702",4144,136,36,0,469,7,689,11,5492
"06097150800",3811,244,18,0,535,547,504,394,6053
"06097150901",3341,424,100,2,1169,188,1593,256,7073
"06097150902",2772,245,8,0,297,17,335,10,3684
"06097151000",3108,271,67,0,235,37,560,202,4480
"06097151100",4175,292,50,0,656,68,690,143,6074
"06097151201",4285,484,167,83,1742,266,1699,187,8913
"06097151203",3468,484,53,0,546,177,561,174,5463
"06097151204",2013,338,219,9,570,123,494,89,3855
"06097151301",2952,451,94,19,1025,224,1562,259,6586
"06097151305",3060,703,168,0,1317,239,1521,130,7138
"06097151306",2208,383,38,0,689,10,546,84,3958
"06097151307",3871,306,47,0,980,109,823,148,6284
"06097151308",3518,400,28,47,567,360,558,246,5724
"06097151309",3911,458,130,11,567,68,815,86,6046
"06097151310",2486,282,51,33,868,305,725,145,4895
"06097151311",4241,1393,68,59,966,165,1083,46,8021
"06097151401",3598,583,18,0,2564,447,2734,715,10659
"06097151402",4618,1085,331,10,2495,666,3367,963,13535
"06097151502",5200,410,203,45,1221,120,1001,147,8347
"06097151503",3181,77,0,0,179,15,161,5,3618
"06097151504",2783,108,78,13,350,29,476,42,3879
"06097151601",2456,112,0,0,70,7,11,0,2656
"06097151602",3081,113,0,0,63,0,91,9,3357
"06097151700",4810,318,92,17,1214,143,1314,179,8087
"06097151800",4163,531,32,0,516,103,564,231,6140
"06097151900",2078,258,50,7,658,199,1119,52,4421
"06097152000",1001,385,13,30,299,75,323,102,2228
"06097152100",1462,330,0,7,673,15,532,8,3027
"06097152201",2263,506,20,21,686,147,465,190,4298
"06097152202",4375,321,86,0,1206,373,1003,348,7712
"06097152203",2488,330,137,88,350,89,266,56,3804
"06097152300",3756,211,46,0,433,31,490,19,4986
"06097152400",7488,222,53,10,2143,70,1066,0,11052
"06097152501",3303,359,95,9,613,0,627,65,5071
"06097152502",2464,358,25,2,481,101,638,231,4300
"06097152600",6657,424,57,0,968,29,747,61,8943
"06097152701",4320,384,55,0,370,227,444,111,5911
"06097152702",3589,478,160,0,985,88,978,208,6486
"06097152801",3713,291,30,5,1094,228,1105,311,6777
"06097152802",4138,718,139,112,1758,181,2958,190,10194
"06097152903",2653,343,188,21,1425,647,2414,742,8433
"06097152904",3736,229,274,0,744,293,778,279,6333
"06097152905",3164,143,26,0,756,45,1327,85,5546
"06097152906",4252,246,307,0,870,63,1069,0,6807
"06097153001",4667,962,138,29,1011,194,2678,682,10361
"06097153002",3310,804,79,38,1136,360,2393,1000,9120
"06097153003",3604,535,8,25,1478,332,1889,408,8279
"06097153005",5305,710,10,24,1063,346,1621,716,9795
"06097153006",5238,497,0,0,917,539,1690,323,9204
"06097153102",2487,490,216,8,1727,367,2867,411,8573
"06097153103",2414,423,52,0,960,463,1727,585,6624
"06097153104",1334,679,32,0,1434,658,1925,880,6942
"06097153200",3344,1089,187,0,3095,595,2851,1248,12409
"06097153300",6320,896,480,67,4076,736,3744,862,17181
"06097153401",5112,509,113,16,741,73,628,48,7240
"06097153403",3132,321,22,0,353,34,396,79,4337
"06097153404",3771,302,28,0,240,142,287,0,4770
"06097153501",3842,355,46,0,317,86,344,122,5112
"06097153502",3153,334,158,0,212,237,169,169,4432
"06097153600",4277,496,0,11,758,85,841,76,6544
"06097153703",2158,514,42,0,176,98,115,97,3200
"06097153704",2284,759,11,0,364,8,152,196,3774
"06097153705",2747,482,82,63,311,124,478,163,4450
"06097153706",3604,232,16,0,426,1,401,1,4681
"06097153801",6569,343,73,0,3430,610,3866,704,15595
"06097153804",2688,36,0,0,523,34,776,23,4080
"06097153806",2571,136,0,0,662,0,746,19,4134
"06097153807",3534,124,0,0,184,0,404,45,4291
"06097153808",2626,189,0,21,1317,69,1712,123,6057
"06097153809",3054,68,0,0,1060,127,1121,127,5557
"06097153901",3587,190,0,14,783,203,1140,217,6134
"06097153902",2650,301,21,0,1202,54,1726,157,6111
"06097153903",3475,202,47,0,451,74,715,114,5078
"06097154000",2042,174,0,21,469,102,545,74,3427
"06097154100",2374,401,5,27,999,164,1081,245,5296
"06097154201",2222,464,32,18,979,26,1471,254,5466
"06097154202",4493,260,55,0,1121,10,1332,66,7337
"06097154302",2699,385,0,0,229,30,141,10,3494
"06097154303",1262,105,4,0,56,14,37,6,1484
"06097154304",1417,219,13,2,209,79,230,17,2186
"06097990100",0,0,0,0,0,0,0,0,0
"06099000101",3959,427,10,2,406,52,636,188,5680
"06099000102",3330,638,0,0,372,18,706,426,5490
"06099000201",4713,406,15,78,337,31,837,50,6467
"06099000202",5123,1318,62,60,613,140,1459,467,9242
"06099000203",6352,1759,106,33,783,170,1981,1300,12484
"06099000301",1290,489,0,0,213,69,801,383,3245
"06099000302",1978,319,7,4,315,28,988,198,3837
"06099000303",4055,600,122,0,731,191,2779,576,9054
"06099000304",3547,967,36,61,792,84,3169,747,9403
"06099000402",7730,421,117,17,2190,374,3361,581,14791
"06099000403",3235,220,92,8,580,10,858,133,5136
"06099000404",3200,1086,192,0,937,272,635,604,6926
"06099000501",5425,304,15,0,1447,300,2419,150,10060
"06099000503",3053,564,139,89,1157,243,1336,325,6906
"06099000504",5259,410,295,5,3086,288,3005,164,12512
"06099000505",2648,806,151,12,1385,195,1216,529,6942
"06099000506",2642,739,101,109,658,259,582,653,5743
"06099000510",6369,628,146,0,1114,433,3300,881,12871
"06099000601",2880,620,107,0,901,37,1466,226,6237
"06099000602",1978,236,18,48,870,60,1401,193,4804
"06099000801",4116,802,100,3,985,98,1261,241,7606
"06099000803",1513,1043,256,35,701,621,1089,1120,6378
"06099000805",3450,836,166,102,1358,591,1939,771,9213
"06099000806",2637,442,71,96,894,132,1018,259,5549
"06099000807",2209,359,55,8,793,145,1083,201,4853
"06099000905",3911,492,142,0,737,215,1196,141,6834
"06099000906",5054,432,232,73,677,0,1590,79,8137
"06099000907",2656,85,0,11,177,29,522,21,3501
"06099000908",3198,566,310,188,640,141,1437,367,6847
"06099000909",2505,789,75,122,770,311,921,536,6029
"06099000910",3864,739,115,192,729,225,1650,609,8123
"06099000911",3752,461,115,129,539,173,1421,294,6884
"06099000912",12019,840,580,0,4574,588,3989,672,23262
"06099001001",3989,833,142,153,319,85,832,458,6811
"06099001002",1926,474,53,0,457,51,689,268,3918
"06099001100",2474,859,42,5,391,131,892,459,5253
"06099001200",2234,682,126,8,602,148,708,273,4781
"06099001300",4133,616,105,2,433,225,726,435,6675
"06099001400",3018,1115,214,235,771,904,1454,727,8438
"06099001500",3786,847,151,19,1497,709,2691,957,10657
"06099001601",2165,943,88,73,1234,633,2477,1022,8635
"06099001603",2471,1647,52,93,1291,881,2605,1820,10860
"06099001604",1376,759,126,20,733,782,1767,1234,6797
"06099001700",1076,774,47,44,230,340,1084,618,4213
"06099001800",978,479,61,23,132,110,303,207,2293
"06099001900",3233,939,67,194,625,33,811,266,6168
"06099002002",2227,1159,55,0,564,795,1393,1330,7523
"06099002004",3184,1778,432,66,848,349,1847,981,9485
"06099002005",1626,552,109,1,957,57,1088,330,4720
"06099002006",2198,428,143,8,1039,392,1028,405,5641
"06099002100",1779,1033,0,42,595,238,1791,839,6317
"06099002200",2554,1646,59,94,1045,916,2438,2035,10787
"06099002301",3100,1914,209,11,1777,1008,3670,2292,13981
"06099002302",1690,1076,0,0,858,247,2046,936,6853
"06099002401",1770,479,135,0,921,427,2116,721,6569
"06099002402",1758,1440,8,0,1422,1278,2861,2445,11212
"06099002501",3369,688,127,0,2027,253,4082,697,11243
"06099002503",2471,861,54,2,426,252,1988,832,6886
"06099002504",2548,347,77,0,1170,316,2562,524,7544
"06099002602",2168,1005,35,10,1174,214,1738,706,7050
"06099002603",1790,136,1,4,414,207,895,171,3618
"06099002604",1870,1084,177,96,910,480,2003,865,7485
"06099002605",2701,460,0,72,378,127,1571,154,5463
"06099002701",2371,322,80,0,1208,149,1998,203,6331
"06099002702",3964,794,69,63,1594,1035,3983,1425,12927
"06099002801",3507,666,59,39,857,244,1560,461,7393
"06099002802",3386,1050,13,60,1369,560,2112,780,9330
"06099002803",1829,519,0,0,273,107,536,402,3666
"06099002901",3470,649,0,1,225,195,726,440,5706
"06099002902",4928,1592,103,0,840,125,1782,1167,10537
"06099003001",5392,389,36,0,4012,211,4922,449,15411
"06099003002",3668,1369,0,0,1616,826,2877,1510,11866
"06099003100",2554,690,0,0,512,126,1436,334,5652
"06099003201",2303,1362,192,79,525,138,1943,1373,7915
"06099003202",8562,1753,1420,235,3772,988,7170,1814,25714
"06099003300",3612,955,103,35,567,52,2281,892,8497
"06099003400",1037,500,0,9,34,26,698,472,2776
"06099003500",7205,1751,154,40,1204,295,5352,1762,17763
"06099003603",2576,713,0,0,287,224,785,414,4999
"06099003604",6295,1888,0,74,792,134,2002,752,11937
"06099003605",5945,858,129,2,777,637,1338,448,10134
"06099003606",8356,308,221,0,2178,204,2991,218,14476
"06099003700",2984,454,173,0,648,448,2042,479,7228
"06099003802",2421,1593,13,168,764,370,2386,1524,9239
"06099003803",1631,668,0,0,492,67,1419,524,4801
"06099003804",4169,1282,75,0,759,393,2306,1204,10188
"06099003805",2024,198,27,0,310,125,1070,101,3855
"06099003904",3351,571,0,0,376,349,1642,455,6744
"06099003905",3371,130,3,0,212,31,637,23,4407
"06099003906",2528,1471,206,139,454,283,1286,1005,7372
"06099003907",5976,285,49,176,775,78,1430,78,8847
"06099003908",1348,452,33,30,375,84,868,152,3342
"06099003909",3765,734,73,0,777,126,1248,277,7000
"06099004000",2806,301,0,0,550,113,904,224,4898
"06101050101",3962,1136,160,62,1239,396,1687,882,9524
"06101050102",2389,753,47,10,644,220,845,251,5159
"06101050201",1205,770,66,98,686,364,638,748,4575
"06101050202",2078,883,24,31,392,329,976,754,5467
"06101050301",1777,252,15,0,263,19,445,109,2880
"06101050302",3818,1304,60,140,760,603,2768,1589,11042
"06101050401",2805,334,141,33,1434,148,841,162,5898
"06101050402",2804,370,20,0,981,105,645,249,5174
"06101050403",2518,193,86,0,876,71,941,61,4746
"06101050501",2738,882,27,0,2114,415,825,550,7551
"06101050503",3260,130,176,0,2463,943,1719,17,8708
"06101050504",3832,105,242,10,2300,155,743,27,7414
"06101050601",2967,458,184,9,1354,625,584,235,6416
"06101050603",3266,310,26,12,912,172,255,157,5110
"06101050604",2435,223,106,33,850,206,515,117,4485
"06101050701",2114,815,0,4,1050,117,1432,749,6281
"06101050702",3382,458,32,0,1350,591,2319,616,8748
"06101050800",2984,266,0,0,334,24,443,40,4091
"06101050900",1120,231,9,23,237,64,417,188,2289
"06101051000",1446,376,50,1,396,106,613,294,3282
"06101051100",2027,279,44,0,286,76,370,127,3209
"06103000100",3005,491,4,8,473,182,554,44,4761
"06103000200",6194,1209,0,0,629,82,463,317,8894
"06103000300",3016,1071,6,0,357,232,615,445,5742
"06103000400",4657,565,3,0,374,4,413,73,6089
"06103000500",3256,653,0,35,786,110,628,45,5513
"06103000600",3193,718,2,8,535,368,1007,228,6059
"06103000700",5317,2106,0,0,805,187,1145,403,9963
"06103000800",2974,396,12,0,498,37,1317,32,5266
"06103000900",2423,658,0,0,535,95,767,305,4783
"06103001000",4479,847,55,0,844,70,1859,334,8488
"06103001100",4851,1922,0,112,686,147,2554,930,11202
"06105000101",1776,567,35,0,97,128,32,93,2728
"06105000102",3201,426,0,0,439,174,114,16,4370
"06105000200",1767,330,26,0,136,29,78,7,2373
"06105000300",1929,652,33,0,516,86,460,79,3755
"06105000400",533,106,1,0,89,64,32,1,826
"06107000100",3895,321,7,0,457,95,1176,111,6062
"06107000201",4007,2895,94,0,2297,585,5194,3456,18528
"06107000202",1291,867,0,0,333,147,1242,854,4734
"06107000301",4350,1406,11,62,610,344,2369,1485,10637
"06107000302",1675,1148,12,0,272,329,1582,1353,6371
"06107000401",3660,1557,38,0,899,65,3963,1388,11570
"06107000402",4730,1388,19,0,1095,257,4165,1603,13257
"06107000501",3151,2157,0,0,733,527,3662,2596,12826
"06107000502",2514,499,0,0,429,395,2651,787,7275
"06107000600",2778,2077,0,25,822,493,3211,2595,12001
"06107000701",1538,587,3,0,357,147,1314,501,4447
"06107000702",3424,1313,0,33,634,302,3560,1353,10619
"06107000800",3782,2068,0,2,898,319,2829,1781,11679
"06107000900",4196,1612,14,207,911,498,3266,1912,12616
"06107001003",13757,3296,287,74,3768,975,8239,2636,33032
"06107001004",3216,1864,61,69,1687,720,3931,2092,13640
"06107001005",2092,134,81,0,484,0,791,78,3660
"06107001006",4381,510,35,0,644,158,877,370,6975
"06107001100",2120,3317,12,217,937,500,1908,3409,12420
"06107001200",499,292,50,20,101,35,213,184,1394
"06107001301",5030,1349,133,0,1182,550,3119,1479,12842
"06107001302",4692,1756,177,47,1128,224,2692,1022,11738
"06107001400",4227,825,52,0,557,48,2927,593,9229
"06107001501",3355,986,0,48,626,119,975,809,6918
"06107001502",3439,1746,83,52,487,85,1705,1083,8680
"06107001601",2538,1885,0,229,636,224,2763,1868,10143
"06107001602",3291,1606,0,0,489,35,2579,1556,9556
"06107001701",2162,1913,270,236,1002,391,1947,1868,9789
"06107001703",4697,855,112,0,1022,31,1788,515,9020
"06107001704",4931,806,147,0,1066,110,2800,477,10337
"06107001800",3533,347,45,56,374,251,1246,306,6158
"06107001901",2800,243,9,3,532,18,1212,146,4963
"06107001902",3038,529,0,0,637,54,1050,335,5643
"06107002002",3114,993,7,43,636,124,1210,786,6913
"06107002003",3886,882,195,83,584,102,1537,624,7893
"06107002004",3532,554,59,0,431,165,1475,470,6686
"06107002006",3753,156,26,8,498,32,1242,81,5796
"06107002007",6291,807,193,0,1015,132,3108,596,12142
"06107002008",1584,878,0,79,208,153,815,578,4295
"06107002009",2912,549,166,36,393,13,1297,380,5746
"06107002100",1814,383,2,14,350,76,1132,309,4080
"06107002202",2600,1913,251,88,642,432,2537,2064,10527
"06107002203",3193,919,23,46,656,138,2924,694,8593
"06107002204",3401,1991,73,139,750,157,2955,1782,11248
"06107002302",3448,255,169,39,257,308,1398,417,6291
"06107002303",4845,235,153,0,732,66,1475,130,7636
"06107002304",1253,405,14,12,47,46,689,180,2646
"06107002400",9719,867,206,27,1526,168,5180,695,18388
"06107002500",2964,525,0,0,421,235,2522,685,7352
"06107002601",2239,1233,0,19,699,336,2670,1467,8663
"06107002602",3202,1323,0,0,727,557,3148,1691,10648
"06107002700",3848,342,6,2,948,508,777,85,6516
"06107002800",1189,1733,53,0,365,195,1305,1751,6591
"06107002901",1411,1177,311,22,310,191,1296,1173,5891
"06107002903",3780,526,83,112,653,197,2200,427,7978
"06107002904",3293,829,135,59,441,147,2069,844,7817
"06107003001",2157,1007,83,10,602,281,2072,1056,7268
"06107003002",2036,715,93,9,346,277,1796,742,6014
"06107003100",2102,869,111,0,290,40,1333,721,5466
"06107003200",3882,2343,9,0,212,306,3271,2430,12453
"06107003300",4051,2619,0,0,810,435,2908,2582,13405
"06107003400",4028,2431,34,26,799,454,2661,2465,12898
"06107003501",1814,432,13,0,391,8,886,263,3807
"06107003502",7648,1590,124,14,1494,372,5241,1406,17889
"06107003601",4192,1605,56,53,867,195,2261,1091,10320
"06107003602",3223,2267,0,0,1098,443,2090,2199,11320
"06107003700",3787,1479,38,0,570,680,2707,1745,11006
"06107003801",1557,937,0,0,339,340,1163,950,5286
"06107003802",1850,1435,0,55,618,441,1875,1437,7711
"06107003901",3342,1689,31,9,1338,285,3565,1754,12013
"06107003902",3266,1584,0,0,479,361,2288,1486,9464
"06107004000",16,44,2,41,3,0,0,8,114
"06107004101",4176,2708,26,26,835,932,4333,3139,16175
"06107004102",890,744,0,0,202,155,701,765,3457
"06107004200",2624,2795,99,76,397,754,2716,2862,12323
"06107004300",3129,2665,22,98,1036,946,3595,3358,14849
"06107004400",2663,3762,23,56,637,419,2886,3971,14417
"06107004500",3066,1813,257,0,808,299,2850,1947,11040
"06109001100",2591,296,39,60,364,24,375,39,3788
"06109001200",1983,1140,67,37,387,121,143,266,4144
"06109002100",3924,364,0,0,347,132,518,68,5353
"06109002200",6766,644,55,3,273,9,568,14,8332
"06109003100",5255,791,0,0,481,51,540,31,7149
"06109003200",4341,722,2,2,532,141,442,219,6401
"06109004100",4257,522,1,2,123,167,419,141,5632
"06109004200",2782,464,0,0,131,56,182,65,3680
"06109005100",6350,1017,0,0,502,151,490,112,8622
"06109005201",1764,59,29,0,167,35,175,0,2229
"06109985202",0,0,0,0,0,0,0,0,0
"06111000100",456,81,0,0,18,19,49,18,641
"06111000200",1880,273,0,32,423,150,2056,365,5179
"06111000302",4503,1148,2,0,1388,262,4219,1215,12737
"06111000303",3508,472,0,0,674,156,3138,595,8543
"06111000304",2064,1560,0,0,722,150,1996,1624,8116
"06111000400",4276,772,10,0,1447,105,4689,748,12047
"06111000500",819,432,0,0,396,67,827,426,2967
"06111000600",2725,1790,51,12,1117,512,3310,2263,11780
"06111000701",3506,1340,0,0,1154,171,3883,1387,11441
"06111000702",2438,222,7,0,687,57,2314,243,5968
"06111000800",6760,511,11,0,1170,324,4808,571,14155
"06111000901",2201,106,0,6,221,4,329,3,2870
"06111000902",1478,269,0,2,106,47,106,34,2042
"06111000903",4106,872,0,22,371,144,776,330,6621
"06111001001",2168,337,0,0,294,63,482,27,3371
"06111001002",5238,922,25,0,405,172,1417,618,8797
"06111001101",4241,277,0,0,267,57,1287,64,6193
"06111001102",2850,624,0,0,323,9,516,60,4382
"06111001201",3064,456,19,8,715,134,1390,353,6139
"06111001202",5266,176,165,29,935,77,1288,84,8020
"06111001204",1786,625,78,7,254,49,1001,383,4183
"06111001206",726,42,0,0,134,11,239,23,1175
"06111001301",5691,1333,161,0,1412,33,2570,937,12137
"06111001302",1175,433,42,12,331,87,753,440,3273
"06111001401",3354,134,31,2,483,29,1019,40,5092
"06111001402",4069,398,81,1,803,65,1552,185,7154
"06111001502",6461,988,206,197,1113,63,2739,497,12264
"06111001503",2925,409,120,0,1007,71,1411,192,6135
"06111001506",4242,292,22,0,547,25,1594,100,6822
"06111001507",2882,408,106,0,665,267,1301,299,5928
"06111001601",772,114,32,9,194,13,349,77,1560
"06111001602",1729,211,0,0,282,2,385,33,2642
"06111001700",2979,90,0,0,345,11,330,0,3755
"06111001800",3460,81,153,0,517,0,605,10,4826
"06111001900",2991,220,62,8,461,139,538,125,4544
"06111002000",2035,233,140,9,339,7,359,87,3209
"06111002102",1108,220,10,0,179,9,219,35,1780
"06111002200",4407,1367,0,0,847,213,3089,1300,11223
"06111002300",5040,992,0,7,1353,195,4904,903,13394
"06111002400",1863,489,84,0,165,103,549,125,3378
"06111002500",4085,199,0,0,238,75,314,39,4950
"06111002600",2377,394,0,0,310,37,651,177,3946
"06111002700",3580,222,0,0,281,84,902,84,5153
"06111002800",4576,718,37,45,1008,58,1660,551,8653
"06111002901",4128,273,307,22,1148,87,2636,291,8892
"06111002905",3156,634,292,12,1418,85,3115,460,9172
"06111003010",2249,221,69,10,634,119,2183,256,5741
"06111003011",3874,1062,185,37,758,82,3868,1019,10885
"06111003012",372,0,0,0,85,8,439,8,912
"06111003013",3542,203,67,0,1212,38,3098,188,8348
"06111003100",9642,639,470,0,4153,732,10272,1274,27182
"06111003201",2259,1490,3,6,439,91,2671,1499,8458
"06111003300",5892,1062,88,156,1125,38,5062,1037,14460
"06111003605",5881,324,714,47,1866,253,4195,434,13714
"06111003608",2292,387,251,0,986,35,2408,336,6695
"06111003609",4469,381,180,0,525,179,352,240,6326
"06111003612",3568,70,98,0,470,12,412,0,4630
"06111003700",3663,1156,349,28,1108,326,4539,1456,12625
"06111003801",3570,499,14,39,762,304,4154,837,10179
"06111003802",1470,665,113,0,309,134,1695,778,5164
"06111003900",4328,1575,88,171,1212,150,4966,1701,14191
"06111004000",4055,779,46,13,1016,722,4449,1369,12449
"06111004101",4976,629,52,0,1269,106,5228,521,12781
"06111004200",3357,458,74,9,1386,88,3318,496,9186
"06111004304",4318,1050,265,0,832,323,3177,877,10842
"06111004305",814,147,92,0,270,22,134,73,1552
"06111004400",4106,783,496,30,1963,269,3228,650,11525
"06111004503",1831,884,14,6,1247,76,2100,960,7118
"06111004504",3133,1003,81,19,1167,313,3204,1128,10048
"06111004505",1483,338,46,16,265,73,1392,312,3925
"06111004506",3218,1916,148,64,1772,339,4305,2167,13929
"06111004600",970,142,87,15,421,21,279,42,1977
"06111004704",1049,215,32,0,170,64,1020,224,2774
"06111004710",2937,505,86,0,1043,82,2934,515,8102
"06111004711",1481,424,55,7,1361,198,1383,518,5427
"06111004715",3263,502,139,0,1428,112,3484,400,9328
"06111004716",2646,614,87,0,1000,111,3038,668,8164
"06111004717",2708,860,97,6,801,35,3098,896,8501
"06111004901",4540,177,150,0,1983,159,4205,139,11353
"06111004902",3165,1412,5,7,309,220,3296,1632,10046
"06111005002",1751,571,10,0,311,145,1853,696,5337
"06111005003",4838,1572,139,1,981,104,4934,1496,14065
"06111005004",3950,651,47,162,1832,180,3163,660,10645
"06111005100",2491,137,21,0,586,39,1463,52,4789
"06111005202",2398,159,11,0,465,83,936,89,4141
"06111005203",4318,326,116,14,675,23,954,92,6518
"06111005204",2767,133,0,0,610,0,379,0,3889
"06111005205",4027,560,54,3,1142,14,1003,212,7015
"06111005303",6743,342,110,13,1954,171,1278,115,10726
"06111005304",3800,273,44,0,781,0,523,0,5421
"06111005305",4418,250,63,0,1027,0,884,43,6685
"06111005306",3964,218,18,0,747,0,980,0,5927
"06111005401",3016,100,84,1,1070,1,1446,51,5769
"06111005403",1882,144,37,0,339,113,1156,161,3832
"06111005404",3211,144,24,0,417,18,1196,76,5086
"06111005502",3000,542,176,76,1663,52,1781,378,7668
"06111005503",2581,109,231,0,1068,2,916,10,4917
"06111005504",3242,182,82,0,692,190,927,258,5573
"06111005600",6168,402,314,67,2134,125,2264,172,11646
"06111005700",1092,65,63,0,312,6,303,12,1853
"06111005801",4111,99,91,0,830,24,509,12,5676
"06111005802",7392,90,129,0,1999,0,1019,27,10656
"06111005901",5945,336,0,0,670,76,735,0,7762
"06111005906",5331,80,103,7,904,0,678,0,7103
"06111005907",3180,172,37,0,247,19,268,19,3942
"06111005908",2066,47,18,0,316,99,375,0,2921
"06111005909",2657,133,37,81,548,15,449,90,4010
"06111005910",1446,46,0,0,229,4,145,4,1874
"06111005911",2871,184,67,0,785,181,811,134,5033
"06111006000",3510,339,27,16,743,61,995,50,5741
"06111006100",4604,281,138,0,2952,546,2560,759,11840
"06111006200",2447,22,0,0,362,0,345,0,3176
"06111006301",4882,71,0,0,1181,32,721,0,6887
"06111006302",1809,247,0,150,377,55,213,77,2928
"06111006400",5899,221,0,0,1744,90,1677,214,9845
"06111006500",2575,216,0,0,667,213,1481,210,5362
"06111006600",3423,295,18,0,565,29,521,57,4908
"06111006700",2336,165,0,0,595,81,331,15,3523
"06111006800",3197,210,1,0,527,70,1056,152,5213
"06111006900",2354,784,22,6,518,100,392,495,4671
"06111007000",2320,577,55,28,932,66,1267,163,5408
"06111007100",4256,711,130,53,806,27,2390,275,8648
"06111007201",3001,97,52,2,302,1,373,1,3829
"06111007202",3510,90,16,0,563,18,362,0,4559
"06111007300",1471,53,0,0,165,58,61,50,1858
"06111007402",5330,160,145,0,699,68,494,0,6896
"06111007403",4550,291,48,0,1092,70,518,11,6580
"06111007405",5364,316,27,0,1079,22,560,25,7393
"06111007406",1876,122,13,0,428,13,122,6,2580
"06111007505",2797,92,0,0,549,3,902,0,4343
"06111007506",6459,221,21,2,849,0,1065,78,8695
"06111007507",5656,46,45,0,1348,0,647,0,7742
"06111007508",3068,176,12,12,302,9,589,19,4187
"06111007509",3380,28,157,0,964,9,566,10,5114
"06111007510",4314,67,36,0,1486,44,512,35,6494
"06111007511",1745,137,33,0,414,10,174,23,2536
"06111007512",4199,135,26,88,1035,0,933,27,6443
"06111007513",1475,22,20,2,142,4,269,2,1936
"06111007514",5198,98,0,0,1146,49,943,49,7483
"06111007606",1283,26,39,0,260,36,444,32,2120
"06111007607",5259,26,0,0,942,0,665,0,6892
"06111007609",2261,21,23,0,330,13,423,6,3077
"06111007610",4033,189,77,0,878,21,988,0,6186
"06111007611",2552,834,14,0,654,359,2269,1171,7853
"06111007612",3695,185,22,0,711,214,1693,280,6800
"06111007613",2861,240,79,0,745,7,680,188,4800
"06111007614",5299,271,48,0,1902,140,1781,230,9671
"06111007700",4301,237,177,0,1048,268,1943,348,8322
"06111007800",2196,610,102,14,1238,49,1457,462,6128
"06111007901",4447,200,164,0,887,44,2431,61,8234
"06111007903",3505,52,58,29,983,3,631,9,5270
"06111007904",4449,137,73,13,1236,48,1876,41,7873
"06111008001",2503,347,27,0,519,178,1027,293,4894
"06111008002",3922,513,0,6,769,17,1995,154,7376
"06111008004",3227,55,118,12,1273,72,1677,72,6506
"06111008005",1701,212,9,2,449,81,721,218,3393
"06111008101",2512,240,0,2,517,19,650,136,4076
"06111008201",2944,301,81,0,911,52,1015,197,5501
"06111008202",3334,244,40,0,956,112,1290,101,6077
"06111008302",3938,591,36,0,976,31,1195,260,7027
"06111008303",2616,242,49,0,667,270,669,148,4661
"06111008304",4081,129,67,0,1297,63,1073,16,6726
"06111008305",2473,68,20,0,1166,60,591,0,4378
"06111008306",2511,295,18,0,936,122,809,100,4791
"06111008401",3896,342,51,0,861,201,1033,267,6651
"06111008402",4287,334,74,0,537,12,599,118,5961
"06111008500",6691,271,193,0,1421,9,1118,35,9738
"06111008600",4727,1571,170,121,1074,427,4652,2029,14771
"06111008700",4094,1026,34,38,1076,71,4131,941,11411
"06111008800",3891,251,57,24,895,7,3495,150,8770
"06111008900",2492,454,54,0,593,56,2693,430,6772
"06111009100",2579,1008,152,10,662,261,3121,1220,9013
"06111980000",0,0,0,0,0,0,0,0,0
"06111990100",0,0,0,0,0,0,0,0,0
"06113010101",3496,1272,352,194,1421,1043,2811,466,11055
"06113010102",3217,998,331,25,2241,398,2414,138,9762
"06113010201",1783,325,48,73,488,216,697,202,3832
"06113010203",2078,1110,110,150,1040,725,1929,924,8066
"06113010204",2881,913,58,55,527,441,965,446,6286
"06113010302",4576,259,242,30,2152,54,1782,182,9277
"06113010310",3221,57,227,18,1937,118,1270,27,6875
"06113010312",4204,181,13,17,886,78,1008,17,6404
"06113010401",3144,446,16,9,612,370,633,437,5667
"06113010402",2273,19,361,21,1420,151,721,38,5004
"06113010501",657,831,0,0,702,847,162,150,3349
"06113010505",2958,421,50,0,1122,324,459,277,5611
"06113010508",1516,327,24,40,302,189,193,87,2678
"06113010509",1814,416,8,19,776,399,459,96,3987
"06113010510",2286,561,48,55,876,1385,264,295,5770
"06113010511",1901,202,0,8,717,468,193,55,3544
"06113010512",1417,668,30,84,992,206,453,112,3962
"06113010513",1289,603,0,0,531,369,140,103,3035
"06113010602",2426,1127,292,168,953,715,825,344,6850
"06113010605",2029,153,4,0,1180,106,389,130,3991
"06113010606",4344,705,74,63,1394,544,758,285,8167
"06113010607",2674,212,71,9,1156,95,384,116,4717
"06113010608",2049,725,88,66,1078,2280,612,431,7329
"06113010701",2823,1054,0,0,452,372,468,111,5280
"06113010703",1588,744,31,22,527,1656,92,447,5107
"06113010704",1241,465,6,40,285,374,252,88,2751
"06113010800",2374,430,0,15,660,302,1663,473,5917
"06113010901",3651,439,41,9,1081,386,2727,472,8806
"06113010902",3041,768,53,283,1654,278,2517,752,9346
"06113011001",3513,1100,38,0,1485,264,2471,871,9742
"06113011002",2832,88,7,0,315,4,892,26,4164
"06113011101",1781,255,8,0,749,280,1197,386,4656
"06113011102",2367,773,79,13,1098,302,2280,807,7719
"06113011103",1964,277,10,14,708,174,1472,218,4837
"06113011203",2078,0,25,0,233,0,449,0,2785
"06113011204",3747,407,27,0,1180,94,1916,379,7750
"06113011205",4759,371,23,0,2738,238,3382,373,11884
"06113011206",5065,111,39,0,1907,200,2184,26,9532
"06113011300",5661,339,53,0,1968,248,3902,228,12399
"06113011400",2704,369,39,40,755,338,1637,489,6371
"06113011500",3204,390,455,0,1370,206,1970,326,7921
"06115040100",2334,942,79,203,453,295,760,362,5428
"06115040200",4409,1642,304,0,1071,314,1240,547,9527
"06115040301",1129,898,97,207,732,439,831,450,4783
"06115040302",954,564,0,42,365,202,580,291,2998
"06115040303",3559,201,285,0,1979,854,1609,598,9085
"06115040400",1884,1301,15,7,937,962,1137,754,6997
"06115040500",1462,964,0,6,1528,284,1448,461,6153
"06115040600",3033,727,58,2,1849,221,1717,368,7975
"06115040700",8287,566,573,23,2570,548,2885,521,15973
"06115040800",2808,403,0,108,700,152,658,152,4981
"06115040901",1751,541,0,6,816,168,639,63,3984
"06115040902",619,108,169,12,265,22,96,10,1301
"06115041000",5367,614,88,0,799,120,552,138,7678
"06115041100",2801,916,4,31,288,247,221,258,4766
"08001007801",824,1070,230,257,680,869,861,1094,5885
"08001007802",1064,1168,371,588,714,457,1341,1436,7139
"08001007900",2098,1061,473,411,1387,520,2371,1202,9523
"08001008000",3336,324,767,444,1123,438,2887,468,9787
"08001008100",530,319,15,24,90,104,127,68,1277
"08001008200",2665,591,859,109,735,55,1335,478,6827
"08001008308",2210,871,343,906,773,442,1440,980,7965
"08001008309",1566,466,470,114,894,285,1725,647,6167
"08001008353",4002,417,787,67,872,9,2102,342,8598
"08001008401",3579,282,20,0,275,42,560,45,4803
"08001008402",4222,308,0,0,288,11,359,0,5188
"08001008505",5350,840,125,0,482,192,1371,471,8831
"08001008506",4223,1291,64,51,281,61,1567,674,8212
"08001008507",5238,682,58,0,969,268,2041,714,9970
"08001008508",4366,430,276,0,569,7,1119,268,7035
"08001008523",5908,393,279,0,370,0,1270,140,8360
"08001008524",6596,186,132,0,863,0,1625,0,9402
"08001008526",6090,113,174,11,673,138,1047,66,8312
"08001008529",5933,417,105,16,799,150,1543,63,9026
"08001008533",6431,465,100,0,567,61,1794,61,9479
"08001008534",4157,49,6,0,521,0,1423,18,6174
"08001008535",3105,56,17,0,315,44,1249,26,4812
"08001008536",2220,85,15,0,323,5,564,47,3259
"08001008537",5452,251,60,0,657,0,1962,222,8604
"08001008538",4873,137,346,0,874,13,1021,21,7285
"08001008539",7227,63,674,0,1301,0,3058,27,12350
"08001008540",5889,59,218,0,811,0,1455,19,8451
"08001008541",3994,181,53,0,384,20,198,0,4830
"08001008542",5911,328,314,0,805,0,1257,11,8626
"08001008543",7053,310,38,0,514,135,2320,295,10665
"08001008544",3869,20,44,0,572,0,455,10,4970
"08001008545",5758,349,152,0,959,23,1009,0,8250
"08001008546",2276,336,0,0,313,0,596,90,3611
"08001008547",3592,50,0,0,173,0,835,50,4700
"08001008548",1317,27,18,0,107,0,439,13,1921
"08001008549",3621,275,23,0,488,21,1090,255,5773
"08001008550",6250,349,82,0,1073,167,1107,57,9085
"08001008551",1131,42,37,0,190,0,265,0,1665
"08001008603",1551,416,24,0,171,57,1073,419,3711
"08001008604",2873,406,31,0,356,84,1943,247,5940
"08001008605",3133,185,0,0,235,58,1007,12,4630
"08001008606",4763,992,0,2,876,112,3777,820,11342
"08001008705",3487,948,61,26,410,172,2375,590,8069
"08001008706",3379,1132,123,1,390,134,2574,1031,8764
"08001008709",4165,2624,322,148,519,828,2827,2897,14330
"08001008801",3613,1360,64,58,396,131,2701,1251,9574
"08001008802",2691,1022,99,6,430,175,1796,830,7049
"08001008901",1551,489,153,7,137,17,1008,313,3675
"08001009001",2963,625,62,131,793,143,2249,536,7502
"08001009002",6784,1449,164,0,1338,175,5319,1061,16290
"08001009101",3955,349,54,0,260,34,1939,330,6921
"08001009103",2788,296,0,0,349,0,2165,85,5683
"08001009104",4162,934,119,0,658,29,2307,813,9022
"08001009202",3354,626,56,0,461,86,2172,581,7336
"08001009203",2362,610,55,0,529,159,1521,453,5689
"08001009204",5234,123,77,167,1478,13,2632,20,9744
"08001009206",1574,76,0,0,479,0,679,39,2847
"08001009207",3331,193,33,0,505,237,1682,242,6223
"08001009304",4609,844,0,9,672,622,2017,1225,9998
"08001009306",2764,529,0,0,480,34,1742,500,6049
"08001009307",2935,699,43,0,345,64,1943,455,6484
"08001009308",3316,493,0,0,525,284,3117,607,8342
"08001009309",2356,348,0,34,877,48,1224,187,5074
"08001009310",4106,1148,15,37,542,43,2835,852,9578
"08001009316",5403,619,5,0,717,157,3471,526,10898
"08001009318",4058,1382,53,34,482,405,2887,1501,10802
"08001009319",1883,597,16,4,84,85,1148,450,4267
"08001009320",1721,652,42,7,328,26,1016,546,4338
"08001009321",2405,575,62,28,487,183,1262,428,5430
"08001009322",3004,761,9,6,374,129,1276,637,6196
"08001009323",3071,385,86,30,267,54,1050,178,5121
"08001009325",4074,312,122,46,421,41,676,92,5784
"08001009326",2104,19,101,33,295,0,308,0,2860
"08001009327",2942,329,5,39,431,138,642,194,4720
"08001009401",3846,357,42,0,997,28,1543,133,6946
"08001009406",3383,391,99,61,641,53,861,244,5733
"08001009407",3350,980,16,29,769,519,1457,846,7966
"08001009408",3609,41,68,21,604,0,531,7,4881
"08001009409",4586,162,38,15,622,251,455,310,6439
"08001009410",2671,48,32,0,194,48,376,0,3369
"08001009411",2605,166,19,0,200,0,622,67,3679
"08001009501",1916,493,10,7,477,266,1300,708,5177
"08001009502",2954,695,10,0,670,123,2209,682,7343
"08001009553",1723,524,59,0,522,161,1285,484,4758
"08001009603",4411,570,115,43,415,186,1393,111,7244
"08001009604",2638,903,93,15,606,39,1035,590,5919
"08001009606",1864,602,11,0,111,279,1241,689,4797
"08001009607",3576,433,38,20,908,105,1934,332,7346
"08001009608",2434,130,19,0,441,44,768,82,3918
"08001009751",2424,827,26,1,276,77,1532,415,5578
"08001009752",1970,194,74,0,689,31,1770,57,4785
"08001015000",2166,464,0,0,168,66,904,349,4117
"08001060000",4125,275,65,0,530,0,533,0,5528
"08001060100",5516,559,170,0,987,10,885,196,8323
"08001060200",2582,360,51,0,541,16,637,103,4290
"08001061200",1509,0,8,0,88,0,126,0,1731
"08001988700",0,0,0,0,0,0,0,0,0
"08003960000",1058,301,0,0,115,13,306,103,1896
"08003960100",2146,513,0,0,265,5,864,327,4120
"08003960200",3859,1844,16,121,347,236,1334,1006,8763
"08003960300",2507,1185,33,103,445,75,1969,998,7315
"08005004951",1017,502,106,0,379,56,491,89,2640
"08005004952",1482,436,194,0,351,221,296,255,3235
"08005005551",1337,614,37,165,1262,55,1601,369,5440
"08005005552",1336,612,0,0,379,189,631,428,3575
"08005005553",2687,354,217,83,314,125,884,249,4913
"08005005611",3920,412,79,0,279,125,190,105,5110
"08005005612",3283,223,10,0,289,29,342,45,4221
"08005005614",2964,157,0,26,195,0,256,0,3598
"08005005619",4027,250,0,0,275,7,551,0,5110
"08005005620",2301,218,8,9,209,0,357,26,3128
"08005005621",2889,183,0,0,131,0,301,1,3505
"08005005622",2129,69,28,0,123,0,63,0,2412
"08005005623",3846,103,1,0,129,33,144,13,4269
"08005005624",2033,102,116,25,68,0,56,0,2400
"08005005625",2441,398,15,0,138,2,232,247,3473
"08005005626",3408,132,0,0,172,24,302,3,4041
"08005005627",4125,124,1,0,240,16,121,0,4627
"08005005628",4916,261,36,0,257,93,148,67,5778
"08005005629",2258,51,12,0,92,0,0,0,2413
"08005005630",4824,185,81,43,121,0,356,2,5612
"08005005631",3045,77,36,0,170,9,338,9,3684
"08005005632",2817,124,205,0,161,0,194,0,3501
"08005005633",2857,88,29,0,203,0,114,8,3299
"08005005634",2703,83,20,0,124,42,112,9,3093
"08005005635",4340,226,62,24,254,0,115,15,5036
"08005005636",1890,41,25,0,38,6,72,0,2072
"08005005700",2391,705,51,13,171,288,590,493,4702
"08005005800",2019,79,67,0,228,24,225,27,2669
"08005005951",2711,940,52,68,415,92,145,139,4562
"08005005952",2256,415,138,2,270,36,249,60,3426
"08005006000",1928,261,0,0,184,341,138,341,3193
"08005006100",2117,397,36,166,74,44,218,127,3179
"08005006200",2621,79,0,6,363,33,249,17,3368
"08005006300",1913,296,20,0,187,0,265,0,2681
"08005006400",2212,163,19,15,345,464,601,444,4263
"08005006501",1384,443,21,16,223,57,204,40,2388
"08005006502",2802,455,0,35,87,50,318,133,3880
"08005006601",3541,680,240,11,551,162,966,350,6501
"08005006603",2965,233,0,16,215,77,386,57,3949
"08005006604",3251,572,33,0,184,70,522,152,4784
"08005006704",3880,48,145,64,372,0,75,0,4584
"08005006705",1706,24,20,0,70,0,30,0,1850
"08005006706",4476,61,0,0,366,119,345,10,5377
"08005006707",3952,547,82,81,515,41,232,10,5460
"08005006708",4514,196,43,0,276,23,323,17,5392
"08005006709",4904,148,0,0,566,0,306,32,5956
"08005006711",3436,87,27,0,416,21,147,28,4162
"08005006712",1333,28,0,0,75,0,101,0,1537
"08005006713",907,15,38,0,423,27,198,0,1608
"08005006808",5324,64,53,0,366,0,216,2,6025
"08005006815",2711,264,127,0,1059,89,817,2,5069
"08005006854",2067,130,136,11,340,0,273,65,3022
"08005006855",3782,282,0,0,1377,88,264,138,5931
"08005006856",5117,137,268,207,1204,201,760,51,7945
"08005006857",2019,6,0,0,236,0,72,0,2333
"08005006858",3226,439,82,0,744,67,584,0,5142
"08005007101",4344,350,29,0,285,7,269,45,5329
"08005007103",1356,122,20,0,181,5,125,22,1831
"08005007104",2999,131,683,0,948,55,748,47,5611
"08005007105",2636,100,410,0,970,249,881,264,5510
"08005007106",3823,178,349,68,677,8,565,8,5676
"08005007107",5355,217,440,9,827,25,884,9,7766
"08005007201",1258,529,616,177,759,443,1198,607,5587
"08005007202",2134,487,388,314,643,435,1888,452,6741
"08005007301",1025,121,424,120,469,192,1004,115,3470
"08005007302",1925,824,709,241,1185,851,1975,976,8686
"08005007400",2729,633,422,77,1123,570,2569,999,9122
"08005007500",1366,309,219,105,520,129,1085,329,4062
"08005007600",1722,410,418,191,368,395,1178,483,5165
"08005007702",2100,355,368,137,818,178,1460,306,5722
"08005007703",1975,423,674,215,463,552,909,727,5938
"08005007704",1644,397,1223,505,612,289,1088,547,6305
"08005015100",2205,85,46,51,139,0,159,21,2706
"08005080000",1579,148,493,223,636,176,644,248,4147
"08005080100",2090,517,897,251,652,0,937,228,5572
"08005080200",3098,116,960,136,931,139,1177,21,6578
"08005080300",3664,289,469,33,834,137,503,139,6068
"08005080400",3400,220,616,17,478,31,380,0,5142
"08005080500",2292,210,337,55,619,64,360,75,4012
"08005080600",1984,117,324,76,452,213,521,220,3907
"08005080700",2272,246,900,72,1511,287,1146,436,6870
"08005080800",1775,311,295,278,483,218,1292,500,5152
"08005080900",2370,271,411,27,972,337,1347,339,6074
"08005081000",2249,770,950,459,789,1085,1731,1107,9140
"08005081100",1870,170,1746,603,1016,307,988,378,7078
"08005081200",1601,449,1010,239,926,179,940,229,5573
"08005081300",1194,258,834,85,437,364,613,460,4245
"08005081400",2439,401,363,29,681,0,500,155,4568
"08005081500",2625,218,39,0,75,25,33,25,3040
"08005081600",3311,56,252,71,986,78,846,11,5611
"08005081700",2282,50,188,0,386,12,53,7,2978
"08005081800",2226,923,459,74,1239,528,2370,1255,9074
"08005081900",2873,892,987,488,774,428,1652,1115,9209
"08005082000",1407,443,990,240,699,124,1057,373,5333
"08005082100",3679,304,1002,176,1550,354,1799,370,9234
"08005082200",3388,157,1339,45,1023,191,1268,214,7625
"08005082300",1802,394,422,177,433,447,528,579,4782
"08005082400",2332,129,661,149,1208,135,1412,85,6111
"08005082500",1621,146,372,6,169,6,484,36,2840
"08005082600",1963,110,1188,220,1193,430,819,485,6408
"08005082700",1998,218,930,0,309,25,369,20,3869
"08005082800",3140,122,613,111,806,172,1017,161,6142
"08005082900",2871,187,452,293,817,22,1123,144,5909
"08005083000",2067,132,675,0,639,25,374,30,3942
"08005083100",4021,170,877,117,1183,0,1130,0,7498
"08005083200",6285,219,836,165,1572,170,925,0,10172
"08005083300",3260,244,383,100,744,10,823,107,5671
"08005083400",4330,353,884,140,1384,10,1355,154,8610
"08005083500",2299,416,806,162,1701,409,1289,210,7292
"08005083600",2354,373,398,105,341,25,292,103,3991
"08005083700",3149,117,544,68,400,122,195,21,4616
"08005083800",1809,107,655,21,296,0,397,7,3292
"08005083900",2141,172,104,14,483,0,347,4,3265
"08005084000",1886,126,31,0,380,11,415,0,2849
"08005084100",2792,152,367,130,893,43,817,10,5204
"08005084200",2788,159,357,0,680,26,895,96,5001
"08005084300",2207,216,302,71,412,72,424,119,3823
"08005084400",1647,113,216,0,791,227,434,157,3585
"08005084500",1767,140,351,76,331,121,631,108,3525
"08005084600",3784,205,602,0,871,119,1161,63,6805
"08005084700",3261,213,590,161,469,71,543,150,5458
"08005084800",2849,114,147,188,361,0,434,7,4100
"08005084900",2693,43,197,0,409,0,103,7,3452
"08005085000",1252,9,78,0,410,1,208,0,1958
"08005085100",4800,214,640,17,1343,50,239,0,7303
"08005085200",2426,17,36,2,424,12,137,0,3054
"08005085300",2009,17,65,18,278,8,250,0,2645
"08005085400",3409,126,359,25,557,72,601,25,5174
"08005085500",4069,145,216,0,843,97,500,0,5870
"08005085600",2692,88,119,0,546,24,579,46,4094
"08005085700",3010,125,380,12,640,87,756,27,5037
"08005085800",1398,57,19,0,198,10,122,0,1804
"08005085900",2575,70,505,46,647,11,601,11,4466
"08005086000",5383,187,820,196,1222,139,680,190,8817
"08005086100",3256,208,292,50,1111,7,951,10,5885
"08005086200",4787,228,360,147,709,24,389,0,6644
"08005086300",2885,217,125,81,634,237,574,18,4771
"08005086400",1924,40,33,0,208,0,151,0,2356
"08005086500",4032,71,61,0,1006,0,588,0,5758
"08005086600",4577,255,155,0,230,56,108,0,5381
"08005086700",3373,10,45,24,498,0,126,0,4076
"08005086800",2622,853,915,908,705,181,291,222,6697
"08005086900",1117,309,672,332,385,224,231,19,3289
"08005087000",2466,531,954,85,753,396,1134,537,6856
"08005087100",1542,380,414,117,165,12,564,219,3413
"08005087200",2211,336,667,288,741,37,199,24,4503
"08005087300",3627,655,1109,422,1852,309,2170,485,10629
"08007940400",988,133,11,0,139,7,180,7,1465
"08007974200",4297,304,54,2,501,197,741,270,6366
"08007974300",2502,297,25,0,165,165,571,140,3865
"08007974400",1741,247,18,0,172,53,251,53,2535
"08009964600",1295,210,0,0,15,32,168,25,1745
"08009964700",1496,444,14,30,39,20,105,54,2202
"08011966700",2553,846,0,0,128,77,813,511,4928
"08013012101",4128,418,0,0,200,98,107,63,5014
"08013012102",5509,778,0,13,616,228,352,242,7738
"08013012103",3126,316,41,0,421,26,261,0,4191
"08013012104",2324,154,0,0,173,51,217,41,2960
"08013012105",4952,601,16,0,201,13,1045,279,7107
"08013012201",2582,1012,8,0,54,49,43,11,3759
"08013012202",2910,2292,118,92,768,266,652,162,7260
"08013012203",4614,1162,17,0,556,209,789,451,7798
"08013012204",1835,1516,22,14,113,66,133,113,3812
"08013012300",484,342,4,65,517,233,63,23,1731
"08013012401",1940,3155,22,70,232,233,144,502,6298
"08013012501",1867,328,17,0,181,133,89,100,2715
"08013012505",3275,294,0,0,353,8,106,0,4036
"08013012507",2598,1161,54,13,368,121,260,75,4650
"08013012508",2306,520,0,13,179,51,76,32,3177
"08013012509",2840,296,51,0,250,39,163,16,3655
"08013012510",4291,190,0,0,253,7,85,0,4826
"08013012511",2647,653,0,0,243,273,139,212,4167
"08013012603",2757,410,0,0,123,19,57,203,3569
"08013012605",748,536,0,0,292,144,80,23,1823
"08013012607",1852,1952,60,63,534,384,176,267,5288
"08013012608",1857,363,0,0,135,39,106,48,2548
"08013012701",5212,160,12,0,169,0,54,20,5627
"08013012705",3017,307,53,10,343,48,208,120,4106
"08013012707",1466,261,0,0,41,8,177,166,2119
"08013012708",4838,305,37,0,109,0,235,55,5579
"08013012709",1681,57,11,0,94,0,95,0,1938
"08013012710",3269,226,0,0,69,64,259,53,3940
"08013012800",10294,314,114,0,831,14,687,14,12268
"08013012903",2024,47,14,0,257,5,233,7,2587
"08013012904",4605,199,27,0,562,49,178,0,5620
"08013012905",1798,359,11,0,304,64,458,86,3080
"08013012907",2553,201,42,0,448,24,364,62,3694
"08013013003",5020,232,39,0,214,46,209,0,5760
"08013013004",3101,127,0,0,440,17,119,49,3853
"08013013005",3026,336,10,0,140,15,237,92,3856
"08013013006",4791,138,0,0,337,15,313,0,5594
"08013013201",1262,172,0,4,65,19,132,19,1673
"08013013202",1222,153,17,0,48,18,62,52,1572
"08013013205",4981,372,0,25,216,0,155,176,5925
"08013013207",3619,392,13,0,241,35,311,182,4793
"08013013208",4423,328,0,0,356,125,291,0,5523
"08013013210",3883,470,50,54,434,62,1544,283,6780
"08013013211",4436,835,0,9,261,658,779,1167,8145
"08013013212",3655,195,63,4,551,63,449,2,4982
"08013013213",6195,465,66,69,1058,0,587,220,8660
"08013013302",4091,240,60,0,246,46,199,31,4913
"08013013305",3765,592,5,0,379,28,1128,278,6175
"08013013306",3413,519,39,8,586,294,1712,517,7088
"08013013307",2472,566,34,0,261,36,668,254,4291
"08013013308",2383,567,34,0,289,86,414,275,4048
"08013013401",1934,1160,0,16,330,235,789,820,5284
"08013013402",5834,633,20,0,1246,138,2139,529,10539
"08013013503",3491,1085,116,0,671,263,1768,787,8181
"08013013505",2673,1080,193,20,488,479,1361,1202,7496
"08013013506",3371,434,30,0,405,18,386,374,5018
"08013013507",2541,149,0,37,494,8,834,82,4145
"08013013508",6063,137,239,0,866,12,1106,31,8454
"08013013601",3505,354,20,0,247,18,125,42,4311
"08013013602",909,20,2,0,53,0,14,0,998
"08013013701",5806,382,58,8,327,23,251,64,6919
"08013013702",5124,669,0,2,144,115,226,2,6282
"08013060600",3890,245,28,0,1269,128,269,0,5829
"08013060700",2637,111,0,0,354,8,174,21,3305
"08013060800",4885,1066,0,0,869,42,1810,686,9358
"08013060900",3782,297,0,0,461,7,464,33,5044
"08013061300",2741,48,76,0,708,5,404,15,3997
"08013061400",2906,76,22,0,737,0,154,0,3895
"08014030000",2606,233,18,14,452,94,401,80,3898
"08014030100",1864,194,38,0,241,0,249,33,2619
"08014030200",1653,94,0,0,55,12,147,12,1973
"08014030300",2666,479,27,0,179,36,178,224,3789
"08014030400",3479,82,0,0,148,0,196,15,3920
"08014030500",4283,187,72,0,1076,75,489,0,6182
"08014030600",4713,273,103,0,1001,40,1327,0,7457
"08014030700",2499,193,0,7,282,54,428,0,3463
"08014030800",4918,119,0,25,345,194,556,105,6262
"08014030900",4718,255,60,0,863,25,521,65,6507
"08014031000",4457,157,28,123,636,0,508,13,5922
"08014031100",2571,188,19,0,343,0,376,0,3497
"08014031200",3519,218,29,30,454,224,786,127,5387
"08014031300",2071,48,11,0,126,0,63,8,2327
"08014031400",3231,257,0,0,455,0,152,0,4095
"08014980100",0,0,0,0,0,0,0,0,0
"08014980200",0,0,0,0,0,0,0,0,0
"08014980300",0,0,0,0,0,0,0,0,0
"08015000100",2324,229,0,0,196,6,379,76,3210
"08015000200",3427,438,24,0,272,7,340,28,4536
"08015000300",3273,240,10,0,32,0,209,47,3811
"08015000401",4033,320,0,0,89,47,185,11,4685
"08015000402",1953,214,54,0,35,1,109,20,2386
"08017960600",1725,162,4,0,53,6,184,63,2197
"08019014700",4377,217,52,0,210,0,91,0,4947
"08019014800",1438,203,5,50,31,91,69,151,2038
"08019014900",2035,177,4,0,69,10,124,0,2419
"08021974800",2617,902,4,0,231,95,1635,844,6328
"08021974900",3497,473,2,2,319,19,1724,209,6245
"08023972600",1345,460,0,0,134,38,631,376,2984
"08023972700",1187,337,0,0,65,15,991,308,2903
"08025969600",2612,1245,9,0,273,204,748,425,5516
"08027970100",3302,664,84,51,97,21,89,21,4329
"08029964600",2969,381,0,0,122,103,301,39,3915
"08029964700",3019,597,0,4,151,25,254,163,4213
"08029964800",2706,457,7,0,113,16,371,169,3839
"08029964900",4234,871,0,0,222,0,803,267,6397
"08029965000",4106,480,0,0,89,14,484,122,5295
"08029965100",3189,703,0,0,139,117,473,220,4841
"08029965200",3154,904,30,8,49,36,376,66,4623
"08031000102",2533,269,27,11,259,59,571,159,3888
"08031000201",2919,349,26,3,577,54,2118,216,6262
"08031000202",2582,661,19,28,311,283,1426,622,5932
"08031000301",4461,410,0,0,442,14,1266,188,6781
"08031000302",3828,102,78,219,119,25,454,34,4859
"08031000303",4120,443,11,0,175,14,619,283,5665
"08031000401",2192,250,78,19,545,151,871,259,4365
"08031000402",4109,703,103,24,155,72,719,422,6307
"08031000501",1595,146,41,0,125,26,328,54,2315
"08031000502",3417,1021,117,479,825,0,1226,703,7788
"08031000600",1413,680,92,46,541,55,971,483,4281
"08031000701",2200,665,125,173,434,181,1382,473,5633
"08031000702",2117,1673,154,470,434,385,1171,1552,7956
"08031000800",92,579,33,372,67,274,97,559,2073
"08031000902",3461,1136,74,0,677,462,2857,1298,9965
"08031000903",3799,1723,72,0,552,447,3370,1715,11678
"08031000904",2560,1697,93,68,502,148,2222,1422,8712
"08031000905",2715,877,113,0,299,63,2262,705,7034
"08031001000",2184,831,86,87,344,210,1900,1006,6648
"08031001101",1388,451,44,87,545,81,1249,432,4277
"08031001102",2736,332,6,195,474,16,1183,112,5054
"08031001301",3038,640,1,34,786,126,2766,629,8020
"08031001302",2430,579,35,8,851,120,2303,594,6920
"08031001401",3845,792,39,29,1179,415,3474,883,10656
"08031001402",2021,478,457,22,629,880,1762,1025,7274
"08031001403",2114,339,114,235,347,92,624,256,4121
"08031001500",1800,632,75,28,217,449,1183,890,5274
"08031001600",6349,1724,503,242,715,239,1342,870,11984
"08031001701",3829,713,9,53,207,193,320,122,5446
"08031001702",2384,532,148,131,293,90,307,56,3941
"08031001800",2054,529,85,52,390,263,920,448,4741
"08031001901",1124,600,195,294,115,298,633,566,3825
"08031001902",73,8,0,0,14,0,0,0,95
"08031002000",1346,166,61,51,123,22,79,11,1859
"08031002100",3614,924,122,61,558,520,858,1113,7770
"08031002300",3357,636,729,747,285,171,758,590,7273
"08031002402",900,129,315,158,126,121,48,156,1953
"08031002403",1938,483,83,239,361,62,501,145,3812
"08031002601",1988,576,64,160,202,85,110,69,3254
"08031002602",2080,280,76,37,210,90,143,103,3019
"08031002701",3115,657,138,58,724,123,643,118,5576
"08031002702",4425,602,110,25,511,45,320,4,6042
"08031002703",3582,605,221,269,400,55,233,236,5601
"08031002801",2367,295,23,0,199,0,107,66,3057
"08031002802",3378,668,13,48,151,69,315,295,4937
"08031002803",3609,516,107,1,301,14,169,31,4748
"08031002901",2411,289,61,15,230,122,208,47,3383
"08031002902",3652,140,60,0,289,0,273,6,4420
"08031003001",4946,375,83,0,247,53,276,27,6007
"08031003002",2071,185,26,15,113,14,135,37,2596
"08031003003",1581,324,0,0,82,71,79,92,2229
"08031003004",3342,842,157,7,588,293,213,53,5495
"08031003101",877,106,150,112,193,0,199,70,1707
"08031003102",1599,559,97,364,199,65,190,190,3263
"08031003201",4352,514,18,179,351,38,399,16,5867
"08031003202",2373,358,89,0,133,50,161,11,3175
"08031003203",2887,79,0,0,211,10,98,10,3295
"08031003300",3077,128,41,0,332,26,292,12,3908
"08031003401",2190,154,35,0,54,0,25,16,2474
"08031003402",4263,241,0,0,366,7,195,126,5198
"08031003500",3518,1609,188,98,801,336,3562,1889,12001
"08031003601",2466,701,331,262,667,173,1762,672,7034
"08031003602",1927,535,773,381,494,140,1352,452,6054
"08031003603",1573,92,944,248,238,52,495,36,3678
"08031003701",2492,227,67,128,105,32,163,91,3305
"08031003702",3471,608,156,137,234,61,296,64,5027
"08031003703",2285,188,79,95,220,35,336,76,3314
"08031003800",5187,495,0,53,461,71,284,89,6640
"08031003901",4481,146,45,0,56,0,175,43,4946
"08031003902",3988,333,36,3,295,7,335,27,5024
"08031004002",3088,149,25,5,89,7,146,34,3543
"08031004003",3728,232,259,0,276,18,499,10,5022
"08031004004",1713,58,53,0,74,10,40,9,1957
"08031004005",1788,715,47,0,331,133,148,50,3212
"08031004006",3526,454,37,29,150,135,177,39,4547
"08031004101",1508,413,960,698,650,95,1004,422,5750
"08031004102",1135,565,1600,504,529,118,879,335,5665
"08031004103",3559,67,1286,197,287,399,149,363,6307
"08031004104",2118,285,1426,269,635,0,632,9,5374
"08031004106",8186,115,132,49,852,0,535,30,9899
"08031004107",3984,271,455,73,760,7,367,11,5928
"08031004201",3986,275,116,44,219,31,509,67,5247
"08031004202",3083,114,433,16,247,19,353,9,4274
"08031004301",3136,532,147,92,470,12,443,93,4925
"08031004302",1904,108,110,3,185,16,217,30,2573
"08031004303",3583,232,50,0,177,0,60,22,4124
"08031004304",4807,344,45,53,430,88,754,77,6598
"08031004306",4371,143,234,17,204,64,118,21,5172
"08031004403",1912,804,663,173,490,167,717,635,5561
"08031004404",2452,760,834,1188,789,1018,808,611,8460
"08031004405",6578,398,254,191,671,81,677,150,9000
"08031004503",2558,1060,0,20,529,273,2503,1297,8240
"08031004504",2199,438,77,0,1042,463,2492,747,7458
"08031004505",2363,1507,2,4,255,254,2208,1466,8059
"08031004506",1495,711,79,303,572,327,1720,776,5983
"08031004601",3679,757,19,2,1062,311,2958,802,9590
"08031004602",4074,701,100,11,2308,470,4796,894,13354
"08031004603",3430,606,126,67,857,864,2313,1133,9396
"08031004700",4201,894,16,0,1362,271,3075,1026,10845
"08031004801",2213,189,0,0,712,89,1213,182,4598
"08031005001",1676,203,103,326,450,0,251,42,3051
"08031005002",3196,614,1235,607,1088,469,732,477,8418
"08031005102",2967,187,63,32,126,162,481,162,4180
"08031005104",2037,402,131,162,407,276,646,134,4195
"08031005200",2643,201,214,0,223,70,367,13,3731
"08031005300",891,137,119,46,151,0,51,56,1451
"08031005502",1112,164,13,32,429,43,564,111,2468
"08031005503",3419,310,7,98,671,62,1283,106,5956
"08031006701",2330,263,118,0,216,9,121,8,3065
"08031006804",2051,78,15,30,149,9,108,17,2457
"08031006809",5212,412,629,24,923,73,956,0,8229
"08031006810",3951,73,677,42,433,57,673,19,5925
"08031006811",3842,224,814,36,1058,170,776,71,6991
"08031006812",3080,157,78,11,298,42,221,42,3929
"08031006813",2398,557,945,98,347,121,319,141,4926
"08031006814",2505,487,842,116,533,43,655,220,5401
"08031006901",2536,540,444,50,1068,323,1120,199,6280
"08031007006",1685,536,569,113,1436,271,995,350,5955
"08031007013",2375,220,516,24,361,16,483,23,4018
"08031007037",1411,518,711,605,666,139,1058,555,5663
"08031007088",2773,354,513,165,548,167,726,91,5337
"08031007089",3485,299,609,124,312,225,343,273,5670
"08031008304",2264,472,462,372,314,106,1999,554,6543
"08031008305",2466,588,633,304,312,84,2279,597,7263
"08031008306",2258,1263,1409,671,779,220,2312,1526,10438
"08031008312",3128,1514,1428,551,902,78,2986,1378,11965
"08031008386",2494,556,832,125,642,139,2510,672,7970
"08031008387",3641,1063,959,481,553,134,3222,836,10889
"08031008388",4784,235,1833,130,502,33,3240,188,10945
"08031008389",5155,224,2549,186,1346,53,3389,140,13042
"08031008390",4142,474,1920,628,1972,346,3168,586,13236
"08031008391",3513,128,2107,349,2255,0,3511,107,11970
"08031011902",5015,387,217,205,949,91,3052,220,10136
"08031011903",1999,221,0,0,158,4,543,125,3050
"08031012001",1556,161,60,13,158,56,347,68,2419
"08031012010",3960,242,19,0,745,0,628,0,5594
"08031012014",4918,472,0,0,931,0,1125,68,7514
"08031015300",2495,362,285,33,423,104,450,87,4239
"08031015400",2766,427,29,3,252,44,871,232,4624
"08031015500",2220,460,170,69,569,50,750,130,4418
"08031015600",2681,2269,1,176,1248,749,2496,2749,12369
"08031015700",3116,876,126,0,1018,112,2219,570,8037
"08031980000",477,86,371,75,153,69,212,43,1486
"08031980100",0,0,0,0,0,0,0,0,0
"08033000100",1399,392,0,0,55,6,100,10,1962
"08035013901",6400,191,70,0,345,0,368,0,7374
"08035013904",3584,402,37,7,170,58,414,102,4774
"08035013905",3172,116,86,0,170,23,178,23,3768
"08035013907",3932,334,24,20,437,34,410,48,5239
"08035013908",6466,130,0,0,146,0,189,45,6976
"08035013909",5991,222,19,0,419,21,547,129,7348
"08035013910",5616,90,83,0,232,0,373,25,6419
"08035013911",5758,271,11,0,666,31,542,31,7310
"08035014001",6276,60,0,0,509,0,1409,0,8254
"08035014005",4517,141,17,0,303,139,391,0,5508
"08035014006",4948,77,178,10,552,26,347,16,6154
"08035014007",1943,336,104,0,417,48,267,0,3115
"08035014008",5731,273,35,0,380,26,446,38,6929
"08035014009",3020,85,30,0,260,75,168,0,3638
"08035014010",4739,44,137,23,783,0,599,0,6325
"08035014011",1625,21,33,0,426,19,202,0,2326
"08035014012",6948,374,95,0,705,92,738,92,9044
"08035014013",4339,49,199,0,356,0,234,1,5178
"08035014107",3378,120,15,0,166,0,187,32,3898
"08035014108",4704,130,9,0,172,21,240,0,5276
"08035014109",2417,120,14,0,83,11,133,0,2778
"08035014110",4558,467,0,0,374,82,290,163,5934
"08035014112",3981,58,81,0,136,0,395,0,4651
"08035014113",2784,93,30,0,434,0,352,14,3707
"08035014114",2861,66,40,0,421,105,346,0,3839
"08035014115",3517,250,0,26,452,24,207,58,4534
"08035014116",3425,269,135,0,1386,116,413,80,5824
"08035014122",6900,115,0,0,458,16,425,31,7945
"08035014123",2162,358,40,77,87,75,167,189,3155
"08035014124",5050,86,41,0,202,0,429,0,5808
"08035014125",2842,129,0,0,249,7,64,0,3291
"08035014126",1326,41,0,0,301,87,151,2,1908
"08035014127",4769,0,47,0,485,23,370,0,5694
"08035014128",4208,90,12,0,588,0,536,7,5441
"08035014129",3236,220,103,0,314,12,224,0,4109
"08035014130",7503,56,151,0,577,67,586,0,8940
"08035014131",3390,163,0,0,293,0,219,0,4065
"08035014132",5254,107,18,14,652,0,149,0,6194
"08035014133",6052,286,62,0,365,0,868,46,7679
"08035014134",4921,257,46,0,1091,13,550,9,6887
"08035014135",2967,112,0,0,188,0,140,0,3407
"08035014136",7668,221,184,0,812,0,870,10,9765
"08035014137",8139,238,65,0,1579,192,612,49,10874
"08035014138",2770,234,19,37,511,16,328,22,3937
"08035014139",3572,51,16,0,405,0,357,0,4401
"08035014140",4677,130,115,0,449,20,94,0,5485
"08035014202",1859,75,0,0,63,23,55,0,2075
"08035014203",6417,51,136,0,382,0,523,0,7509
"08035014204",2988,35,11,0,130,10,338,10,3522
"08035014300",697,37,0,0,18,0,26,0,778
"08035014403",4652,166,29,0,218,33,232,8,5338
"08035014404",2356,81,52,0,98,0,66,16,2669
"08035014405",6951,174,33,0,530,43,706,84,8521
"08035014406",8542,92,148,10,761,0,641,0,10194
"08035014503",4971,166,81,0,235,0,707,1,6161
"08035014504",3377,537,32,11,234,100,303,46,4640
"08035014505",3969,155,36,30,185,19,434,11,4839
"08035014506",3497,166,37,0,139,0,364,75,4278
"08035014602",2319,143,0,0,28,0,148,20,2658
"08035014603",6659,119,13,0,257,0,558,26,7632
"08035014604",3551,444,0,0,154,14,301,251,4715
"08037000100",979,159,0,0,141,115,618,234,2246
"08037000200",5795,407,0,0,819,0,2797,288,10106
"08037000301",4602,109,23,0,1057,113,2412,67,8383
"08037000302",1796,126,0,0,201,0,364,35,2522
"08037000401",4060,551,0,0,399,613,845,928,7396
"08037000402",2773,408,0,0,757,0,1265,322,5525
"08037000403",7199,108,0,0,514,0,1027,108,8956
"08037000501",629,85,2,0,48,0,0,22,786
"08037000502",3378,484,69,0,250,0,518,292,4991
"08037000503",5117,812,127,0,312,0,2142,677,9187
"08037000600",1109,97,53,0,123,53,357,68,1860
"08037000701",980,26,0,0,0,0,50,0,1056
"08037000702",1230,48,35,26,65,6,33,1,1444
"08037000703",2631,434,5,0,86,0,120,9,3285
"08039961100",1642,168,22,0,55,20,84,0,1991
"08039961204",6474,278,44,0,312,2,614,4,7728
"08039961205",1471,254,0,0,52,5,59,63,1904
"08039961206",3134,102,0,24,147,50,185,0,3642
"08039961207",3702,61,23,0,27,21,178,8,4020
"08039961208",2633,581,12,0,121,0,109,63,3519
"08039961209",2010,83,0,0,171,0,62,0,2326
"08041000101",4130,351,201,102,802,171,976,103,6836
"08041000102",2996,288,2,0,299,14,390,41,4030
"08041000202",3390,677,79,28,274,140,351,265,5204
"08041000203",3069,519,87,59,114,204,235,240,4527
"08041000301",2349,299,30,0,339,118,562,147,3844
"08041000302",2469,938,120,14,279,227,559,174,4780
"08041000400",1915,153,28,69,77,44,96,66,2448
"08041000500",1697,289,72,63,88,66,109,39,2423
"08041000600",2964,346,218,0,36,18,317,223,4122
"08041000700",2047,622,172,179,252,105,332,240,3949
"08041000800",2071,254,36,0,364,23,315,8,3071
"08041000900",1800,384,46,1,217,3,50,7,2508
"08041001000",1980,92,13,32,118,12,88,47,2382
"08041001101",949,183,0,8,47,26,244,116,1573
"08041001104",2354,274,24,65,385,42,650,97,3891
"08041001301",1849,413,0,0,58,12,218,102,2652
"08041001302",3808,781,107,0,302,79,425,179,5681
"08041001400",2673,564,1,3,200,41,330,45,3857
"08041001500",1782,234,45,0,172,24,170,69,2496
"08041001600",1168,423,0,0,119,35,223,23,1991
"08041001700",1128,436,114,43,220,113,170,107,2331
"08041001800",1589,169,15,34,122,15,176,40,2160
"08041001900",2810,605,166,0,531,195,678,345,5330
"08041002000",3924,1012,254,251,1112,773,955,962,9243
"08041002101",2285,472,119,23,350,140,459,184,4032
"08041002102",2217,493,573,107,990,407,1122,483,6392
"08041002200",1718,231,70,87,388,78,394,60,3026
"08041002300",675,542,104,47,188,82,218,73,1929
"08041002400",3334,774,66,284,317,393,479,554,6201
"08041002501",2910,228,0,0,129,9,171,100,3547
"08041002502",3115,274,153,7,495,51,525,79,4699
"08041002700",1774,530,231,39,235,78,277,187,3351
"08041002800",2910,678,434,142,1366,246,1802,726,8304
"08041002900",3094,934,514,433,396,615,1294,844,8124
"08041003000",3608,481,40,190,514,69,586,107,5595
"08041003100",3773,196,60,8,185,30,114,32,4398
"08041003303",3357,946,271,79,581,319,857,322,6732
"08041003305",6338,174,138,50,614,15,559,90,7978
"08041003306",2661,413,52,0,117,18,256,159,3676
"08041003307",2739,209,60,201,394,15,535,13,4166
"08041003308",4605,301,189,0,1194,13,1074,64,7440
"08041003400",2837,251,60,9,160,138,200,8,3663
"08041003701",6607,369,25,0,499,234,547,225,8506
"08041003702",4302,264,60,0,450,6,376,6,5464
"08041003705",4258,201,28,2,713,40,433,1,5676
"08041003706",4157,303,21,163,265,12,391,45,5357
"08041003707",3563,154,167,55,98,74,367,0,4478
"08041003708",2249,113,91,67,295,127,409,0,3351
"08041003709",5075,373,154,68,381,131,260,169,6611
"08041003801",1175,58,261,0,334,5,244,42,2119
"08041003802",0,0,0,0,0,0,0,0,0
"08041003902",9784,276,283,6,1065,0,1557,0,12971
"08041003905",2887,248,41,59,182,16,269,29,3731
"08041003906",5725,113,179,69,458,43,417,118,7122
"08041003909",5782,390,180,0,185,47,381,15,6980
"08041004008",977,40,49,0,142,11,388,5,1612
"08041004009",783,220,325,75,257,157,356,194,2367
"08041004100",3236,673,363,67,501,98,497,311,5746
"08041004200",2707,310,144,22,553,62,702,79,4579
"08041004300",3893,640,507,132,1243,293,1415,321,8444
"08041004401",5442,1284,1060,0,1099,210,958,519,10572
"08041004402",231,131,0,0,3,0,71,0,436
"08041004403",292,31,197,0,180,0,131,0,831
"08041004501",2243,429,124,111,930,101,1066,114,5118
"08041004502",3916,137,401,0,604,120,733,55,5966
"08041004503",9011,649,1585,0,1810,25,2132,156,15368
"08041004506",2920,394,440,0,804,65,714,73,5410
"08041004507",2390,61,411,12,408,8,635,0,3925
"08041004508",4153,668,436,120,779,47,946,183,7332
"08041004510",5527,273,885,61,1078,70,950,36,8880
"08041004511",5412,613,533,3,756,115,1348,110,8890
"08041004601",3236,304,41,0,265,0,209,18,4073
"08041004602",2964,544,75,0,229,37,83,116,4048
"08041004603",4312,138,323,0,873,36,659,33,6374
"08041004701",4047,163,103,44,465,105,795,0,5722
"08041004702",1964,77,134,0,284,0,154,0,2613
"08041004703",4948,154,109,60,779,12,759,0,6821
"08041004705",6037,206,218,0,1017,55,696,0,8229
"08041004706",4177,268,91,198,516,0,533,88,5871
"08041004800",3959,602,175,36,439,147,820,225,6403
"08041004901",2452,322,54,0,848,32,978,46,4732
"08041004902",4588,165,509,0,437,0,572,1,6272
"08041005000",3434,208,428,0,1089,49,917,60,6185
"08041005104",6127,437,479,84,601,0,1049,102,8879
"08041005105",5421,427,223,70,961,0,747,0,7849
"08041005106",8331,621,294,15,956,223,916,408,11764
"08041005107",6204,346,588,0,847,0,1114,23,9122
"08041005108",6908,432,580,0,1089,0,978,65,10052
"08041005109",5271,603,419,14,1193,56,972,0,8528
"08041005110",2939,331,169,30,451,69,715,90,4794
"08041005111",4569,306,900,21,944,135,1134,70,8079
"08041005201",1549,940,362,148,845,469,1138,842,6293
"08041005202",1259,368,514,196,273,77,312,53,3052
"08041005300",1993,785,508,454,846,448,811,780,6625
"08041005400",2121,926,570,203,1125,1002,1119,1255,8321
"08041005501",3415,223,189,34,569,274,505,154,5363
"08041005502",3028,320,209,160,540,571,751,359,5938
"08041005601",4070,397,87,33,388,15,429,117,5536
"08041005602",2544,210,28,38,286,1,446,53,3606
"08041005700",4074,434,405,27,1306,15,653,0,6914
"08041005800",2704,203,50,24,106,11,288,37,3423
"08041005900",4653,430,818,14,924,49,940,218,8046
"08041006000",3341,675,351,92,1359,747,1082,747,8394
"08041006100",1601,600,187,217,896,826,1215,893,6435
"08041006200",2606,932,543,25,1061,857,1233,1108,8365
"08041006301",2838,425,615,233,964,69,1501,220,6865
"08041006302",2488,909,380,613,1083,416,1407,1026,8322
"08041006400",3517,880,513,269,2190,190,2133,363,10055
"08041006501",1483,214,542,128,802,585,694,696,5144
"08041006502",3176,615,775,106,1180,523,1481,877,8733
"08041006600",2174,249,0,0,87,31,105,61,2707
"08041006700",4654,794,32,29,265,31,261,162,6228
"08041006801",3478,533,109,9,217,0,530,9,4885
"08041006802",3012,31,254,0,399,141,313,30,4180
"08041006901",4415,360,159,0,580,11,612,54,6191
"08041006902",4319,212,160,33,531,35,422,35,5747
"08041007000",3384,149,110,0,471,0,203,43,4360
"08041007101",4842,289,606,0,986,34,715,59,7531
"08041007102",7443,303,491,0,941,0,650,142,9970
"08041007201",5926,338,146,0,744,155,610,39,7958
"08041007202",8031,92,157,14,790,34,433,34,9585
"08041007300",8311,503,166,34,576,57,800,1,10448
"08041007400",7933,141,88,0,353,31,418,17,8981
"08041007500",7301,205,0,0,367,31,180,16,8100
"08041007601",5603,424,181,0,420,3,745,3,7379
"08041007602",2570,278,39,0,401,18,124,18,3448
"08041007700",4782,306,182,57,169,147,458,92,6193
"08041007800",2961,312,229,8,237,56,140,0,3943
"08041007900",2114,78,65,0,152,0,101,18,2528
"08041008000",3053,592,79,0,384,88,470,271,4937
"08043978100",2983,586,26,1,135,13,251,123,4118
"08043978200",2484,855,0,0,277,19,444,141,4220
"08043978300",4287,779,34,0,182,0,421,102,5805
"08043978400",1495,369,3,4,104,11,156,99,2241
"08043978500",4042,885,0,0,113,17,120,47,5224
"08043978600",1854,904,0,0,82,129,182,73,3224
"08043978800",2032,600,0,0,28,0,57,146,2863
"08043979000",3029,258,0,0,45,0,71,0,3403
"08043979100",2331,569,0,0,214,1,98,88,3301
"08043979200",1758,24,0,0,95,54,72,0,2003
"08043979400",2151,181,8,0,38,13,132,5,2528
"08043980100",0,0,0,0,0,0,0,0,0
"08043980200",0,0,0,0,0,0,0,0,0
"08043980300",0,0,0,0,0,0,0,0,0
"08045951600",3122,389,0,1,387,0,1086,89,5074
"08045951701",3095,107,76,155,209,195,435,334,4606
"08045951702",2661,497,0,0,157,188,468,261,4232
"08045951802",3471,55,0,0,335,21,1132,0,5014
"08045951803",4708,818,0,0,619,0,2119,382,8646
"08045951804",3198,223,0,0,528,99,830,106,4984
"08045951901",3343,523,17,0,615,20,1037,199,5754
"08045951902",5226,855,18,1,765,47,2157,316,9385
"08045952001",3373,395,68,0,598,534,1094,692,6754
"08045952002",6282,855,0,0,532,33,811,409,8922
"08045952100",5464,720,46,0,317,55,1525,266,8393
"08047013800",4788,347,19,0,332,66,454,30,6036
"08049000100",2386,314,0,0,186,151,389,46,3472
"08049000201",4191,244,157,10,133,4,87,37,4863
"08049000202",5271,765,30,6,437,49,274,45,6877
"08051963600",3286,278,0,0,39,66,29,118,3816
"08051963700",3539,1766,0,0,145,21,615,362,6448
"08051963800",4341,268,12,0,180,7,90,2,4900
"08051963900",688,85,10,0,54,18,41,4,900
"08053973100",790,70,0,0,14,0,11,0,885
"08055960600",1721,490,24,0,557,153,1500,356,4801
"08055960900",2752,489,0,0,94,39,289,73,3736
"08057955600",1136,103,0,0,38,52,146,58,1533
"08059009806",3282,153,39,5,225,34,90,14,3842
"08059009807",1384,122,10,0,35,0,181,0,1732
"08059009808",4647,223,14,0,455,0,361,0,5700
"08059009815",4887,158,0,0,192,25,396,99,5757
"08059009823",4406,72,0,0,240,6,534,0,5258
"08059009824",4220,111,43,9,633,23,610,44,5693
"08059009827",4790,316,14,0,1011,189,372,0,6692
"08059009828",4722,200,0,0,466,0,841,78,6307
"08059009829",1728,32,8,0,128,14,153,0,2063
"08059009830",1871,124,16,38,186,0,215,42,2492
"08059009831",1721,151,128,22,139,116,364,58,2699
"08059009832",2260,181,64,0,218,0,467,7,3197
"08059009833",4895,458,68,0,226,131,957,156,6891
"08059009834",3853,231,59,9,357,0,612,34,5155
"08059009835",3340,86,43,0,133,10,386,24,4022
"08059009836",3584,89,6,0,173,20,123,35,4030
"08059009837",2588,38,17,0,135,4,107,18,2907
"08059009838",4247,51,0,10,279,12,221,22,4842
"08059009839",2201,47,0,10,154,0,152,19,2583
"08059009840",3617,150,33,0,73,0,209,0,4082
"08059009841",2146,119,20,0,81,7,242,52,2667
"08059009842",2740,248,0,0,89,33,143,8,3261
"08059009843",7486,312,0,0,169,46,379,2,8394
"08059009845",3673,191,0,0,208,15,54,7,4148
"08059009846",4198,100,0,0,112,10,158,0,4578
"08059009847",2774,102,0,0,78,0,110,12,3076
"08059009848",2010,155,27,0,81,0,36,47,2356
"08059009849",4406,780,0,15,245,226,497,28,6197
"08059009850",2370,73,2,6,139,2,125,0,2717
"08059009851",3362,148,11,0,291,20,205,37,4074
"08059009852",3210,249,3,0,343,5,70,60,3940
"08059009900",1939,267,0,13,90,48,180,35,2572
"08059010000",1796,752,0,41,156,139,84,58,3026
"08059010100",3232,610,25,0,211,30,274,251,4633
"08059010205",2234,101,1,0,69,0,46,1,2452
"08059010206",3631,334,0,0,216,32,323,266,4802
"08059010208",4240,457,0,33,593,425,995,319,7062
"08059010209",4802,427,195,0,626,81,1127,336,7594
"08059010210",2663,295,0,9,321,20,341,0,3649
"08059010211",2805,391,28,0,56,17,354,81,3732
"08059010212",3855,449,0,0,313,19,863,296,5795
"08059010213",3401,597,80,0,595,121,1021,237,6052
"08059010303",4624,319,37,0,268,28,614,14,5904
"08059010304",2676,67,0,0,125,0,254,0,3122
"08059010305",3081,497,101,0,169,78,530,294,4750
"08059010306",2526,137,15,9,208,2,386,52,3335
"08059010307",4077,427,59,167,343,2,774,19,5868
"08059010308",5094,355,2,0,142,84,605,114,6396
"08059010402",3411,1131,26,0,515,198,1107,470,6858
"08059010403",3525,816,0,0,479,138,943,443,6344
"08059010405",1579,465,85,32,109,50,326,185,2831
"08059010406",1713,488,5,0,326,36,1057,411,4036
"08059010502",4140,639,0,6,537,34,965,286,6607
"08059010503",3708,354,23,0,287,74,711,51,5208
"08059010504",2825,8,0,8,82,0,296,0,3219
"08059010603",2675,267,27,11,374,27,753,115,4249
"08059010604",1981,206,18,0,118,51,654,115,3143
"08059010701",3622,192,0,0,139,21,620,54,4648
"08059010702",3394,1149,14,0,273,252,1031,923,7036
"08059010801",2274,209,0,0,32,0,446,41,3002
"08059010901",3691,415,16,0,288,0,507,37,4954
"08059010902",1739,383,110,24,180,29,613,98,3176
"08059011000",4201,784,66,0,316,157,1239,157,6920
"08059011100",4328,995,22,2,578,98,1503,361,7887
"08059011202",3555,359,79,0,314,18,584,18,4927
"08059011300",2623,284,42,23,118,17,519,142,3768
"08059011401",2045,466,162,40,110,47,1368,320,4558
"08059011402",2319,632,51,5,492,222,915,479,5115
"08059011550",3887,1281,19,18,257,242,1079,403,7186
"08059011601",1965,1290,25,0,348,99,598,1152,5477
"08059011602",2908,1008,27,0,523,51,1270,696,6483
"08059011701",4199,273,37,9,331,3,933,8,5793
"08059011702",4535,495,47,22,579,24,698,316,6716
"08059011708",3273,152,2,0,441,39,628,39,4574
"08059011709",3114,112,36,0,136,10,654,9,4071
"08059011710",3162,147,28,0,459,10,439,10,4255
"08059011711",3506,323,0,0,273,8,457,0,4567
"08059011712",3789,231,13,0,276,6,554,0,4869
"08059011720",4266,393,0,0,483,0,243,64,5449
"08059011721",2426,165,0,0,164,0,166,0,2921
"08059011723",2686,306,49,0,307,41,305,20,3714
"08059011724",4335,159,27,0,493,0,251,0,5265
"08059011725",1447,42,29,0,155,1,160,19,1853
"08059011726",5115,184,18,0,615,26,505,0,6463
"08059011727",3283,71,17,0,215,0,440,0,4026
"08059011728",2298,87,44,0,157,130,324,0,3040
"08059011729",3108,487,0,0,343,53,610,240,4841
"08059011730",2806,426,168,0,140,27,623,205,4395
"08059011731",3600,136,47,0,290,103,539,69,4784
"08059011732",3487,911,104,0,598,34,892,36,6062
"08059011733",1007,200,11,37,127,0,267,68,1717
"08059011803",4169,499,27,38,765,93,2090,267,7948
"08059011804",3499,220,17,12,450,18,1198,18,5432
"08059011805",3748,393,120,49,375,24,1588,24,6321
"08059011806",3798,640,0,0,198,47,1652,247,6582
"08059011904",1802,154,52,0,262,11,439,11,2731
"08059011951",2406,338,16,69,252,20,562,132,3795
"08059012022",5219,263,37,0,229,0,543,62,6353
"08059012023",2710,183,65,0,306,17,374,17,3672
"08059012024",4734,246,46,16,246,0,503,0,5791
"08059012026",3170,293,17,0,73,0,124,0,3677
"08059012027",2716,119,57,0,68,0,287,12,3259
"08059012030",3623,217,6,7,96,14,134,12,4109
"08059012031",3470,352,34,0,218,0,516,0,4590
"08059012032",2273,149,0,0,70,4,94,4,2594
"08059012033",2605,53,0,0,80,0,60,0,2798
"08059012034",3494,39,0,0,185,0,225,18,3961
"08059012035",4920,189,22,0,210,39,174,0,5554
"08059012036",3646,0,0,0,254,0,159,0,4059
"08059012037",3095,128,0,0,54,0,132,12,3421
"08059012038",3094,163,91,16,223,0,345,90,4022
"08059012039",4857,217,83,0,393,0,1087,25,6662
"08059012041",4760,347,14,2,673,45,952,45,6838
"08059012042",3504,93,28,0,328,30,369,30,4382
"08059012043",4811,202,172,0,234,29,547,0,5995
"08059012044",3142,259,63,0,365,0,440,24,4293
"08059012045",5275,91,9,0,569,0,303,0,6247
"08059012046",1826,68,14,44,148,12,303,18,2433
"08059012047",3315,304,75,0,445,19,516,11,4685
"08059012048",2104,61,0,0,157,10,262,0,2594
"08059012049",3077,36,84,0,477,26,313,6,4019
"08059012050",3201,198,15,0,452,76,414,0,4356
"08059012051",3175,147,62,0,146,24,119,21,3694
"08059012052",4550,353,88,0,298,0,453,0,5742
"08059012053",3322,219,63,156,274,9,577,9,4629
"08059012054",3808,67,0,0,344,7,384,9,4619
"08059012055",3326,59,44,1,139,8,341,12,3930
"08059012057",5338,103,2,0,474,44,383,56,6400
"08059012058",3556,191,5,0,218,0,81,0,4051
"08059012059",2934,187,88,2,83,5,144,0,3443
"08059012060",2801,191,25,0,118,0,354,29,3518
"08059015800",2700,330,12,45,443,61,288,30,3909
"08059015900",2637,253,19,0,260,41,715,23,3948
"08059060300",3898,28,54,0,495,30,270,11,4786
"08059060400",3279,204,28,0,291,0,484,8,4294
"08059060500",3884,186,95,0,714,15,361,16,5271
"08059980000",0,0,0,0,0,0,0,0,0
"08059980400",0,0,0,0,0,0,0,0,0
"08061960100",1173,175,7,0,65,14,98,7,1539
"08063962100",3756,636,0,0,113,84,627,326,5542
"08063962200",1048,243,3,0,50,16,104,113,1577
"08063962300",919,178,2,0,2,0,36,35,1172
"08065961700",3979,366,0,0,478,0,1315,116,6254
"08065961900",1480,465,0,0,448,2,1116,204,3715
"08067940300",3912,338,2,1,1621,297,1377,146,7694
"08067940400",4848,390,26,0,262,71,617,54,6268
"08067970600",7812,555,2,0,330,46,778,41,9564
"08067970701",4398,423,16,1,224,19,676,19,5776
"08067970703",4211,375,0,44,602,88,366,31,5717
"08067970704",3197,327,11,0,126,34,217,41,3953
"08067970800",4191,546,0,0,434,160,583,172,6086
"08067970900",3205,328,0,0,255,36,371,0,4195
"08067971000",2576,197,0,1,239,2,62,0,3077
"08067971100",3073,1067,57,0,252,86,486,284,5305
"08069000100",1564,635,12,12,19,47,132,105,2526
"08069000201",1886,1347,0,42,19,127,36,13,3470
"08069000202",1894,561,71,0,124,75,231,160,3116
"08069000300",2425,307,8,14,133,58,41,25,3011
"08069000401",1427,318,16,6,124,59,186,50,2186
"08069000402",1797,630,27,19,97,233,109,167,3079
"08069000503",1782,2216,152,33,227,596,130,270,5406
"08069000504",1527,1326,9,32,317,109,405,86,3811
"08069000505",1348,1628,37,46,181,223,249,260,3972
"08069000506",1851,851,0,0,292,52,253,81,3380
"08069000600",433,417,18,38,80,149,55,85,1275
"08069000700",1911,709,0,0,87,59,115,102,2983
"08069000801",1183,522,0,5,66,17,31,175,1999
"08069000802",1029,111,10,0,120,6,232,0,1508
"08069000901",4362,722,0,7,80,10,359,109,5649
"08069000902",2504,500,48,6,250,152,322,171,3953
"08069001003",3949,446,125,0,307,72,393,42,5334
"08069001004",2739,294,3,0,160,8,193,0,3397
"08069001007",2490,598,25,20,355,68,517,108,4181
"08069001008",1575,145,0,0,239,0,256,0,2215
"08069001009",5438,661,0,1,308,115,403,1,6927
"08069001010",2266,48,0,0,94,0,31,0,2439
"08069001104",4594,895,122,0,321,50,749,145,6876
"08069001106",3742,543,113,0,370,70,245,159,5242
"08069001107",3902,922,31,0,414,205,754,118,6346
"08069001109",3996,556,44,0,252,107,431,56,5442
"08069001110",3516,1749,0,0,277,286,445,170,6443
"08069001111",1250,485,9,17,325,147,6,179,2418
"08069001112",3628,345,0,0,376,45,600,162,5156
"08069001113",3033,193,0,16,255,13,251,32,3793
"08069001114",2179,35,31,0,130,21,122,0,2518
"08069001301",3135,461,0,0,208,22,99,200,4125
"08069001304",1528,593,0,0,256,225,997,666,4265
"08069001305",1361,466,0,0,123,175,302,278,2705
"08069001306",1207,420,54,103,254,172,582,201,2993
"08069001307",3686,268,5,0,259,17,614,17,4866
"08069001308",4766,143,47,0,390,32,380,0,5758
"08069001601",1312,210,0,0,95,89,238,80,2024
"08069001602",3853,430,29,0,345,7,381,128,5173
"08069001603",4269,477,73,0,519,12,939,226,6515
"08069001605",2373,252,65,18,344,0,222,36,3310
"08069001606",2390,60,163,0,360,58,112,0,3143
"08069001607",3375,117,20,0,301,11,237,0,4061
"08069001608",4385,299,0,0,654,13,452,0,5803
"08069001704",7222,761,2,0,658,337,1396,253,10629
"08069001706",5607,391,32,0,339,128,687,128,7312
"08069001707",4084,830,23,0,359,50,479,397,6222
"08069001708",3034,140,11,9,295,0,300,0,3789
"08069001709",13012,385,64,0,500,108,1133,13,15215
"08069001804",3162,528,0,0,252,37,220,117,4316
"08069001806",6129,473,44,0,739,56,820,74,8335
"08069001807",4937,161,24,0,267,231,388,231,6239
"08069001808",4448,95,0,0,355,33,204,0,5135
"08069001809",10020,487,72,19,594,64,1093,14,12363
"08069001901",3136,700,63,0,114,100,224,148,4485
"08069001902",3983,229,8,0,241,181,357,24,5023
"08069001903",3380,321,0,0,27,33,64,29,3854
"08069002005",4636,288,28,0,263,147,551,147,6060
"08069002007",2499,549,54,0,21,137,109,206,3575
"08069002008",2934,145,28,0,330,38,364,66,3905
"08069002010",2469,91,11,0,21,0,135,0,2727
"08069002011",5139,264,0,0,214,0,348,0,5965
"08069002300",2823,254,0,0,157,99,79,19,3431
"08069002401",898,164,0,0,7,3,118,5,1195
"08069002402",2197,161,90,0,125,0,113,0,2686
"08069002501",7388,465,14,0,409,235,317,518,9346
"08069002502",7439,299,46,11,675,71,1119,117,9777
"08069002503",3125,576,14,0,117,14,246,498,4590
"08069002600",5993,345,21,0,389,81,403,123,7355
"08069002700",4584,476,41,0,262,74,276,12,5725
"08069002801",2782,549,3,28,47,6,47,35,3497
"08069002802",4899,461,0,12,37,18,248,0,5675
"08069002803",59,18,0,0,0,14,0,14,105
"08071000100",2296,440,127,0,463,66,1438,238,5068
"08071000200",1533,291,25,13,391,45,741,138,3177
"08071000300",1478,260,0,0,285,11,542,126,2702
"08071000400",1135,277,0,0,351,82,865,218,2928
"08071000500",1301,249,0,0,185,129,760,221,2845
"08071000800",2009,150,0,0,150,42,589,85,3025
"08073961700",1588,297,17,0,43,0,115,35,2095
"08073961800",1468,306,0,3,18,18,98,3,1914
"08075965900",1128,89,4,0,17,0,105,24,1367
"08075966000",1855,259,6,0,75,12,109,9,2325
"08075966100",5037,1713,0,0,512,102,847,866,9077
"08075966200",2938,346,0,32,133,89,649,150,4337
"08075966300",3491,627,117,0,544,10,282,43,5114
"08075966400",1390,242,13,0,46,8,17,9,1725
"08077000200",1529,405,0,9,194,113,416,130,2796
"08077000300",1028,332,0,16,54,4,232,12,1678
"08077000400",2583,572,0,0,280,55,512,126,4128
"08077000500",758,352,0,14,22,61,91,10,1308
"08077000601",2903,949,4,69,80,191,107,336,4639
"08077000602",3311,1181,22,10,333,85,405,265,5612
"08077000700",2236,830,10,26,507,394,671,321,4995
"08077000800",6424,1289,44,28,490,112,1106,362,9855
"08077000900",1894,286,65,15,123,49,384,50,2866
"08077001001",3967,292,0,0,182,1,167,103,4712
"08077001002",5051,587,0,0,612,114,633,55,7052
"08077001101",6616,1103,7,49,168,39,770,436,9188
"08077001102",3961,559,55,0,127,26,385,181,5294
"08077001200",1894,139,9,0,149,21,70,26,2308
"08077001301",5462,2810,30,4,421,74,1218,949,10968
"08077001302",3901,365,0,0,208,34,406,0,4914
"08077001402",5669,400,0,0,370,24,158,24,6645
"08077001403",3261,218,32,0,74,176,202,176,4139
"08077001404",4392,218,0,0,153,0,351,0,5114
"08077001501",9912,1728,46,0,951,12,1658,55,14362
"08077001502",6688,570,36,0,143,17,266,17,7737
"08077001600",3047,256,0,0,60,14,134,0,3511
"08077001702",4052,318,12,0,289,46,342,36,5095
"08077001703",3336,497,0,0,266,0,454,60,4613
"08077001705",4040,905,134,0,230,104,1432,231,7076
"08077001706",3969,1783,0,0,402,0,1171,778,8103
"08077001707",5184,483,67,0,170,0,794,183,6881
"08077001800",2387,403,0,24,48,99,165,97,3223
"08077001900",4584,362,10,39,18,185,176,2,5376
"08079973600",610,49,3,3,64,4,75,4,812
"08081000300",2796,110,0,0,86,10,74,25,3101
"08081000400",3278,508,0,50,186,152,692,150,5016
"08081000500",3614,347,0,5,148,38,544,111,4807
"08081000600",1186,143,0,0,105,99,89,99,1721
"08083941100",155,38,4,0,547,378,20,56,1198
"08083969000",2893,434,0,0,135,0,143,0,3605
"08083969100",2719,473,4,0,225,58,269,92,3840
"08083969200",2275,427,0,0,8,54,148,161,3073
"08083969300",4099,356,0,5,587,103,616,65,5831
"08083969400",2315,860,0,8,711,501,457,158,5010
"08083969600",3480,647,32,3,661,205,682,194,5904
"08085966100",1718,288,0,0,105,39,122,17,2289
"08085966201",2230,245,99,0,72,17,323,0,2986
"08085966202",3229,1000,43,7,177,13,1100,409,5978
"08085966300",3978,1072,0,9,215,498,692,1052,7516
"08085966400",4601,1136,0,18,157,135,936,47,7030
"08085966501",2511,468,0,0,49,0,154,107,3289
"08085966502",3043,580,0,20,339,34,424,212,4652
"08085966503",2165,868,0,0,234,0,342,375,3984
"08085966601",3255,627,22,0,330,133,1231,394,5992
"08085966602",3842,397,25,0,124,40,134,0,4562
"08087000100",2591,53,144,0,10,2,200,0,3000
"08087000200",2256,403,0,0,111,6,295,185,3256
"08087000300",1682,257,0,0,44,38,759,181,2961
"08087000400",3105,572,247,0,336,38,1379,282,5959
"08087000500",1494,360,59,11,279,131,693,362,3389
"08087000600",5233,542,189,0,184,8,2601,338,9095
"08087000700",4335,560,22,0,664,62,2063,199,7905
"08087000800",1486,123,0,3,35,49,155,34,1885
"08089968000",1108,309,0,0,10,25,148,65,1665
"08089968100",1631,858,19,1,107,148,975,671,4410
"08089968200",2555,187,0,7,154,0,1151,78,4132
"08089968300",3055,616,3,3,78,109,1035,406,5305
"08089968400",681,248,0,0,58,13,247,119,1366
"08089968500",1258,162,0,0,54,27,137,87,1725
"08089968600",2494,1228,0,3,406,452,1167,1296,7046
"08091967600",4139,325,0,0,74,30,214,6,4788
"08093000100",5165,238,0,0,206,92,597,1,6299
"08093000200",3485,66,0,0,197,0,107,0,3855
"08093000300",2517,270,0,0,6,6,38,0,2837
"08093000400",1216,196,0,0,0,0,39,0,1451
"08093000500",1974,289,0,0,126,13,86,24,2512
"08095967600",2196,516,6,0,131,18,464,317,3648
"08095967700",1267,114,0,0,48,10,11,0,1450
"08097000100",6746,989,0,50,159,39,611,448,9042
"08097000401",3744,191,86,87,136,0,150,9,4403
"08097000402",2516,120,27,0,118,135,298,0,3214
"08097000500",1983,98,6,0,115,0,151,10,2363
"08099000100",1145,97,0,0,94,2,77,41,1456
"08099000200",1433,607,31,0,94,7,925,304,3401
"08099000300",4149,764,0,0,87,55,1462,398,6915
"08099000600",973,257,0,0,71,17,308,143,1769
"08099000700",1480,448,0,10,65,0,437,242,2682
"08101000100",1832,182,20,2,349,262,767,318,3732
"08101000200",763,606,41,5,619,56,998,409,3497
"08101000300",0,0,0,0,0,0,0,0,0
"08101000400",1830,280,15,16,354,297,965,386,4143
"08101000500",1568,143,108,0,183,88,535,97,2722
"08101000600",794,545,16,0,370,209,713,473,3120
"08101000800",1478,808,51,6,300,393,1126,989,5151
"08101000902",3224,1035,37,0,1326,451,2495,1172,9740
"08101000903",0,30,0,10,0,12,0,0,52
"08101000904",2648,775,25,0,372,194,1005,469,5488
"08101000905",1130,404,21,29,361,97,563,242,2847
"08101001000",1925,1203,15,0,1112,980,1836,1574,8645
"08101001100",778,706,7,1,354,618,886,980,4330
"08101001200",934,502,25,32,216,372,799,789,3669
"08101001400",527,253,11,0,224,165,381,315,1876
"08101001500",1237,547,12,3,168,41,484,295,2787
"08101001600",1404,150,0,0,157,14,437,71,2233
"08101001700",3608,343,35,3,313,134,1363,340,6139
"08101001800",1539,323,2,3,325,70,816,214,3292
"08101001900",832,233,6,19,166,28,370,155,1809
"08101002000",1361,800,44,110,551,335,1176,929,5306
"08101002100",700,196,9,32,412,219,815,323,2706
"08101002200",991,263,38,31,69,104,584,251,2331
"08101002300",1803,501,67,70,550,180,1391,564,5126
"08101002400",1094,240,11,7,276,176,845,268,2917
"08101002500",1986,354,83,17,354,246,1308,326,4674
"08101002600",1570,841,10,107,504,527,1152,1100,5811
"08101002700",3483,901,20,22,777,214,2218,874,8509
"08101002801",3233,852,121,0,677,280,1994,693,7850
"08101002802",2679,337,117,0,540,88,1238,132,5131
"08101002804",3585,544,5,4,216,35,297,4,4690
"08101002806",3336,110,23,0,249,14,861,14,4607
"08101002807",3078,276,43,17,880,155,1785,268,6502
"08101002808",2386,228,0,0,331,168,908,133,4154
"08101002901",1428,375,141,79,651,351,1340,430,4795
"08101002903",3690,922,279,16,1116,331,2379,634,9367
"08101002906",3978,105,0,22,280,7,886,0,5278
"08101002911",2195,207,0,0,378,0,467,89,3336
"08101002912",1185,214,81,13,420,102,705,179,2899
"08101002913",3200,24,27,0,176,51,446,36,3960
"08101002914",2326,266,25,4,723,70,1116,118,4648
"08101002915",2001,210,0,5,219,25,674,31,3165
"08101002916",2127,342,29,11,378,67,584,66,3604
"08101002917",2346,265,6,0,223,0,558,0,3398
"08101002918",5276,210,265,8,465,20,919,50,7213
"08101003001",695,275,19,0,92,6,223,71,1381
"08101003004",2074,31,79,103,324,56,710,13,3390
"08101003103",1273,308,12,25,198,58,704,228,2806
"08101003104",1747,223,0,0,225,53,602,108,2958
"08101003105",2994,84,0,0,181,6,792,11,4068
"08101003106",916,99,1,0,104,8,299,35,1462
"08101003200",2563,250,0,0,281,324,550,458,4426
"08101003500",695,359,6,46,271,384,520,518,2799
"08101003600",982,401,4,57,473,260,784,468,3429
"08101980100",0,0,0,0,0,0,0,0,0
"08103951100",2927,669,0,13,110,158,262,219,4358
"08103951200",2188,273,0,0,72,0,156,12,2701
"08105976700",3113,792,0,43,792,130,2560,555,7985
"08105976800",1205,459,18,0,203,162,817,366,3230
"08105977000",3620,500,15,0,310,112,567,210,5334
"08107000100",1978,63,0,1,7,0,20,0,2069
"08107000200",1662,207,0,0,74,31,230,48,2252
"08107000300",1788,230,4,0,20,30,21,7,2100
"08107000400",2824,242,49,0,259,0,263,115,3752
"08107000500",3372,338,38,0,104,101,213,75,4241
"08107000600",2792,140,0,0,58,31,182,31,3234
"08107000700",4059,585,0,0,236,25,167,64,5136
"08107000800",1539,296,1,1,69,48,127,0,2081
"08109977600",2487,565,12,6,159,95,395,33,3752
"08109977700",1855,537,0,0,242,247,1256,722,4859
"08111972600",474,97,0,0,32,3,91,26,723
"08113968101",1775,195,0,0,49,0,238,10,2267
"08113968102",1525,188,16,0,117,45,235,60,2186
"08113968103",1849,136,0,0,56,0,46,0,2087
"08113968200",1375,290,0,0,29,0,139,0,1833
"08115968300",1838,301,29,0,124,34,253,65,2644
"08117000100",6481,716,256,0,551,316,1049,435,9804
"08117000200",5507,770,20,29,526,572,1293,717,9434
"08117000300",3163,361,0,0,153,9,77,3,3766
"08117000401",3470,494,0,0,327,144,547,57,5039
"08117000402",4346,538,18,0,54,0,44,10,5010
"08119010103",7274,323,0,0,127,0,464,0,8188
"08119010104",1548,344,0,0,80,13,38,0,2023
"08119010105",4667,370,51,0,104,20,100,19,5331
"08119010106",4104,347,183,0,401,0,244,0,5279
"08119010201",2034,231,0,0,274,5,469,28,3041
"08119010202",502,71,0,0,40,4,23,0,640
"08121924100",1752,222,0,0,31,12,14,54,2085
"08121924200",2156,211,0,4,80,17,263,29,2760
"08123000100",1091,790,45,55,94,238,584,402,3299
"08123000200",583,1042,119,141,188,135,278,394,2880
"08123000300",0,0,0,0,0,0,0,0,0
"08123000401",2043,437,5,7,428,41,386,90,3437
"08123000402",2282,571,85,88,505,115,1315,278,5239
"08123000501",1519,829,15,0,523,427,1701,1079,6093
"08123000502",1290,492,36,2,845,537,1390,736,5328
"08123000600",421,62,0,0,237,106,602,165,1593
"08123000701",860,316,12,0,424,78,947,296,2933
"08123000703",3648,1291,88,18,1277,732,3469,1457,11980
"08123000704",619,64,12,0,44,0,421,60,1220
"08123000705",860,65,0,0,334,125,375,129,1888
"08123000800",1196,1314,31,120,287,406,484,486,4324
"08123000900",1985,569,6,0,437,74,735,224,4030
"08123001003",2154,1525,160,533,700,191,1927,1151,8341
"08123001004",2417,1249,0,1,802,410,1921,1122,7922
"08123001005",5475,946,11,11,606,7,2626,331,10013
"08123001006",3791,688,0,0,351,76,2027,331,7264
"08123001100",2912,334,154,2,540,66,879,146,5033
"08123001201",2731,472,0,0,457,223,1202,450,5535
"08123001202",2009,198,23,43,577,126,611,109,3696
"08123001300",5089,509,78,0,1013,423,3140,457,10709
"08123001404",2375,339,0,0,203,41,633,185,3776
"08123001405",3636,121,35,0,364,27,1541,33,5757
"08123001406",4453,514,14,0,566,25,1301,0,6873
"08123001407",1938,28,0,0,89,0,145,0,2200
"08123001408",1792,119,4,0,179,111,392,76,2673
"08123001409",2381,494,0,0,273,0,271,28,3447
"08123001410",3097,221,47,0,83,21,424,23,3916
"08123001411",2323,111,0,0,68,0,494,31,3027
"08123001412",1821,132,7,0,164,75,266,103,2568
"08123001413",2586,154,18,0,127,48,1163,12,4108
"08123001414",1855,145,0,42,220,0,630,49,2941
"08123001415",3478,105,0,0,259,0,644,0,4486
"08123001416",1962,81,0,0,213,0,384,0,2640
"08123001417",1390,168,4,0,340,56,551,137,2646
"08123001500",6101,182,31,17,322,0,1393,0,8046
"08123001600",3968,335,17,4,320,96,1050,139,5929
"08123001700",3894,821,0,0,279,30,1129,466,6619
"08123001800",3376,733,5,0,315,0,982,356,5767
"08123001902",5160,1125,0,0,840,0,2111,790,10026
"08123001905",3270,618,30,0,625,63,2407,338,7351
"08123001906",1171,51,11,0,387,23,559,23,2225
"08123001907",2467,234,22,0,290,79,1041,186,4319
"08123001908",1824,282,9,2,204,19,880,165,3385
"08123002004",3313,233,76,0,348,87,1456,81,5594
"08123002005",584,0,0,0,157,0,155,0,896
"08123002006",261,0,0,0,62,0,75,0,398
"08123002007",5052,136,0,0,765,16,644,22,6635
"08123002008",4297,100,32,0,588,0,445,12,5474
"08123002009",1233,99,0,0,10,0,48,5,1395
"08123002010",1542,607,7,0,222,19,403,375,3175
"08123002011",433,0,0,0,50,0,15,0,498
"08123002012",932,0,0,0,143,0,80,0,1155
"08123002013",2818,45,7,0,118,22,300,30,3340
"08123002014",1189,153,0,0,113,0,138,23,1616
"08123002015",949,18,0,0,100,0,123,0,1190
"08123002016",2883,218,33,0,243,0,687,56,4120
"08123002017",791,24,0,0,0,10,116,0,941
"08123002018",971,94,5,0,170,0,90,0,1330
"08123002019",3517,197,18,0,405,118,661,109,5025
"08123002020",4714,84,20,0,314,52,580,65,5829
"08123002021",420,15,0,0,25,0,21,0,481
"08123002101",6594,184,55,0,447,212,2049,0,9541
"08123002102",11100,176,17,0,911,0,1718,0,13922
"08123002103",7325,359,0,0,598,51,833,50,9216
"08123002203",1200,32,0,0,23,0,96,24,1375
"08123002204",1861,104,0,0,29,0,98,7,2099
"08123002205",4076,486,48,0,159,33,472,118,5392
"08123002206",2963,221,0,0,180,18,353,44,3779
"08123002207",2225,196,0,0,155,0,107,0,2683
"08123002208",4487,125,38,0,263,7,525,24,5469
"08123002209",1331,32,0,0,9,0,46,0,1418
"08123002210",663,21,19,0,43,0,23,0,769
"08123002300",3875,655,0,0,290,76,849,125,5870
"08123002501",3990,677,12,9,169,84,264,151,5356
"08123002502",4915,611,0,0,59,79,669,246,6579
"08125963100",3882,696,3,0,92,14,644,228,5559
"08125963200",4289,579,0,119,313,43,976,328,6647
"09001010101",3679,258,0,8,219,96,227,0,4487
"09001010102",3227,320,91,3,343,2,85,16,4087
"09001010201",2609,99,121,25,283,12,166,42,3357
"09001010202",4428,108,12,10,773,15,536,15,5897
"09001010300",3476,111,22,25,427,0,294,12,4367
"09001010400",4444,204,322,4,513,84,406,7,5984
"09001010500",3969,334,322,6,940,0,940,133,6644
"09001010600",1314,159,149,0,158,11,214,17,2022
"09001010700",3191,184,197,39,232,72,371,82,4368
"09001010800",2867,122,75,3,362,28,235,82,3774
"09001010900",3899,233,153,49,869,8,793,75,6079
"09001011000",4726,149,29,8,491,56,433,27,5919
"09001011100",4124,88,53,0,399,11,207,0,4882
"09001011200",1409,131,0,2,67,15,172,0,1796
"09001011300",2448,248,113,54,913,47,1357,230,5410
"09001020100",1849,322,537,507,479,61,673,68,4496
"09001020200",3218,56,92,0,290,36,247,0,3939
"09001020300",6203,111,296,0,569,36,354,66,7635
"09001020400",3369,89,103,0,452,15,695,0,4723
"09001020500",4222,44,209,1,384,25,452,0,5337
"09001020600",4020,81,315,0,484,0,535,13,5448
"09001020700",3931,113,102,0,386,32,484,32,5080
"09001020800",2415,29,86,0,329,0,212,0,3071
"09001020900",3020,230,469,124,1182,72,730,85,5912
"09001021000",2393,81,219,0,482,0,261,0,3436
"09001021100",3819,102,514,78,1084,110,1235,2,6944
"09001021200",3356,66,283,40,707,3,515,18,4988
"09001021300",2577,36,928,22,894,32,1092,16,5597
"09001021400",2340,146,1429,215,1781,346,2412,328,8997
"09001021500",1342,332,1555,381,1840,662,2052,959,9123
"09001021600",3288,251,347,404,2715,319,1047,235,8606
"09001021700",3104,371,859,96,2168,519,1206,613,8936
"09001021801",2282,242,514,190,1305,29,1092,199,5853
"09001021802",2200,88,1476,77,1033,82,1310,82,6348
"09001021900",3236,387,867,152,1044,225,1667,317,7895
"09001022000",1498,59,371,188,864,25,1045,41,4091
"09001022100",3112,281,1362,239,2993,371,3770,529,12657
"09001022200",1440,410,679,126,1227,480,1734,716,6812
"09001022300",2182,93,1421,441,1372,961,1926,1010,9406
"09001022400",2024,76,32,0,237,1,301,4,2675
"09001030100",3453,172,1,11,80,5,176,7,3905
"09001030200",3342,212,0,0,91,193,38,35,3911
"09001030300",3811,52,0,0,145,11,53,11,4083
"09001030400",3379,224,53,0,474,35,139,0,4304
"09001030500",4885,229,20,5,492,6,154,34,5825
"09001035100",6778,175,273,3,440,37,484,6,8196
"09001035200",3006,43,62,0,114,0,116,0,3341
"09001035300",3654,86,0,0,274,0,234,13,4261
"09001035400",4748,158,12,0,270,0,75,8,5271
"09001042500",3245,177,388,1,355,0,349,75,4590
"09001042600",3443,162,236,5,427,0,598,0,4871
"09001042700",3594,71,239,0,738,0,309,0,4951
"09001042800",3830,301,314,63,432,0,437,140,5517
"09001042900",1544,18,30,0,73,0,74,0,1739
"09001043000",2525,70,506,1,119,37,370,0,3628
"09001043100",4034,64,190,34,464,117,504,71,5478
"09001043200",1808,145,553,60,440,11,607,112,3736
"09001043300",2826,127,487,43,84,0,1216,27,4810
"09001043400",2353,216,985,221,469,77,1127,152,5600
"09001043500",2175,67,238,31,91,18,226,7,2853
"09001043600",2332,65,314,77,299,9,583,22,3701
"09001043700",1165,253,320,92,119,89,573,262,2873
"09001043800",4381,323,879,371,1536,122,2286,132,10030
"09001043900",4483,199,688,52,616,0,1838,80,7956
"09001044000",3209,665,964,251,701,80,2293,722,8885
"09001044100",1944,250,616,216,161,64,1025,217,4493
"09001044200",2095,422,919,46,327,0,764,190,4763
"09001044300",3094,222,201,25,312,13,509,145,4521
"09001044400",1752,396,1031,133,190,155,1210,488,5355
"09001044500",821,93,1306,263,561,35,1295,127,4501
"09001044600",3192,150,8,9,15,0,75,0,3449
"09001045101",3836,105,26,0,296,12,38,8,4321
"09001045102",4750,277,40,13,619,29,285,12,6025
"09001045200",2100,13,15,0,168,0,72,0,2368
"09001045300",2336,59,0,0,213,15,14,0,2637
"09001045400",2995,42,49,0,414,10,53,7,3570
"09001050100",3739,64,14,0,432,15,102,10,4376
"09001050200",3543,52,18,10,450,7,131,0,4211
"09001050300",7023,404,4,0,579,0,342,110,8462
"09001050400",2001,183,0,79,63,9,102,36,2473
"09001050500",4264,324,45,10,266,4,134,82,5129
"09001050600",2957,61,15,0,393,46,124,0,3596
"09001055100",5133,109,83,13,470,5,430,43,6286
"09001055200",4189,36,21,0,296,0,197,0,4739
"09001060100",2357,59,52,0,204,0,255,0,2927
"09001060200",3604,97,10,0,485,45,230,0,4471
"09001060300",3696,7,99,0,168,0,292,0,4262
"09001060400",4020,284,34,2,128,1,124,1,4594
"09001060500",2629,28,0,0,108,0,139,0,2904
"09001060600",2123,102,18,0,134,0,58,0,2435
"09001060700",4789,117,0,9,228,19,280,0,5442
"09001060800",2021,27,0,0,79,0,36,2,2165
"09001060900",2389,49,0,0,149,0,145,0,2732
"09001061000",3221,297,113,8,277,0,211,24,4151
"09001061100",3512,83,36,1,252,18,74,0,3976
"09001061200",1789,56,14,0,329,42,153,0,2383
"09001061300",2224,212,14,0,771,96,186,23,3526
"09001061400",1760,203,195,0,609,146,565,0,3478
"09001061500",3826,287,20,0,416,54,141,152,4896
"09001061600",4853,87,0,8,236,0,71,0,5255
"09001070100",3240,364,163,56,554,81,518,56,5032
"09001070200",1371,116,1167,530,1010,162,1270,238,5864
"09001070300",18,209,113,350,201,265,247,518,1921
"09001070400",383,124,146,39,230,33,100,47,1102
"09001070500",312,173,549,390,432,372,601,422,3251
"09001070600",555,320,387,225,321,137,577,279,2801
"09001070900",599,270,547,286,316,391,847,616,3872
"09001071000",896,142,1180,461,975,409,1436,463,5962
"09001071100",1010,267,1517,694,1064,137,1209,334,6232
"09001071200",1085,600,1660,438,952,668,1634,1062,8099
"09001071300",846,592,1049,379,457,464,969,958,5714
"09001071400",1472,423,485,287,875,391,1138,724,5795
"09001071600",139,681,302,615,270,478,289,1209,3983
"09001071900",951,448,1321,308,949,225,1164,669,6035
"09001072000",1383,231,1068,332,585,151,1148,285,5183
"09001072100",3024,358,1066,214,570,82,1455,126,6895
"09001072200",2262,277,646,223,327,295,1044,198,5272
"09001072300",2494,484,1459,61,1442,221,2084,551,8796
"09001072400",828,61,736,105,940,181,1385,179,4415
"09001072500",3340,446,1829,132,489,80,1265,307,7888
"09001072600",3919,1143,1329,31,637,0,851,208,8118
"09001072700",1374,103,1430,11,698,18,1063,30,4727
"09001072800",873,225,2816,464,1230,239,1454,490,7791
"09001072900",1549,188,2201,246,761,59,1385,122,6511
"09001073000",770,129,625,63,203,99,559,126,2574
"09001073100",1481,278,1266,646,622,157,1263,376,6089
"09001073200",940,148,678,66,597,17,541,32,3019
"09001073300",705,188,1566,202,690,0,1114,137,4602
"09001073400",1455,128,1333,579,802,246,1610,306,6459
"09001073500",635,205,767,481,989,120,1603,324,5124
"09001073600",491,243,633,210,545,422,913,687,4144
"09001073700",887,380,1612,446,903,414,1561,697,6900
"09001073800",300,356,575,245,589,373,780,753,3971
"09001073900",709,725,586,290,842,230,1401,931,5714
"09001074000",409,303,512,188,250,178,664,469,2973
"09001074300",525,463,1464,568,473,365,849,798,5505
"09001074400",356,519,1918,399,949,242,1194,670,6247
"09001080100",2404,325,734,56,883,73,975,186,5636
"09001080200",2177,628,901,274,465,70,853,336,5704
"09001080400",1754,157,2451,628,666,29,1003,163,6851
"09001080500",2671,329,30,0,55,0,160,19,3264
"09001080600",1669,91,337,8,103,46,310,0,2564
"09001080700",1439,271,301,7,87,20,137,100,2362
"09001080800",4191,110,255,28,339,0,375,7,5305
"09001080900",3797,229,735,0,355,0,644,0,5760
"09001081000",3446,81,327,73,580,0,434,5,4946
"09001081100",4216,57,364,4,106,0,431,0,5178
"09001081200",4479,142,525,45,320,28,371,47,5957
"09001081300",4281,248,150,31,169,27,711,90,5707
"09001090100",3007,26,71,0,270,12,111,2,3499
"09001090200",7108,50,376,0,446,2,415,0,8397
"09001090300",4099,117,51,0,385,1,538,1,5192
"09001090400",5323,208,479,0,544,0,742,0,7296
"09001090500",4095,132,140,0,358,0,368,0,5093
"09001090600",2872,139,10,0,271,37,46,6,3381
"09001090700",4848,83,72,1,456,1,568,1,6030
"09001100100",5446,307,28,0,133,0,371,0,6285
"09001100200",6420,209,7,4,571,0,270,0,7481
"09001100300",5821,247,105,0,439,38,248,0,6898
"09001105100",3728,181,28,0,143,0,180,0,4260
"09001105200",3090,130,0,0,300,0,136,34,3690
"09001110100",1541,403,0,12,62,0,138,68,2224
"09001110201",4167,340,117,0,496,30,417,10,5577
"09001110202",4410,182,56,18,225,6,411,6,5314
"09001110301",5333,251,71,0,424,151,355,15,6600
"09001110302",2399,110,0,0,205,0,56,0,2770
"09001110400",4869,125,0,0,160,0,115,0,5269
"09001110500",5583,118,29,1,63,0,76,0,5870
"09001110600",7519,292,0,1,523,2,492,2,8831
"09001200100",2928,107,102,0,575,0,462,0,4174
"09001200200",3910,137,68,0,548,160,441,8,5272
"09001200301",4567,106,37,0,414,0,517,3,5644
"09001200302",4854,72,38,0,319,28,163,11,5485
"09001205100",3315,61,13,0,801,57,197,57,4501
"09001205200",6226,90,17,2,131,15,136,2,6619
"09001205300",5461,255,52,0,404,4,346,0,6522
"09001210100",2064,937,167,23,2453,511,2666,834,9655
"09001210200",1537,173,204,268,2808,1286,2609,1207,10092
"09001210300",3087,461,252,0,1637,255,1342,419,7453
"09001210400",4674,414,1076,235,2201,583,2070,875,12128
"09001210500",5112,578,418,6,1035,247,941,276,8613
"09001210600",2701,339,217,88,2572,250,2081,361,8609
"09001210701",2351,200,169,84,1815,325,2089,270,7303
"09001210702",2344,471,504,58,979,313,1495,476,6640
"09001210800",3554,133,261,78,761,10,638,41,5476
"09001210900",4573,112,51,2,377,0,386,0,5501
"09001211000",3173,137,299,0,538,29,698,61,4935
"09001211100",24,0,15,0,0,0,0,0,39
"09001211200",4314,396,342,61,1077,66,708,116,7080
"09001211300",3102,222,185,50,352,1,246,16,4174
"09001211400",4128,228,149,0,869,0,715,0,6089
"09001220100",4516,54,34,0,335,9,370,19,5337
"09001220200",4718,120,0,18,410,0,514,0,5780
"09001220300",3404,83,19,4,164,121,122,2,3919
"09001230100",6539,247,0,0,193,0,383,0,7362
"09001230200",1759,65,8,0,171,3,136,15,2157
"09001230300",3097,116,33,0,364,13,362,2,3987
"09001230400",5761,142,33,0,347,67,136,88,6574
"09001230501",3717,100,62,0,198,39,244,39,4399
"09001230502",3833,230,0,49,244,0,297,0,4653
"09001240100",4131,117,43,48,217,0,154,1,4711
"09001240200",4361,178,13,0,117,10,53,0,4732
"09001245100",2813,22,34,0,167,0,97,0,3133
"09001245200",3967,93,9,0,132,1,188,1,4391
"09001245300",4552,215,0,12,226,30,233,104,5372
"09001245400",3170,26,0,0,236,0,155,0,3587
"09001245500",2681,59,13,0,161,0,161,0,3075
"09001245600",5785,236,74,2,297,2,313,1,6710
"09001257100",3378,56,0,0,179,0,74,0,3687
"09001257200",1178,267,1006,305,712,162,1253,198,5081
"09001990000",0,0,0,0,0,0,0,0,0
"09003330100",1962,136,17,0,69,0,47,0,2231
"09003400100",6432,302,0,1,305,313,334,106,7793
"09003400200",5459,58,133,0,292,0,245,0,6187
"09003400300",6887,176,0,0,71,4,136,34,7308
"09003405100",2664,98,78,0,170,217,293,170,3690
"09003405200",3342,502,23,1,159,0,40,107,4174
"09003405300",5239,402,16,0,194,180,543,180,6754
"09003405401",2809,131,21,0,127,51,220,0,3359
"09003405402",2531,249,293,0,1022,30,450,30,4605
"09003405500",4253,410,125,0,335,13,623,85,5844
"09003405600",6131,352,221,93,382,114,703,108,8104
"09003405700",1458,371,26,78,160,143,94,314,2644
"09003405800",6514,338,24,0,495,164,559,164,8258
"09003405900",4120,89,161,13,55,79,319,30,4866
"09003406001",2751,370,84,255,187,246,478,567,4938
"09003406002",4176,225,102,0,174,94,196,63,5030
"09003406100",1952,594,406,28,593,311,761,368,5013
"09003410101",5084,165,46,0,155,0,120,0,5570
"09003410102",3777,47,91,0,110,0,94,0,4119
"09003415300",1134,375,453,96,449,518,931,843,4799
"09003415400",2942,262,1029,14,974,297,1746,352,7616
"09003415500",910,589,198,53,550,439,973,743,4455
"09003415600",1984,643,591,42,966,323,1759,589,6897
"09003415700",1801,252,266,134,329,125,528,195,3630
"09003415800",1165,289,386,49,526,179,646,248,3488
"09003415900",864,542,64,25,122,37,336,338,2328
"09003416000",3397,500,62,72,442,244,1372,289,6378
"09003416100",1825,1116,329,236,735,768,1703,1578,8290
"09003416200",1077,1026,118,147,384,208,860,1159,4979
"09003416300",1301,679,217,32,794,515,873,801,5212
"09003416400",2724,47,43,0,462,4,521,4,3805
"09003416500",2662,667,621,108,929,72,1917,460,7436
"09003416600",1089,724,275,96,305,153,604,761,4007
"09003416700",3978,638,510,46,769,264,1633,485,8323
"09003416800",2034,507,100,25,360,72,855,138,4091
"09003417100",449,472,148,158,293,201,542,517,2780
"09003417200",911,405,183,18,141,51,354,113,2176
"09003417300",0,5,0,0,0,4,0,0,9
"09003417400",1563,344,311,0,291,24,364,80,2977
"09003417500",3590,259,248,0,400,190,601,232,5520
"09003420400",2716,156,26,0,118,1,112,1,3130
"09003420500",3959,444,217,45,212,134,384,73,5468
"09003420600",4910,402,256,1,288,204,418,250,6729
"09003420700",3207,173,55,4,91,25,101,7,3663
"09003430100",3512,339,81,28,115,0,42,0,4117
"09003430201",2704,142,0,1,410,0,80,11,3348
"09003430202",4521,32,75,0,274,0,144,0,5046
"09003430203",4040,108,78,1,260,0,101,27,4615
"09003430301",3583,64,0,0,61,0,94,0,3802
"09003430302",2726,84,15,1,43,6,54,0,2929
"09003430400",4075,176,49,42,13,30,50,3,4438
"09003430500",6424,18,98,0,56,5,200,5,6806
"09003430601",4311,352,93,0,156,0,207,0,5119
"09003430602",3508,156,35,0,306,0,212,30,4247
"09003460100",2591,77,17,0,428,8,65,0,3186
"09003460202",3286,411,76,22,403,79,85,16,4378
"09003460203",2077,65,89,0,308,133,106,30,2808
"09003460204",4965,166,149,2,1089,0,129,66,6566
"09003460301",4433,173,108,1,333,73,333,61,5515
"09003460302",3397,163,43,9,196,3,74,0,3885
"09003462101",5731,117,0,0,464,0,376,10,6698
"09003462102",3125,156,7,0,678,19,101,0,4086
"09003462201",4374,59,16,0,565,34,47,0,5095
"09003462202",2380,66,0,0,299,37,58,0,2840
"09003464101",5093,91,54,0,175,0,101,0,5514
"09003464102",4330,128,26,0,341,0,325,0,5150
"09003466101",3894,186,137,0,231,0,204,127,4779
"09003466102",4315,91,67,0,514,9,373,25,5394
"09003466201",1914,126,129,54,190,0,68,0,2481
"09003466202",4131,45,38,0,259,12,72,0,4557
"09003466300",4279,111,112,0,171,71,189,71,5004
"09003466400",2282,65,45,15,86,10,80,26,2609
"09003468101",6552,146,111,0,272,17,290,5,7393
"09003468102",3627,108,31,0,321,42,20,0,4149
"09003470100",4503,127,267,0,226,0,215,0,5338
"09003471100",313,73,2947,315,137,12,169,43,4009
"09003471200",290,0,2256,74,170,14,131,0,2935
"09003471300",1688,219,2220,95,541,105,242,25,5135
"09003471400",3224,57,1570,169,271,5,220,5,5521
"09003471500",899,72,2083,49,221,23,72,14,3433
"09003473100",2276,83,3456,39,496,5,821,5,7181
"09003473400",1091,66,399,60,179,22,69,18,1904
"09003473501",2587,123,902,0,668,43,351,13,4687
"09003473502",2124,37,647,7,322,72,164,0,3373
"09003473601",2476,36,418,0,226,3,251,25,3435
"09003473602",1174,88,564,62,554,49,144,19,2654
"09003473700",1949,130,2644,167,408,258,363,258,6177
"09003473800",383,27,838,357,158,21,171,32,1987
"09003476100",3347,302,167,10,339,179,128,2,4474
"09003476200",2408,66,13,3,102,28,17,28,2665
"09003476300",4281,102,356,0,749,24,347,16,5875
"09003477101",3620,144,73,0,154,0,69,0,4060
"09003477102",4879,508,335,0,434,0,278,0,6434
"09003477200",2565,31,15,0,117,0,69,0,2797
"09003480300",2111,179,47,0,152,0,50,13,2552
"09003480400",3230,166,103,0,120,0,86,0,3705
"09003480500",2735,167,33,0,393,0,182,0,3510
"09003480600",2714,414,384,121,493,915,952,879,6872
"09003480700",1507,143,118,11,191,91,145,33,2239
"09003480800",3547,192,226,7,290,33,182,14,4491
"09003480900",2071,76,18,0,127,0,177,0,2469
"09003481000",3380,114,23,21,18,0,130,0,3686
"09003481100",3483,206,127,0,28,10,132,10,3996
"09003481200",3078,259,93,139,82,0,93,10,3754
"09003481300",2730,56,32,0,80,11,92,0,3001
"09003484100",3942,155,462,0,824,0,126,26,5535
"09003484200",4748,331,213,1,460,49,416,116,6334
"09003487100",5275,506,237,2,673,0,393,40,7126
"09003487201",3923,114,307,1,373,11,208,1,4938
"09003487202",2878,2,116,38,578,54,301,3,3970
"09003487300",1258,42,5,0,211,8,88,0,1612
"09003487400",1890,40,74,0,301,0,117,4,2426
"09003487500",4832,184,368,24,1210,87,149,26,6880
"09003490100",3707,449,273,13,432,148,369,214,5605
"09003490302",5974,169,107,5,2118,219,219,48,8859
"09003492100",2969,93,133,0,287,0,226,15,3723
"09003492200",3373,123,214,11,256,44,535,33,4589
"09003492300",4373,180,320,0,942,86,967,129,6997
"09003492400",2791,97,0,0,119,0,108,0,3115
"09003492500",2991,54,86,21,95,19,94,19,3379
"09003492600",5884,304,19,20,347,196,614,0,7384
"09003494100",4633,122,218,13,779,30,629,30,6454
"09003494201",3522,192,189,2,543,24,214,8,4694
"09003494202",2367,50,145,0,281,0,303,0,3146
"09003494300",3261,131,174,130,363,14,354,45,4472
"09003494400",4043,181,70,4,471,103,330,98,5300
"09003494500",3544,110,231,0,691,6,524,20,5126
"09003494600",2772,200,113,1,521,11,167,2,3787
"09003496100",1104,257,354,186,720,33,611,163,3428
"09003496200",3468,101,75,2,666,2,387,29,4730
"09003496300",3005,204,149,9,238,52,381,143,4181
"09003496400",2632,40,33,1,175,0,48,0,2929
"09003496500",2338,37,23,1,237,3,155,3,2797
"09003496600",2049,80,237,0,320,12,0,12,2710
"09003496700",2446,192,597,17,699,34,687,80,4752
"09003496800",2050,162,237,270,565,181,547,258,4270
"09003496900",3925,419,446,582,494,237,868,19,6990
"09003497000",4116,18,38,2,197,22,126,0,4519
"09003497100",3303,220,71,10,371,132,232,52,4391
"09003497200",1435,27,95,0,142,1,151,1,1852
"09003497300",3323,116,141,0,613,5,382,0,4580
"09003497400",3319,120,32,49,355,116,159,103,4253
"09003497500",2794,395,191,35,390,120,254,14,4193
"09003497600",1851,140,63,4,127,88,37,7,2317
"09003497700",3857,44,144,89,274,44,27,0,4479
"09003500100",663,650,544,266,873,847,1399,1403,6645
"09003500200",532,527,370,398,551,202,840,746,4166
"09003500300",542,295,298,253,357,305,830,527,3407
"09003500400",376,419,327,251,300,130,569,520,2892
"09003500500",270,160,261,103,468,175,366,191,1994
"09003500700",0,0,48,0,0,0,0,0,48
"09003500900",481,290,597,445,251,292,703,663,3722
"09003501200",88,148,915,793,301,138,351,239,2973
"09003501300",12,73,673,529,91,224,127,266,1995
"09003501400",121,86,1288,921,235,155,324,334,3464
"09003501500",66,136,2143,976,289,108,314,173,4205
"09003501700",166,52,603,143,265,250,477,344,2300
"09003501800",181,387,615,513,475,586,574,985,4316
"09003502100",1079,150,223,76,361,109,161,76,2235
"09003502300",2750,805,848,0,1248,325,2316,1011,9303
"09003502400",2529,915,965,356,848,993,2955,1744,11305
"09003502500",709,348,152,141,466,96,839,352,3103
"09003502600",1168,790,685,139,813,271,1471,803,6140
"09003502700",744,553,325,329,530,605,996,1118,5200
"09003502800",639,812,232,187,462,429,1098,1264,5123
"09003502900",758,630,626,318,493,486,778,1051,5140
"09003503000",497,621,596,339,682,509,1051,1118,5413
"09003503100",932,219,1334,426,647,301,652,463,4974
"09003503300",508,286,792,365,559,162,841,332,3845
"09003503500",210,0,766,413,49,170,301,204,2113
"09003503700",51,79,1671,528,123,10,34,73,2569
"09003503800",87,17,237,90,100,56,124,61,772
"09003503900",77,0,4077,725,130,0,136,0,5145
"09003504000",61,20,2849,680,45,2,36,0,3693
"09003504100",494,398,280,144,241,127,530,559,2773
"09003504200",1796,1057,529,616,576,441,930,331,6276
"09003504300",687,482,338,330,490,349,848,707,4231
"09003504500",730,880,591,230,1074,557,1536,1422,7020
"09003504800",1265,289,487,167,1584,394,2190,591,6967
"09003504900",1211,533,847,208,937,569,1767,1048,7120
"09003510100",1021,96,644,72,325,181,359,221,2919
"09003510200",852,200,740,189,356,73,424,151,2985
"09003510300",1259,266,1490,477,553,390,882,494,5811
"09003510400",1391,759,955,495,745,515,1565,945,7370
"09003510500",1018,96,552,191,991,170,706,58,3782
"09003510600",1600,524,1171,236,1187,29,1624,382,6753
"09003510700",2748,113,811,279,577,469,845,469,6311
"09003510800",1509,122,580,32,627,22,573,48,3513
"09003510900",2301,86,520,17,521,0,627,0,4072
"09003511000",2212,63,620,109,873,1,736,1,4615
"09003511100",2277,110,332,3,646,39,507,90,4004
"09003511200",1453,266,932,311,644,278,761,462,5107
"09003511300",1074,83,1135,235,1023,104,980,125,4759
"09003511400",1697,74,509,14,184,5,385,0,2868
"09003514101",2804,125,20,0,257,17,139,2,3364
"09003514102",3149,242,478,88,2878,155,777,78,7845
"09003514200",1991,326,489,71,281,29,575,115,3877
"09003514300",3014,145,536,10,542,0,461,16,4724
"09003514400",2871,541,461,147,325,172,637,195,5349
"09003514500",3132,131,501,11,642,62,564,8,5051
"09003514600",2912,242,889,261,741,370,1054,393,6862
"09003514700",2021,727,872,102,522,112,459,367,5182
"09003514800",1838,728,679,157,286,231,511,519,4949
"09003514900",2352,110,55,0,151,6,70,6,2750
"09003515000",2589,162,141,15,45,0,261,91,3304
"09003515101",1371,169,383,50,151,109,105,129,2467
"09003515102",3233,119,550,532,1537,223,590,82,6866
"09003515200",2647,65,68,26,368,20,153,34,3381
"09003520100",5218,153,75,0,431,0,231,0,6108
"09003520201",3064,94,146,0,324,4,114,4,3750
"09003520202",3974,159,0,0,365,3,66,3,4570
"09003520301",3331,111,207,16,689,154,217,154,4879
"09003520302",2792,185,130,0,423,100,190,31,3851
"09003520400",6701,104,25,0,1046,8,94,8,7986
"09003520501",3574,169,13,0,558,1,180,24,4519
"09003524100",6035,64,71,2,113,0,238,0,6523
"09003524200",4687,309,181,87,398,202,246,199,6309
"09003524300",3321,67,164,0,216,11,66,0,3845
"09003524400",349,461,1351,643,301,138,688,627,4558
"09003524501",1233,143,438,80,488,299,672,281,3634
"09003524502",807,174,737,207,99,84,197,178,2483
"09003524600",413,143,1400,609,619,44,475,99,3802
"09003524700",1468,198,480,74,687,192,1574,380,5053
"09003980000",0,0,0,0,0,0,0,0,0
"09005250100",1551,46,4,2,75,1,78,1,1758
"09005253100",3077,32,51,0,151,165,148,165,3789
"09005253200",5741,294,211,74,568,159,562,159,7768
"09005253300",1812,192,82,0,224,0,150,0,2460
"09005253400",5683,108,0,0,358,0,220,0,6369
"09005253500",5525,131,0,0,345,0,203,0,6204
"09005253600",1784,377,73,9,246,17,176,71,2753
"09005260200",2816,250,9,0,17,0,139,47,3278
"09005261100",3320,83,91,0,32,1,112,1,3640
"09005262100",2250,180,0,15,163,60,18,0,2686
"09005263200",1169,143,0,0,50,0,5,2,1369
"09005265100",1276,146,0,0,34,5,28,18,1507
"09005266100",2239,166,182,15,42,44,0,7,2695
"09005267100",3147,140,0,0,83,14,154,36,3574
"09005268100",2166,70,0,0,35,0,40,0,2311
"09005290100",3610,72,0,3,43,0,18,0,3746
"09005293100",1484,59,5,0,15,10,6,0,1579
"09005296100",2454,394,0,21,48,17,85,71,3090
"09005298300",2504,272,0,0,0,0,0,22,2798
"09005298400",2576,96,0,8,82,0,15,0,2777
"09005300100",2397,133,28,0,78,31,18,0,2685
"09005300400",1816,121,10,0,58,0,24,0,2029
"09005300500",3322,188,0,0,64,0,40,4,3618
"09005303100",2186,92,7,0,20,0,44,0,2349
"09005306100",6529,216,41,0,57,0,165,0,7008
"09005310100",3446,401,16,24,269,140,599,46,4941
"09005310200",1922,456,18,0,196,72,296,107,3067
"09005310300",727,453,0,28,128,0,46,0,1382
"09005310400",2333,144,22,0,110,0,37,0,2646
"09005310500",1520,186,34,0,90,8,111,27,1976
"09005310601",3171,176,20,0,249,6,62,39,3723
"09005310602",4433,128,67,0,324,0,32,0,4984
"09005310700",3245,269,106,0,209,16,124,0,3969
"09005310801",1833,338,96,63,241,96,269,147,3083
"09005310803",3312,223,324,20,345,0,633,0,4857
"09005310804",2193,355,2,0,34,106,155,308,3153
"09005320100",4824,804,116,0,109,0,925,0,6778
"09005320200",4026,499,119,0,417,18,166,0,5245
"09005342100",3220,230,0,36,12,8,20,6,3532
"09005349100",4460,153,0,0,162,27,83,2,4887
"09005349200",2581,199,12,0,43,39,99,39,3012
"09005360100",4527,173,54,0,395,5,438,5,5597
"09005360200",6852,297,14,10,247,32,24,9,7485
"09005360300",3029,139,265,8,114,0,427,34,4016
"09005360400",5350,332,86,0,68,10,57,0,5903
"09005362101",3722,140,10,14,368,0,233,0,4487
"09005362102",4937,301,0,6,246,47,175,2,5714
"09005425300",3504,260,112,0,199,20,330,0,4425
"09005425400",3948,198,14,1,113,4,71,4,4353
"09005425500",3072,297,54,0,148,0,145,0,3716
"09005425600",2428,141,12,0,41,65,74,0,2761
"09007541100",1054,297,547,86,425,93,349,194,3045
"09007541200",3575,353,380,333,416,36,562,60,5715
"09007541300",4397,373,530,226,585,53,462,42,6668
"09007541401",2755,38,97,18,353,6,141,0,3408
"09007541402",4109,431,574,19,349,38,395,12,5927
"09007541500",841,163,102,25,207,7,63,7,1415
"09007541600",648,375,177,140,139,14,417,113,2023
"09007541700",1454,383,479,319,130,58,214,268,3305
"09007542000",3358,215,310,14,316,23,281,0,4517
"09007542100",2113,229,360,127,236,13,204,105,3387
"09007542200",1226,27,150,5,104,8,49,8,1577
"09007550100",5065,222,0,0,518,0,323,0,6128
"09007550201",3463,83,0,2,183,0,199,0,3930
"09007550202",2645,257,210,24,134,8,60,8,3346
"09007560100",5880,99,0,0,77,0,53,0,6109
"09007560200",2750,298,12,145,80,38,11,173,3507
"09007570100",3736,111,553,0,575,0,391,56,5422
"09007570200",2846,75,160,0,104,4,61,4,3254
"09007570300",5012,170,308,0,59,91,418,91,6149
"09007580100",4168,136,3,1,108,11,63,10,4500
"09007585100",6767,192,17,0,296,0,122,0,7394
"09007590100",7493,543,57,0,220,8,208,18,8547
"09007595101",3474,28,78,0,44,9,142,9,3784
"09007595102",4753,217,0,56,334,40,64,40,5504
"09007600100",3893,133,13,19,82,13,98,0,4251
"09007610100",2002,191,3,3,27,8,29,0,2263
"09007610200",3015,287,10,0,221,57,91,21,3702
"09007610300",3681,460,0,1,48,0,368,157,4715
"09007610400",2782,122,37,0,137,0,94,0,3172
"09007620100",4063,144,38,106,184,13,123,41,4712
"09007630100",6007,329,165,0,26,0,151,0,6678
"09007640100",6046,111,11,0,292,0,182,0,6642
"09007670100",4240,151,23,0,260,43,122,0,4839
"09007670200",4564,380,41,0,365,0,214,0,5564
"09007680100",5999,543,92,19,198,0,288,11,7150
"09007680200",4519,144,649,5,431,15,329,12,6104
"09007990100",0,0,0,0,0,0,0,0,0
"09009120100",4616,254,420,114,250,239,597,216,6706
"09009120200",4164,949,109,0,1056,382,1707,702,9069
"09009125100",3798,231,179,8,141,37,317,54,4765
"09009125200",3728,1153,227,187,566,51,1393,221,7526
"09009125300",3155,249,414,377,689,223,744,356,6207
"09009125400",2003,660,134,320,272,93,526,472,4480
"09009130101",4153,170,90,0,248,0,483,0,5144
"09009130102",2179,344,74,10,271,0,158,23,3059
"09009130200",7112,255,693,88,482,170,804,55,9659
"09009140100",1741,238,419,164,707,189,366,64,3888
"09009140200",443,127,193,319,47,253,212,352,1946
"09009140300",474,149,791,331,511,458,844,445,4003
"09009140400",695,368,612,833,708,691,736,730,5373
"09009140500",492,661,1022,533,602,783,946,1498,6537
"09009140600",658,493,1016,895,719,369,1103,819,6072
"09009140700",1246,576,1004,515,164,370,873,332,5080
"09009140800",675,208,1383,440,487,548,818,552,5111
"09009140900",949,468,2127,406,302,136,202,282,4872
"09009141000",2664,236,648,43,442,0,443,29,4505
"09009141100",1435,98,1251,64,430,6,316,27,3627
"09009141200",1085,352,2086,543,599,129,561,177,5532
"09009141300",1235,543,1118,791,390,140,370,158,4745
"09009141400",880,281,2289,592,509,297,434,404,5686
"09009141500",14,0,3388,1231,308,632,284,661,6518
"09009141600",464,135,1988,963,303,246,378,183,4660
"09009141800",1134,279,771,203,1294,77,258,65,4081
"09009141900",3898,352,58,2,674,113,277,16,5390
"09009142000",1922,311,57,61,541,184,185,42,3303
"09009142100",412,259,294,388,321,131,332,389,2526
"09009142200",1148,163,35,0,174,57,57,31,1665
"09009142300",1410,788,921,363,1369,948,2228,1607,9634
"09009142400",1255,1000,894,635,1771,352,2548,1095,9550
"09009142500",2031,688,1052,341,1207,803,2514,1382,10018
"09009142601",1291,435,1759,652,1266,384,881,322,6990
"09009142603",1698,350,942,33,632,459,1083,510,5707
"09009142604",1557,105,431,119,610,117,1057,164,4160
"09009142700",2891,254,818,826,926,453,1946,613,8727
"09009142800",3549,74,895,0,338,50,144,50,5100
"09009150100",3243,239,0,112,222,20,175,20,4031
"09009150200",2364,350,48,14,629,10,199,249,3863
"09009150300",3575,327,200,0,249,30,446,58,4885
"09009150400",3290,334,84,174,279,0,232,28,4421
"09009150500",3469,235,152,4,130,134,238,22,4384
"09009150600",5625,476,16,0,553,111,406,132,7319
"09009150700",4364,48,11,0,202,0,144,0,4769
"09009150800",3301,139,86,0,312,32,231,0,4101
"09009150900",3409,203,63,30,195,25,126,68,4119
"09009151000",3572,166,7,0,143,8,121,0,4017
"09009151100",6293,113,29,18,324,16,401,13,7207
"09009151200",2659,114,94,3,112,12,123,15,3132
"09009154100",3403,307,1914,481,831,457,1795,323,9511
"09009154200",3018,331,2078,638,597,413,1599,331,9005
"09009154500",2157,563,760,103,261,219,545,241,4849
"09009154600",2514,338,912,160,445,106,614,158,5247
"09009154700",5033,466,105,0,324,34,117,120,6199
"09009154800",4038,184,331,2,257,2,285,2,5101
"09009154900",2885,241,153,52,242,26,770,54,4423
"09009155000",3230,224,1477,18,610,439,743,318,7059
"09009155100",1972,200,416,113,566,37,816,30,4150
"09009157100",2101,121,16,0,292,45,95,1,2671
"09009157200",3118,103,100,0,389,0,204,0,3914
"09009157300",2620,96,43,0,374,0,172,0,3305
"09009157400",3941,142,20,17,349,0,88,0,4557
"09009160100",2928,17,24,0,214,136,143,0,3462
"09009160200",4390,123,49,3,953,16,108,2,5644
"09009161100",4978,195,1,0,359,0,306,0,5839
"09009165100",2450,112,817,204,601,15,703,31,4933
"09009165200",2098,20,44,28,209,15,72,0,2486
"09009165300",2109,102,34,0,158,0,58,0,2461
"09009165400",3150,266,619,146,375,16,147,2,4721
"09009165500",1047,177,2670,348,404,11,611,30,5298
"09009165600",2976,332,1160,232,939,71,1191,262,7163
"09009165700",1725,19,1572,98,372,135,375,73,4369
"09009165801",2724,265,1484,51,1434,47,621,24,6650
"09009165802",2964,71,1266,11,126,27,326,27,4818
"09009165900",5710,563,786,32,406,0,335,0,7832
"09009166001",3924,966,403,157,991,34,300,0,6775
"09009166002",3486,125,263,0,111,2,78,2,4067
"09009167100",6775,239,226,89,644,0,186,21,8180
"09009167201",3452,83,69,0,434,85,182,25,4330
"09009167202",3863,208,127,0,236,37,255,0,4726
"09009167300",6311,184,25,13,677,0,157,0,7367
"09009170100",740,541,132,53,132,215,526,639,2978
"09009170200",939,317,324,86,189,55,703,255,2868
"09009170300",893,279,134,103,238,337,557,543,3084
"09009170400",1103,76,103,10,223,17,235,30,1797
"09009170500",5817,292,231,0,168,0,634,223,7365
"09009170600",1892,242,108,37,223,35,457,122,3116
"09009170700",1813,184,121,31,225,46,459,101,2980
"09009170800",3739,795,451,199,248,133,1192,540,7297
"09009170900",1100,175,269,120,280,161,609,255,2969
"09009171000",846,278,164,125,230,67,450,173,2333
"09009171100",3937,828,315,118,373,80,700,493,6844
"09009171200",6637,411,889,83,515,95,418,78,9126
"09009171300",2544,506,252,41,177,94,593,497,4704
"09009171400",814,236,126,76,377,99,787,256,2771
"09009171500",1535,509,562,86,339,41,1190,453,4715
"09009171600",3217,104,661,88,390,0,445,54,4959
"09009171700",3738,130,248,33,174,0,411,17,4751
"09009175100",2501,177,35,0,205,33,565,1,3517
"09009175200",2052,168,34,0,158,0,576,79,3067
"09009175300",3250,492,47,1,311,0,275,0,4376
"09009175400",3027,399,131,5,474,9,569,108,4722
"09009175500",6214,195,412,0,430,81,191,0,7523
"09009175600",4307,77,116,0,468,0,395,0,5363
"09009175700",2325,147,12,0,71,0,111,32,2698
"09009175800",3352,62,9,0,410,0,260,0,4093
"09009175900",4362,87,43,14,471,3,664,6,5650
"09009176000",6413,115,53,1,312,0,237,0,7131
"09009180100",4969,659,68,0,877,25,693,22,7313
"09009180200",3178,409,534,0,1071,462,775,530,6959
"09009180300",1554,381,93,1,158,117,150,94,2548
"09009180400",2442,80,141,0,170,0,459,0,3292
"09009180500",3734,178,52,0,566,29,589,0,5148
"09009180601",2516,214,3,0,130,14,179,0,3056
"09009180602",3664,121,0,0,70,138,127,138,4258
"09009184100",4415,271,106,27,227,0,186,48,5280
"09009184200",3083,345,154,3,648,51,303,45,4632
"09009184300",3529,109,0,1,129,0,261,0,4029
"09009184400",2914,191,23,0,170,0,24,0,3322
"09009184500",2388,82,0,2,40,0,50,3,2565
"09009184600",2923,156,0,0,13,0,88,0,3180
"09009184700",4793,578,20,4,494,0,68,0,5957
"09009186100",6878,164,79,0,249,0,307,0,7677
"09009186200",6229,354,289,2,64,1,192,45,7176
"09009190100",2736,326,0,4,62,2,130,26,3286
"09009190200",3180,127,1,1,143,1,120,1,3574
"09009190301",6302,172,6,0,520,0,325,0,7325
"09009190302",4545,271,45,4,353,4,114,24,5360
"09009190303",3128,140,25,9,98,0,47,0,3447
"09009194100",4882,244,5,3,167,3,62,0,5366
"09009194201",6554,316,0,13,356,2,94,4,7339
"09009194202",5001,132,45,0,264,8,19,2,5471
"09009341100",5661,248,78,0,82,0,324,0,6393
"09009343101",3386,120,10,5,269,7,37,0,3834
"09009343102",2985,62,0,33,420,0,117,4,3621
"09009343200",5581,67,44,20,970,0,811,0,7493
"09009343300",5608,195,91,16,557,33,300,97,6897
"09009343400",5650,40,51,0,598,16,81,9,6445
"09009344100",4144,207,41,29,353,29,73,13,4889
"09009344200",2451,34,25,0,238,0,93,0,2841
"09009345100",4712,537,605,172,463,91,394,151,7125
"09009345201",5047,619,336,0,564,109,702,109,7486
"09009345202",3261,277,194,0,398,21,440,21,4612
"09009345300",5403,362,464,80,457,3,739,23,7531
"09009345400",5778,443,374,2,526,36,911,168,8238
"09009346101",6109,346,286,0,222,0,281,0,7244
"09009346102",5572,115,42,5,130,0,287,0,6151
"09009347100",5075,63,307,0,130,0,254,0,5829
"09009347200",3561,296,15,0,110,1,46,9,4038
"09009348111",1994,678,21,0,188,0,93,0,2974
"09009348122",3603,236,74,2,181,3,159,16,4274
"09009348123",5353,161,23,1,90,89,189,0,5906
"09009348124",2167,99,0,0,54,0,126,14,2460
"09009348125",3665,370,76,0,425,0,249,0,4785
"09009350100",936,943,336,177,294,535,680,937,4838
"09009350200",935,618,472,648,250,510,984,1048,5465
"09009350300",430,325,433,212,248,255,372,559,2834
"09009350400",488,635,692,340,184,309,446,894,3988
"09009350500",702,588,133,237,468,641,859,1198,4826
"09009350800",2531,1233,678,467,350,356,1694,1232,8541
"09009350900",1053,53,398,236,247,11,551,81,2630
"09009351000",1846,595,891,541,395,64,1087,573,5992
"09009351100",1309,525,999,445,321,420,759,617,5395
"09009351200",1193,588,821,498,621,465,1290,892,6368
"09009351300",3241,693,814,76,1033,96,1683,235,7871
"09009351400",1890,524,563,104,573,518,1580,930,6682
"09009351500",2584,413,709,275,551,416,707,751,6406
"09009351601",2048,288,227,260,248,331,416,408,4226
"09009351602",4392,577,455,88,383,247,469,528,7139
"09009351700",600,867,385,256,450,62,697,558,3875
"09009351800",2709,231,563,33,166,28,232,91,4053
"09009351900",1450,170,140,47,188,73,221,110,2399
"09009352000",3144,142,322,13,1017,119,585,120,5462
"09009352100",2119,383,456,262,423,103,774,371,4891
"09009352200",633,445,617,213,373,270,487,581,3619
"09009352300",1511,734,834,196,153,44,791,605,4868
"09009352400",1689,237,422,111,360,142,952,235,4148
"09009352500",1623,185,477,39,230,18,361,76,3009
"09009352600",3284,489,522,251,871,84,840,337,6678
"09009352701",2055,358,205,21,154,31,652,167,3643
"09009352702",3301,571,1181,73,409,0,956,303,6794
"09009352800",3659,652,621,320,1012,432,1885,754,9335
"09009361100",5851,400,202,0,200,3,339,3,6998
"09009361200",4949,127,258,1,177,0,493,1,6006
"09009361300",3998,186,54,1,157,0,70,0,4466
"09009361401",893,582,82,87,355,90,113,90,2292
"09009361402",163,38,5,0,24,31,5,0,266
"09009361500",2004,376,1063,734,992,217,1872,151,7409
"09009990000",0,0,0,0,0,0,0,0,0
"09011650100",2269,88,0,0,67,30,81,18,2553
"09011660101",3146,26,0,0,51,1,61,1,3286
"09011660102",3966,87,99,0,188,0,35,0,4375
"09011690300",1802,646,1016,368,1312,994,1391,1217,8746
"09011690400",892,297,400,42,356,140,846,363,3336
"09011690500",800,595,404,375,279,351,196,317,3317
"09011690700",611,281,152,14,98,29,211,176,1572
"09011690800",1461,389,437,90,664,218,566,363,4188
"09011690900",3141,242,324,0,511,210,373,210,5011
"09011693300",4250,367,122,2,371,0,197,0,5309
"09011693400",3319,312,66,3,430,68,307,17,4522
"09011693500",3114,144,26,70,119,0,74,14,3561
"09011693600",2631,82,34,14,202,2,47,2,3014
"09011693700",2546,116,37,2,503,0,339,68,3611
"09011695201",4149,400,85,39,245,62,171,94,5245
"09011695202",5380,530,33,0,715,16,507,3,7184
"09011696100",3406,239,180,228,665,113,578,0,5409
"09011696200",3697,61,312,15,721,18,674,0,5498
"09011696300",1983,83,68,0,315,105,186,112,2852
"09011696400",2704,446,807,267,897,584,801,162,6668
"09011696500",1786,420,410,37,465,23,327,26,3494
"09011696600",2581,156,277,120,724,49,309,9,4225
"09011696700",2454,958,703,349,1206,343,568,532,7113
"09011696800",1795,310,456,93,858,316,388,173,4389
"09011697000",2918,544,71,144,1133,246,982,225,6263
"09011700100",3859,154,112,10,520,74,66,0,4795
"09011701100",6017,301,214,0,1264,101,559,152,8608
"09011701200",6033,438,105,0,529,0,249,31,7385
"09011702100",3869,119,62,44,498,0,412,24,5028
"09011702300",1525,197,97,17,300,0,273,88,2497
"09011702400",2425,124,466,22,521,57,147,0,3762
"09011702500",2032,843,618,50,809,151,727,514,5744
"09011702600",1020,35,0,0,86,0,20,0,1161
"09011702700",3534,261,28,48,892,0,446,64,5273
"09011702800",2379,422,216,50,1067,29,437,60,4660
"09011702900",2328,113,1,0,136,16,93,1,2688
"09011703000",3121,196,44,8,122,0,39,0,3530
"09011705101",3926,280,0,0,180,59,122,11,4578
"09011705102",3514,411,93,104,260,77,78,121,4658
"09011705200",3111,179,25,0,83,32,9,0,3439
"09011705300",2958,106,0,0,263,0,234,0,3561
"09011705400",2217,169,0,0,155,0,24,4,2569
"09011707100",4355,310,128,1,445,32,48,79,5398
"09011708100",2318,117,6,0,143,17,71,0,2672
"09011709100",5378,541,121,0,545,14,45,7,6651
"09011709200",4163,683,0,2,318,30,209,202,5607
"09011710100",4152,58,0,0,105,9,42,0,4366
"09011711100",2516,178,32,0,166,72,41,28,3033
"09011712100",1761,96,0,0,48,10,23,7,1945
"09011713100",2363,105,18,11,87,31,86,0,2701
"09011714101",2534,331,27,1,86,7,123,0,3109
"09011714103",7318,179,49,0,244,55,19,0,7864
"09011714104",4739,146,76,0,140,6,105,16,5228
"09011715100",3597,186,59,0,318,0,79,0,4239
"09011716101",3598,107,53,11,296,0,105,0,4170
"09011716102",4100,139,106,7,613,107,401,98,5571
"09011870100",6512,460,46,0,246,14,73,7,7358
"09011870200",4237,265,583,0,647,1,646,15,6394
"09011870300",896,928,617,229,620,295,758,819,5162
"09011870501",2549,84,218,0,1154,59,211,49,4324
"09011870502",1994,102,10,7,163,5,107,15,2403
"09011870701",1900,65,46,0,107,0,127,7,2252
"09011870703",1493,63,0,0,51,47,166,0,1820
"09011870704",3615,196,41,2,274,39,190,19,4376
"09011980000",4,0,0,0,14,0,0,0,18
"09011990100",0,0,0,0,0,0,0,0,0
"09013526101",4284,40,20,0,113,0,41,0,4498
"09013526102",4844,95,40,1,159,0,153,9,5301
"09013528100",2999,84,25,0,109,0,68,0,3285
"09013529100",4430,149,77,14,285,2,169,2,5128
"09013530100",1759,97,56,0,301,2,314,0,2529
"09013530200",4099,553,296,152,305,428,327,349,6509
"09013530301",3583,447,924,159,340,47,326,288,6114
"09013530302",4980,363,55,0,592,0,261,0,6251
"09013530400",2429,267,126,56,478,75,304,49,3784
"09013530500",2953,111,14,0,110,0,93,14,3295
"09013530600",2220,32,166,7,118,4,58,4,2609
"09013533101",8817,181,30,17,169,15,447,32,9708
"09013533102",5230,180,0,12,155,5,75,0,5657
"09013535100",8563,280,62,0,365,50,324,3,9647
"09013535200",5660,120,69,0,604,18,54,0,6525
"09013538100",0,0,0,0,0,0,0,0,0
"09013538201",4686,310,0,17,239,30,73,2,5357
"09013538202",3881,49,32,12,131,0,69,0,4174
"09013840100",4919,810,0,0,206,26,322,0,6283
"09013850100",4957,76,58,0,225,2,174,2,5494
"09013850200",6713,299,8,0,93,7,192,24,7336
"09013860100",4495,230,93,0,635,0,173,0,5626
"09013881100",3273,170,74,0,419,78,340,9,4363
"09013881200",104,126,0,0,10,6,0,0,246
"09013881300",2088,1275,55,0,392,110,60,88,4068
"09013881500",3603,384,197,11,614,78,59,23,4969
"09013890100",3008,815,10,39,229,84,88,184,4457
"09013890201",3273,69,3,0,65,43,49,0,3502
"09013890202",4630,240,41,9,46,43,68,40,5117
"09015800300",1757,805,292,135,488,362,630,1027,5496
"09015800400",2629,202,73,0,803,102,1210,189,5208
"09015800500",4873,952,187,2,472,295,969,705,8455
"09015800600",1525,1252,150,80,676,412,1811,1150,7056
"09015800700",1626,486,119,18,817,195,994,235,4490
"09015815000",2102,76,0,24,48,14,115,8,2387
"09015820000",1667,79,17,0,62,12,49,0,1886
"09015825000",1588,64,4,0,36,0,58,0,1750
"09015830100",3787,307,67,0,39,30,52,2,4284
"09015900100",4356,184,20,0,126,0,10,6,4702
"09015900200",4201,292,0,0,69,10,56,12,4640
"09015901100",7379,225,0,0,241,39,273,0,8157
"09015902200",1631,48,3,4,55,4,16,4,1765
"09015902500",3875,91,36,0,50,0,46,15,4113
"09015903100",6035,687,11,0,228,68,217,18,7264
"09015903200",1964,170,0,6,33,3,13,0,2189
"09015904100",6531,388,59,0,284,11,81,18,7372
"09015904400",3598,386,16,0,172,15,144,0,4331
"09015904500",3940,510,125,96,468,320,136,374,5969
"09015905100",6795,747,0,14,83,0,247,244,8130
"09015906100",4743,244,30,0,64,7,7,0,5095
"09015907100",3880,366,137,2,109,147,44,0,4685
"09015907200",4610,378,224,0,158,0,440,5,5815
"09015907300",4377,217,88,0,284,27,194,0,5187
"09015908100",3107,382,74,0,165,7,85,0,3820
"10001040100",5010,710,422,61,171,92,212,69,6747
"10001040201",3416,391,812,210,324,10,36,87,5286
"10001040202",8947,284,3541,404,919,77,539,168,14879
"10001040203",3275,412,1834,181,55,26,149,0,5932
"10001040501",2088,321,1508,311,389,69,208,166,5060
"10001040502",1094,61,591,74,149,53,184,14,2220
"10001040700",1795,144,1440,395,413,165,253,2,4607
"10001040900",1085,224,212,103,80,69,51,0,1824
"10001041000",2885,760,2092,308,399,79,671,455,7649
"10001041100",2162,366,352,0,522,19,471,67,3959
"10001041200",1842,387,1146,233,860,233,117,100,4918
"10001041300",707,185,435,687,127,90,60,164,2455
"10001041400",1413,221,829,458,513,46,548,61,4089
"10001041500",2229,201,929,557,213,126,51,72,4378
"10001041600",1363,84,257,35,233,17,38,12,2039
"10001041701",4131,193,897,93,564,88,271,0,6237
"10001041702",2789,393,1429,80,230,51,187,7,5166
"10001041801",5440,744,2476,354,827,61,520,66,10488
"10001041802",3276,288,831,299,603,110,454,49,5910
"10001041900",3957,523,348,213,121,17,207,256,5642
"10001042000",2287,394,80,16,135,41,51,1,3005
"10001042100",3030,432,366,22,112,63,176,144,4345
"10001042201",6117,809,1806,522,997,272,717,276,11516
"10001042202",6447,599,1062,254,749,115,259,4,9489
"10001042500",1370,148,1056,310,155,131,407,126,3703
"10001042800",4987,774,807,206,266,73,214,219,7546
"10001042900",3868,316,356,178,165,3,165,13,5064
"10001043000",3521,567,918,149,231,193,158,0,5737
"10001043100",2235,305,128,48,62,5,86,0,2869
"10001043202",2647,432,317,7,90,51,176,7,3727
"10001043300",1501,236,952,168,202,294,145,59,3557
"10001043400",3031,292,760,110,209,93,357,71,4923
"10001990000",0,0,0,0,0,0,0,0,0
"10003000200",1148,53,3474,1169,556,128,447,168,7143
"10003000300",466,27,1718,506,199,19,161,0,3096
"10003000400",1165,150,1061,452,60,13,54,91,3046
"10003000500",340,65,1976,548,111,0,83,20,3143
"10003000601",45,74,2172,426,143,8,81,12,2961
"10003000602",231,115,1851,1004,149,36,91,9,3486
"10003000900",42,15,1363,403,81,17,132,20,2073
"10003001100",2036,305,439,94,131,43,115,75,3238
"10003001200",1296,100,51,0,67,9,150,0,1673
"10003001300",3281,102,69,3,152,0,31,3,3641
"10003001400",1413,138,537,84,85,36,225,96,2614
"10003001500",771,142,622,223,129,45,56,0,1988
"10003001600",280,192,1000,440,150,92,197,110,2461
"10003001902",341,13,827,398,179,14,19,14,1805
"10003002100",88,15,966,732,123,115,99,91,2229
"10003002200",516,134,717,636,616,250,1003,321,4193
"10003002300",513,365,1441,437,472,45,776,363,4412
"10003002400",2371,372,1146,572,236,24,847,151,5719
"10003002500",1719,146,595,168,229,157,598,168,3780
"10003002600",935,137,1394,399,331,733,758,670,5357
"10003002700",792,211,763,363,284,36,473,106,3028
"10003002800",742,158,460,147,114,22,72,21,1736
"10003002900",50,122,1383,1954,17,83,24,177,3810
"10003003002",55,59,937,622,60,73,66,81,1953
"10003010101",1389,338,1450,379,688,114,132,146,4636
"10003010104",2070,176,875,400,282,15,176,24,4018
"10003010200",1346,104,377,25,151,0,108,0,2111
"10003010300",1900,169,755,26,289,35,252,0,3426
"10003010400",3514,183,445,62,331,10,37,2,4584
"10003010502",4529,430,722,117,219,164,199,165,6545
"10003010702",2993,131,1506,166,408,247,306,0,5757
"10003010800",3837,151,353,28,373,81,188,81,5092
"10003010900",2387,63,30,9,68,0,140,0,2697
"10003011000",2614,117,216,3,154,35,135,57,3331
"10003011100",2432,79,182,1,95,0,24,6,2819
"10003011201",1475,103,35,3,504,28,25,0,2173
"10003011202",3199,186,130,10,784,20,143,20,4492
"10003011203",2662,176,926,38,711,0,9,0,4522
"10003011204",2762,55,249,0,156,11,56,12,3301
"10003011205",1802,24,127,1,72,0,57,1,2084
"10003011206",3679,33,280,0,287,8,97,0,4384
"10003011300",1940,37,87,5,119,0,45,0,2233
"10003011400",2710,78,161,0,265,0,48,0,3262
"10003011500",2181,185,69,0,462,38,104,0,3039
"10003011600",2690,161,144,1,389,0,81,0,3466
"10003011700",3635,85,25,1,160,0,103,0,4009
"10003011800",3329,171,24,1,369,0,1,0,3895
"10003011900",2596,225,78,0,473,92,319,186,3969
"10003012000",3183,663,487,77,205,37,476,572,5700
"10003012100",2181,168,83,0,116,0,370,32,2950
"10003012200",2962,794,483,138,132,77,558,638,5782
"10003012300",2026,276,160,64,284,54,659,115,3638
"10003012400",3642,306,212,14,176,61,886,44,5341
"10003012500",4020,219,435,429,272,71,863,23,6332
"10003012600",2138,220,117,2,77,0,444,1,2999
"10003012700",2742,540,471,141,213,37,136,295,4575
"10003012900",2263,552,904,410,293,246,620,721,6009
"10003013000",1526,90,73,5,61,20,66,59,1900
"10003013100",1658,183,29,22,206,20,191,105,2414
"10003013200",1760,111,276,9,397,168,444,220,3385
"10003013300",1499,80,59,0,68,41,128,41,1916
"10003013400",1991,84,98,24,258,25,17,25,2522
"10003013501",5053,90,141,40,629,8,28,0,5989
"10003013503",6096,172,82,5,808,58,90,0,7311
"10003013505",2466,58,153,0,316,0,22,0,3015
"10003013506",3965,0,148,0,461,20,154,0,4748
"10003013604",3326,257,156,0,336,0,190,0,4265
"10003013607",3684,183,469,93,701,21,399,0,5550
"10003013608",1505,113,248,1,110,90,101,87,2255
"10003013610",4762,152,285,20,660,32,495,0,6406
"10003013611",3803,115,749,0,735,33,316,0,5751
"10003013612",4554,42,361,0,1041,0,225,0,6223
"10003013613",4060,93,796,64,645,0,354,0,6012
"10003013614",2406,553,171,2,220,0,975,467,4794
"10003013615",2847,474,102,22,118,274,176,463,4476
"10003013700",2192,470,481,88,324,178,558,429,4720
"10003013800",3169,134,668,16,823,20,402,0,5232
"10003013901",2273,78,573,16,359,21,489,28,3837
"10003013903",3170,121,1157,15,520,0,371,0,5354
"10003013904",4324,292,2039,111,1567,21,553,0,8907
"10003014000",2496,445,1387,133,798,113,494,38,5904
"10003014100",2716,123,1234,167,313,189,288,137,5167
"10003014200",1483,118,172,7,252,25,234,30,2321
"10003014300",3310,292,312,33,231,247,75,0,4500
"10003014402",1844,1169,83,1,448,122,48,267,3982
"10003014403",2588,413,671,247,368,18,325,53,4683
"10003014404",3076,150,239,0,264,90,59,0,3878
"10003014501",508,1460,21,46,66,118,0,91,2310
"10003014502",733,1555,110,150,74,62,44,144,2872
"10003014702",1536,121,140,1,111,0,217,0,2126
"10003014703",2793,329,647,175,834,11,397,12,5198
"10003014705",3125,254,1005,178,264,29,270,0,5125
"10003014706",1317,105,921,291,446,87,377,79,3623
"10003014803",2637,218,512,0,410,18,180,0,3975
"10003014805",6250,96,1632,301,1350,81,447,0,10157
"10003014807",5453,379,1371,118,1270,114,539,19,9263
"10003014808",3167,395,1683,35,790,136,357,97,6660
"10003014809",4993,313,1818,64,607,73,650,52,8570
"10003014810",4883,253,1424,204,555,0,416,0,7735
"10003014903",2204,1045,2202,933,644,225,1019,870,9142
"10003014904",2483,106,1341,36,806,16,302,15,5105
"10003014906",1675,190,1623,253,764,71,411,36,5023
"10003014907",2043,340,1852,137,598,37,536,17,5560
"10003014908",486,151,1243,84,190,39,138,8,2339
"10003014909",2200,433,3003,531,283,89,642,259,7440
"10003015000",2970,434,1755,187,378,0,396,129,6249
"10003015100",2472,164,601,0,154,87,279,123,3880
"10003015200",3018,475,924,382,560,61,892,73,6385
"10003015400",75,9,2079,708,149,45,402,46,3513
"10003015502",594,209,1118,748,222,49,266,11,3217
"10003015600",789,206,1208,145,288,71,640,150,3497
"10003015802",1200,143,390,9,334,81,478,141,2776
"10003015900",1881,287,1082,26,249,143,496,165,4329
"10003016000",1051,142,1222,98,315,240,309,213,3590
"10003016100",1108,68,360,56,143,13,123,0,1871
"10003016200",1969,262,223,38,79,263,232,215,3281
"10003016301",3099,170,924,200,812,0,611,22,5838
"10003016302",2892,72,3099,108,1245,24,630,62,8132
"10003016305",2688,214,3788,594,788,106,163,108,8449
"10003016401",3743,239,1533,42,988,0,189,0,6734
"10003016404",2392,266,464,6,184,0,179,44,3535
"10003016601",8766,363,2139,40,539,16,555,117,12535
"10003016602",5891,133,996,49,451,0,128,0,7648
"10003016604",7805,416,3028,349,968,0,596,160,13322
"10003016608",4004,74,298,15,180,50,60,0,4681
"10003016801",4499,259,1094,26,263,9,124,18,6292
"10003016804",5621,120,1343,101,217,0,181,16,7599
"10003016901",1858,132,78,2,27,0,8,0,2105
"10003016904",1255,80,24,3,0,6,23,0,1391
"10003980100",0,0,0,0,0,0,0,0,0
"10003990100",0,0,0,0,0,0,0,0,0
"10005050101",2632,183,415,173,191,16,96,12,3718
"10005050103",3594,305,210,11,285,3,261,3,4672
"10005050104",2780,364,724,203,181,164,252,300,4968
"10005050105",3483,748,1348,93,239,201,536,464,7112
"10005050200",2150,605,640,184,53,29,141,80,3882
"10005050301",5044,793,985,856,258,111,973,193,9213
"10005050302",3468,361,455,243,216,54,327,148,5272
"10005050401",2874,279,205,397,33,17,11,23,3839
"10005050403",2240,365,583,70,197,97,373,161,4086
"10005050405",3031,273,299,27,177,12,586,0,4405
"10005050406",1760,305,1325,848,27,147,190,171,4773
"10005050407",3010,232,880,521,294,36,182,72,5227
"10005050408",2871,473,646,53,280,50,229,92,4694
"10005050501",2693,129,449,34,395,1,450,0,4151
"10005050503",3145,497,524,170,815,390,2565,747,8853
"10005050504",3398,578,368,133,233,59,739,382,5890
"10005050601",3720,398,449,152,54,138,188,50,5149
"10005050602",3624,813,752,243,350,163,289,338,6572
"10005050701",2429,360,717,144,259,60,240,66,4275
"10005050703",1449,166,151,82,187,59,143,67,2304
"10005050704",3315,275,332,71,157,0,122,0,4272
"10005050705",4031,446,118,0,453,0,110,0,5158
"10005050706",1340,89,0,0,42,0,7,0,1478
"10005050801",2502,206,376,119,79,22,197,35,3536
"10005050802",3853,231,373,66,147,1,187,1,4859
"10005050803",6106,461,403,115,297,57,566,68,8073
"10005050901",2000,170,9,25,138,0,87,0,2429
"10005050902",3739,241,228,1,275,1,55,13,4553
"10005051003",3894,206,354,154,212,41,257,130,5248
"10005051004",3572,322,327,70,270,6,148,9,4724
"10005051005",3904,295,139,2,205,9,85,0,4639
"10005051006",2640,248,20,0,98,0,45,0,3051
"10005051007",4328,407,32,33,91,53,116,0,5060
"10005051101",595,71,0,0,0,0,0,0,666
"10005051102",839,48,6,0,15,4,0,0,912
"10005051103",839,60,0,0,12,0,22,6,939
"10005051201",1250,70,15,0,26,0,93,0,1454
"10005051202",754,27,0,0,0,3,12,0,796
"10005051203",606,42,0,0,20,0,12,0,680
"10005051204",598,37,0,0,2,0,8,2,647
"10005051205",659,19,0,0,5,0,0,0,683
"10005051301",5131,389,13,17,172,26,65,203,6016
"10005051302",2354,547,200,7,18,0,161,221,3508
"10005051303",4826,258,41,1,266,0,102,24,5518
"10005051305",2154,219,47,0,56,0,58,42,2576
"10005051306",2222,201,86,0,103,10,117,24,2763
"10005051400",2709,540,468,93,392,129,971,434,5736
"10005051500",3361,538,819,65,269,41,400,324,5817
"10005051701",3594,223,261,0,84,0,153,0,4315
"10005051702",4358,378,313,0,21,205,122,205,5602
"10005051801",3325,277,269,285,77,0,114,0,4347
"10005051802",1911,475,1205,542,374,196,219,97,5019
"10005051900",3226,425,352,87,160,85,31,161,4527
"10005990000",0,0,0,0,0,0,0,0,0
"11001000100",4600,176,66,0,334,12,488,58,5734
"11001000201",18,10,0,44,0,8,0,10,90
"11001000202",2750,614,110,193,163,73,221,28,4152
"11001000300",4501,648,197,166,456,127,414,0,6509
"11001000400",1187,78,65,24,170,54,254,0,1832
"11001000501",2680,143,128,12,426,66,489,21,3965
"11001000502",2497,63,124,0,289,0,308,0,3281
"11001000600",3450,302,260,69,388,29,430,122,5050
"11001000701",3740,290,142,215,845,13,225,0,5470
"11001000702",2487,292,124,51,292,70,240,0,3556
"11001000801",4408,552,287,60,591,251,365,316,6830
"11001000802",2036,314,342,0,333,128,439,24,3616
"11001000901",3682,191,135,259,318,56,485,89,5215
"11001000902",2168,25,63,3,182,14,343,6,2804
"11001001001",6061,280,100,57,1037,17,737,73,8362
"11001001002",2051,729,136,58,320,203,150,98,3745
"11001001100",3694,111,347,77,503,1,366,10,5109
"11001001200",3776,191,295,13,584,49,280,49,5237
"11001001301",2958,184,388,4,317,61,130,80,4122
"11001001302",5175,527,510,63,1083,233,688,115,8394
"11001001401",2570,170,181,79,368,1,277,28,3674
"11001001402",2323,91,292,65,379,165,299,38,3652
"11001001500",5037,101,581,5,406,0,239,0,6369
"11001001600",1086,12,2750,123,152,25,284,8,4440
"11001001702",1226,27,1263,213,287,33,363,9,3421
"11001001803",374,0,2225,387,931,125,1003,85,5130
"11001001804",734,207,3037,548,884,158,1536,342,7446
"11001001901",641,7,2505,401,428,15,633,15,4645
"11001001902",277,4,1519,177,338,16,428,11,2770
"11001002001",794,49,1107,132,753,13,806,25,3679
"11001002002",856,148,1845,324,674,44,632,180,4703
"11001002101",473,83,3272,598,1239,194,1505,217,7581
"11001002102",535,12,2973,565,498,304,500,290,5677
"11001002201",388,7,2356,266,625,16,519,0,4177
"11001002202",249,42,1727,828,949,179,875,221,5070
"11001002301",766,14,1622,153,488,170,412,79,3704
"11001002302",298,278,562,62,225,0,57,0,1482
"11001002400",941,83,2130,150,822,96,838,143,5203
"11001002501",966,13,899,546,171,48,472,97,3212
"11001002502",1500,191,2271,549,1222,119,1859,297,8008
"11001002600",1285,39,771,41,383,51,242,27,2839
"11001002701",3320,297,548,64,527,494,867,653,6770
"11001002702",4006,227,1075,222,725,45,1659,58,8017
"11001002801",856,315,1313,388,1001,138,998,389,5398
"11001002802",2077,136,591,410,1138,384,1805,423,6964
"11001002900",2120,104,1168,65,924,172,1058,152,5763
"11001003000",1455,147,888,769,265,10,286,31,3851
"11001003100",1043,186,829,122,1123,47,1233,208,4791
"11001003200",1617,195,2149,418,404,200,1117,289,6389
"11001003301",1664,117,1237,132,444,25,277,36,3932
"11001003302",909,56,874,218,271,10,124,10,2472
"11001003400",900,98,1234,331,126,95,301,84,3169
"11001003500",1019,47,1067,551,321,43,383,11,3442
"11001003600",2488,223,1437,296,576,6,558,37,5621
"11001003700",2364,356,1320,524,839,69,1193,273,6938
"11001003800",3279,205,492,235,645,113,743,151,5863
"11001003900",3202,287,348,154,493,0,366,0,4850
"11001004001",3341,141,126,0,455,41,395,57,4556
"11001004002",2478,79,177,0,216,35,221,11,3217
"11001004100",2172,111,111,6,318,41,301,28,3088
"11001004201",2838,128,185,49,425,0,171,15,3811
"11001004202",1953,133,51,14,344,40,188,13,2736
"11001004300",2263,114,673,319,345,6,588,6,4314
"11001004400",3766,319,807,125,355,323,212,207,6114
"11001004600",973,32,1231,350,326,26,223,18,3179
"11001004701",700,101,2305,802,414,156,179,20,4677
"11001004702",1259,94,500,237,200,17,147,10,2464
"11001004801",832,25,868,183,301,6,138,9,2362
"11001004802",1119,26,1055,676,440,203,389,43,3951
"11001004901",1056,63,586,475,401,0,377,30,2988
"11001004902",1337,131,522,87,634,131,494,111,3447
"11001005001",1428,59,195,94,313,22,283,22,2416
"11001005002",2980,389,805,402,1475,0,1202,188,7441
"11001005201",4540,344,175,52,1017,96,700,96,7020
"11001005301",3776,271,136,16,681,102,228,46,5256
"11001005500",4178,751,201,32,848,378,670,73,7131
"11001005600",3377,607,217,102,448,435,403,197,5786
"11001005800",1777,81,57,144,492,230,153,0,2934
"11001005900",1449,97,274,220,495,41,268,26,2870
"11001006202",66,0,51,0,0,0,0,0,117
"11001006400",209,0,938,911,40,32,86,0,2216
"11001006500",2056,80,170,130,132,0,235,23,2826
"11001006600",1662,26,68,0,124,24,73,0,1977
"11001006700",3261,121,476,40,235,0,136,0,4269
"11001006801",682,36,988,147,94,16,46,0,2009
"11001006802",1206,75,679,162,191,14,116,5,2448
"11001006804",0,0,12,119,0,0,0,0,131
"11001006900",1526,17,454,68,116,0,92,0,2273
"11001007000",1706,33,244,74,227,13,197,0,2494
"11001007100",1108,69,1046,682,143,16,56,1,3121
"11001007200",2708,192,708,330,354,0,190,0,4482
"11001007301",2094,68,816,0,305,22,338,22,3665
"11001007304",73,32,1861,1301,39,17,59,0,3382
"11001007401",5,0,946,1489,10,0,22,22,2494
"11001007403",29,14,2332,1094,31,0,31,67,3598
"11001007404",26,1,2201,1527,34,6,0,6,3801
"11001007406",0,0,2094,916,51,0,18,0,3079
"11001007407",23,0,1961,686,49,0,0,0,2719
"11001007408",0,0,1434,1396,24,182,24,19,3079
"11001007409",25,0,2341,1390,0,46,0,0,3802
"11001007502",50,10,2379,2653,13,4,12,0,5121
"11001007503",31,8,1372,1251,21,11,4,11,2709
"11001007504",2,10,1428,1320,0,0,0,0,2760
"11001007601",73,25,3065,936,17,34,20,68,4238
"11001007603",243,19,2740,606,148,194,81,288,4319
"11001007604",155,2,2839,676,94,0,61,0,3827
"11001007605",65,14,2258,961,242,63,10,0,3613
"11001007703",0,0,2751,2460,56,0,39,0,5306
"11001007707",0,0,3085,1213,12,0,70,0,4380
"11001007708",0,0,2106,964,0,0,0,0,3070
"11001007709",31,6,1377,616,127,0,71,38,2266
"11001007803",45,0,2209,711,447,14,388,0,3814
"11001007804",0,0,2000,844,118,22,124,0,3108
"11001007806",35,22,1463,522,29,3,6,3,2083
"11001007807",32,1,1765,480,21,11,32,0,2342
"11001007808",26,3,2890,1263,107,0,121,10,4420
"11001007809",48,19,1957,661,109,0,54,0,2848
"11001007901",774,0,2155,874,110,38,101,14,4066
"11001007903",332,12,892,462,101,10,50,0,1859
"11001008001",1712,34,881,148,336,21,155,0,3287
"11001008002",2133,75,955,181,193,0,130,0,3667
"11001008100",2560,43,372,13,214,0,242,0,3444
"11001008200",2185,182,102,6,199,16,153,37,2880
"11001008301",1767,58,239,13,222,18,189,0,2506
"11001008302",1646,92,300,42,173,14,65,11,2343
"11001008402",1035,44,710,172,150,6,60,6,2183
"11001008410",636,39,533,71,58,4,52,5,1398
"11001008701",785,15,1249,222,23,9,116,28,2447
"11001008702",247,13,1071,424,123,52,130,45,2105
"11001008802",668,123,2579,912,156,150,44,0,4632
"11001008803",95,37,498,643,49,9,78,27,1436
"11001008804",136,64,1330,533,220,133,153,26,2595
"11001008903",252,27,1989,962,85,142,70,138,3665
"11001008904",112,30,1694,717,493,0,370,0,3416
"11001009000",108,50,2352,484,55,0,90,26,3165
"11001009102",342,22,3183,1405,217,34,217,38,5458
"11001009201",509,107,816,215,165,75,88,67,2042
"11001009203",412,99,1527,385,183,0,123,57,2786
"11001009204",227,33,1221,969,193,142,337,96,3218
"11001009301",1106,123,1563,118,281,13,140,45,3389
"11001009302",220,17,560,57,199,0,90,0,1143
"11001009400",714,213,3425,339,131,22,287,40,5171
"11001009501",325,92,2955,509,631,576,829,570,6487
"11001009503",712,23,2178,267,83,0,27,64,3354
"11001009504",570,116,1609,194,481,67,471,60,3568
"11001009505",146,0,1869,245,411,15,327,15,3028
"11001009507",137,7,1306,176,5,0,121,49,1801
"11001009508",367,6,2777,251,390,38,360,38,4227
"11001009509",72,26,2783,124,480,0,421,0,3906
"11001009601",0,2,1209,951,37,0,9,0,2208
"11001009602",16,9,1888,1426,118,0,94,9,3560
"11001009603",0,10,2315,461,192,27,135,0,3140
"11001009604",54,2,1821,197,24,4,46,0,2148
"11001009700",4,5,2027,1282,31,10,4,10,3373
"11001009801",20,2,1196,734,42,105,37,7,2143
"11001009802",0,3,830,813,0,0,7,0,1653
"11001009803",6,0,1484,1229,6,8,0,0,2733
"11001009804",34,17,1710,745,69,203,58,151,2987
"11001009807",63,4,1890,988,11,0,18,4,2978
"11001009810",0,0,1538,1067,51,9,0,9,2674
"11001009811",0,0,3345,1648,25,0,10,0,5028
"11001009901",114,4,2169,241,35,0,34,0,2597
"11001009902",21,0,2362,305,73,0,0,0,2761
"11001009903",46,0,1398,324,60,0,24,0,1852
"11001009904",55,5,1484,776,31,83,25,94,2553
"11001009905",147,2,1870,740,0,1,147,0,2907
"11001009906",16,21,1071,389,24,0,30,9,1560
"11001009907",11,0,1773,1031,15,60,40,49,2979
"11001010100",1611,158,220,57,396,122,286,38,2888
"11001010200",1134,39,945,126,282,11,181,0,2718
"11001010300",474,56,1626,370,381,256,429,255,3847
"11001010400",193,77,2558,1216,93,5,83,25,4250
"11001010500",1443,53,1189,363,370,0,169,0,3587
"11001010600",3275,342,1130,446,492,98,341,85,6209
"11001010700",1031,294,45,13,283,39,120,0,1825
"11001010800",635,276,24,49,206,208,88,43,1529
"11001010900",13,52,2131,1948,28,59,35,30,4296
"11001011000",2151,90,897,37,288,0,199,19,3681
"11001011100",582,62,3514,1002,64,22,296,20,5562
"12001000200",1363,3579,793,285,119,393,272,415,7219
"12001000301",1189,615,833,370,158,155,193,20,3533
"12001000302",1097,487,413,132,403,57,186,117,2892
"12001000400",1348,480,2069,1380,200,211,332,232,6252
"12001000500",2761,1018,216,718,177,82,248,106,5326
"12001000600",199,57,2291,1290,141,58,38,11,4085
"12001000700",1124,268,3932,1521,33,27,124,0,7029
"12001000806",670,643,158,106,162,132,67,178,2116
"12001000808",1578,751,438,386,627,429,233,263,4705
"12001000809",470,154,243,94,116,20,68,9,1174
"12001000901",150,36,19,20,277,173,62,33,770
"12001000902",8,4,0,0,20,2,0,0,34
"12001001000",2928,2713,35,12,143,56,243,565,6695
"12001001100",5622,166,166,332,487,58,461,17,7309
"12001001201",2189,50,212,0,460,42,426,0,3379
"12001001202",4598,373,472,756,561,0,528,53,7341
"12001001203",2003,720,411,133,299,237,235,110,4148
"12001001400",545,353,1139,326,106,70,42,12,2593
"12001001514",413,434,309,72,71,49,55,117,1520
"12001001515",1109,1719,394,566,499,800,142,556,5785
"12001001516",552,530,154,171,181,215,115,95,2013
"12001001517",1239,1557,537,466,66,687,86,465,5103
"12001001519",720,659,193,398,211,549,121,111,2962
"12001001520",493,853,262,66,170,141,241,205,2431
"12001001521",1353,1248,552,304,376,311,320,393,4857
"12001001603",691,455,261,29,64,26,171,41,1738
"12001001604",3069,3291,611,448,507,410,380,504,9220
"12001001701",3705,679,573,614,507,130,532,87,6827
"12001001702",3889,398,240,0,524,69,395,90,5605
"12001001801",5420,415,886,92,150,22,225,72,7282
"12001001802",1439,231,446,219,196,8,44,68,2651
"12001001803",3606,287,799,942,573,0,217,82,6506
"12001001805",1206,87,63,42,69,5,141,8,1621
"12001001806",6598,1075,673,272,434,41,565,176,9834
"12001001811",5135,548,154,53,875,65,925,31,7786
"12001001813",2290,126,153,0,592,0,225,0,3386
"12001001814",2609,57,339,0,323,0,454,0,3782
"12001001902",474,880,625,786,131,0,28,67,2991
"12001001907",1910,585,165,27,67,30,36,137,2957
"12001001908",2824,396,500,80,225,0,64,8,4097
"12001002000",3440,844,924,405,93,62,69,15,5852
"12001002101",1248,210,266,74,92,25,69,15,1999
"12001002102",695,67,98,35,9,0,34,0,938
"12001002201",3313,390,191,294,239,40,167,10,4644
"12001002202",5148,197,402,22,197,0,141,13,6120
"12001002204",7853,237,770,0,2320,0,816,0,11996
"12001002205",7713,650,269,178,1041,64,794,81,10790
"12001002207",2852,54,187,0,475,15,388,0,3971
"12001002208",2278,68,66,0,160,0,248,0,2820
"12001002209",6035,627,456,193,830,54,576,159,8930
"12001002210",2716,368,671,351,192,0,409,0,4707
"12001002217",2087,661,1427,813,239,293,394,250,6164
"12001002218",777,257,674,632,34,9,100,46,2529
"12001002219",3031,604,1129,308,442,88,519,297,6418
"12001002220",1115,183,343,185,149,13,110,41,2139
"12001110800",1442,340,123,24,35,24,111,38,2137
"12003040101",5067,726,350,0,173,17,92,0,6425
"12003040102",4481,1172,691,315,38,0,0,134,6831
"12003040201",3305,1179,911,177,184,33,179,63,6031
"12003040202",4482,644,133,130,8,0,22,22,5441
"12005000201",4131,432,0,0,68,98,58,8,4795
"12005000202",4689,615,110,0,495,22,0,0,5931
"12005000300",5050,1737,0,46,145,138,125,57,7298
"12005000400",7290,773,76,0,213,120,132,108,8712
"12005000500",4295,270,324,0,574,0,434,0,5897
"12005000600",1097,174,14,0,51,8,42,6,1392
"12005000700",1791,163,328,37,446,30,339,10,3144
"12005000803",2903,547,590,405,305,220,198,23,5191
"12005000804",1420,215,351,0,115,0,121,0,2222
"12005000805",2638,667,675,57,432,114,255,0,4838
"12005000806",2624,593,545,0,387,168,266,40,4623
"12005000900",2874,553,570,151,179,74,142,1,4544
"12005001000",901,522,404,296,100,57,62,11,2353
"12005001100",2037,817,541,318,436,258,222,53,4682
"12005001200",1693,476,902,121,210,53,190,42,3687
"12005001301",4453,359,375,11,277,50,220,0,5745
"12005001302",5192,767,806,109,223,108,389,53,7647
"12005001402",5653,564,1079,2,268,0,59,33,7658
"12005001403",1683,174,98,170,37,29,65,0,2256
"12005001404",5428,670,341,52,405,26,328,0,7250
"12005001501",4140,248,548,28,266,35,387,9,5661
"12005001502",4246,556,202,17,273,158,174,72,5698
"12005001600",846,364,1681,857,104,79,120,57,4108
"12005001700",990,244,1309,238,358,108,254,63,3564
"12005001800",718,272,139,127,240,41,12,2,1551
"12005001900",3472,218,32,0,420,22,188,22,4374
"12005002000",941,238,203,50,157,19,7,0,1615
"12005002200",2094,1034,633,414,97,238,371,516,5397
"12005002300",2975,548,288,9,98,120,179,99,4316
"12005002400",2528,1029,171,437,168,101,227,558,5219
"12005002500",2467,206,49,26,281,52,90,24,3195
"12005002601",1813,201,174,53,201,0,161,0,2603
"12005002603",1817,396,6,32,34,0,114,4,2403
"12005002604",5837,676,167,34,150,33,152,0,7049
"12005002605",809,189,12,0,9,0,81,0,1100
"12005002606",1252,276,6,0,108,0,55,10,1707
"12005002607",884,166,4,5,11,0,16,0,1086
"12005002608",2377,14,0,0,80,0,83,0,2554
"12005002701",3351,266,167,0,343,92,284,118,4621
"12005002702",2295,284,14,0,45,11,24,11,2684
"12005002703",2636,217,135,44,269,0,296,0,3597
"12005002704",4408,440,31,31,509,0,350,0,5769
"12005002705",1624,139,69,60,96,7,163,18,2176
"12005990000",0,0,0,0,0,0,0,0,0
"12007000100",2422,749,1170,690,266,7,0,7,5311
"12007000200",4801,719,635,291,43,53,192,56,6790
"12007000300",6263,942,117,314,98,27,161,4,7926
"12007000400",2749,741,326,362,32,1,144,3,4358
"12009060101",2315,375,314,424,209,63,165,0,3865
"12009060102",2835,116,0,0,64,0,13,0,3028
"12009060200",4521,126,606,36,119,119,229,21,5777
"12009060300",3978,403,299,107,200,82,171,78,5318
"12009060400",2394,629,575,346,196,81,280,93,4594
"12009060500",3251,736,660,26,150,48,92,47,5010
"12009060600",2919,605,351,856,211,26,312,13,5293
"12009060700",572,234,632,822,0,284,63,167,2774
"12009061001",3168,525,831,57,491,3,326,15,5416
"12009061002",2035,789,11,120,115,92,114,200,3476
"12009061100",4519,578,316,98,141,41,243,2,5938
"12009061201",5402,348,681,74,506,0,432,0,7443
"12009061202",2761,185,62,0,438,16,262,0,3724
"12009062103",6066,609,528,0,404,0,373,19,7999
"12009062104",5396,643,426,36,320,13,468,101,7403
"12009062106",2030,824,38,82,156,266,51,321,3768
"12009062107",2237,426,11,116,40,10,74,0,2914
"12009062108",4432,357,410,43,457,77,482,30,6288
"12009062109",2579,517,167,69,87,0,120,28,3567
"12009062301",1039,277,1131,895,286,111,153,115,4007
"12009062302",1333,820,455,114,188,153,351,74,3488
"12009062400",3323,1790,621,497,313,142,396,844,7926
"12009062500",2189,511,785,580,165,0,106,162,4498
"12009062600",321,696,1085,908,157,271,243,581,4262
"12009062800",3393,229,75,56,56,127,151,144,4231
"12009062900",2460,278,1393,632,360,0,312,0,5435
"12009063000",3051,207,361,28,513,32,470,0,4662
"12009063102",6732,378,510,178,679,0,424,144,9045
"12009063104",2416,110,692,34,165,0,273,0,3690
"12009063105",6358,360,1073,111,1025,117,1243,123,10410
"12009063106",2931,369,216,73,454,28,313,206,4590
"12009063107",7803,723,221,27,571,63,740,304,10452
"12009064102",4366,36,97,0,341,0,408,0,5248
"12009064123",4652,366,385,0,169,0,405,38,6015
"12009064124",3122,255,391,129,256,40,157,44,4394
"12009064125",4828,446,89,0,515,0,839,100,6817
"12009064126",3961,69,237,13,229,46,133,13,4701
"12009064127",5823,387,43,3,517,3,500,5,7281
"12009064128",10048,829,854,0,789,40,1573,23,14156
"12009064201",1519,287,0,9,145,13,153,25,2151
"12009064202",1984,535,92,84,68,9,282,30,3084
"12009064301",5051,892,382,137,397,80,544,28,7511
"12009064302",3829,588,488,73,776,0,488,70,6312
"12009064400",3975,603,48,99,177,0,453,175,5530
"12009064500",3256,744,24,26,239,169,379,86,4923
"12009064601",5579,542,303,0,134,66,383,3,7010
"12009064602",1857,261,112,12,56,6,165,0,2469
"12009064700",2500,761,183,128,35,53,224,64,3948
"12009064800",1802,398,62,204,123,10,64,25,2688
"12009064901",3871,614,159,19,252,390,438,48,5791
"12009064902",848,564,1186,588,88,111,129,9,3523
"12009065001",2257,189,76,0,213,54,108,0,2897
"12009065021",8549,868,122,0,1227,22,662,82,11532
"12009065022",3854,554,72,0,340,0,364,54,5238
"12009065121",3269,1355,1006,126,691,85,1062,569,8163
"12009065122",3386,974,626,661,784,210,676,395,7712
"12009065123",2185,626,445,169,91,39,144,26,3725
"12009065124",436,127,811,950,33,213,68,59,2697
"12009065125",4485,608,398,240,226,159,596,120,6832
"12009065201",4324,897,111,410,67,68,256,25,6158
"12009065202",3720,544,526,16,159,149,550,174,5838
"12009065231",4612,411,155,290,59,168,83,36,5814
"12009065234",2947,439,27,0,44,24,62,37,3580
"12009065235",3695,991,85,0,0,22,99,0,4892
"12009065236",1251,88,52,0,144,0,32,12,1579
"12009066101",4068,77,0,0,103,0,207,0,4455
"12009066103",1500,145,0,0,18,18,36,19,1736
"12009066104",4739,482,0,0,122,85,411,0,5839
"12009066200",2136,314,35,0,133,0,119,13,2750
"12009066301",5803,706,34,28,201,125,221,47,7165
"12009066302",4006,176,0,10,411,0,380,10,4993
"12009066400",4199,579,0,0,150,103,26,0,5057
"12009066500",2970,308,45,0,136,42,184,46,3731
"12009066600",3756,139,77,0,183,0,146,6,4307
"12009066700",4278,106,188,0,125,0,298,44,5039
"12009066800",1156,116,85,16,115,0,223,22,1733
"12009066900",5820,578,152,2,198,60,272,61,7143
"12009067100",697,53,169,0,209,37,191,25,1381
"12009068101",1868,144,0,0,117,44,11,34,2218
"12009068102",3253,214,0,2,78,0,101,9,3657
"12009068200",2429,150,0,13,67,8,19,0,2686
"12009068300",2501,105,28,0,14,9,7,0,2664
"12009068400",1892,166,29,10,106,7,76,7,2293
"12009068501",1865,164,30,9,20,0,16,0,2104
"12009068502",2010,419,15,0,50,0,174,0,2668
"12009068601",1494,272,138,0,47,12,45,12,2020
"12009068602",3391,576,0,0,102,10,256,0,4335
"12009069100",4370,397,37,15,201,0,262,122,5404
"12009069200",1944,239,0,0,91,13,248,13,2548
"12009069300",2467,407,1,1,128,46,271,15,3336
"12009069400",5210,115,0,0,408,35,175,0,5943
"12009069700",1370,610,153,41,177,0,176,244,2771
"12009069801",2956,262,73,24,240,63,346,0,3964
"12009069802",3356,682,343,117,232,179,185,57,5151
"12009069901",6680,689,13,0,435,36,556,35,8444
"12009069902",2694,489,412,451,208,0,318,127,4699
"12009071100",3176,343,0,0,59,0,76,7,3661
"12009071200",11931,813,258,0,1409,107,1421,173,16112
"12009071301",3673,125,331,11,120,14,325,35,4634
"12009071322",5661,1415,1692,264,486,189,1351,644,11702
"12009071332",6327,1376,2502,793,765,236,1379,414,13792
"12009071334",5997,1134,529,610,363,55,1077,47,9812
"12009071335",3711,216,493,12,84,0,435,29,4980
"12009071336",4074,454,617,228,888,0,946,50,7257
"12009071337",4234,1223,1165,208,457,147,1059,319,8812
"12009071338",5486,582,1908,161,525,32,1162,27,9883
"12009071339",5529,612,1194,258,499,0,1146,58,9296
"12009071340",7736,812,1558,707,688,2,1482,173,13158
"12009071400",2146,728,88,28,58,16,195,77,3336
"12009071500",2238,149,66,47,47,42,168,10,2767
"12009071600",3036,771,176,0,172,24,201,0,4380
"12009980000",0,0,0,0,0,0,0,0,0
"12009980100",0,0,0,0,0,0,0,0,0
"12009990000",0,0,0,0,0,0,0,0,0
"12011010102",2675,201,26,0,46,3,348,32,3331
"12011010103",2921,373,7,3,45,28,192,80,3649
"12011010104",1815,149,0,9,0,0,95,11,2079
"12011010200",4466,609,398,16,325,68,945,155,6982
"12011010304",753,304,1827,915,119,26,466,163,4573
"12011010305",2303,484,970,399,168,103,851,308,5586
"12011010306",569,56,1084,467,209,16,269,0,2670
"12011010307",1203,296,1636,1108,281,102,350,109,5085
"12011010308",3358,571,361,46,205,12,311,48,4912
"12011010401",3813,406,288,29,302,98,934,61,5931
"12011010402",2640,393,222,71,153,86,599,52,4216
"12011010403",4121,831,0,15,15,11,277,29,5299
"12011010405",3570,923,1333,352,541,101,746,458,8024
"12011010406",3118,229,284,42,608,29,824,57,5191
"12011010407",3880,461,404,34,191,50,713,30,5763
"12011010502",2369,251,303,0,242,188,306,166,3825
"12011010503",11332,347,401,55,1274,0,2616,109,16134
"12011010504",4665,318,396,0,742,0,701,178,7000
"12011010601",6745,123,264,68,1288,0,1206,0,9694
"12011010603",3828,296,549,9,590,6,1002,91,6371
"12011010604",2850,162,699,97,313,14,966,31,5132
"12011010605",4843,112,507,0,593,17,1128,0,7200
"12011010606",4894,473,1133,53,765,23,1888,372,9601
"12011010607",7548,186,1298,324,1123,52,2784,148,13463
"12011010609",2435,273,379,63,544,0,555,74,4323
"12011010610",4433,778,439,19,279,97,1153,544,7742
"12011010611",2714,167,434,88,669,23,1064,47,5206
"12011010612",4747,138,628,19,815,0,1329,98,7774
"12011010701",2301,468,1920,408,134,115,770,194,6310
"12011010702",1990,469,4129,1570,265,112,1375,161,10071
"12011010800",3798,477,842,1152,721,133,1956,225,9304
"12011010901",2162,142,59,0,6,39,177,39,2624
"12011010902",2491,158,36,0,105,16,327,6,3139
"12011011000",1465,49,9,0,41,0,157,14,1735
"12011020101",4681,508,1352,33,1669,39,2738,204,11224
"12011020103",3491,294,623,452,708,93,1419,208,7288
"12011020104",1189,266,691,69,174,25,313,94,2821
"12011020204",3472,522,938,236,407,98,999,90,6762
"12011020205",3283,314,1638,170,996,85,1099,131,7716
"12011020206",2165,588,888,262,667,110,799,120,5599
"12011020207",3598,308,1656,72,194,96,1217,105,7246
"12011020209",1613,245,337,104,499,81,1086,70,4035
"12011020210",4429,501,1101,154,220,30,1024,29,7488
"12011020211",2081,232,314,30,56,5,702,17,3437
"12011020212",1965,452,706,66,95,64,392,250,3990
"12011020302",3802,619,1106,607,555,41,1439,352,8521
"12011020308",1987,242,2232,796,570,186,924,261,7198
"12011020309",3910,521,894,111,514,16,1446,153,7565
"12011020311",1907,343,653,162,202,60,318,96,3741
"12011020312",3447,356,822,0,712,121,1193,187,6838
"12011020313",2950,501,1668,528,642,254,1487,283,8313
"12011020314",2614,428,1366,186,518,41,1167,288,6608
"12011020315",3782,304,767,295,391,19,1288,219,7065
"12011020316",2320,423,968,6,429,188,855,499,5688
"12011020317",2303,179,499,138,183,45,788,154,4289
"12011020318",6828,384,1075,200,1033,21,1863,315,11719
"12011020319",5149,325,561,175,283,16,1502,151,8162
"12011020320",3734,171,551,167,319,29,1350,143,6464
"12011020321",1670,16,178,0,16,0,243,2,2125
"12011020322",2153,28,154,173,558,0,858,0,3924
"12011020323",2143,321,583,158,268,209,982,337,5001
"12011020324",3514,180,1778,60,919,142,2686,35,9314
"12011020325",1825,119,777,99,459,31,838,60,4208
"12011020326",2560,257,2222,652,934,212,2071,184,9092
"12011020404",1549,139,4520,829,753,107,889,160,8946
"12011020405",1923,420,1401,652,319,135,1355,372,6577
"12011020406",4682,599,1802,423,542,18,2583,378,11027
"12011020407",1874,464,3406,1039,871,184,1166,341,9345
"12011020409",6030,711,981,0,120,0,1300,129,9271
"12011020411",4854,389,1242,100,267,0,1486,294,8632
"12011020412",648,311,1544,859,283,30,872,394,4941
"12011020413",1813,441,3357,1018,548,27,1181,316,8701
"12011020414",2925,414,407,69,109,0,1318,327,5569
"12011020415",2456,201,404,257,361,21,925,68,4693
"12011020501",1909,219,2294,227,620,79,1261,88,6697
"12011020502",2184,190,3006,811,482,387,1103,337,8500
"12011030100",4077,79,94,51,358,0,374,0,5033
"12011030201",1991,791,673,519,144,64,786,353,5321
"12011030202",869,68,317,306,71,19,152,0,1802
"12011030203",2661,710,619,249,190,0,751,240,5420
"12011030301",737,467,925,399,72,21,445,375,3441
"12011030302",2558,408,3098,1571,63,0,846,64,8608
"12011030401",95,81,2495,1049,40,0,40,58,3858
"12011030402",90,261,1738,1638,90,105,163,329,4414
"12011030500",1044,614,1945,1058,317,42,846,474,6340
"12011030600",657,418,3366,1017,161,7,409,163,6198
"12011030702",2580,69,471,31,234,34,738,44,4201
"12011030703",3147,306,683,0,330,62,743,27,5298
"12011030704",3994,303,402,0,335,32,420,58,5544
"12011030705",3082,369,58,33,0,10,196,0,3748
"12011030801",2583,1541,1431,884,690,263,1459,1472,10323
"12011030802",4646,649,522,17,759,117,1166,260,8136
"12011030902",2383,407,297,108,86,6,111,0,3398
"12011030903",2171,779,168,245,184,192,356,500,4595
"12011030904",4034,529,15,102,207,11,480,25,5403
"12011031001",1662,298,50,98,232,18,301,36,2695
"12011031002",3555,600,109,52,105,69,696,103,5289
"12011031101",2000,219,0,203,28,0,148,45,2643
"12011031102",2468,287,186,34,69,86,334,24,3488
"12011031202",5128,534,87,0,132,48,454,46,6429
"12011031203",921,35,11,0,41,0,15,0,1023
"12011031204",1711,400,0,0,25,0,119,24,2279
"12011031205",1413,71,21,0,62,20,118,0,1705
"12011040101",1267,159,0,0,137,0,119,0,1682
"12011040102",2657,238,66,0,41,0,269,0,3271
"12011040203",1454,182,0,0,103,0,213,45,1997
"12011040204",2296,181,87,0,47,41,319,13,2984
"12011040205",4196,209,200,131,202,23,845,16,5822
"12011040206",2098,222,97,0,171,0,466,0,3054
"12011040300",3018,443,120,59,216,36,450,198,4540
"12011040401",2165,85,43,0,64,22,229,0,2608
"12011040402",2454,247,45,29,112,18,330,133,3368
"12011040502",3036,135,0,1,54,0,97,15,3338
"12011040503",1919,171,123,15,0,0,134,18,2380
"12011040504",3038,215,0,0,144,0,239,0,3636
"12011040601",2741,431,0,0,306,17,358,0,3853
"12011040602",2653,129,7,13,188,6,183,21,3200
"12011040701",2148,175,93,24,141,125,360,91,3157
"12011040702",2735,299,305,96,285,258,606,190,4774
"12011040801",1128,395,2369,1836,74,35,145,162,6144
"12011040802",1938,683,1234,603,253,57,420,116,5304
"12011040901",104,16,2982,1667,75,42,88,16,4990
"12011040902",154,9,2474,873,125,2,177,0,3814
"12011041000",28,12,2138,854,4,42,17,11,3106
"12011041100",83,9,3360,1066,85,3,272,4,4882
"12011041200",192,46,3012,1339,0,183,129,21,4922
"12011041300",106,471,5678,1272,83,38,99,471,8218
"12011041400",27,81,1642,1554,6,0,32,63,3405
"12011041500",85,102,1854,1491,70,75,76,138,3891
"12011041600",681,116,3346,1367,428,53,489,0,6480
"12011041700",704,445,1023,1628,70,49,376,207,4502
"12011041801",1287,195,28,34,112,11,163,52,1882
"12011041802",2397,347,65,41,258,0,422,43,3573
"12011041900",2682,228,126,45,108,0,545,0,3734
"12011042000",2903,237,24,0,71,9,316,58,3618
"12011042100",2231,372,56,52,134,20,434,0,3299
"12011042200",2638,210,14,0,148,0,131,20,3161
"12011042301",2800,297,118,0,131,65,301,66,3778
"12011042302",809,341,137,278,41,0,376,92,2074
"12011042400",1165,55,27,0,30,0,80,0,1357
"12011042500",3792,718,589,109,415,139,670,257,6689
"12011042600",3475,641,456,288,150,39,509,129,5687
"12011042700",2573,614,927,1118,409,66,1089,344,7140
"12011042800",1149,1492,4216,1287,257,0,867,1183,10451
"12011042900",743,286,5152,1828,348,24,468,122,8971
"12011043001",1175,69,0,0,24,11,179,11,1469
"12011043002",4732,1150,1309,109,172,85,2527,1009,11093
"12011043100",3670,703,466,2,367,151,1043,552,6954
"12011043301",3659,598,330,2,157,84,994,272,6096
"12011043302",988,343,216,243,30,5,280,219,2324
"12011050100",2621,530,69,7,891,603,1704,831,7256
"12011050204",3443,601,1016,263,334,63,975,173,6868
"12011050205",2477,365,94,0,58,0,465,99,3558
"12011050206",2049,264,607,241,110,0,535,30,3836
"12011050207",1976,557,2241,866,390,331,757,102,7220
"12011050208",1410,602,1050,425,418,211,954,787,5857
"12011050301",679,41,5706,1604,196,302,420,0,8948
"12011050306",221,249,2880,744,199,73,207,228,4801
"12011050307",519,181,3699,1776,79,95,254,223,6826
"12011050308",35,30,2007,907,7,23,17,0,3026
"12011050309",904,264,875,227,201,55,912,321,3759
"12011050310",1508,279,4086,288,77,86,473,43,6840
"12011050311",697,185,1503,646,113,3,234,28,3409
"12011050312",413,135,1201,308,161,36,347,12,2613
"12011050401",1685,459,1224,171,369,21,480,277,4686
"12011050402",2361,603,802,67,351,62,688,132,5066
"12011050501",2666,440,367,48,369,33,1190,272,5385
"12011050502",2821,277,683,339,583,230,1315,134,6382
"12011050601",2712,154,105,95,206,120,579,49,4020
"12011050602",1845,449,381,368,263,138,734,192,4370
"12011050701",1470,349,990,592,403,72,737,280,4893
"12011050702",2237,796,1597,676,392,82,1461,610,7851
"12011050800",278,86,2935,923,126,69,263,4,4684
"12011050900",3341,295,1104,217,570,22,995,21,6565
"12011051001",2587,588,369,0,50,0,278,248,4120
"12011051002",2314,241,55,14,77,0,186,8,2895
"12011060105",2813,397,2225,575,592,66,1369,176,8213
"12011060107",1247,207,1137,178,306,0,901,143,4119
"12011060109",1624,120,879,52,100,5,352,57,3189
"12011060111",3451,405,1709,96,449,119,1412,79,7720
"12011060112",3531,623,1138,114,465,64,1427,510,7872
"12011060113",3216,603,1328,436,438,10,1035,235,7301
"12011060114",2602,256,2873,106,740,134,1125,131,7967
"12011060115",4207,154,1831,70,554,0,2480,133,9429
"12011060116",3599,250,2649,291,797,34,2194,45,9859
"12011060117",2958,803,2340,397,584,0,1825,473,9380
"12011060118",3779,272,623,16,387,16,1416,78,6587
"12011060119",3415,348,1083,1,547,20,1410,269,7093
"12011060120",4774,302,1299,15,959,129,2660,125,10263
"12011060121",3913,179,615,39,411,21,982,72,6232
"12011060122",3079,181,803,0,604,153,1819,128,6767
"12011060123",1083,194,1600,246,148,0,320,21,3612
"12011060124",1227,223,3062,594,207,54,655,228,6250
"12011060125",605,158,1313,124,186,10,257,32,2685
"12011060126",1218,66,3117,621,700,0,365,19,6106
"12011060127",1009,59,919,1059,175,0,470,65,3756
"12011060128",2157,209,2758,418,358,55,1095,98,7148
"12011060203",179,157,3724,1378,174,171,169,73,6025
"12011060206",2172,420,671,501,504,82,1168,260,5778
"12011060207",1610,269,984,162,397,19,943,117,4501
"12011060208",840,212,3344,960,149,22,376,139,6042
"12011060209",698,107,1425,328,129,16,334,91,3128
"12011060210",1931,265,569,24,534,19,782,90,4214
"12011060211",3402,331,461,23,218,44,1061,145,5685
"12011060212",2099,82,513,477,121,0,1151,61,4504
"12011060213",2572,562,383,53,318,86,1132,326,5432
"12011060302",216,225,3517,2681,278,42,170,114,7243
"12011060303",110,0,4578,2058,67,36,84,36,6969
"12011060304",147,32,1845,1316,86,7,34,28,3495
"12011060305",462,76,1252,292,155,5,308,32,2582
"12011060306",640,222,511,91,154,22,179,138,1957
"12011060401",483,68,2718,1100,121,0,113,8,4611
"12011060402",146,114,4453,1487,218,32,246,59,6755
"12011060403",330,141,3711,552,373,13,398,51,5569
"12011060501",2901,676,2144,484,399,120,1162,602,8488
"12011060503",3360,72,627,132,445,118,755,118,5627
"12011060504",3809,216,374,0,218,0,991,32,5640
"12011060505",3094,299,748,29,201,62,1035,77,5545
"12011060603",2982,267,590,35,692,101,1257,226,6150
"12011060605",2128,273,748,63,434,26,789,112,4573
"12011060606",2824,256,1419,209,348,41,970,71,6138
"12011060607",2301,161,552,40,200,16,522,55,3847
"12011060608",4435,1527,918,44,762,17,2056,116,9875
"12011060609",2264,208,471,27,175,44,800,144,4133
"12011060700",2076,158,617,111,92,0,332,21,3407
"12011060801",1495,99,70,101,232,45,156,12,2210
"12011060802",911,129,3659,1216,308,200,822,91,7336
"12011060900",3359,197,630,22,344,63,840,42,5497
"12011061001",5058,248,442,30,514,45,1099,28,7464
"12011061002",7125,310,571,112,831,139,2203,137,11428
"12011061100",4272,1405,778,356,648,414,3549,1541,12963
"12011070101",4533,1414,721,593,975,476,2168,769,11649
"12011070102",970,80,79,0,85,0,236,59,1509
"12011070204",2460,715,485,138,235,266,853,179,5331
"12011070205",4633,362,188,8,481,177,1854,109,7812
"12011070207",4793,644,152,101,262,0,1331,326,7609
"12011070208",6042,692,168,15,947,187,2124,183,10358
"12011070209",4679,63,43,0,511,0,805,0,6101
"12011070210",2376,325,255,101,306,14,822,92,4291
"12011070211",4313,320,383,103,450,80,1238,66,6953
"12011070304",6472,177,510,267,1123,21,3442,38,12050
"12011070305",5570,887,148,22,950,235,3464,372,11648
"12011070306",5451,150,964,110,823,19,1889,0,9406
"12011070310",2643,221,8,0,483,12,1567,191,5125
"12011070311",4850,253,283,123,885,67,2786,208,9455
"12011070312",6761,277,110,0,660,42,3152,231,11233
"12011070313",8502,295,408,0,1199,0,4965,267,15636
"12011070314",3967,321,292,4,512,16,2347,107,7566
"12011070315",4123,110,610,55,904,68,1868,88,7826
"12011070316",3362,172,806,8,669,0,1117,10,6144
"12011070317",11434,1373,952,193,1519,195,7563,1160,24389
"12011070318",5994,264,283,34,103,0,2489,168,9335
"12011070319",3680,200,101,0,564,67,1773,80,6465
"12011070320",6368,291,211,0,499,125,3653,164,11311
"12011070321",2010,264,169,0,172,103,1123,212,4053
"12011070322",5081,649,222,15,627,105,3957,577,11233
"12011070401",5072,195,326,0,904,213,2186,303,9199
"12011070402",2674,84,179,7,319,0,779,12,4054
"12011070403",3938,429,309,4,859,25,1578,176,7318
"12011070404",2714,268,22,0,343,0,589,23,3959
"12011070405",3978,114,364,0,1111,104,1513,68,7252
"12011070501",4752,66,285,60,609,0,1196,30,6998
"12011070502",5229,708,1576,615,2152,282,4324,541,15427
"12011070601",3365,712,190,38,418,292,1576,438,7029
"12011070602",2849,594,422,34,275,132,1107,329,5742
"12011080101",3728,416,321,47,240,20,722,0,5494
"12011080102",2402,637,758,539,207,81,1133,166,5923
"12011080103",1270,121,139,7,25,13,717,41,2333
"12011080200",813,124,15,0,41,5,269,11,1278
"12011080402",1855,556,92,24,70,6,329,217,3149
"12011080403",2942,1109,955,111,1079,90,1411,408,8105
"12011080405",1803,299,256,251,174,0,663,100,3546
"12011080406",4449,700,490,39,569,201,1774,256,8478
"12011080500",1043,585,2509,2930,241,200,405,490,8403
"12011090101",5376,734,0,0,201,0,1086,61,7458
"12011090102",1188,244,20,0,7,0,203,21,1683
"12011090200",3644,217,35,0,208,39,707,50,4900
"12011090301",1102,383,145,131,188,87,249,50,2335
"12011090302",4370,1009,615,351,562,340,1809,395,9451
"12011090401",2680,382,438,172,247,33,1078,155,5185
"12011090403",1524,465,1017,245,213,0,758,165,4387
"12011090404",2649,778,735,521,481,197,1128,158,6647
"12011090502",5443,615,497,87,189,0,1383,271,8485
"12011090503",2309,163,43,0,78,0,47,0,2640
"12011090504",1354,468,293,25,410,335,615,566,4066
"12011090601",1720,276,228,23,775,54,1163,214,4453
"12011090602",4332,541,400,17,465,300,2165,394,8614
"12011090700",4328,590,1199,208,905,150,2960,417,10757
"12011090801",2843,450,502,41,182,99,985,416,5518
"12011090802",3319,298,334,54,217,190,1257,183,5852
"12011090900",4455,368,386,15,476,10,1156,65,6931
"12011091000",3387,239,303,44,276,13,1452,79,5793
"12011091100",2927,895,1330,401,1187,177,2567,703,10187
"12011091201",2779,415,642,107,715,166,2333,449,7606
"12011091202",2810,439,559,34,1290,198,2707,381,8418
"12011091300",2650,260,450,161,744,17,2239,225,6746
"12011091400",2562,353,1484,558,853,90,1923,306,8129
"12011091500",1844,266,2108,342,373,122,1244,294,6593
"12011091600",3582,412,956,74,723,32,2000,116,7895
"12011091701",2034,431,594,211,226,41,990,203,4730
"12011091702",2415,382,855,379,157,103,988,160,5439
"12011091801",2049,472,1879,609,463,54,1143,352,7021
"12011091802",1187,266,1038,617,153,19,598,179,4057
"12011091901",2792,410,252,22,229,58,671,88,4522
"12011091902",2864,835,506,81,435,287,1241,311,6560
"12011092000",3320,181,22,0,203,0,943,34,4703
"12011100101",6304,736,185,8,210,58,1546,148,9195
"12011100103",2954,523,105,91,162,15,1049,114,5013
"12011100104",2524,268,39,0,93,44,950,44,3962
"12011100105",1639,401,74,8,32,0,355,38,2547
"12011100201",714,379,112,75,125,3,387,217,2012
"12011100202",3486,842,173,118,190,103,1312,739,6963
"12011100300",3827,678,1060,1212,340,46,2272,726,10161
"12011100400",1224,307,2034,1345,357,9,1164,230,6670
"12011100501",423,84,207,21,18,53,291,71,1168
"12011100502",1889,1253,302,112,231,177,992,1038,5994
"12011100600",2350,573,1531,282,811,190,1780,414,7931
"12011100700",302,128,3506,1350,74,56,172,54,5642
"12011100801",634,409,1740,482,177,67,477,148,4134
"12011100802",2086,481,4105,891,431,55,1005,327,9381
"12011110100",4453,358,1512,367,746,85,2413,295,10229
"12011110301",5211,132,724,22,917,0,3824,97,10927
"12011110302",6334,498,1662,41,585,86,3411,314,12931
"12011110303",3144,134,449,0,503,39,1780,125,6174
"12011110307",4117,409,338,2,861,3,2297,352,8379
"12011110308",3924,992,1140,128,463,93,1654,1041,9435
"12011110309",4551,305,876,3,710,117,2486,251,9299
"12011110311",4495,71,1619,4,954,190,3093,23,10449
"12011110312",4476,585,1654,98,1107,37,3180,274,11411
"12011110313",3124,488,1210,99,658,280,2634,530,9023
"12011110319",1144,61,3401,144,625,46,1225,86,6732
"12011110320",1647,434,6572,1037,1021,115,1978,628,13432
"12011110321",3885,87,895,196,396,20,3016,100,8595
"12011110322",5929,565,3546,19,735,59,5253,606,16712
"12011110323",980,196,3494,705,589,126,893,355,7338
"12011110324",9666,195,4695,21,2459,165,8437,195,25833
"12011110325",14296,271,5583,70,3482,223,11939,121,35985
"12011110326",3014,220,893,78,706,4,1969,150,7034
"12011110327",4486,368,978,36,958,122,3000,109,10057
"12011110328",3236,230,1321,0,747,94,1967,193,7788
"12011110330",2249,109,692,0,624,0,1691,56,5421
"12011110331",7233,344,1635,0,1659,51,4404,115,15441
"12011110332",3385,46,885,10,530,27,1838,25,6746
"12011110333",4485,113,1068,0,1202,197,3324,199,10588
"12011110334",2171,148,109,7,149,16,1041,126,3767
"12011110335",4989,1825,406,76,211,123,2257,1522,11409
"12011110336",3422,278,1802,236,1348,77,2692,248,10103
"12011110337",3062,125,2106,281,723,111,2536,124,9068
"12011110338",2064,96,809,21,567,68,1897,115,5637
"12011110339",2586,240,521,14,235,89,1508,110,5303
"12011110340",2664,267,1936,364,1003,49,1730,42,8055
"12011110341",670,220,1641,260,302,0,670,131,3894
"12011110342",3958,223,5288,476,1460,115,3888,160,15568
"12011110343",4883,494,1481,0,1611,94,3869,367,12799
"12011110402",525,106,3711,542,381,112,365,109,5851
"12011110403",1639,408,2536,622,791,178,1364,473,8011
"12011110404",1528,335,3548,729,424,79,1420,458,8521
"12011110501",898,310,1821,516,223,14,785,328,4895
"12011110502",1237,20,3106,798,176,48,908,31,6324
"12011110600",3888,813,310,1,305,370,1323,553,7563
"12011980000",0,0,0,0,0,0,0,0,0
"12011990000",0,0,0,0,0,0,0,0,0
"12013010100",1870,322,105,5,31,21,13,9,2376
"12013010200",3195,449,0,0,70,25,102,0,3841
"12013010300",3611,1307,819,234,374,44,61,288,6738
"12015010100",2741,362,0,1,86,113,262,58,3623
"12015010200",3423,581,0,0,225,49,193,0,4471
"12015010301",2753,285,9,0,163,0,167,0,3377
"12015010302",1510,767,494,22,116,258,25,210,3402
"12015010401",2737,201,20,10,36,0,18,0,3022
"12015010402",2049,320,45,0,14,25,8,0,2461
"12015010403",1669,62,14,19,34,0,60,13,1871
"12015010404",4325,44,0,0,105,0,182,0,4656
"12015010501",3753,533,0,2,0,0,215,242,4745
"12015010502",5639,481,1,126,259,49,366,30,6951
"12015020101",5810,890,658,42,235,20,630,50,8335
"12015020103",4413,603,488,0,159,0,206,181,6050
"12015020104",2056,79,165,0,32,0,24,0,2356
"12015020201",5349,561,1191,150,129,17,470,166,8033
"12015020202",4893,955,441,50,112,0,447,10,6908
"12015020301",4086,568,485,0,213,46,87,93,5578
"12015020302",2535,374,314,73,402,81,464,40,4283
"12015020303",3914,467,347,30,59,25,469,132,5443
"12015020400",6889,545,365,66,381,66,274,66,8652
"12015020501",4304,241,188,1,155,0,364,0,5253
"12015020502",1272,77,0,0,212,43,161,43,1808
"12015020601",1917,410,24,121,41,0,249,143,2905
"12015020602",1789,418,428,34,57,62,100,122,3010
"12015020700",2553,878,108,233,620,73,266,0,4731
"12015020800",2757,1055,210,103,166,61,356,216,4924
"12015020900",5206,800,484,67,411,0,486,33,7487
"12015021001",1360,153,42,17,31,5,109,5,1722
"12015021002",2760,120,46,2,153,0,190,2,3273
"12015021003",1902,387,427,16,91,0,113,150,3086
"12015030100",5385,1023,0,0,27,6,206,98,6745
"12015030200",6312,1007,0,0,297,95,464,77,8252
"12015030301",2307,226,0,0,33,12,82,31,2691
"12015030302",3118,285,0,0,81,21,124,6,3635
"12015030401",1643,442,10,49,0,0,7,195,2346
"12015030402",1699,166,0,0,12,13,0,13,1903
"12015030501",3287,141,30,1,21,0,28,0,3508
"12015030502",4591,348,0,0,53,0,85,0,5077
"12015030503",5360,530,17,0,14,0,66,0,5987
"12015990000",0,0,0,0,0,0,0,0,0
"12017450101",5109,1005,218,132,88,0,299,22,6873
"12017450102",2958,731,38,0,55,50,146,52,4030
"12017450201",2382,779,163,0,230,44,277,47,3922
"12017450202",3009,1746,132,26,75,0,286,277,5551
"12017450302",7119,964,262,153,161,36,599,197,9491
"12017450303",3834,1302,45,100,319,51,335,38,6024
"12017450304",8506,983,362,0,409,0,488,0,10748
"12017450400",4416,844,86,17,54,125,45,0,5587
"12017450500",3044,709,0,23,192,0,149,59,4176
"12017450601",3321,1151,11,0,189,11,24,105,4812
"12017450602",2987,436,172,116,100,78,60,0,3949
"12017450701",5292,489,297,0,587,0,194,17,6876
"12017450702",6508,1255,233,339,330,0,551,139,9355
"12017450800",3393,891,149,0,43,62,222,0,4760
"12017450901",2448,438,0,7,10,47,20,124,3094
"12017450902",1817,405,48,113,106,0,19,5,2513
"12017451000",4235,936,206,0,238,14,269,168,6066
"12017451101",1843,141,21,16,29,5,132,38,2225
"12017451102",4622,964,42,103,219,0,69,96,6115
"12017451200",3002,630,24,0,161,0,65,62,3944
"12017451300",2525,460,47,12,27,0,198,46,3315
"12017451400",3088,836,0,0,34,0,41,202,4201
"12017451501",2239,422,0,0,15,21,172,5,2874
"12017451502",4233,1992,0,6,383,77,2,96,6789
"12017451601",4908,197,53,0,74,35,148,0,5415
"12017451602",6130,464,0,35,124,106,180,35,7074
"12017451700",3186,749,0,24,72,0,64,0,4095
"12017990000",0,0,0,0,0,0,0,0,0
"12019030102",5799,1721,265,133,348,0,22,115,8403
"12019030103",4334,969,0,0,128,15,199,43,5688
"12019030104",2505,662,35,0,165,26,172,25,3590
"12019030201",9373,638,2443,227,1939,343,1095,228,16286
"12019030202",6764,691,710,99,460,212,819,205,9960
"12019030203",10584,461,2521,571,2849,84,2054,84,19208
"12019030301",5580,370,1306,52,724,63,851,74,9020
"12019030303",1663,174,274,41,340,79,401,9,2981
"12019030304",2556,426,694,19,479,31,519,37,4761
"12019030400",1232,243,320,338,81,99,392,115,2820
"12019030500",1530,176,275,64,518,0,290,0,2853
"12019030600",3313,377,524,13,374,61,127,30,4819
"12019030701",7525,157,27,19,86,12,554,0,8380
"12019030702",10894,950,1057,177,1611,30,1723,49,16491
"12019030703",10588,221,453,135,849,97,857,145,13345
"12019030801",4763,374,250,19,189,24,517,0,6136
"12019030802",5317,559,477,27,238,39,132,95,6884
"12019030902",6876,744,1145,240,973,85,958,164,11185
"12019030903",2719,709,169,74,295,185,345,170,4666
"12019030904",4864,193,1091,30,624,10,746,0,7558
"12019031101",2464,277,29,0,105,0,57,0,2932
"12019031104",3324,331,6,85,61,0,215,0,4022
"12019031105",1373,530,6,0,52,5,66,5,2037
"12019031106",5229,1363,25,0,109,0,122,0,6848
"12019031107",358,5,0,0,0,0,0,0,363
"12019031108",1205,149,47,0,12,0,0,8,1421
"12019031200",11470,1379,1029,43,375,54,1300,19,15669
"12019031300",5083,240,248,76,129,0,388,27,6191
"12019031400",2582,700,857,229,252,43,539,135,5337
"12019031500",2434,474,11,0,108,9,86,42,3164
"12021000101",1353,82,0,0,12,0,5,0,1452
"12021000102",1327,166,0,4,0,0,3,1,1501
"12021000200",1745,110,28,0,120,0,159,10,2172
"12021000301",2701,80,0,0,0,18,172,25,2996
"12021000302",1336,93,0,0,0,0,27,0,1456
"12021000401",2492,112,0,0,14,11,38,0,2667
"12021000402",1983,19,0,0,0,0,0,0,2002
"12021000500",1614,151,0,0,56,0,74,29,1924
"12021000600",1318,95,28,0,12,10,39,0,1502
"12021000700",277,241,575,331,0,0,96,212,1732
"12021010102",4706,248,165,17,71,59,583,71,5920
"12021010105",3726,243,0,0,50,0,481,68,4568
"12021010106",4154,139,0,12,33,0,41,0,4379
"12021010107",3642,221,41,7,68,0,323,70,4372
"12021010108",2982,189,0,0,6,0,196,13,3386
"12021010109",1959,216,39,0,120,0,131,87,2552
"12021010110",3649,609,29,1,511,0,1055,279,6133
"12021010205",2326,182,52,0,126,0,115,0,2801
"12021010208",2756,44,0,0,6,9,0,9,2824
"12021010209",1992,58,6,0,6,0,122,0,2184
"12021010210",3190,358,5,0,38,26,180,176,3973
"12021010211",1500,128,50,36,6,7,157,38,1922
"12021010212",5244,439,15,0,81,0,465,221,6465
"12021010213",3597,252,55,0,95,0,246,0,4245
"12021010215",2287,38,0,0,31,0,0,0,2356
"12021010300",3222,478,263,114,82,34,781,186,5160
"12021010401",3484,536,186,287,85,20,382,39,5019
"12021010405",10455,414,668,93,672,84,2356,121,14863
"12021010408",2266,255,57,2,310,79,460,76,3505
"12021010410",5277,2365,826,384,638,520,4121,2467,16598
"12021010411",4548,1050,1675,266,336,447,2851,1412,12585
"12021010412",7513,529,201,264,205,38,2314,207,11271
"12021010413",5760,787,114,2,693,153,2617,476,10602
"12021010414",6109,344,766,40,202,28,2418,146,10053
"12021010415",12595,529,355,622,1515,0,2741,28,18385
"12021010416",5099,349,0,0,335,0,496,42,6321
"12021010417",4143,532,17,0,268,0,801,233,5994
"12021010418",4930,400,208,0,183,0,529,22,6272
"12021010419",2340,577,513,294,41,184,1765,602,6316
"12021010420",3772,1042,702,411,441,488,2941,1258,11055
"12021010505",5252,739,425,45,214,0,1978,248,8901
"12021010506",3908,1535,0,0,343,97,933,1279,8095
"12021010507",3137,673,181,196,195,0,871,632,5885
"12021010508",3826,400,101,0,227,0,938,139,5631
"12021010509",3997,460,269,30,38,24,95,123,5036
"12021010510",2691,321,61,0,71,13,43,36,3236
"12021010601",1528,589,190,57,52,23,538,273,3250
"12021010602",2338,403,387,0,15,9,200,194,3546
"12021010604",2002,295,227,12,30,0,417,33,3016
"12021010605",2502,266,377,41,169,8,580,19,3962
"12021010606",2069,68,17,0,70,0,143,9,2376
"12021010701",2568,732,339,67,115,0,404,408,4633
"12021010702",2210,452,125,0,92,0,842,8,3729
"12021010801",3187,128,5,0,25,2,210,0,3557
"12021010802",6175,1418,1825,511,592,48,3603,1195,15367
"12021010803",2864,589,353,11,62,83,646,269,4877
"12021010902",3407,193,0,0,10,32,368,32,4042
"12021010903",4753,470,1,0,0,138,184,127,5673
"12021010904",1388,119,0,0,13,0,32,42,1594
"12021010905",2875,211,22,0,10,0,410,0,3528
"12021011001",1466,59,9,6,45,0,35,17,1637
"12021011002",2090,89,10,0,62,0,103,0,2354
"12021011102",6082,1518,110,88,586,36,1111,35,9566
"12021011103",1287,690,221,33,19,4,439,495,3188
"12021011105",2214,268,10,0,20,0,566,27,3105
"12021011106",2105,340,51,155,167,0,459,216,3493
"12021011201",7514,576,50,0,392,24,629,131,9316
"12021011202",19810,805,273,253,824,5,6473,279,28722
"12021011204",852,1034,699,822,286,456,1065,1516,6730
"12021011205",343,684,258,734,299,178,485,776,3757
"12021011301",3272,2360,837,233,170,42,3283,2313,12510
"12021011302",3225,1748,655,430,424,361,3436,1933,12212
"12021011400",2068,1222,199,62,610,511,2390,1592,8654
"12021990000",0,0,0,0,0,0,0,0,0
"12023110201",3139,390,264,223,137,89,257,104,4603
"12023110202",2245,449,837,1225,51,21,98,109,5035
"12023110300",2380,855,1009,423,168,46,67,36,4984
"12023110400",1197,315,901,517,178,78,82,8,3276
"12023110500",4449,416,776,495,363,44,284,111,6938
"12023110601",6152,1395,511,179,598,97,307,88,9327
"12023110602",3389,385,326,170,64,62,225,88,4709
"12023110700",3418,383,936,116,88,58,395,11,5405
"12023110800",4351,718,408,158,163,109,41,36,5984
"12023110901",3548,943,47,3,182,1,151,2,4877
"12023110903",2854,1041,122,8,131,0,230,6,4392
"12023110904",4570,911,362,79,88,96,114,126,6346
"12027010101",2723,997,12,22,45,0,409,584,4792
"12027010102",1707,1156,68,270,83,94,396,367,4141
"12027010200",2522,903,594,374,421,0,691,515,6020
"12027010301",4308,2655,175,253,469,93,2854,2403,13210
"12027010302",334,290,843,812,31,0,56,186,2552
"12027010403",2160,481,16,113,59,0,67,49,2945
"12027010404",2194,808,0,84,105,41,177,568,3977
"12027010405",1134,37,23,0,11,25,0,25,1255
"12027010406",2720,568,141,14,9,33,770,150,4405
"12029970101",2342,669,492,222,93,7,79,0,3904
"12029970102",5222,1392,0,0,83,49,77,58,6881
"12029970200",2941,625,111,70,148,27,91,44,4057
"12029990000",0,0,0,0,0,0,0,0,0
"12031000100",1896,293,1756,495,207,111,156,102,5016
"12031000200",58,37,1623,945,34,26,0,41,2764
"12031000300",363,176,565,833,31,82,39,17,2106
"12031000600",2983,641,711,697,454,298,103,132,6019
"12031000700",2923,123,289,258,220,29,111,28,3981
"12031000800",1797,165,98,96,130,0,130,33,2449
"12031001000",165,222,425,874,8,89,8,99,1890
"12031001100",736,232,289,353,54,0,57,0,1721
"12031001200",657,241,732,509,169,70,37,8,2423
"12031001300",143,302,1959,1500,49,0,19,101,4073
"12031001400",658,119,2140,1973,110,0,0,8,5008
"12031001500",27,22,1839,1461,30,11,22,21,3433
"12031001600",6,13,494,836,0,15,0,0,1364
"12031002101",2199,312,128,20,122,67,135,9,2992
"12031002102",2411,101,80,26,155,22,67,0,2862
"12031002200",3384,738,22,16,34,91,26,18,4329
"12031002300",1376,152,34,0,89,0,106,0,1757
"12031002400",1699,72,0,19,22,4,120,1,1937
"12031002501",1591,513,805,719,245,79,391,94,4437
"12031002502",2216,361,484,69,381,36,103,0,3650
"12031002600",167,246,1223,1401,9,5,21,32,3104
"12031002701",296,30,2133,928,94,0,117,0,3598
"12031002702",933,107,1270,934,66,47,174,48,3579
"12031002801",22,58,2327,1398,28,0,0,58,3891
"12031002802",45,94,2071,1505,38,12,1,0,3766
"12031002901",57,14,1693,1560,31,9,43,0,3407
"12031002902",12,0,1659,962,9,50,8,42,2742
"12031010101",4115,438,709,0,253,0,309,29,5853
"12031010102",6820,1133,1085,83,1174,32,710,52,11089
"12031010103",4387,258,829,11,428,1,372,56,6342
"12031010201",5878,1440,2549,103,776,0,786,227,11759
"12031010202",2807,167,165,0,174,2,114,2,3431
"12031010301",2348,406,793,32,255,44,55,0,3933
"12031010303",1508,85,4339,556,225,0,106,0,6819
"12031010304",594,96,5105,1097,162,51,208,0,7313
"12031010401",993,228,1327,690,23,19,111,121,3512
"12031010402",1126,378,1386,780,72,186,206,41,4175
"12031010500",3800,1289,8449,1084,668,180,703,59,16232
"12031010600",3958,525,860,226,88,30,187,12,5886
"12031010700",116,121,3681,1456,65,13,0,82,5534
"12031010800",97,107,4172,1416,18,15,41,36,5902
"12031010900",288,81,2619,440,103,0,12,0,3543
"12031011000",664,247,2064,912,73,40,0,0,4000
"12031011100",270,148,1747,1118,28,102,7,29,3449
"12031011200",60,17,1879,316,0,17,51,29,2369
"12031011300",7,0,1870,1108,10,7,0,0,3002
"12031011400",25,0,1665,632,11,17,11,109,2470
"12031011500",95,21,2413,1444,11,46,11,46,4087
"12031011600",0,260,2044,1371,0,0,0,21,3696
"12031011700",1562,701,865,153,34,18,293,27,3653
"12031011800",1208,293,688,725,52,148,48,80,3242
"12031011901",5481,760,867,0,194,53,193,0,7548
"12031011902",5154,1475,2594,578,1571,300,856,76,12604
"12031011903",3276,448,1201,128,387,0,98,27,5565
"12031012000",3393,238,931,445,348,15,433,0,5803
"12031012100",729,375,212,179,36,126,63,176,1896
"12031012200",2417,858,1292,2445,238,49,164,191,7654
"12031012300",2428,504,504,221,248,122,720,36,4783
"12031012400",2262,275,291,17,14,0,70,95,3024
"12031012500",1658,391,668,762,186,84,156,77,3982
"12031012601",931,231,1001,555,225,79,303,51,3376
"12031012602",2068,324,1864,793,208,12,429,0,5698
"12031012702",2607,887,1365,267,178,127,290,292,6013
"12031012703",2464,350,1246,645,716,95,361,34,5911
"12031012704",1632,221,2188,463,639,122,661,51,5977
"12031012800",2938,647,2368,1097,641,255,548,232,8726
"12031012900",1764,169,586,67,283,40,156,7,3072
"12031013000",2271,209,48,0,60,0,40,0,2628
"12031013100",1736,88,301,60,8,0,74,0,2267
"12031013200",652,277,123,78,199,124,157,105,1715
"12031013300",3534,653,1692,578,729,111,664,438,8399
"12031013402",1967,868,871,817,379,60,285,364,5611
"12031013403",1474,196,729,371,74,96,93,88,3121
"12031013404",1330,384,678,542,84,177,88,310,3593
"12031013502",1513,224,1129,221,299,0,352,17,3755
"12031013503",3151,478,3062,933,1101,352,524,188,9789
"12031013504",2343,433,1566,1259,835,27,470,292,7225
"12031013521",3646,481,3682,1674,913,483,1002,319,12200
"12031013522",1869,301,1420,216,512,45,707,37,5107
"12031013721",4181,1461,2956,536,1247,302,1496,918,13097
"12031013723",3553,714,1526,397,592,119,768,384,8053
"12031013726",5148,677,1656,149,1938,150,966,422,11106
"12031013727",4557,535,2058,49,1357,184,466,20,9226
"12031013800",1138,262,11,12,214,0,108,31,1776
"12031013901",2189,366,682,117,246,44,368,0,4012
"12031013902",3097,578,578,226,471,19,668,66,5703
"12031013904",2677,463,705,170,271,185,245,192,4908
"12031013905",3929,182,10,0,222,0,134,43,4520
"12031013906",3881,135,156,0,185,0,177,0,4534
"12031014001",3307,585,0,0,53,0,246,0,4191
"12031014002",2262,59,42,0,189,0,176,0,2728
"12031014101",3879,269,14,23,225,0,62,11,4483
"12031014102",3234,274,14,16,229,0,126,29,3922
"12031014202",2985,396,390,218,137,0,144,39,4309
"12031014203",3957,216,14,0,69,0,145,0,4401
"12031014204",4261,414,377,39,345,56,315,73,5880
"12031014311",2411,945,647,405,389,92,428,556,5873
"12031014312",4230,593,1386,360,545,278,511,345,8248
"12031014326",5507,411,651,0,685,0,363,0,7617
"12031014328",3806,393,1121,89,916,163,846,25,7359
"12031014329",2118,164,327,0,196,23,369,44,3241
"12031014330",3764,162,274,0,294,53,105,18,4670
"12031014331",4110,552,119,43,353,16,296,117,5606
"12031014332",6595,298,285,0,438,11,829,0,8456
"12031014333",2155,90,597,80,122,6,180,29,3259
"12031014334",2969,518,921,207,377,32,254,58,5336
"12031014335",6077,274,786,20,889,78,576,0,8700
"12031014336",3711,287,1004,0,1609,161,895,48,7715
"12031014337",5457,715,1565,506,2609,290,1691,315,13148
"12031014338",2437,360,719,206,747,115,525,182,5291
"12031014401",7821,1482,1203,748,1540,394,1724,741,15653
"12031014404",3456,700,541,213,1008,82,314,0,6314
"12031014406",5155,135,444,39,1320,48,488,0,7629
"12031014408",2842,302,75,21,207,111,146,13,3717
"12031014409",7759,183,236,0,1134,69,616,69,10066
"12031014410",5768,408,281,0,510,22,596,0,7585
"12031014411",3859,250,887,127,2126,55,470,34,7808
"12031014412",9649,546,1343,29,3029,0,1701,0,16297
"12031014413",4065,461,207,112,724,20,567,86,6242
"12031014500",2970,406,223,368,307,173,508,118,5073
"12031014601",5122,225,458,0,193,11,233,41,6283
"12031014603",2554,403,1046,31,523,0,142,0,4699
"12031014604",1942,297,1475,132,286,29,274,0,4435
"12031014701",2909,816,2934,761,352,0,433,220,8425
"12031014702",1371,200,554,817,307,0,109,15,3373
"12031014800",1578,115,815,690,81,29,265,42,3615
"12031014901",3102,285,1875,251,236,63,452,50,6314
"12031014902",2913,238,2167,225,714,22,592,97,6968
"12031015001",2942,367,895,418,403,0,218,94,5337
"12031015002",1856,229,1175,344,255,14,254,26,4153
"12031015100",2403,322,1060,453,230,2,828,75,5373
"12031015200",1543,186,836,332,104,171,264,146,3582
"12031015300",1540,393,652,284,26,20,50,78,3043
"12031015400",1318,198,454,249,83,10,95,17,2424
"12031015501",1332,395,472,512,213,26,25,14,2989
"12031015502",1351,374,1622,1203,162,0,93,12,4817
"12031015600",2627,442,578,153,169,0,90,0,4059
"12031015700",2260,869,1216,269,373,110,453,548,6098
"12031015801",4860,617,247,329,267,61,692,0,7073
"12031015802",2950,775,1566,1542,316,274,900,222,8545
"12031015922",1785,317,565,42,335,81,257,58,3440
"12031015923",5433,298,568,1278,1315,101,427,31,9451
"12031015924",3886,406,350,102,267,11,519,42,5583
"12031015925",2407,663,938,144,999,217,617,9,5994
"12031015926",3281,519,731,282,357,85,359,343,5957
"12031016000",4170,724,502,331,748,43,597,56,7171
"12031016100",3989,1086,803,1015,1013,64,721,558,9249
"12031016200",969,452,219,92,355,48,85,238,2458
"12031016300",1252,218,447,200,145,118,98,21,2499
"12031016400",4207,476,545,134,131,0,113,212,5818
"12031016500",3861,455,240,0,312,361,199,198,5626
"12031016601",2363,771,1399,580,693,73,796,282,6957
"12031016603",2819,173,137,10,71,37,204,31,3482
"12031016604",3366,389,363,185,192,20,511,160,5186
"12031016711",3691,101,39,15,217,0,114,4,4181
"12031016722",4952,565,1092,471,128,135,218,0,7561
"12031016724",2982,590,890,12,173,107,546,182,5482
"12031016725",2428,301,855,189,432,124,757,138,5224
"12031016726",2712,264,296,0,320,62,444,16,4114
"12031016727",2575,221,83,0,101,34,295,0,3309
"12031016728",3205,226,397,17,391,43,240,103,4622
"12031016729",4958,416,694,113,384,173,563,94,7395
"12031016801",2011,115,8,0,145,20,174,43,2516
"12031016803",6294,269,87,0,332,73,407,115,7577
"12031016804",6929,127,261,28,433,0,226,0,8004
"12031016805",5398,213,798,138,1397,168,724,113,8949
"12031016806",9644,388,1117,29,1015,30,1544,0,13767
"12031016807",2689,366,143,7,682,147,358,152,4544
"12031016808",2885,273,317,23,318,72,263,40,4191
"12031017100",3735,645,403,25,162,24,314,84,5392
"12031017200",594,197,427,524,133,22,140,35,2072
"12031017300",4797,893,854,199,485,148,589,45,8010
"12031017400",43,53,1420,902,11,20,19,0,2468
"12031990000",0,0,0,0,0,0,0,0,0
"12033000100",656,92,381,125,134,41,21,0,1450
"12033000300",949,216,556,173,199,36,138,0,2267
"12033000400",290,108,1751,1043,84,17,55,44,3392
"12033000500",787,110,210,211,46,9,12,11,1396
"12033000600",269,54,830,472,2,3,17,3,1650
"12033000800",3040,328,862,312,157,60,146,29,4934
"12033000900",2209,104,71,18,39,0,40,8,2489
"12033001001",5100,219,109,128,495,131,214,0,6396
"12033001002",2366,287,154,53,279,11,170,0,3320
"12033001101",4687,144,320,19,280,37,399,114,6000
"12033001103",2143,221,167,12,91,28,95,0,2757
"12033001104",4042,529,648,86,815,127,323,8,6578
"12033001201",2183,551,1230,92,528,162,83,47,4876
"12033001202",2472,447,944,140,283,11,69,92,4458
"12033001300",918,266,1845,1281,199,126,66,11,4712
"12033001401",1219,120,0,36,43,8,40,16,1482
"12033001402",3372,572,1718,1226,623,360,467,119,8457
"12033001500",14,0,939,412,9,0,0,0,1374
"12033001600",60,0,620,471,14,84,0,0,1249
"12033001700",878,181,553,519,29,24,10,0,2194
"12033001800",590,226,772,374,43,4,30,0,2039
"12033001900",639,161,730,463,158,119,6,22,2298
"12033002000",520,166,712,720,5,240,11,36,2410
"12033002100",2129,441,896,262,170,421,50,0,4369
"12033002200",1866,492,294,338,203,15,65,74,3347
"12033002300",3423,750,255,145,50,63,117,0,4803
"12033002400",901,33,167,0,140,23,161,27,1452
"12033002500",2355,163,0,0,141,137,116,93,3005
"12033002601",2450,51,254,0,254,5,159,0,3173
"12033002602",1207,64,7,0,19,5,3,13,1318
"12033002603",6798,546,537,21,193,0,451,58,8604
"12033002604",3043,450,259,55,367,0,160,64,4398
"12033002605",3627,173,367,68,590,231,448,0,5504
"12033002701",2089,107,368,21,545,11,66,28,3235
"12033002703",873,424,744,556,164,26,65,266,3118
"12033002704",2685,545,474,301,568,121,234,50,4978
"12033002801",1533,391,162,455,88,0,223,35,2887
"12033002802",2525,677,560,288,767,37,219,283,5356
"12033002803",1469,379,519,320,154,23,76,0,2940
"12033002804",1331,69,290,86,186,7,245,0,2214
"12033002900",2438,427,339,546,377,0,198,103,4428
"12033003000",2755,389,1985,317,575,54,278,34,6387
"12033003100",1204,82,2496,470,279,91,52,8,4682
"12033003201",2428,102,1138,447,440,66,344,0,4965
"12033003203",1859,132,2139,661,200,26,101,16,5134
"12033003204",2210,16,354,0,430,0,129,0,3139
"12033003301",3069,299,359,35,272,64,128,52,4278
"12033003305",1592,217,192,47,141,10,50,59,2308
"12033003306",4137,417,595,16,804,62,185,0,6216
"12033003307",1237,289,565,139,289,6,37,0,2562
"12033003308",2721,215,866,0,399,11,119,33,4364
"12033003309",4566,670,558,369,378,0,200,0,6741
"12033003400",3185,251,851,308,687,415,303,192,6192
"12033003503",4797,617,724,307,291,355,261,61,7413
"12033003505",2383,334,345,26,275,49,205,102,3719
"12033003506",2881,189,858,271,293,344,214,154,5204
"12033003507",3127,642,883,247,1505,227,604,216,7451
"12033003508",3244,642,2024,394,392,239,390,100,7425
"12033003603",5643,435,547,0,634,76,253,24,7612
"12033003607",1056,335,79,19,73,30,31,19,1642
"12033003608",6181,1281,827,104,129,53,336,41,8952
"12033003609",2529,361,517,25,268,145,20,0,3865
"12033003610",5491,511,359,60,543,18,291,0,7273
"12033003611",3913,153,532,0,483,0,235,0,5316
"12033003612",4026,130,223,19,315,82,163,55,5013
"12033003613",3240,629,12,4,39,0,195,55,4174
"12033003614",4283,235,439,665,161,6,72,29,5890
"12033003700",2396,559,683,147,148,60,87,19,4099
"12033003800",3505,286,316,69,193,189,51,39,4648
"12033003900",3092,429,231,93,141,232,215,39,4472
"12033004000",1489,98,515,289,101,10,3,2,2507
"12033990000",0,0,0,0,0,0,0,0,0
"12035060103",1413,118,9,61,53,84,60,56,1854
"12035060104",3138,329,84,12,170,0,357,18,4108
"12035060105",3004,170,231,15,128,0,83,0,3631
"12035060106",2227,293,33,0,9,0,7,0,2569
"12035060107",3039,556,386,65,263,232,513,143,5197
"12035060204",5112,631,746,194,581,642,478,650,9034
"12035060205",5871,928,690,139,616,0,953,34,9231
"12035060206",3642,674,77,434,208,21,196,37,5289
"12035060207",3548,721,373,444,14,86,81,96,5363
"12035060208",4399,1498,425,202,230,12,949,81,7796
"12035060209",5079,651,491,25,339,0,296,133,7014
"12035060210",2155,668,915,90,106,87,126,267,4414
"12035060211",4484,136,776,276,450,24,456,2,6604
"12035060212",3283,888,663,226,346,43,435,306,6190
"12035060213",3636,198,641,743,543,409,416,443,7029
"12035060214",5685,782,859,287,1029,0,1246,0,9888
"12035060301",4519,163,197,17,304,60,487,0,5747
"12035060302",3218,214,55,0,0,23,149,10,3669
"12035060303",2052,61,76,0,17,14,41,0,2261
"12035060304",2303,67,9,0,28,101,14,12,2534
"12035990000",0,0,0,0,0,0,0,0,0
"12037970100",1946,857,56,19,68,48,34,2,3030
"12037970200",2143,623,54,36,69,0,35,63,3023
"12037970302",1470,184,382,82,115,0,4,0,2237
"12037970304",1316,128,152,0,8,0,41,7,1652
"12037990000",0,0,0,0,0,0,0,0,0
"12037990100",0,0,0,0,0,0,0,0,0
"12039020101",2658,204,755,422,14,10,16,30,4109
"12039020102",2481,315,1932,1231,55,16,103,7,6140
"12039020300",938,329,3064,1312,45,24,176,214,6102
"12039020400",1551,866,1220,1083,106,0,190,27,5043
"12039020500",2082,100,2003,671,89,0,963,53,5961
"12039020600",1109,94,2485,491,75,0,157,75,4486
"12039020701",398,48,1632,682,164,42,108,42,3116
"12039020702",434,210,2257,1892,530,355,503,376,6557
"12039020800",2836,686,945,525,180,299,716,705,6892
"12041950100",3571,1834,0,10,35,31,29,170,5680
"12041950201",1518,149,0,1,57,0,72,8,1805
"12041950202",1505,500,9,0,41,16,26,7,2104
"12041950203",2561,438,0,0,87,0,124,12,3222
"12041950204",2525,475,148,139,93,5,141,120,3646
"12043000100",1844,348,0,0,15,27,89,0,2323
"12043000200",4951,1141,435,350,130,99,1672,419,9197
"12043000300",1222,282,457,27,454,134,217,107,2900
"12043990000",0,0,0,0,0,0,0,0,0
"12045960100",4571,807,527,25,46,127,297,65,6465
"12045960200",2086,241,978,142,87,0,2,2,3538
"12045960300",2991,558,40,0,187,24,67,30,3897
"12045990000",0,0,0,0,0,0,0,0,0
"12047960100",2396,558,828,838,148,28,136,2,4934
"12047960200",2740,534,427,627,55,194,257,243,5077
"12047960300",664,245,538,109,13,101,22,3,1695
"12049970101",2552,1143,0,0,127,230,955,990,5997
"12049970102",2231,1145,15,2,112,110,820,488,4923
"12049970201",2474,881,234,33,185,171,1324,893,6195
"12049970202",1119,197,0,0,15,5,343,0,1679
"12049970300",4097,1164,249,113,642,709,2542,1051,10567
"12049970400",4054,782,318,288,190,56,1835,311,7834
"12051000100",3947,547,611,228,1345,460,2953,714,10805
"12051000200",3516,1224,1445,978,270,185,2222,1032,10872
"12051000300",3520,1676,178,27,520,246,2032,1516,9715
"12051000401",2118,1025,0,0,379,484,1236,1192,6434
"12051000402",5941,1120,175,245,435,134,3205,804,12059
"12051000600",2144,640,20,43,484,434,1447,691,5903
"12051990000",0,0,0,0,0,0,0,0,0
"12053040101",3739,501,75,6,67,183,154,0,4725
"12053040102",1570,299,51,53,24,0,31,104,2132
"12053040201",2340,600,27,0,46,0,68,207,3288
"12053040202",3838,1476,143,396,99,0,38,94,6084
"12053040301",1212,344,12,33,42,4,89,14,1750
"12053040302",3264,473,41,5,9,7,210,48,4057
"12053040303",1711,374,0,0,48,0,189,84,2406
"12053040400",1780,245,504,216,0,12,34,6,2797
"12053040501",2139,521,406,438,30,105,168,223,4030
"12053040502",2006,766,0,183,131,45,90,40,3261
"12053040601",1606,218,100,379,5,15,31,95,2449
"12053040602",1912,309,83,0,152,0,0,0,2456
"12053040701",5164,428,176,8,53,47,339,73,6288
"12053040702",4226,660,27,4,229,0,680,120,5946
"12053040801",2639,530,63,0,156,21,164,0,3573
"12053040802",3964,292,14,0,93,12,584,12,4971
"12053040901",4165,603,280,67,147,36,482,22,5802
"12053040905",5796,114,259,0,323,0,690,0,7182
"12053040906",4718,423,199,76,485,82,1069,88,7140
"12053040907",2060,132,232,0,88,65,497,14,3088
"12053040908",5129,1014,340,0,502,16,859,529,8389
"12053040909",3727,242,79,294,257,52,460,0,5111
"12053040910",2706,718,26,99,241,0,241,160,4191
"12053040911",2662,272,303,0,266,6,757,16,4282
"12053041003",1357,1045,216,220,118,26,275,116,3373
"12053041004",5184,604,247,20,291,540,717,421,8024
"12053041005",1742,359,74,13,61,15,379,201,2844
"12053041006",5118,935,195,38,392,24,916,164,7782
"12053041103",2936,522,29,254,289,0,404,6,4440
"12053041104",2151,272,116,7,132,0,297,1,2976
"12053041105",3122,729,247,368,165,22,980,141,5774
"12053041106",3147,410,97,1,240,67,515,73,4550
"12053041201",3048,533,98,152,185,12,513,171,4712
"12053041203",3181,608,75,89,264,21,307,219,4764
"12053041204",2453,763,10,42,71,103,293,298,4033
"12053041302",1968,723,54,43,132,103,382,117,3522
"12053041303",2377,25,6,0,9,0,0,0,2417
"12053041304",1570,160,6,0,4,0,11,0,1751
"12053041305",1224,78,14,0,35,8,54,0,1413
"12053041401",3481,924,13,0,223,66,411,25,5143
"12053041402",4579,333,263,42,44,71,474,90,5896
"12053041501",2348,712,0,0,20,0,95,0,3175
"12053041502",2771,372,126,14,54,0,342,47,3726
"12053041600",5061,326,35,42,24,0,179,38,5705
"12053990000",0,0,0,0,0,0,0,0,0
"12055960101",2545,153,87,27,0,30,17,0,2859
"12055960102",508,31,406,269,3,0,33,0,1250
"12055960103",2674,472,714,49,0,354,279,460,5002
"12055960200",2253,430,476,171,150,234,745,366,4825
"12055960300",1357,1193,1207,794,463,253,853,973,7093
"12055960400",4500,1355,508,208,854,57,1127,591,9200
"12055960501",1105,95,31,0,33,0,319,0,1583
"12055960502",5234,818,400,48,680,133,1016,119,8448
"12055960601",2402,105,353,21,155,0,385,53,3474
"12055960602",5061,750,92,0,357,82,372,178,6892
"12055960700",3090,437,289,4,232,67,318,122,4559
"12055960800",1217,467,124,63,65,55,301,286,2578
"12055960900",1264,217,942,225,8,157,188,242,3243
"12055961000",3092,482,27,15,285,0,474,238,4613
"12055961100",1956,871,103,234,76,152,503,440,4335
"12055961200",3365,1056,69,31,66,4,379,224,5194
"12055961301",5889,219,155,2,298,1,871,2,7437
"12055961302",3533,507,15,0,85,15,189,0,4344
"12055961400",4206,261,43,0,86,0,158,51,4805
"12055961500",3270,480,88,0,150,268,597,268,5121
"12055961601",830,251,0,0,5,10,70,36,1202
"12055961602",799,59,13,0,87,0,75,4,1037
"12055961603",3486,1950,109,332,31,609,467,1448,8432
"12055961700",3698,640,43,410,419,180,1561,351,7302
"12055980000",16,0,0,0,0,0,0,0,16
"12055980100",0,0,0,0,0,0,0,0,0
"12055980200",0,0,0,0,0,0,0,0,0
"12057000101",1256,517,467,326,269,363,338,336,3872
"12057000102",2346,821,1247,961,120,72,1065,778,7410
"12057000201",392,443,810,1020,166,18,325,120,3294
"12057000202",1651,330,1633,874,413,253,1283,401,6838
"12057000300",2583,743,1739,1239,659,256,1602,875,9696
"12057000401",1225,403,229,175,256,19,525,195,3027
"12057000402",1428,268,379,21,349,250,977,270,3942
"12057000500",2872,565,105,0,180,0,656,275,4653
"12057000601",2671,808,525,178,269,64,1882,469,6866
"12057000602",1259,237,353,72,287,88,735,172,3203
"12057000700",1367,656,1953,1843,131,35,626,681,7292
"12057000800",1161,498,926,425,157,46,394,239,3846
"12057000901",922,413,821,282,201,42,478,328,3487
"12057000902",723,265,2041,1016,196,0,344,60,4645
"12057001001",493,427,1308,1003,91,127,379,579,4407
"12057001002",345,45,2519,1826,31,134,266,296,5462
"12057001100",1456,339,444,115,60,21,309,177,2921
"12057001200",922,390,314,330,450,459,499,458,3822
"12057001300",3879,885,323,121,1185,242,2366,685,9686
"12057001400",2874,1235,334,220,289,21,1265,974,7212
"12057001500",1779,201,88,342,160,32,397,144,3143
"12057001600",1401,245,149,86,53,3,212,137,2286
"12057001700",2088,448,702,806,416,56,578,294,5388
"12057001800",162,154,1783,1541,24,176,186,330,4356
"12057001900",48,78,1890,1176,28,12,131,78,3441
"12057002000",375,163,1192,870,122,83,293,131,3229
"12057002100",1169,264,728,414,128,24,337,316,3380
"12057002200",1125,115,264,188,56,25,274,75,2122
"12057002300",2682,258,207,20,256,93,642,179,4337
"12057002400",2379,730,363,37,284,3,1229,474,5499
"12057002500",2856,1414,1152,301,479,197,2835,1430,10664
"12057002600",490,394,87,80,160,38,602,295,2146
"12057002700",5116,1177,511,68,458,270,4134,1057,12791
"12057002800",2056,407,233,133,41,20,637,65,3592
"12057002900",1136,284,538,308,81,2,533,191,3073
"12057003000",441,305,770,955,26,30,273,291,3091
"12057003100",592,221,935,770,129,124,427,304,3502
"12057003200",791,304,761,965,148,11,673,175,3828
"12057003300",347,146,706,846,64,4,272,99,2484
"12057003400",73,135,1462,973,15,73,57,189,2977
"12057003500",125,172,1443,771,71,0,71,123,2776
"12057003600",362,504,1941,1428,211,63,227,384,5120
"12057003700",199,323,94,162,48,49,53,121,1049
"12057003800",297,87,201,376,0,0,55,73,1089
"12057003900",782,268,438,465,92,10,214,311,2580
"12057004000",0,34,15,85,0,0,0,31,165
"12057004100",358,346,346,358,25,32,143,247,1855
"12057004200",355,99,387,200,69,14,123,64,1311
"12057004300",275,341,582,1970,42,39,245,354,3848
"12057004400",400,238,1042,379,115,28,397,263,2862
"12057004500",2164,833,656,324,266,124,2362,952,7681
"12057004600",1791,256,1275,286,333,35,751,63,4790
"12057004700",1650,317,243,49,156,9,705,252,3381
"12057004800",2292,690,485,11,355,0,1360,489,5682
"12057004900",2341,645,582,275,180,12,426,117,4578
"12057005000",619,448,787,406,175,19,156,117,2727
"12057005101",940,206,39,34,76,54,143,51,1543
"12057005102",3046,232,143,0,311,0,371,0,4103
"12057005301",2439,195,150,0,273,0,434,24,3515
"12057005302",1278,380,67,84,240,192,1275,483,3999
"12057005401",4757,140,50,54,137,0,769,36,5943
"12057005500",1686,235,38,0,242,29,222,51,2503
"12057005700",3421,214,268,48,316,7,498,104,4876
"12057005800",3966,206,63,0,376,41,627,38,5317
"12057005900",5407,273,15,0,642,0,1306,0,7643
"12057006000",4919,153,38,5,187,51,480,1,5834
"12057006101",2605,220,25,0,138,8,160,51,3207
"12057006103",3377,247,91,13,45,0,664,81,4518
"12057006200",3376,227,14,7,401,12,426,10,4473
"12057006300",3621,90,217,0,158,10,399,18,4513
"12057006400",3389,365,208,0,148,39,388,70,4607
"12057006501",1998,289,213,37,341,365,325,379,3947
"12057006502",1360,192,147,8,46,0,253,9,2015
"12057006600",2741,381,43,0,444,52,377,182,4220
"12057006700",4408,410,0,0,595,0,445,0,5858
"12057006801",3343,199,276,15,640,24,524,0,5021
"12057006802",2871,290,216,2,148,23,366,49,3965
"12057006900",4422,232,262,0,541,144,610,37,6248
"12057007001",2169,321,177,134,624,111,368,111,4015
"12057007002",1352,232,561,900,233,325,344,122,4069
"12057007102",1786,234,296,16,108,49,145,36,2670
"12057007103",2879,526,338,53,219,24,482,347,4868
"12057007200",2724,443,570,90,277,131,290,44,4569
"12057007300",1423,83,234,63,98,4,224,24,2153
"12057010103",3388,368,54,9,107,50,336,44,4356
"12057010105",3631,502,95,56,274,199,660,424,5841
"12057010106",4724,803,0,14,192,40,994,303,7070
"12057010107",2851,495,30,24,180,113,211,305,4209
"12057010108",1621,184,131,33,73,67,96,4,2209
"12057010203",929,351,362,68,77,20,186,75,2068
"12057010204",3231,526,851,349,382,73,725,249,6386
"12057010205",5211,338,1269,103,1978,14,1584,55,10552
"12057010209",6091,377,2249,271,2210,104,1738,196,13236
"12057010210",1945,526,262,99,1103,173,465,210,4783
"12057010211",3621,134,550,57,687,206,740,254,6249
"12057010212",3210,266,536,0,1047,32,638,35,5764
"12057010213",1107,298,303,88,73,39,66,57,2031
"12057010214",147,31,0,0,13,0,13,0,204
"12057010303",2339,840,0,26,173,94,220,122,3814
"12057010304",2904,283,183,126,276,0,635,0,4407
"12057010305",1608,740,657,270,270,3,280,91,3919
"12057010401",2581,576,1137,504,245,213,459,270,5985
"12057010402",1812,675,1955,411,614,185,739,389,6780
"12057010501",784,208,2642,1042,124,235,394,311,5740
"12057010502",772,286,974,179,173,47,226,155,2812
"12057010600",1780,255,466,129,205,87,249,88,3259
"12057010701",3773,346,603,467,583,116,760,230,6878
"12057010702",1919,260,196,153,9,75,306,88,3006
"12057010805",1184,1185,824,789,724,471,1105,1340,7622
"12057010808",400,634,324,276,220,302,325,568,3049
"12057010809",1377,982,318,461,162,201,211,409,4121
"12057010810",1318,228,452,59,666,55,231,23,3032
"12057010811",3242,457,1330,318,798,142,843,159,7289
"12057010812",1111,1223,704,351,662,503,321,267,5142
"12057010813",928,1094,490,445,212,466,202,234,4071
"12057010814",1102,278,878,268,90,24,505,193,3338
"12057010815",307,224,528,392,181,86,334,242,2294
"12057010816",645,917,843,795,351,322,766,917,5556
"12057010817",1596,699,505,348,571,266,1597,670,6252
"12057010818",594,1161,757,1174,1088,395,1246,1138,7553
"12057010900",0,0,0,0,0,0,0,0,0
"12057011003",2257,534,424,105,374,209,264,248,4415
"12057011005",2080,220,265,0,256,73,384,45,3323
"12057011006",4425,349,54,15,218,3,636,100,5800
"12057011007",2699,171,269,20,189,5,469,14,3836
"12057011008",4199,483,512,149,1209,18,752,29,7351
"12057011010",2734,543,622,864,219,193,725,81,5981
"12057011012",4545,241,493,0,1314,32,956,89,7670
"12057011013",2068,135,537,250,571,189,504,81,4335
"12057011014",550,166,215,0,81,0,243,71,1326
"12057011015",3352,649,641,359,909,265,545,68,6788
"12057011016",2162,166,597,0,572,40,426,63,4026
"12057011103",2970,271,123,6,175,2,355,11,3913
"12057011106",1090,202,88,15,381,48,550,137,2511
"12057011107",5034,459,419,76,1024,107,1640,191,8950
"12057011108",1216,154,16,8,36,60,226,79,1795
"12057011109",2869,80,19,0,113,0,553,9,3643
"12057011203",2349,133,248,0,318,28,760,40,3876
"12057011204",3200,719,496,242,380,419,773,680,6909
"12057011205",2078,240,253,24,170,43,403,108,3319
"12057011206",1424,498,241,93,236,115,308,97,3012
"12057011301",2485,194,41,17,102,58,590,33,3520
"12057011303",2092,142,117,43,351,176,603,124,3648
"12057011304",3788,217,504,48,626,44,783,68,6078
"12057011407",1931,200,82,0,132,0,379,10,2734
"12057011408",2222,383,98,0,443,0,604,191,3941
"12057011409",2555,106,124,56,15,2,667,64,3589
"12057011410",4894,148,374,16,1325,2,1365,15,8139
"12057011411",1327,130,96,2,121,63,518,147,2404
"12057011412",2553,273,90,38,435,31,733,157,4310
"12057011413",3954,266,325,46,1175,53,1786,173,7778
"12057011414",4102,1044,958,104,556,109,2701,665,10239
"12057011415",3635,414,313,61,1052,80,1915,333,7803
"12057011416",4928,448,742,302,834,167,3150,576,11147
"12057011417",2587,454,292,0,950,200,1440,133,6056
"12057011418",2875,119,521,0,146,52,557,121,4391
"12057011504",1591,176,56,0,169,10,243,10,2255
"12057011506",5796,702,769,44,936,101,734,98,9180
"12057011507",5392,296,340,158,987,58,1327,42,8600
"12057011509",5617,105,215,0,444,29,685,0,7095
"12057011510",3341,60,223,35,509,1,912,34,5115
"12057011512",3191,44,35,0,433,9,565,12,4289
"12057011514",4430,563,431,4,386,160,1216,388,7578
"12057011515",2805,174,159,15,301,6,706,82,4248
"12057011516",2373,89,66,0,338,6,671,0,3543
"12057011517",7732,84,326,0,823,30,871,0,9866
"12057011518",3160,127,263,11,292,10,444,9,4316
"12057011519",2210,65,46,0,88,0,294,5,2708
"12057011520",4383,153,169,21,480,10,646,0,5862
"12057011521",2743,584,196,0,240,129,799,331,5022
"12057011522",3317,290,15,10,488,23,578,49,4770
"12057011523",1479,39,24,0,98,0,293,0,1933
"12057011524",3079,670,717,179,415,60,1035,367,6522
"12057011603",3486,251,133,156,412,163,1687,281,6569
"12057011605",4226,711,258,62,851,44,3478,531,10161
"12057011606",5627,293,770,14,593,28,1490,162,8977
"12057011607",5412,678,871,263,702,48,2269,332,10575
"12057011608",980,17,18,0,149,18,316,18,1516
"12057011610",3108,826,204,82,371,124,2254,705,7674
"12057011611",2607,346,259,199,604,126,1988,328,6457
"12057011612",5203,1034,160,120,279,49,2592,843,10280
"12057011613",3636,1039,253,183,165,235,1753,1084,8348
"12057011614",3830,1252,482,448,539,137,2834,1400,10922
"12057011615",2865,977,55,26,623,0,2348,718,7612
"12057011706",5340,886,440,185,907,181,3781,643,12363
"12057011708",3247,203,282,27,404,108,1032,127,5430
"12057011709",806,26,73,0,111,0,57,0,1073
"12057011710",4783,410,237,13,565,118,1375,96,7597
"12057011712",3751,707,294,84,541,26,1162,317,6882
"12057011802",4896,1431,240,6,238,299,3952,1092,12154
"12057011803",3912,1635,655,39,584,179,2717,1155,10876
"12057011804",3289,812,180,322,1030,144,3313,814,9904
"12057011901",3357,672,356,342,623,103,1686,484,7623
"12057011902",4083,879,597,40,1294,552,3282,1363,12090
"12057011904",886,196,420,120,95,26,515,160,2418
"12057011905",805,386,49,165,151,9,726,363,2654
"12057011906",2440,538,422,200,610,169,1885,357,6621
"12057012001",1018,239,616,594,95,22,334,128,3046
"12057012002",1185,720,850,543,710,60,805,225,5098
"12057012103",2811,561,1298,179,1529,301,1159,185,8023
"12057012104",3527,1475,1156,186,635,1024,1324,1377,10704
"12057012106",3083,779,429,47,703,147,443,328,5959
"12057012107",2875,506,515,140,496,0,790,140,5462
"12057012108",2036,282,331,3,315,63,654,9,3693
"12057012206",3899,450,1060,144,570,135,1261,249,7768
"12057012207",5393,390,818,10,126,0,1123,0,7860
"12057012208",5257,123,627,0,885,64,1096,0,8052
"12057012209",2866,340,407,174,888,6,880,204,5765
"12057012210",3525,729,428,109,217,8,705,88,5809
"12057012211",116,8,0,0,0,0,83,0,207
"12057012212",1817,871,886,342,524,80,1169,535,6224
"12057012213",3071,213,457,15,335,42,530,147,4810
"12057012301",3719,433,961,117,777,46,796,55,6904
"12057012303",2654,192,295,56,82,103,970,75,4427
"12057012304",3288,881,532,305,361,25,1307,714,7413
"12057012401",2801,1244,143,0,766,233,1157,1231,7575
"12057012402",1650,768,20,76,163,242,616,682,4217
"12057012403",3926,1028,471,86,302,333,1143,837,8126
"12057012501",2385,585,165,0,387,125,699,341,4687
"12057012503",2963,411,155,19,484,291,528,524,5375
"12057012504",2643,236,175,70,360,0,279,155,3918
"12057012600",2425,337,1234,655,539,162,789,272,6413
"12057012701",3120,1628,238,60,1733,203,2674,1397,11053
"12057012702",2461,306,160,0,339,0,864,84,4214
"12057012800",2436,446,241,38,372,181,846,241,4801
"12057012900",761,228,1130,605,232,84,442,250,3732
"12057013001",2675,508,111,41,219,179,544,294,4571
"12057013002",3492,431,177,118,525,177,1298,222,6440
"12057013003",2065,360,120,23,543,485,959,612,5167
"12057013004",2266,587,716,184,219,188,954,469,5583
"12057013100",2261,218,129,78,79,145,438,240,3588
"12057013203",2354,336,287,0,285,0,528,36,3826
"12057013204",1983,552,239,104,275,130,580,293,4156
"12057013205",5967,351,782,50,692,38,1346,140,9366
"12057013206",4686,189,603,44,596,11,986,52,7167
"12057013207",3180,266,93,79,565,28,637,44,4892
"12057013208",4138,173,80,0,313,0,639,10,5353
"12057013305",3837,212,111,13,312,0,775,13,5273
"12057013307",1948,282,516,37,489,0,789,178,4239
"12057013310",1707,110,575,0,195,21,581,43,3232
"12057013311",1654,419,287,6,215,61,364,151,3157
"12057013312",2835,454,537,49,629,18,704,230,5456
"12057013313",3651,469,578,0,387,0,652,224,5961
"12057013314",1997,427,172,0,309,27,405,373,3710
"12057013315",2046,150,801,183,389,53,643,91,4356
"12057013316",1128,548,446,116,217,7,554,283,3299
"12057013317",1251,79,380,53,142,170,379,84,2538
"12057013318",1769,107,626,124,699,49,656,94,4124
"12057013319",3501,225,928,99,650,119,1105,205,6832
"12057013320",2031,306,724,32,466,228,578,264,4629
"12057013321",4444,474,1899,95,569,125,1516,250,9372
"12057013322",4503,490,1232,412,766,29,2151,142,9725
"12057013406",843,202,202,55,70,27,289,68,1756
"12057013407",5155,153,675,13,608,11,923,11,7549
"12057013409",3374,258,431,46,566,73,565,117,5430
"12057013410",2821,200,691,277,1132,104,1034,55,6314
"12057013411",1488,302,35,0,142,44,139,17,2167
"12057013412",2622,259,296,64,379,56,453,96,4225
"12057013413",3047,230,157,66,206,0,376,0,4082
"12057013414",4667,275,352,0,841,25,752,37,6949
"12057013415",3016,119,304,0,474,19,451,43,4426
"12057013501",1726,646,841,218,418,229,1056,572,5706
"12057013503",1383,722,785,227,522,201,1171,789,5800
"12057013504",1919,694,660,112,485,10,1707,597,6184
"12057013505",1033,393,997,482,384,269,948,527,5033
"12057013602",1133,302,7,90,160,165,521,385,2763
"12057013604",543,423,19,12,49,72,94,224,1436
"12057013702",3918,586,2785,463,715,164,1474,407,10512
"12057013703",2547,137,1367,245,999,416,1520,365,7596
"12057013704",4861,719,1851,451,1176,361,1434,701,11554
"12057013801",1241,808,158,59,296,301,893,611,4367
"12057013802",1802,667,300,21,360,56,495,373,4074
"12057013803",912,441,0,0,142,79,298,156,2028
"12057013804",5012,719,2433,168,991,376,2619,662,12980
"12057013806",792,249,14,0,227,30,220,74,1606
"12057013807",3748,381,1338,110,953,134,1818,441,8923
"12057013903",2968,302,7,0,169,106,285,106,3943
"12057013907",1643,168,16,15,430,10,354,84,2720
"12057013908",5695,630,1187,83,1259,37,2312,101,11304
"12057013912",1927,470,362,41,456,199,650,414,4519
"12057013913",2894,830,631,244,894,882,1928,1516,9819
"12057013914",2448,521,10,0,476,473,2079,874,6881
"12057013915",4046,183,1622,164,1556,14,1283,101,8969
"12057013916",5470,167,2306,0,1348,117,2053,71,11532
"12057013917",4756,212,1568,0,1095,0,1883,23,9537
"12057013918",1377,514,9,25,187,17,209,52,2390
"12057013919",4259,398,732,0,727,15,1005,47,7183
"12057013920",2548,435,69,51,705,26,676,133,4643
"12057013921",2241,48,68,0,177,0,264,5,2803
"12057013922",5369,216,158,0,530,66,747,88,7174
"12057013923",4408,350,322,0,327,98,766,181,6452
"12057014002",1447,473,0,0,315,618,437,813,4103
"12057014003",1237,96,55,0,99,0,208,0,1695
"12057014007",1761,135,791,39,496,6,898,6,4132
"12057014008",3201,198,0,14,0,0,0,0,3413
"12057014009",1476,53,6,0,25,0,93,0,1653
"12057014010",2247,240,0,0,8,0,56,27,2578
"12057014011",2932,247,73,0,26,0,227,15,3520
"12057014012",2567,112,46,0,8,0,0,0,2733
"12057014013",807,315,33,0,87,78,234,245,1799
"12057014014",1972,102,22,24,0,0,19,64,2203
"12057014015",1454,23,0,42,11,23,31,16,1600
"12057014016",812,16,20,0,0,0,35,0,883
"12057014104",1207,195,0,4,91,1,127,24,1649
"12057014106",2103,629,93,1,127,64,179,290,3486
"12057014108",3164,1224,181,140,748,246,1517,766,7986
"12057014109",2744,498,671,19,1082,647,2082,823,8566
"12057014117",2654,142,0,0,101,11,123,0,3031
"12057014118",3313,169,142,45,91,64,140,79,4043
"12057014119",3111,453,731,57,561,15,709,80,5717
"12057014121",3384,116,854,0,252,0,611,7,5224
"12057014122",2206,295,704,0,552,328,1172,499,5756
"12057980100",0,0,0,0,0,0,0,0,0
"12057980200",0,0,0,0,0,0,0,0,0
"12057980300",17,0,0,0,17,0,0,0,34
"12057980400",34,0,0,0,4,0,0,0,38
"12057980500",17,0,0,0,0,0,17,0,34
"12057980600",0,0,0,0,0,0,0,0,0
"12057980700",0,0,0,0,0,0,0,0,0
"12057990000",0,0,0,0,0,0,0,0,0
"12057990100",0,0,0,0,0,0,0,0,0
"12059960100",3216,759,76,47,101,115,53,121,4488
"12059960200",3660,1785,42,0,38,45,12,34,5616
"12059960300",1940,626,0,18,219,11,20,0,2834
"12059960400",3160,1285,167,144,108,68,7,55,4994
"12061050100",4482,1661,597,88,252,119,347,270,7816
"12061050200",2609,561,39,116,73,0,183,165,3746
"12061050301",2529,286,107,136,168,37,160,7,3430
"12061050302",1466,676,1646,1476,99,0,322,641,6326
"12061050401",2250,783,570,46,157,0,163,206,4175
"12061050402",1638,239,0,0,26,47,52,0,2002
"12061050501",4531,140,112,0,38,0,282,0,5103
"12061050503",4268,129,0,0,44,0,104,12,4557
"12061050504",1489,21,0,20,8,1,20,2,1561
"12061050505",3058,205,9,0,97,0,33,0,3402
"12061050601",1662,317,44,61,100,0,111,62,2357
"12061050602",3943,785,143,46,90,78,315,95,5495
"12061050603",3337,385,838,188,118,99,857,30,5852
"12061050604",1280,92,101,0,19,0,39,13,1544
"12061050605",1572,218,0,0,27,0,58,0,1875
"12061050606",7217,1092,2265,803,471,116,1677,157,13798
"12061050702",4739,399,207,67,270,82,403,82,6249
"12061050703",8461,490,151,108,390,21,671,105,10397
"12061050704",2150,371,0,5,104,12,39,12,2693
"12061050705",4079,307,103,26,30,14,220,51,4830
"12061050802",7474,388,399,1,191,42,619,24,9138
"12061050804",4411,643,225,53,620,29,431,35,6447
"12061050805",3000,341,316,442,46,1,332,51,4529
"12061050806",4262,570,293,0,87,109,265,0,5586
"12061050807",3822,554,149,0,74,0,364,26,4989
"12061050808",3306,462,196,8,42,59,208,171,4452
"12061050902",4257,229,178,0,0,0,189,0,4853
"12061050903",5619,673,218,0,143,21,628,94,7396
"12061050904",4377,1780,82,94,909,804,3224,1958,13228
"12061980000",0,0,0,0,0,0,0,0,0
"12061990000",0,0,0,0,0,0,0,0,0
"12063210100",1271,386,682,141,30,0,5,43,2558
"12063210200",425,76,539,244,26,0,44,0,1354
"12063210300",2303,736,663,72,52,62,98,193,4179
"12063210400",1823,522,564,356,61,39,62,34,3461
"12063210500",2407,144,521,1025,173,0,14,0,4284
"12063210600",2253,1275,1505,777,156,66,0,1,6033
"12063210700",2378,278,528,171,46,77,48,56,3582
"12063210800",1915,303,784,362,117,5,87,0,3573
"12063210900",2940,433,279,218,30,159,68,266,4393
"12063211000",4104,399,137,54,94,49,48,20,4905
"12063211100",2869,617,194,43,107,1,70,41,3942
"12065250101",1986,195,1230,527,31,130,119,24,4242
"12065250102",2469,103,767,266,9,0,31,29,3674
"12065250200",2425,336,903,295,31,10,60,33,4093
"12065990000",0,0,0,0,0,0,0,0,0
"12067960100",973,284,0,0,2,0,126,59,1444
"12067960200",4059,732,419,258,136,151,223,323,6301
"12069030102",2395,1121,0,0,45,10,244,282,4097
"12069030104",1191,258,32,63,34,48,17,79,1722
"12069030105",6306,1087,373,19,373,13,760,132,9063
"12069030106",1000,262,0,4,32,0,127,31,1456
"12069030107",4084,1531,180,0,64,20,117,241,6237
"12069030108",3421,441,93,24,164,0,548,86,4777
"12069030203",7218,590,348,266,305,0,697,63,9487
"12069030204",2368,1156,446,10,207,96,276,844,5403
"12069030206",1624,594,1218,740,190,38,419,191,5014
"12069030207",3733,696,179,0,100,187,44,187,5126
"12069030208",3203,487,656,7,235,223,183,37,5031
"12069030209",1649,551,12,47,90,17,145,77,2588
"12069030302",2687,478,269,20,171,37,109,0,3771
"12069030305",2286,212,28,0,19,13,35,26,2619
"12069030306",3279,417,69,0,26,0,66,53,3910
"12069030307",3150,593,253,0,67,46,124,242,4475
"12069030308",3151,700,114,7,20,0,261,19,4272
"12069030405",3233,518,250,169,228,310,48,0,4756
"12069030406",3066,512,345,13,40,8,212,32,4228
"12069030407",1745,573,400,8,254,18,153,73,3224
"12069030408",3425,199,62,0,55,0,224,0,3965
"12069030409",4029,295,0,0,42,0,0,0,4366
"12069030410",2763,105,283,61,70,52,19,0,3353
"12069030411",4298,1552,46,104,77,0,126,569,6772
"12069030502",3750,479,925,410,145,363,159,117,6348
"12069030503",558,307,385,86,21,0,96,200,1653
"12069030504",3561,427,814,1036,486,5,717,53,7099
"12069030601",2935,288,459,55,154,113,310,14,4328
"12069030602",844,316,422,370,7,54,170,196,2379
"12069030701",1697,99,289,0,15,12,51,0,2163
"12069030702",2780,670,459,64,451,10,216,188,4838
"12069030803",2634,452,265,123,140,32,61,32,3739
"12069030804",971,168,13,70,27,16,54,16,1335
"12069030805",2154,244,188,183,286,8,121,111,3295
"12069030806",2534,168,209,96,22,0,126,0,3155
"12069030807",2562,200,252,198,320,205,419,177,4333
"12069030902",10827,448,799,0,1171,50,1555,28,14878
"12069030912",3912,736,558,46,438,37,488,365,6580
"12069030913",1485,68,0,0,0,0,66,3,1622
"12069030914",2564,611,1055,358,83,15,288,114,5088
"12069031000",6300,740,210,23,326,75,814,231,8719
"12069031101",6425,778,169,0,95,0,101,11,7579
"12069031102",6767,161,115,15,224,0,324,0,7606
"12069031103",1458,159,22,0,36,0,102,56,1833
"12069031202",4770,641,172,145,710,58,1279,74,7849
"12069031203",4827,608,439,217,245,0,1231,98,7665
"12069031204",8821,1086,1759,32,664,55,1658,286,14361
"12069031205",1465,807,4,13,473,48,899,288,3997
"12069031301",5041,296,214,0,384,41,961,8,6945
"12069031305",4229,867,819,104,715,542,805,453,8534
"12069031306",4373,494,633,17,397,146,779,52,6891
"12069031307",12600,1486,1646,385,1894,151,3267,504,21933
"12069031308",4635,46,543,19,906,0,860,0,7009
"12069031309",8331,577,651,63,935,0,2486,86,13129
"12069031310",10868,1655,1303,52,1343,127,2689,176,18213
"12069031311",11091,2029,1907,97,1587,320,4696,1450,23177
"12071000301",1985,860,209,201,152,538,870,1027,5842
"12071000302",1975,1474,664,413,699,142,2097,1341,8805
"12071000401",1373,724,157,15,346,120,899,610,4244
"12071000402",1571,347,32,0,35,45,415,86,2531
"12071000502",115,172,1723,971,23,92,35,160,3291
"12071000503",892,656,1744,486,359,31,906,533,5607
"12071000504",1072,524,376,86,233,151,728,608,3778
"12071000600",137,167,2522,1745,85,47,26,114,4843
"12071000700",469,403,502,678,137,114,209,175,2687
"12071000800",1244,221,33,8,10,0,16,55,1587
"12071000900",2522,88,0,0,254,0,196,0,3060
"12071001000",4728,890,269,0,425,68,867,551,7798
"12071001101",1247,563,593,416,81,222,302,457,3881
"12071001102",1343,555,525,506,153,0,309,265,3656
"12071001201",2790,574,1279,1108,714,264,1379,387,8495
"12071001202",7669,605,286,89,737,0,1309,97,10792
"12071001300",1578,562,126,218,122,0,627,213,3446
"12071001401",3340,824,423,168,235,347,995,857,7189
"12071001402",2489,139,0,0,66,0,68,7,2769
"12071001501",2497,84,29,0,24,0,82,7,2723
"12071001502",3205,1429,52,403,411,255,1581,1224,8560
"12071001601",3444,339,146,0,360,119,417,221,5046
"12071001602",2778,206,0,0,70,17,74,9,3154
"12071001701",2183,271,0,0,102,0,63,23,2642
"12071001703",3628,259,84,2,163,35,194,34,4399
"12071001705",2613,193,42,0,7,15,72,15,2957
"12071001706",2922,358,29,0,19,0,263,74,3665
"12071001707",4253,678,101,26,325,0,258,0,5641
"12071001801",3946,545,10,0,92,41,183,138,4955
"12071001802",1920,230,20,0,9,0,32,0,2211
"12071001903",2904,125,0,0,0,0,77,0,3106
"12071001906",5237,1050,252,136,109,167,802,502,8255
"12071001907",5012,267,192,20,607,13,396,13,6520
"12071001908",778,51,0,0,0,0,0,0,829
"12071001910",1923,330,0,0,10,0,51,0,2314
"12071001911",910,66,0,0,17,0,10,0,1003
"12071001912",1478,133,30,0,70,0,38,0,1749
"12071001913",1438,95,0,0,17,17,0,17,1584
"12071001914",4308,492,0,0,0,0,409,105,5314
"12071001915",2554,106,0,0,33,0,0,0,2693
"12071010102",6450,1041,222,43,462,48,1039,306,9611
"12071010103",7037,1250,223,88,255,191,1481,585,11110
"12071010104",1838,101,0,0,6,0,14,0,1959
"12071010105",4225,526,186,25,108,0,417,162,5649
"12071010201",7679,1783,732,408,328,199,2094,774,13997
"12071010203",4358,1641,372,65,210,25,1178,788,8637
"12071010204",7442,1181,749,0,32,178,579,194,10355
"12071010302",3804,1416,360,136,210,8,1062,636,7632
"12071010303",5302,182,275,37,43,93,732,33,6697
"12071010304",7631,817,602,116,563,269,1685,314,11997
"12071010305",2928,705,9,128,38,0,163,306,4277
"12071010306",4256,915,84,34,245,9,1123,407,7073
"12071010307",4328,966,396,442,402,145,1202,715,8596
"12071010404",5573,935,39,33,349,77,1478,322,8806
"12071010405",6960,913,461,0,328,111,1436,579,10788
"12071010406",5137,235,42,13,344,54,763,40,6628
"12071010407",6589,559,64,0,380,26,909,66,8593
"12071010409",7443,1037,123,60,229,131,662,131,9816
"12071010410",10161,753,135,26,536,167,1412,263,13453
"12071010411",4103,544,39,22,426,0,538,338,6010
"12071010412",3539,654,81,0,129,0,538,218,5159
"12071010501",3005,398,39,9,135,18,539,168,4311
"12071010502",4138,195,207,17,310,57,556,26,5506
"12071010601",3530,757,17,24,275,0,680,143,5426
"12071010602",2055,256,114,11,115,0,237,92,2880
"12071010701",3604,418,57,0,22,0,201,133,4435
"12071010702",2215,137,39,0,20,0,99,10,2520
"12071010801",1969,381,96,0,58,0,151,122,2777
"12071010802",2475,800,0,0,143,23,328,231,4000
"12071010803",1588,203,17,0,85,5,146,0,2044
"12071020101",3957,254,0,0,172,99,280,32,4794
"12071020102",3772,436,173,0,56,59,688,90,5274
"12071020201",1133,283,0,0,0,0,50,46,1512
"12071020202",2289,228,0,6,56,61,289,63,2992
"12071020300",3329,1962,0,0,13,0,181,0,5485
"12071020400",2395,183,0,0,24,0,67,23,2692
"12071020501",2155,322,27,0,128,0,68,8,2708
"12071020502",3000,691,62,0,17,8,29,73,3880
"12071020600",1909,667,37,3,62,72,159,200,3109
"12071020700",2871,264,0,137,27,0,198,9,3506
"12071020800",2469,769,31,0,200,0,210,24,3703
"12071030100",2292,253,0,27,193,0,83,35,2883
"12071030201",859,57,0,0,34,0,19,0,969
"12071030202",4161,597,81,0,571,14,1329,76,6829
"12071030203",1276,235,139,0,18,0,27,116,1811
"12071030204",610,98,33,38,8,7,0,0,794
"12071030300",2049,112,53,49,51,71,73,30,2488
"12071040108",2666,213,204,0,215,7,146,0,3451
"12071040109",2468,1311,606,416,440,141,1323,674,7379
"12071040110",1083,105,159,0,336,0,115,14,1812
"12071040111",2111,264,0,0,25,8,7,0,2415
"12071040112",2233,62,61,6,621,8,487,0,3478
"12071040113",1577,37,0,0,38,0,40,0,1692
"12071040114",3891,298,12,0,195,0,95,7,4498
"12071040115",1829,230,7,0,4,0,561,49,2680
"12071040116",5091,294,511,47,238,0,633,44,6858
"12071040117",2894,66,39,0,478,0,110,0,3587
"12071040118",895,44,0,0,7,0,19,0,965
"12071040119",822,19,0,0,82,0,34,0,957
"12071040120",895,66,147,0,144,14,203,44,1513
"12071040121",1579,497,634,575,454,103,945,275,5062
"12071040122",2469,1006,1342,953,1177,157,2536,917,10557
"12071040123",3276,542,31,208,182,40,258,317,4854
"12071040124",3017,470,973,315,711,733,1590,1090,8899
"12071040125",1275,226,165,215,331,2,744,177,3135
"12071040126",1266,429,691,242,367,92,792,385,4264
"12071040127",1518,665,814,189,469,176,729,658,5218
"12071040203",6584,1048,1853,106,942,468,2967,600,14568
"12071040205",3505,478,613,194,151,64,650,412,6067
"12071040206",1229,69,0,1,32,0,75,3,1409
"12071040207",2996,215,507,82,258,86,595,139,4878
"12071040208",1013,430,170,33,155,77,284,175,2337
"12071040209",2202,481,579,14,158,66,434,363,4297
"12071040210",1338,161,176,128,352,0,414,65,2634
"12071040301",4026,746,1900,370,709,38,2598,522,10909
"12071040302",2015,738,833,182,265,235,1306,489,6063
"12071040303",3414,864,862,815,534,195,2021,708,9413
"12071040304",2853,766,281,332,597,206,1669,545,7249
"12071040305",1685,691,229,17,477,51,1185,361,4696
"12071040308",2149,921,702,228,341,70,1276,659,6346
"12071040309",3735,622,1649,39,430,63,1299,177,8014
"12071040310",1800,289,394,20,95,76,554,231,3459
"12071040311",2070,881,550,44,472,228,1326,616,6187
"12071040312",1176,107,251,46,37,38,379,52,2086
"12071040313",687,419,257,2,89,5,324,386,2169
"12071040314",1341,463,548,28,60,48,522,191,3201
"12071050103",777,216,0,0,52,0,13,113,1171
"12071050104",2201,285,0,0,59,0,120,0,2665
"12071050105",2104,25,0,0,20,0,23,0,2172
"12071050106",3196,197,0,0,24,19,188,0,3624
"12071050203",3997,284,103,0,131,50,249,0,4814
"12071050204",1733,74,41,0,98,0,214,32,2192
"12071050205",1223,218,0,0,214,0,313,28,1996
"12071050206",2507,189,9,0,366,0,483,100,3654
"12071050207",1840,123,37,0,90,0,111,0,2201
"12071050208",4207,1001,19,9,81,64,715,285,6381
"12071050209",7457,1307,82,35,675,161,2480,158,12355
"12071050305",2742,178,0,0,55,0,55,0,3030
"12071050306",1885,71,20,0,47,0,58,0,2081
"12071050307",4074,157,34,0,0,10,106,0,4381
"12071050308",5815,1809,40,70,370,348,346,1379,10177
"12071050310",4652,144,0,0,225,117,168,0,5306
"12071050311",5444,134,152,0,307,0,426,15,6478
"12071050312",2031,457,0,23,53,46,118,137,2865
"12071050313",4951,525,163,14,116,17,325,345,6456
"12071050314",3329,208,421,46,27,0,15,0,4046
"12071050400",6547,2247,146,0,1125,697,3298,2568,16628
"12071050500",4104,1515,148,16,567,168,2020,1468,10006
"12071050601",2464,259,6,0,41,0,92,31,2893
"12071050602",3895,362,30,2,342,299,499,292,5721
"12071060101",552,79,0,0,0,4,0,0,635
"12071060102",2012,341,22,0,50,0,118,0,2543
"12071060201",944,52,0,0,63,0,23,0,1082
"12071060202",1462,71,0,0,20,0,7,26,1586
"12071060203",1340,182,19,27,39,24,37,7,1675
"12071060300",1017,63,0,0,33,0,27,0,1140
"12071070101",1288,161,0,0,0,0,57,16,1522
"12071070102",2543,485,8,0,89,0,86,0,3211
"12071070200",3360,327,0,0,11,0,257,0,3955
"12071080100",57,84,12,25,0,0,8,0,186
"12071080202",2342,135,11,0,20,0,51,0,2559
"12071080203",1468,103,0,0,21,6,13,0,1611
"12071080204",2469,219,20,0,19,0,24,0,2751
"12071080300",1118,186,229,107,51,16,104,20,1831
"12071090100",613,63,45,80,42,13,0,8,864
"12071980000",0,0,0,0,0,0,0,0,0
"12071990000",0,0,0,0,0,0,0,0,0
"12073000200",3179,444,131,126,39,1,164,125,4209
"12073000301",912,41,375,55,101,14,54,14,1566
"12073000302",1592,201,266,160,72,77,31,74,2473
"12073000303",1007,316,1771,638,233,24,44,6,4039
"12073000400",162,8,375,501,0,22,26,11,1105
"12073000500",371,1021,137,138,28,56,33,213,1997
"12073000600",498,804,1123,1572,90,52,133,29,4301
"12073000700",1134,207,237,391,43,24,69,41,2146
"12073000800",2037,178,402,163,123,0,95,0,2998
"12073000901",4969,558,1286,502,841,205,537,0,8898
"12073000903",1040,200,712,194,48,1,67,0,2262
"12073000904",1958,249,710,25,169,0,202,34,3347
"12073000905",1418,189,812,325,282,59,121,26,3232
"12073001001",207,71,976,1599,57,130,60,80,3180
"12073001002",155,24,1228,859,0,19,12,0,2297
"12073001101",53,91,811,850,11,42,0,123,1981
"12073001102",95,0,1569,913,49,0,0,0,2626
"12073001200",26,92,506,763,0,3,0,3,1393
"12073001300",0,1,0,4,0,0,0,0,5
"12073001401",190,220,850,591,83,50,20,9,2013
"12073001402",632,1164,812,2040,80,511,28,192,5459
"12073001500",2233,710,1045,597,0,25,79,92,4781
"12073001601",2191,518,1023,793,481,66,489,219,5780
"12073001602",2855,95,168,6,188,0,89,2,3403
"12073001700",5308,368,679,130,254,35,302,40,7116
"12073001801",635,195,1960,1439,123,215,82,125,4774
"12073001802",1770,316,2912,757,350,16,273,31,6425
"12073001901",199,46,1183,697,335,246,53,28,2787
"12073001902",722,410,1509,1279,142,18,60,0,4140
"12073002003",340,206,280,546,22,40,86,29,1549
"12073002004",1360,2921,1151,1217,320,310,494,418,8191
"12073002005",698,1669,160,230,46,130,161,279,3373
"12073002006",1096,1440,385,582,79,194,96,234,4106
"12073002101",1910,1084,1262,422,237,0,33,51,4999
"12073002103",972,1555,873,436,39,122,133,256,4386
"12073002104",1789,3399,1224,1225,210,455,379,600,9281
"12073002201",1817,370,1162,1690,96,0,250,26,5411
"12073002205",2523,410,1460,722,314,52,163,15,5659
"12073002206",2057,75,899,0,174,9,219,0,3433
"12073002207",1209,209,508,290,11,0,0,0,2227
"12073002208",3261,274,1535,58,140,23,137,23,5451
"12073002302",2185,113,753,58,131,0,45,0,3285
"12073002303",2152,92,1457,245,61,55,160,37,4259
"12073002304",1449,613,810,220,169,48,156,102,3567
"12073002403",1439,170,736,171,304,66,110,26,3022
"12073002408",6505,166,624,0,489,0,385,0,8169
"12073002410",3627,561,1495,52,464,37,199,200,6635
"12073002411",1128,82,27,24,107,0,19,0,1387
"12073002412",7989,171,420,0,812,53,462,0,9907
"12073002413",2282,40,153,21,53,0,60,11,2620
"12073002414",4172,125,183,2,0,7,249,0,4738
"12073002415",3566,42,224,0,303,0,359,0,4494
"12073002416",2568,34,281,0,52,0,73,0,3008
"12073002417",5752,230,478,0,1049,23,512,0,8044
"12073002505",2801,415,1103,250,399,0,335,46,5349
"12073002507",1683,70,611,52,59,48,57,48,2628
"12073002508",6348,426,2076,155,431,34,721,34,10225
"12073002509",1201,312,888,223,317,64,167,84,3256
"12073002510",3832,174,1292,50,477,0,268,10,6103
"12073002511",837,24,229,98,122,0,7,0,1317
"12073002512",2792,86,335,26,244,0,204,0,3687
"12073002513",3599,26,463,63,539,35,43,0,4768
"12073002603",1794,236,1626,541,126,37,59,0,4419
"12073002604",2098,146,226,110,62,19,92,2,2755
"12073002605",3428,107,745,27,620,0,216,0,5143
"12073002606",2863,33,411,0,63,0,84,0,3454
"12073002701",2475,719,1246,178,115,106,269,74,5182
"12073002702",3711,558,85,141,204,56,379,220,5354
"12075970101",1248,226,105,158,56,117,201,27,2138
"12075970102",5008,2010,623,110,145,50,850,311,9107
"12075970200",2511,765,305,315,137,70,151,88,4342
"12075970301",1114,177,0,0,0,8,0,24,1323
"12075970302",5307,1046,25,17,41,92,295,0,6823
"12075970400",1912,525,11,0,31,18,120,0,2617
"12075970500",5876,1236,232,115,181,0,628,51,8319
"12075970600",1875,468,1192,261,168,73,137,79,4253
"12075970700",2315,664,11,37,48,43,81,26,3225
"12075990000",0,0,0,0,0,0,0,0,0
"12077950100",2107,147,11,0,23,0,0,0,2288
"12077950200",2687,685,426,299,245,106,266,104,4818
"12079110100",1991,447,506,107,110,0,153,0,3314
"12079110200",1522,643,1173,431,35,19,21,57,3901
"12079110301",1058,259,399,190,52,0,66,0,2024
"12079110302",768,201,1681,1086,52,39,33,0,3860
"12079110400",2534,584,378,240,109,23,301,33,4202
"12081000101",961,188,86,9,16,25,77,1,1363
"12081000103",1371,670,1181,536,284,302,970,645,5959
"12081000105",1713,1556,376,351,327,173,723,1127,6346
"12081000106",1546,1347,754,278,144,584,1187,1716,7556
"12081000201",2459,937,116,22,215,84,101,17,3951
"12081000202",2512,569,214,0,31,18,126,140,3610
"12081000304",1846,345,120,170,86,0,598,222,3387
"12081000305",2672,1671,584,724,826,682,2611,1956,11726
"12081000306",3208,1849,375,467,78,381,1122,1329,8809
"12081000307",1623,648,81,0,550,0,422,340,3664
"12081000308",3216,225,146,212,300,20,113,37,4269
"12081000309",2240,631,767,257,160,219,574,421,5269
"12081000310",2702,1187,65,112,291,162,760,832,6111
"12081000403",1499,61,0,0,30,0,24,0,1614
"12081000405",2528,82,0,7,88,9,311,0,3025
"12081000406",3300,264,109,0,78,42,295,1,4089
"12081000407",3554,251,0,0,38,0,100,0,3943
"12081000408",4198,541,86,25,433,9,390,106,5788
"12081000501",2689,350,250,0,80,17,165,0,3551
"12081000503",2768,299,384,3,93,0,76,4,3627
"12081000504",2760,495,62,11,117,6,167,83,3701
"12081000601",1593,624,208,278,318,26,431,65,3543
"12081000603",2762,393,39,7,20,114,600,224,4159
"12081000604",2045,896,111,262,31,74,459,455,4333
"12081000703",892,218,1045,333,58,24,465,195,3230
"12081000704",2609,873,1197,991,223,31,1648,632,8204
"12081000705",1897,695,1665,763,295,44,936,434,6729
"12081000803",5674,613,1457,640,505,3,1627,408,10927
"12081000804",3152,259,30,0,344,0,172,30,3987
"12081000805",3875,833,213,241,811,42,485,584,7084
"12081000807",5630,177,101,0,306,84,890,0,7188
"12081000808",5029,524,126,0,161,0,114,72,6026
"12081000809",4534,348,182,0,190,0,836,21,6111
"12081000810",5229,203,207,0,41,0,269,0,5949
"12081000901",3268,532,251,97,285,173,430,415,5451
"12081000902",3553,340,268,0,603,66,699,50,5579
"12081001000",3809,656,38,216,332,12,646,159,5868
"12081001104",2900,281,79,0,450,0,353,62,4125
"12081001105",2483,392,436,166,236,32,130,55,3930
"12081001106",2574,227,434,53,143,59,438,53,3981
"12081001107",2916,262,349,0,60,0,34,0,3621
"12081001108",2150,248,0,4,18,2,90,49,2561
"12081001202",3885,522,22,2,83,19,211,129,4873
"12081001203",3809,754,11,4,258,31,468,84,5419
"12081001204",4996,209,188,0,259,29,39,0,5720
"12081001300",2385,540,35,0,4,0,228,225,3417
"12081001402",1340,293,0,0,0,0,33,225,1891
"12081001403",3721,920,40,0,114,0,732,479,6006
"12081001404",2542,295,338,56,119,112,465,112,4039
"12081001501",1339,720,1284,563,94,16,910,542,5468
"12081001502",2247,761,1894,323,350,410,1360,953,8298
"12081001601",3638,456,498,45,72,0,573,202,5484
"12081001602",2525,362,60,0,34,0,114,0,3095
"12081001701",1281,147,0,3,42,25,115,11,1624
"12081001703",1482,112,0,0,46,117,13,0,1770
"12081001704",672,40,0,0,11,0,0,0,723
"12081001800",3851,671,118,2,30,19,50,45,4786
"12081001904",3926,552,35,0,22,69,74,202,4880
"12081001907",3804,605,379,0,205,13,254,134,5394
"12081001908",5354,654,84,61,206,0,351,64,6774
"12081001909",2833,136,106,0,96,0,66,0,3237
"12081001910",3660,195,131,9,408,0,170,9,4582
"12081001911",5597,133,288,20,526,12,976,0,7552
"12081001912",3899,247,331,27,325,0,291,55,5175
"12081001913",2874,72,72,6,142,13,263,29,3471
"12081001914",1911,452,74,28,423,15,506,266,3675
"12081002003",3563,225,389,33,330,54,324,5,4923
"12081002005",4554,358,186,0,88,0,471,0,5657
"12081002007",5006,375,318,0,187,0,229,0,6115
"12081002008",4863,184,29,15,0,0,146,0,5237
"12081002010",2488,292,0,110,248,151,341,208,3838
"12081002011",3114,480,308,223,301,11,753,159,5349
"12081002012",3908,250,39,68,235,15,118,16,4649
"12081002013",10797,499,318,0,359,99,792,26,12890
"12081002014",3842,155,0,8,97,0,79,0,4181
"12081002015",5215,472,65,0,200,0,549,7,6508
"12081002016",5681,686,186,0,185,0,177,247,7162
"12081002017",3245,400,87,0,171,21,397,134,4455
"12081990000",0,0,0,0,0,0,0,0,0
"12083000100",3399,855,462,302,72,0,290,6,5386
"12083000200",3545,857,1375,703,271,59,316,78,7204
"12083000301",2912,446,351,68,157,46,172,26,4178
"12083000302",1673,742,621,460,35,9,288,184,4012
"12083000401",1774,353,22,18,213,15,153,0,2548
"12083000402",3816,963,0,0,77,20,55,64,4995
"12083000501",1393,259,0,0,0,0,143,0,1795
"12083000502",945,296,0,0,14,35,0,93,1383
"12083000601",2882,856,3,30,21,96,69,142,4099
"12083000602",4400,969,0,0,87,54,58,14,5582
"12083000604",2418,1384,0,8,0,79,184,238,4311
"12083000605",1687,866,59,1,19,0,39,1,2672
"12083000701",2740,1318,328,135,112,108,181,68,4990
"12083000702",6767,380,82,0,154,20,355,62,7820
"12083000801",13127,632,385,10,303,0,352,49,14858
"12083000802",9023,656,0,48,35,107,315,107,10291
"12083000901",4027,1093,173,0,113,52,782,235,6475
"12083000902",6699,1614,130,0,544,246,1334,788,11355
"12083001003",714,541,30,6,87,11,123,160,1672
"12083001004",7924,1940,2545,276,1080,622,4196,1068,19651
"12083001005",3986,414,2235,71,194,0,367,209,7476
"12083001006",7840,492,690,96,660,296,1435,287,11796
"12083001007",4758,91,298,184,328,0,794,11,6464
"12083001008",3850,234,166,0,57,0,216,36,4559
"12083001102",2073,398,161,19,53,6,197,32,2939
"12083001103",4091,558,745,59,499,12,796,107,6867
"12083001104",3999,1063,383,10,434,0,408,221,6518
"12083001204",2750,1420,1798,744,269,46,952,705,8684
"12083001205",2859,479,261,14,68,0,270,56,4007
"12083001206",968,372,418,17,103,114,87,268,2347
"12083001207",6492,1637,2076,665,872,308,1854,883,14787
"12083001208",2931,513,194,59,38,0,186,59,3980
"12083001301",4182,501,591,0,245,108,576,0,6203
"12083001302",5108,520,423,62,0,24,464,81,6682
"12083001401",2258,926,764,956,149,78,165,183,5479
"12083001402",3275,651,298,233,235,17,261,64,5034
"12083001500",788,381,1502,776,42,7,167,29,3692
"12083001600",1020,436,259,61,220,127,368,279,2770
"12083001700",933,740,1943,1619,35,458,404,923,7055
"12083001800",35,42,586,1215,16,8,0,8,1910
"12083001900",1203,274,193,243,23,22,67,201,2226
"12083002001",1712,580,249,80,144,7,278,100,3150
"12083002002",2164,701,230,625,163,14,224,22,4143
"12083002100",4017,218,73,18,83,20,372,36,4837
"12083002201",2811,372,162,0,46,20,198,45,3654
"12083002202",3299,140,1,0,32,0,95,66,3633
"12083002203",5528,585,288,282,145,20,245,61,7154
"12083002301",3988,664,572,74,354,20,244,129,6045
"12083002302",5045,171,757,254,52,0,238,62,6579
"12083002401",3454,436,309,158,144,12,335,0,4848
"12083002402",3671,441,133,251,645,34,142,215,5532
"12083002502",8420,1233,109,27,1874,39,1422,230,13354
"12083002503",3646,901,700,0,107,766,428,986,7534
"12083002504",2795,639,836,753,210,14,246,293,5786
"12083002601",3938,1423,535,82,273,426,381,390,7448
"12083002602",4097,2013,214,190,178,43,660,1436,8831
"12083002604",2718,370,186,0,92,16,261,92,3735
"12083002605",2374,269,122,22,142,24,138,17,3108
"12083002606",5564,620,0,0,62,0,71,26,6343
"12083002701",4156,1562,15,0,73,42,375,162,6385
"12083002702",5136,818,393,171,214,7,73,22,6834
"12083980000",0,0,0,0,0,0,0,0,0
"12083980100",0,0,0,0,0,0,0,0,0
"12085000100",2176,131,12,0,31,0,36,0,2386
"12085000200",2617,240,231,11,103,17,72,28,3319
"12085000300",4843,665,133,404,150,37,354,61,6647
"12085000400",6930,832,15,0,60,0,353,2,8192
"12085000501",3312,845,50,43,71,23,88,21,4453
"12085000502",1930,54,26,0,47,0,117,0,2174
"12085000603",4993,213,74,0,429,52,401,0,6162
"12085000604",5155,158,0,0,239,14,255,0,5821
"12085000606",4743,312,40,0,36,11,405,0,5547
"12085000607",2616,101,31,0,81,0,114,56,2999
"12085000610",3638,87,36,0,207,0,90,22,4080
"12085000700",3075,441,78,1,65,0,68,10,3738
"12085000800",637,232,732,289,80,23,73,89,2155
"12085000901",1859,130,30,1,0,0,19,0,2039
"12085000902",3522,536,27,130,49,19,415,157,4855
"12085001000",2811,554,374,294,557,584,800,601,6575
"12085001102",5938,399,0,2,337,0,125,99,6900
"12085001103",1978,92,13,0,178,0,262,0,2523
"12085001104",7470,466,83,0,420,59,1096,184,9778
"12085001200",1224,425,43,68,302,42,546,160,2810
"12085001301",3890,1109,344,89,1143,370,2163,1037,10145
"12085001302",3785,245,186,32,66,11,43,31,4399
"12085001404",4715,207,322,152,141,197,270,197,6201
"12085001406",3116,263,122,21,23,8,98,0,3651
"12085001407",1709,122,0,0,0,0,13,0,1844
"12085001408",2249,592,356,204,133,64,376,379,4353
"12085001409",3096,237,0,0,89,0,113,0,3535
"12085001410",3768,326,366,93,515,109,402,216,5795
"12085001500",3197,142,85,20,67,0,282,13,3806
"12085001601",3884,240,0,52,151,11,105,23,4466
"12085001602",1152,6,0,0,7,0,145,0,1310
"12085001700",8228,639,105,64,463,122,488,183,10292
"12085001801",2345,828,923,617,1917,529,2751,1418,11328
"12085001802",866,742,16,138,173,327,277,893,3432
"12085990000",0,0,0,0,0,0,0,0,0
"12085990100",0,0,0,0,0,0,0,0,0
"12086000107",2166,457,111,0,146,17,876,325,4098
"12086000109",1738,798,693,79,179,183,1304,780,5754
"12086000113",6268,926,170,0,310,45,2239,228,10186
"12086000115",2161,264,105,0,96,18,1016,108,3768
"12086000118",787,326,0,0,24,27,190,137,1491
"12086000119",3322,274,262,183,52,0,1445,19,5557
"12086000120",3433,598,162,7,504,0,1426,207,6337
"12086000121",1477,184,74,7,88,0,499,0,2329
"12086000122",2988,659,79,0,80,35,771,254,4866
"12086000123",3156,503,140,0,43,0,873,246,4961
"12086000124",610,467,639,419,258,46,672,294,3405
"12086000125",2662,432,254,100,186,45,1269,147,5095
"12086000126",1615,498,27,23,116,0,719,193,3191
"12086000127",2763,297,58,11,172,13,1269,155,4738
"12086000128",1706,127,136,30,73,9,1060,85,3226
"12086000129",1801,34,0,0,0,0,445,0,2280
"12086000130",2136,247,0,34,13,0,578,96,3104
"12086000131",2453,70,12,0,32,0,1079,36,3682
"12086000132",4013,964,109,0,148,87,1384,596,7301
"12086000133",6282,376,140,0,281,0,2233,157,9469
"12086000134",2183,375,46,81,200,33,1350,301,4569
"12086000140",2693,425,209,0,156,115,1886,226,5710
"12086000202",3652,1131,1047,841,675,158,2276,958,10738
"12086000204",884,209,2947,820,239,27,769,220,6115
"12086000206",1351,387,2859,1136,163,23,1251,338,7508
"12086000209",820,509,3086,1597,347,82,788,406,7635
"12086000211",1773,336,630,11,243,51,1042,167,4253
"12086000212",1015,380,1689,1153,140,13,1024,377,5791
"12086000213",2327,576,2230,777,96,25,1004,229,7264
"12086000214",2894,968,1168,326,257,136,1211,666,7626
"12086000215",739,130,2019,878,405,0,730,81,4982
"12086000216",1113,164,2894,849,146,14,1114,85,6379
"12086000217",644,183,3353,1542,588,270,971,456,8007
"12086000218",471,103,2096,905,142,50,444,63,4274
"12086000219",917,345,1212,1482,101,251,772,396,5476
"12086000220",1133,379,2845,735,195,119,995,403,6804
"12086000301",923,322,3715,991,459,0,989,245,7644
"12086000302",664,109,1619,104,335,0,717,30,3578
"12086000305",618,411,4363,1440,376,66,634,425,8333
"12086000306",756,314,2635,1263,76,0,532,189,5765
"12086000307",1309,129,2506,888,276,42,1384,256,6790
"12086000308",1431,154,3004,1083,354,20,1389,146,7581
"12086000402",150,216,2209,1384,0,0,133,71,4163
"12086000403",461,570,3327,1634,57,0,437,614,7100
"12086000404",925,206,4799,663,171,101,1250,332,8447
"12086000405",878,205,2543,708,253,10,966,205,5768
"12086000408",528,319,2280,941,64,109,575,471,5287
"12086000409",531,681,2686,814,201,189,732,761,6595
"12086000410",1216,221,2690,238,167,118,1311,350,6311
"12086000411",571,111,3624,1758,188,149,1016,291,7708
"12086000412",2047,726,2297,1074,107,297,2077,925,9550
"12086000413",1022,133,2274,1195,212,0,757,172,5765
"12086000414",770,279,2591,1311,86,52,392,300,5781
"12086000501",1688,1575,2930,974,119,40,2042,1564,10932
"12086000503",1779,1254,1698,2479,196,140,2011,1847,11404
"12086000504",1595,832,1822,476,276,0,1887,827,7715
"12086000505",4561,1448,32,10,20,79,4414,1524,12088
"12086000601",3526,1557,38,0,105,24,3481,1508,10239
"12086000602",3638,1654,7,11,13,0,3411,1541,10275
"12086000603",3933,1277,25,22,13,0,3656,1271,10197
"12086000604",4467,1664,20,20,243,0,4622,1633,12669
"12086000605",2933,1148,66,139,127,24,3014,1279,8730
"12086000607",4041,1601,11,0,24,24,3933,1592,11226
"12086000608",4471,2580,79,84,66,55,4382,2599,14316
"12086000705",2953,1338,19,3,543,13,3464,1335,9668
"12086000706",5839,1786,134,110,362,0,6197,1896,16324
"12086000707",5874,1024,183,158,147,208,5836,1355,14785
"12086000708",4377,1964,228,33,460,141,4935,1771,13909
"12086000709",5177,1538,34,19,170,14,5381,1552,13885
"12086000710",3003,1726,29,44,48,0,2871,1758,9479
"12086000711",3050,1761,191,29,72,56,3101,1817,10077
"12086000712",1724,842,2,23,32,0,1739,709,5071
"12086000804",3376,1486,48,36,40,68,3325,1583,9962
"12086000805",4665,1160,159,0,44,7,4688,1118,11841
"12086000806",2858,1562,21,155,61,0,2913,1662,9232
"12086000807",1819,1956,20,151,120,30,1883,1998,7977
"12086000808",2228,1395,56,29,93,27,2315,1341,7484
"12086000901",4676,1366,760,144,216,88,4927,1459,13636
"12086000902",2470,1039,1721,352,38,28,2724,1216,9588
"12086000903",640,239,1159,429,124,60,776,316,3743
"12086001002",911,292,2989,1156,80,86,614,324,6452
"12086001003",635,253,2940,991,100,59,932,301,6211
"12086001004",500,329,2779,2880,62,39,414,480,7483
"12086001005",117,40,1127,292,8,216,75,265,2140
"12086001006",981,497,2069,1077,324,33,954,438,6373
"12086001101",1175,209,3162,707,241,124,885,275,6778
"12086001102",1436,515,2646,388,46,16,1061,489,6597
"12086001103",925,191,1636,793,157,56,844,156,4758
"12086001104",3220,341,1144,111,320,18,1412,215,6781
"12086001203",2303,881,2070,1990,257,15,1688,500,9704
"12086001204",3786,594,892,0,215,10,1828,357,7682
"12086001205",2469,125,412,82,252,17,883,79,4319
"12086001206",2960,816,50,239,426,0,1630,366,6487
"12086001301",1916,760,818,415,242,92,1112,705,6060
"12086001302",3387,331,1077,828,341,0,1832,290,8086
"12086001401",142,343,2706,1927,45,71,211,318,5763
"12086001402",699,287,2169,2987,279,26,540,218,7205
"12086001501",125,341,1331,2266,10,28,107,344,4552
"12086001502",104,83,1374,2110,0,223,104,340,4338
"12086001602",4543,1818,62,124,54,34,4314,1849,12798
"12086001603",2818,665,23,2,70,9,2812,672,7071
"12086001605",1498,1785,229,179,17,0,1696,1853,7257
"12086001606",3062,1388,107,16,20,48,3028,1452,9121
"12086001701",796,762,2234,912,43,0,885,665,6297
"12086001702",483,274,1318,453,12,6,479,297,3322
"12086001703",2869,1049,397,197,279,363,3450,1587,10191
"12086001801",354,231,1755,1977,11,0,333,349,5010
"12086001802",501,490,1685,1051,265,48,786,505,5331
"12086001803",208,328,960,1526,0,216,295,603,4136
"12086001901",21,230,2158,988,116,38,208,237,3996
"12086001903",213,188,2094,892,30,0,343,154,3914
"12086001904",169,28,2244,1317,82,158,261,186,4445
"12086002001",56,89,1614,1685,141,16,287,127,4015
"12086002003",167,388,1754,1110,126,12,157,387,4101
"12086002004",734,280,1196,791,40,6,752,258,4057
"12086002100",1546,562,556,13,131,0,707,336,3851
"12086002201",1402,192,1300,179,311,9,1180,141,4714
"12086002202",1176,529,2665,1686,188,157,1400,632,8433
"12086002300",516,286,2669,1283,91,68,623,267,5803
"12086002402",2563,1541,354,406,340,209,3024,1746,10183
"12086002403",2248,612,610,242,551,165,3108,998,8534
"12086002404",1824,1617,556,444,244,291,2369,2096,9441
"12086002501",1454,831,722,948,521,381,2068,1506,8431
"12086002502",1311,881,819,501,325,104,1780,955,6676
"12086002600",3411,1199,393,1018,335,335,2920,1418,11029
"12086002702",1927,611,266,319,212,9,1939,535,5818
"12086002703",4933,381,350,38,409,14,2595,353,9073
"12086002705",2150,505,78,163,84,0,1364,375,4719
"12086002706",2627,327,197,162,489,126,2146,239,6313
"12086002800",267,312,298,446,52,16,300,178,1869
"12086002900",3327,1286,780,385,559,384,4167,1710,12598
"12086003001",522,591,318,213,105,86,363,599,2797
"12086003003",3629,2189,304,413,56,14,3751,2292,12648
"12086003004",1980,1381,358,96,146,36,2091,1460,7548
"12086003100",337,156,1632,2013,105,62,501,380,5186
"12086003400",47,205,866,625,0,49,116,214,2122
"12086003601",562,927,812,1033,180,166,768,1055,5503
"12086003602",4150,2501,131,240,93,63,3999,2635,13812
"12086003702",2449,576,219,369,259,53,1558,364,5847
"12086003703",1040,215,197,0,118,47,494,68,2179
"12086003704",815,180,211,40,35,31,410,110,1832
"12086003705",945,96,16,0,90,0,649,46,1842
"12086003706",0,0,0,0,0,0,0,0,0
"12086003707",675,208,38,120,148,25,340,143,1697
"12086003801",4284,454,155,144,594,350,2108,472,8561
"12086003803",2031,389,25,0,232,0,1021,268,3966
"12086003804",5200,257,20,0,477,33,2011,146,8144
"12086003906",2884,185,49,0,104,5,718,100,4045
"12086003909",788,186,107,41,161,88,670,256,2297
"12086003911",1902,1184,109,209,1433,158,2766,1152,8913
"12086003912",2533,485,70,63,1113,350,2706,668,7988
"12086003913",2473,556,124,0,1412,166,3061,708,8500
"12086003914",1865,941,140,171,395,96,1269,862,5739
"12086003915",3225,1167,45,65,889,54,2595,970,9010
"12086003916",2310,531,414,94,816,72,2275,509,7021
"12086003917",3301,445,77,39,885,124,2854,478,8203
"12086003918",1635,263,75,0,578,105,1018,220,3894
"12086003919",1891,166,39,0,95,0,1024,137,3352
"12086003921",2018,369,29,0,310,0,1258,293,4277
"12086003922",2700,327,40,0,111,8,1338,214,4738
"12086004000",4139,483,60,61,511,75,1094,192,6615
"12086004102",2859,245,14,26,269,19,1013,142,4587
"12086004103",1595,272,666,69,572,84,1463,253,4974
"12086004105",1588,194,59,0,342,8,1142,58,3391
"12086004106",3272,350,104,36,342,53,1144,182,5483
"12086004203",3128,537,170,0,707,35,1220,207,6004
"12086004204",1470,164,26,0,324,20,996,51,3051
"12086004205",1577,284,46,0,599,92,1060,138,3796
"12086004206",843,146,95,27,271,25,802,162,2371
"12086004301",1207,94,111,0,413,43,782,65,2715
"12086004303",1079,1036,129,65,210,82,460,938,3999
"12086004304",1564,247,15,39,547,64,1006,303,3785
"12086004403",1541,690,112,81,457,34,1187,674,4776
"12086004404",1321,425,6,78,45,31,660,462,3028
"12086004405",1677,613,40,133,582,474,1452,1016,5987
"12086004406",1522,197,69,0,404,67,799,175,3233
"12086004500",2956,476,0,0,435,46,1470,328,5711
"12086004602",3922,166,0,49,94,48,2419,79,6777
"12086004605",3398,299,0,0,0,0,2051,264,6012
"12086004607",2834,171,0,0,210,0,1747,130,5092
"12086004608",1501,96,0,0,82,18,928,54,2679
"12086004701",4928,413,51,3,284,23,3295,244,9241
"12086004702",5237,986,237,0,129,1,4280,914,11784
"12086004703",3756,648,33,127,198,0,3291,733,8786
"12086004901",1929,1239,133,1,245,0,2113,1202,6862
"12086004902",5735,1294,21,10,255,32,5826,1325,14498
"12086005001",5479,1381,107,37,130,0,5488,1349,13971
"12086005002",3554,1718,152,5,108,13,3721,1721,10992
"12086005102",2731,1251,98,108,160,0,2557,1250,8155
"12086005103",1887,855,86,26,0,3,1955,875,5687
"12086005104",1971,1593,297,201,118,0,2117,1574,7871
"12086005201",3056,1858,304,185,353,0,3316,1896,10968
"12086005202",3434,1266,110,89,326,263,3729,1541,10758
"12086005302",2718,3212,176,191,101,37,2909,3390,12734
"12086005303",2220,1289,40,96,22,60,2254,1375,7356
"12086005304",2849,1632,83,86,191,86,3033,1741,9701
"12086005403",965,298,84,7,10,0,953,305,2622
"12086005405",2355,719,174,158,62,4,2359,866,6697
"12086005406",2062,1504,232,67,190,81,2464,1652,8252
"12086005407",1589,599,122,8,39,0,1600,604,4561
"12086005409",2234,1235,59,50,65,56,2288,1284,7271
"12086005410",2552,805,59,31,0,25,2557,853,6882
"12086005501",4417,903,328,64,271,156,4805,1087,12031
"12086005502",4178,2440,0,54,196,0,4236,2484,13588
"12086005600",4476,850,243,0,84,71,4424,909,11057
"12086005701",4600,1718,17,22,96,151,4651,1864,13119
"12086005703",5277,1459,44,0,336,26,5295,1453,13890
"12086005704",6555,2150,77,19,86,49,6615,2194,17745
"12086005801",6879,1050,311,17,103,30,7092,1002,16484
"12086005802",7526,2578,63,39,142,10,7409,2523,20290
"12086005901",3364,775,0,0,202,0,3183,746,8270
"12086005902",2867,886,77,0,91,0,2833,841,7595
"12086005903",4512,1061,18,0,157,0,4376,1001,11125
"12086005904",3719,509,11,19,205,19,3470,536,8488
"12086006001",5283,742,56,17,198,0,4559,673,11528
"12086006002",4542,555,82,19,128,31,4022,394,9773
"12086006101",5649,276,41,0,270,0,4238,163,10637
"12086006102",5638,364,38,0,141,0,3349,110,9640
"12086006201",1995,638,0,1,126,14,1810,651,5235
"12086006203",1440,235,0,2,257,4,991,196,3125
"12086006205",2935,387,221,77,304,74,2727,451,7176
"12086006206",2282,476,37,0,36,78,1551,299,4759
"12086006301",4962,1620,157,80,239,1,4833,1583,13475
"12086006302",3978,489,72,16,245,154,3825,575,9354
"12086006401",2762,767,134,28,177,95,2825,852,7640
"12086006402",3083,635,72,37,102,34,3092,650,7705
"12086006403",1984,1074,230,1,181,28,2020,1083,6601
"12086006501",2673,1164,0,24,143,26,2603,1113,7746
"12086006503",1954,456,73,0,301,5,1871,452,5112
"12086006504",2078,295,0,10,199,29,1897,287,4795
"12086006601",5499,1061,110,61,149,170,4745,1233,13028
"12086006602",2773,1393,89,60,545,0,2636,1369,8865
"12086006702",7322,1002,231,0,382,74,3677,595,13283
"12086006705",2448,311,62,0,65,63,1403,242,4594
"12086006706",1758,92,107,0,74,21,1080,56,3188
"12086006707",3935,248,0,0,132,0,2282,190,6787
"12086006709",676,118,47,29,183,6,349,17,1425
"12086006711",1954,189,214,0,274,14,1534,131,4310
"12086006713",1326,650,16,0,36,48,683,629,3388
"12086006714",1119,239,0,0,376,0,1094,182,3010
"12086006801",2375,362,28,6,71,17,751,279,3889
"12086006802",3250,323,20,2,148,0,1406,258,5407
"12086006900",4576,996,67,57,443,98,4020,1072,11329
"12086007001",7071,1600,261,34,687,118,7002,1579,18352
"12086007002",5596,1475,229,74,143,20,5544,1432,14513
"12086007101",1146,228,941,334,46,0,644,147,3486
"12086007103",1481,74,19,5,110,0,628,33,2350
"12086007104",2211,431,95,19,155,15,948,207,4081
"12086007200",540,94,1340,915,18,0,295,193,3395
"12086007300",3540,192,26,12,267,31,1447,97,5612
"12086007400",6436,334,0,0,408,0,4119,155,11452
"12086007501",2645,169,16,0,69,21,1682,88,4690
"12086007503",806,89,0,0,13,0,444,45,1397
"12086007601",2519,383,5,12,134,0,1774,168,4995
"12086007603",1443,558,1026,239,95,34,1023,243,4661
"12086007604",4647,279,140,0,209,167,2806,216,8464
"12086007605",3486,586,22,14,427,139,2156,323,7153
"12086007606",4382,461,723,24,334,104,3014,183,9225
"12086007701",5866,656,101,0,97,0,5294,570,12584
"12086007702",5786,429,21,26,349,42,4662,434,11749
"12086007704",3475,491,155,29,274,167,2888,314,7793
"12086007705",3913,390,131,0,201,0,3273,291,8199
"12086007801",816,99,8,4,19,0,414,93,1453
"12086007804",5692,538,108,5,444,287,4584,385,12043
"12086007805",4171,153,84,57,266,31,2717,109,7588
"12086007806",4072,137,47,26,258,30,2091,163,6824
"12086007807",3973,290,11,0,303,166,2172,201,7116
"12086007901",3079,241,84,29,112,16,1635,157,5353
"12086007902",3148,102,0,0,124,0,1477,40,4891
"12086008000",5426,211,529,0,185,0,3047,147,9545
"12086008101",3297,167,8,2,96,0,1064,31,4665
"12086008102",3917,219,29,3,871,106,1739,129,7013
"12086008202",2920,322,312,17,299,38,1260,204,5372
"12086008205",3898,31,73,0,251,0,1720,7,5980
"12086008206",3394,160,214,12,403,56,1420,163,5822
"12086008207",3916,59,37,16,167,0,1711,28,5934
"12086008208",2861,586,226,477,589,26,1836,427,7028
"12086008209",3893,124,382,0,464,0,1726,98,6687
"12086008304",1097,719,5166,1233,382,99,1125,812,10633
"12086008305",3917,407,583,13,461,12,2098,309,7800
"12086008306",4491,811,2487,544,656,13,3897,705,13604
"12086008307",2851,644,2639,585,287,77,2418,630,10131
"12086008308",2438,1073,1851,121,394,77,1938,924,8816
"12086008309",183,246,2375,1507,80,54,397,209,5051
"12086008405",5165,350,86,225,255,0,3034,281,9396
"12086008407",6363,483,44,12,455,10,4741,478,12586
"12086008409",4632,235,152,224,401,0,3053,168,8865
"12086008410",5489,186,32,2,278,27,3215,116,9345
"12086008412",4382,782,203,21,176,36,3814,678,10092
"12086008414",6081,570,413,4,541,0,4039,520,12168
"12086008415",4517,67,153,0,311,20,2362,28,7458
"12086008416",3034,121,14,0,212,0,2310,108,5799
"12086008417",3660,712,282,12,233,42,3342,621,8904
"12086008418",2204,308,33,118,118,67,2078,191,5117
"12086008419",3941,310,27,346,19,54,3443,321,8461
"12086008501",6166,1142,169,68,42,28,5643,1048,14306
"12086008502",4343,405,5,0,150,9,3779,336,9027
"12086008601",4030,523,8,49,69,132,3672,512,8995
"12086008602",5521,519,7,8,234,0,5055,468,11812
"12086008701",5143,908,0,11,44,17,4662,876,11661
"12086008702",5340,478,0,40,226,85,4828,437,11434
"12086008803",5070,1058,178,63,91,11,4951,1033,12455
"12086008804",5741,854,279,104,118,12,5555,936,13599
"12086008805",3895,1223,34,302,64,12,3864,1478,10872
"12086008806",3462,601,0,13,5,4,3199,553,7837
"12086008901",6774,490,78,0,42,0,6586,457,14427
"12086008902",5695,885,29,74,52,10,5452,905,13102
"12086008904",0,19,0,0,0,0,0,7,26
"12086008906",4205,784,20,199,110,16,4089,946,10369
"12086008907",3883,647,109,3,26,68,3623,470,8829
"12086009006",8224,1267,328,10,172,181,8035,1168,19385
"12086009010",4677,295,95,0,152,0,3800,276,9295
"12086009014",3573,399,36,10,202,0,3503,403,8126
"12086009015",3926,674,32,17,203,56,3900,691,9499
"12086009017",4466,1406,14,8,136,32,4480,1385,11927
"12086009019",4251,323,12,0,171,15,4279,316,9367
"12086009020",1737,1003,11,69,12,18,1697,1090,5637
"12086009021",3393,1228,47,22,55,14,3430,1194,9383
"12086009022",1668,324,11,4,128,12,1690,320,4157
"12086009023",5376,1526,76,7,223,217,5476,1516,14417
"12086009024",3764,616,78,0,347,32,3617,635,9089
"12086009026",1712,665,0,0,44,106,1615,651,4793
"12086009027",3366,743,11,0,372,6,3403,698,8599
"12086009028",3819,420,7,0,131,0,3650,385,8412
"12086009029",3356,447,6,10,86,0,3171,457,7533
"12086009030",3619,841,83,0,49,65,3605,781,9043
"12086009031",3064,653,13,18,228,8,3122,661,7767
"12086009034",6405,613,279,0,785,19,5508,533,14142
"12086009035",3988,678,125,40,282,74,3396,699,9282
"12086009036",6606,1150,70,20,485,41,5666,1105,15143
"12086009038",6512,793,266,0,436,29,5601,740,14377
"12086009039",4170,414,156,30,601,31,3820,353,9575
"12086009040",113,45,0,2,0,0,108,47,315
"12086009043",4005,748,157,15,127,0,3474,703,9229
"12086009044",1165,473,0,0,82,10,1096,467,3293
"12086009046",678,244,55,96,41,21,598,284,2017
"12086009047",2592,455,51,14,62,41,2281,449,5945
"12086009100",3957,1270,6,9,274,0,4084,1264,10864
"12086009200",2919,580,11,125,50,0,2816,669,7170
"12086009305",4395,405,83,0,216,16,3620,361,9096
"12086009306",4668,1110,35,138,293,35,4402,1233,11914
"12086009307",4254,1582,218,76,414,37,4591,1526,12698
"12086009308",4238,2948,21,318,260,93,4274,3286,15438
"12086009309",6169,1137,16,4,288,73,6338,1196,15221
"12086009311",4797,1260,10,19,158,9,4798,1236,12287
"12086009312",4088,623,208,0,117,47,3391,623,9097
"12086009313",4492,464,114,0,116,11,3657,372,9226
"12086009314",2864,1235,43,37,268,40,3058,1226,8771
"12086009315",2113,691,66,0,8,27,1999,646,5550
"12086009400",1507,643,3636,927,85,74,1474,689,9035
"12086009501",482,44,3554,1165,54,22,637,96,6054
"12086009503",340,74,3095,1019,67,0,508,73,5176
"12086009504",574,25,3412,1013,16,8,389,43,5480
"12086009600",592,221,5386,925,169,15,585,209,8102
"12086009703",3306,167,12,0,189,18,972,54,4718
"12086009704",4683,202,470,109,362,7,1717,127,7677
"12086009705",2856,1204,216,255,301,92,2106,785,7815
"12086009706",2945,403,264,89,66,93,1590,336,5786
"12086009803",2126,163,2154,275,189,29,1504,94,6534
"12086009804",1470,183,1374,162,301,0,647,122,4259
"12086009806",1025,608,1043,167,123,0,517,403,3886
"12086009807",1583,573,4239,931,105,26,985,285,8727
"12086009808",1706,383,1914,234,243,81,1444,239,6244
"12086009901",1379,134,6151,968,458,60,1316,65,10531
"12086009903",96,17,4363,657,16,22,178,0,5349
"12086009904",131,26,1888,651,115,38,269,68,3186
"12086009905",542,34,3914,1300,9,116,790,0,6705
"12086009906",734,58,4054,602,94,0,631,55,6228
"12086010001",575,631,3536,1812,382,0,978,598,8512
"12086010005",4368,1186,1308,192,419,101,4544,1203,13321
"12086010006",2896,1342,3832,598,184,11,3075,1359,13297
"12086010009",3392,1023,2169,1010,316,0,3555,990,12455
"12086010010",1958,304,1839,793,0,9,1945,381,7229
"12086010011",489,92,3636,1406,313,266,992,361,7555
"12086010012",88,11,3954,887,152,82,302,82,5558
"12086010013",2090,792,1461,96,303,38,2256,808,7844
"12086010015",2328,1242,0,47,141,232,2304,1218,7512
"12086010016",3135,772,568,184,258,3,3275,770,8965
"12086010193",2314,125,99,1,271,0,2072,70,4952
"12086010198",2919,192,346,17,215,0,2079,178,5946
"12086010201",3307,378,522,7,273,3,2641,328,7459
"12086010204",5537,686,602,265,240,25,4706,506,12567
"12086010205",2757,1200,865,303,211,0,2564,1166,9066
"12086010207",1244,684,1242,211,240,0,1233,682,5536
"12086010208",2294,617,1236,510,83,214,2233,678,7865
"12086010209",2895,641,754,642,376,30,2787,708,8833
"12086010210",3767,674,839,787,630,145,3868,741,11451
"12086010300",6113,1544,103,34,351,33,3596,714,12488
"12086010400",1894,556,548,349,72,4,1540,454,5417
"12086010500",5014,1502,2456,1361,125,0,3635,1318,15411
"12086010604",4253,365,151,25,326,0,1807,142,7069
"12086010606",5069,679,883,100,513,0,3385,596,11225
"12086010608",3864,535,962,78,455,26,2517,432,8869
"12086010609",2521,1133,1278,391,204,27,2200,847,8601
"12086010610",2367,591,460,70,225,27,885,615,5240
"12086010612",6626,920,1954,5,681,23,4792,610,15611
"12086010613",3443,598,661,35,464,17,2609,380,8207
"12086010614",4249,1068,1811,1345,486,60,3956,1171,14146
"12086010617",4004,432,746,146,653,80,3321,399,9781
"12086010703",6048,2842,2105,979,800,221,5955,2691,21641
"12086010704",5212,1753,2078,1296,628,131,5279,1560,17937
"12086010801",2586,1651,974,1184,432,215,2667,1662,11371
"12086010802",3037,926,1247,2115,381,184,2868,964,11722
"12086010900",2843,2038,642,267,281,137,2965,2023,11196
"12086011001",4355,3419,1649,997,145,98,4172,3367,18202
"12086011003",2349,901,357,505,175,153,2283,947,7670
"12086011005",3832,1292,1361,187,344,26,3941,1294,12277
"12086011007",5230,232,426,7,271,166,3321,361,10014
"12086011008",2798,217,810,7,227,0,2863,217,7139
"12086011009",3501,539,1048,175,515,57,2745,502,9082
"12086011101",3861,3028,1083,608,422,258,3698,3167,16125
"12086011102",5285,481,583,0,228,99,3151,333,10160
"12086011201",3909,1355,830,651,115,82,2456,1245,10643
"12086011202",4328,2167,259,154,299,0,3419,2052,12678
"12086011300",2399,1440,1858,2921,203,478,2359,1867,13525
"12086011401",8298,1907,3907,830,1439,27,6569,828,23805
"12086011403",2944,1987,512,1364,167,76,2492,1603,11145
"12086011404",2151,2252,605,482,233,67,1915,2254,9959
"12086011500",5884,363,57,0,119,112,3710,230,10475
"12086011600",4823,734,645,54,239,12,4497,671,11675
"12086011700",4586,1336,598,441,485,26,4772,1748,13992
"12086011800",2101,167,1074,23,151,65,2086,154,5821
"12086011900",4231,639,298,51,150,23,3631,648,9671
"12086012000",4714,2231,837,47,289,107,4968,2054,15247
"12086012100",10634,2516,748,484,852,460,10404,2430,28528
"12086012200",5155,368,39,6,80,0,4426,356,10430
"12086012300",5914,248,426,324,329,37,5886,442,13606
"12086012400",8259,827,556,92,196,164,7896,792,18782
"12086012500",5355,801,315,3,319,24,5794,796,13407
"12086012600",5522,1662,0,0,267,0,5473,1628,14552
"12086012700",6348,977,274,4,408,33,6038,1010,15092
"12086012800",7647,846,63,15,347,0,6948,833,16699
"12086012900",3583,625,201,8,66,0,3820,633,8936
"12086013000",4047,706,8,0,490,0,4164,650,10065
"12086013100",4032,1199,128,72,137,161,4216,1396,11341
"12086013200",4818,769,116,19,383,30,5154,684,11973
"12086013300",4441,1096,56,32,207,46,4551,1091,11520
"12086013400",4303,1297,122,20,391,158,4468,1466,12225
"12086013500",3732,1315,70,8,131,154,3861,1377,10648
"12086013600",3965,1722,43,20,97,77,4047,1819,11790
"12086013700",3360,1661,104,0,208,15,3533,1657,10538
"12086013800",5473,1591,90,55,125,30,5540,1582,14486
"12086013900",4162,426,71,6,185,35,4294,463,9642
"12086014000",111,33,0,0,9,9,100,42,304
"12086014100",0,0,0,0,0,0,0,0,0
"12086014200",4782,594,88,9,62,89,4747,590,10961
"12086014300",3301,324,0,12,74,0,3131,311,7153
"12086014400",3731,519,64,2,160,187,3814,496,8973
"12086014500",4060,568,0,23,43,0,3797,541,9032
"12086014600",5898,1646,107,72,69,39,5891,1634,15356
"12086014700",5221,1286,207,1,16,51,5283,1189,13254
"12086014800",4373,1304,188,1,117,0,4361,1259,11603
"12086014900",4981,463,90,1,74,11,4844,463,10927
"12086015000",7695,1169,13,27,174,0,7523,1130,17731
"12086015100",9118,811,203,14,534,121,8866,750,20417
"12086015200",6385,378,51,74,274,20,6273,366,13821
"12086015300",5231,494,0,28,97,0,5026,499,11375
"12086015400",4854,560,57,9,89,29,4815,571,10984
"12086015500",5671,722,36,51,101,13,5080,711,12385
"12086015600",3714,558,104,0,136,8,3148,492,8160
"12086015700",2196,193,43,5,55,70,1910,153,4625
"12086015800",3884,682,253,4,43,2,3771,650,9289
"12086015900",3505,723,0,4,62,0,3134,718,8146
"12086016000",4419,455,23,1,128,0,4119,428,9573
"12086016100",4310,725,50,0,174,6,4246,680,10191
"12086016200",2947,485,0,0,18,0,2646,409,6505
"12086016300",4625,390,124,19,354,10,4382,307,10211
"12086016400",5706,567,79,3,126,9,5569,562,12621
"12086016500",7257,634,503,25,822,60,7250,545,17096
"12086016600",3060,438,274,4,129,18,2974,435,7332
"12086016700",4916,627,37,15,108,164,4530,590,10987
"12086016800",3594,307,62,2,186,82,3150,388,7771
"12086016900",4239,539,23,0,213,5,4218,522,9759
"12086017000",4654,895,0,31,204,154,4474,1058,11470
"12086017100",5215,736,400,30,233,122,5335,736,12807
"12086017200",3766,311,82,28,80,0,3497,300,8064
"12086017300",3766,628,29,0,204,52,3403,663,8745
"12086017400",4799,1277,43,52,60,13,4183,1191,11618
"12086017500",3124,892,37,19,182,41,3112,853,8260
"12086017600",5984,759,2,2,333,57,5648,722,13507
"12086017700",2963,848,212,31,110,62,2899,838,7963
"12086017800",4376,1496,166,116,172,7,4483,1545,12361
"12086017900",7368,733,50,7,616,0,6241,613,15628
"12086018000",6110,1013,613,2,472,57,5666,1024,14957
"12086018100",4178,444,194,10,385,39,3472,434,9156
"12086018200",2027,293,143,0,69,37,1913,271,4753
"12086018300",4199,758,169,10,245,109,3579,610,9679
"12086018400",2993,540,188,0,160,65,2694,595,7235
"12086018500",3388,697,300,2,384,2,2533,689,7995
"12086018600",8126,303,354,69,287,144,6875,299,16457
"12086018700",4344,532,155,11,433,0,3884,467,9826
"12086018800",5966,1029,259,45,464,9,4552,979,13303
"12086018900",5569,1040,187,15,385,39,3312,829,11376
"12086019000",4952,509,187,115,328,0,4033,494,10618
"12086019100",3833,334,234,1,209,46,3078,194,7929
"12086019200",4304,414,453,75,485,82,3075,263,9151
"12086019300",5904,780,915,157,663,0,4074,555,13048
"12086019400",6855,403,329,174,520,37,5494,383,14195
"12086019500",5358,698,302,36,154,171,3952,567,11238
"12086019600",4134,901,591,23,760,0,3103,901,10413
"12086019700",3317,87,599,28,294,0,2419,78,6822
"12086019800",7307,564,523,2,435,0,6342,502,15675
"12086019900",8296,782,895,0,1021,0,8047,770,19811
"12086020000",5613,744,210,108,286,46,4977,564,12548
"12086020100",4145,402,227,14,381,10,3676,363,9218
"12086020200",2790,415,557,1,169,15,2759,430,7136
"12086020300",2755,475,213,45,131,5,2602,469,6695
"12086490100",1173,613,65,33,48,13,1254,659,3858
"12086980100",0,0,0,0,0,0,0,0,0
"12086980200",0,0,0,0,0,0,0,0,0
"12086980300",13,31,0,1,17,0,9,0,71
"12086980400",0,0,0,0,0,0,0,0,0
"12086980500",0,0,0,0,0,0,0,0,0
"12086980600",0,0,0,0,0,0,0,0,0
"12086980700",0,420,4,529,10,48,10,365,1386
"12086980800",0,0,0,0,0,0,0,0,0
"12086980900",0,0,0,0,0,0,0,0,0
"12086981000",0,0,0,0,0,0,0,0,0
"12086990000",0,0,0,0,0,0,0,0,0
"12087970200",837,147,8,53,8,14,52,27,1146
"12087970300",1963,292,26,1,63,0,749,2,3096
"12087970400",2908,729,90,12,208,39,1097,301,5384
"12087970500",2094,207,0,50,132,21,324,50,2878
"12087970600",1383,172,32,3,56,7,171,34,1858
"12087970700",2605,242,24,0,84,0,595,56,3606
"12087970800",3587,390,0,1,43,0,327,45,4393
"12087970900",1441,136,2,15,22,5,184,9,1814
"12087971001",981,79,114,2,17,0,110,2,1305
"12087971002",1074,288,22,24,0,16,237,83,1744
"12087971100",2192,496,94,209,166,114,553,261,4085
"12087971200",1848,376,21,4,0,0,547,200,2996
"12087971300",1094,419,76,141,0,9,650,313,2702
"12087971401",2682,295,37,10,97,6,240,53,3420
"12087971402",1436,116,35,0,22,0,214,61,1884
"12087971501",1588,200,20,0,19,0,171,0,1998
"12087971502",3069,211,0,0,106,0,478,0,3864
"12087971600",1824,49,99,0,127,19,200,12,2330
"12087971700",2334,359,115,141,193,0,817,255,4214
"12087971800",3042,450,714,0,237,260,1294,536,6533
"12087971900",4413,619,617,36,297,29,1681,296,7988
"12087972000",2774,428,318,57,30,57,723,113,4500
"12087972100",3226,418,434,44,194,36,677,93,5122
"12087972200",2850,235,152,31,209,0,392,93,3962
"12087972300",1849,324,57,3,19,92,399,32,2775
"12087972400",1860,394,494,199,30,0,257,89,3323
"12087972500",825,11,7,9,24,34,75,0,985
"12087972600",601,104,0,0,24,1,179,12,921
"12087980000",4,0,0,0,5,0,0,0,9
"12087980100",0,4,0,4,0,0,0,2,10
"12087990000",0,0,0,0,0,0,0,0,0
"12089050101",4305,479,1046,425,66,93,66,80,6560
"12089050102",2614,374,115,13,114,0,162,101,3493
"12089050201",1530,27,0,0,5,0,17,0,1579
"12089050202",5192,373,209,75,506,21,132,58,6566
"12089050203",2884,217,105,0,289,0,41,40,3576
"12089050301",6396,250,454,100,353,40,544,0,8137
"12089050302",5554,1097,233,14,138,11,158,3,7208
"12089050303",8743,2563,855,0,60,31,492,374,13118
"12089050400",6503,1203,330,160,162,105,144,0,8607
"12089050502",6504,545,114,0,200,0,160,0,7523
"12089050503",5385,930,473,23,52,28,110,22,7023
"12089050504",3635,455,28,0,88,0,92,0,4298
"12089990000",0,0,0,0,0,0,0,0,0
"12091020100",5977,796,114,15,389,67,101,52,7511
"12091020200",1337,212,162,80,87,41,78,13,2010
"12091020301",5506,425,81,59,782,182,724,228,7987
"12091020302",4154,360,71,25,84,13,36,0,4743
"12091020400",4068,915,438,69,182,86,59,3,5820
"12091020500",4968,1238,705,289,309,185,237,156,8087
"12091020600",6272,690,1941,478,877,0,433,28,10719
"12091020700",6104,1120,1196,156,912,300,473,47,10308
"12091020800",3350,362,349,0,396,52,221,16,4746
"12091020900",5086,367,362,32,388,0,198,7,6440
"12091021001",5167,342,137,0,433,0,537,0,6616
"12091021002",4432,209,211,0,136,0,303,0,5291
"12091021101",2441,291,210,0,378,6,60,8,3394
"12091021102",5733,794,387,165,824,248,401,16,8568
"12091021200",3183,729,118,0,791,27,355,114,5317
"12091021400",1090,97,106,11,313,31,298,41,1987
"12091021501",2776,277,288,0,408,103,325,83,4260
"12091021502",2732,419,202,173,505,25,317,0,4373
"12091021600",1680,84,66,0,142,0,82,0,2054
"12091021700",2154,453,86,0,233,14,247,14,3201
"12091021801",2836,335,536,263,988,145,326,129,5558
"12091021802",2987,370,306,115,402,392,283,349,5204
"12091021900",4856,537,1007,442,1140,1033,590,488,10093
"12091022001",1907,842,641,113,751,45,886,475,5660
"12091022002",2568,435,301,109,393,26,386,38,4256
"12091022100",1942,423,213,103,730,6,489,30,3936
"12091022300",1685,191,303,70,279,36,224,38,2826
"12091022400",3018,339,43,1,125,22,317,34,3899
"12091022500",2647,277,236,102,433,234,204,219,4352
"12091022600",1741,583,147,226,352,49,213,19,3330
"12091022700",2666,339,209,18,255,201,330,162,4180
"12091022800",1091,260,399,142,297,106,315,42,2652
"12091022900",3203,206,204,66,383,180,295,67,4604
"12091023100",4981,713,553,12,1117,24,531,137,8068
"12091023200",1621,93,24,13,43,89,127,79,2089
"12091023303",1151,224,4,0,19,3,42,0,1443
"12091023304",3539,178,8,0,476,8,287,41,4537
"12091023305",3334,160,8,0,269,34,251,43,4099
"12091023306",1999,171,93,1,247,62,166,29,2768
"12091023307",1366,154,30,6,220,0,35,0,1811
"12091023308",2416,156,0,0,312,0,95,4,2983
"12091990100",0,0,0,0,0,0,0,0,0
"12091990200",0,0,0,0,0,0,0,0,0
"12093910101",2686,1029,196,40,24,42,283,311,4611
"12093910102",2051,356,0,0,159,0,436,6,3008
"12093910201",2771,911,40,430,175,62,1536,456,6381
"12093910202",2087,1581,186,95,182,271,1299,1462,7163
"12093910300",690,381,534,355,0,29,152,199,2340
"12093910401",2238,685,0,41,34,47,192,10,3247
"12093910402",1356,655,0,0,143,378,320,738,3590
"12093910403",1688,834,0,0,88,3,87,95,2795
"12093910500",2794,1000,149,47,76,34,430,397,4927
"12093910601",3849,368,14,0,44,0,143,48,4466
"12093910602",1493,283,0,0,199,8,173,0,2156
"12093990000",0,0,0,0,0,0,0,0,0
"12095010200",3909,245,101,46,403,43,523,60,5330
"12095010300",1776,357,128,28,137,37,278,108,2849
"12095010400",83,12,508,529,22,92,47,107,1400
"12095010500",45,38,648,443,19,36,43,12,1284
"12095010802",2173,375,0,9,139,0,182,9,2887
"12095011000",1999,399,114,53,198,117,377,249,3506
"12095011100",2137,171,96,103,162,148,343,151,3311
"12095011200",2549,143,114,123,180,148,313,71,3641
"12095011300",3317,659,378,119,64,114,161,69,4881
"12095011600",963,167,1644,1304,189,203,387,334,5191
"12095011701",46,15,2400,1556,56,183,33,209,4498
"12095011702",40,21,2434,1168,34,33,42,40,3812
"12095012000",630,161,3694,1712,644,712,666,366,8585
"12095012100",464,358,3226,1307,872,269,1070,252,7818
"12095012201",654,158,2693,742,149,37,408,167,5008
"12095012202",706,82,2127,1269,693,193,552,177,5799
"12095012303",986,148,4374,957,912,219,602,0,8198
"12095012304",630,116,4254,1528,403,125,609,84,7749
"12095012305",959,448,3225,2148,1068,202,1158,576,9784
"12095012306",601,92,1507,512,468,139,508,147,3974
"12095012307",1156,281,3034,1447,298,359,463,324,7362
"12095012401",1370,158,4397,1670,603,114,836,107,9255
"12095012402",1011,707,2585,714,660,235,939,928,7779
"12095012403",1164,279,2167,839,456,0,586,51,5542
"12095012500",1708,307,30,34,58,41,188,81,2447
"12095012600",4047,403,175,21,134,44,432,62,5318
"12095012701",3759,371,116,63,413,0,365,0,5087
"12095012800",3181,134,23,0,219,42,147,48,3794
"12095012900",2318,166,17,0,175,41,193,31,2941
"12095013201",3087,677,46,144,211,181,1866,768,6980
"12095013202",3042,744,632,143,641,53,2381,758,8394
"12095013300",4456,1087,208,243,345,166,1883,986,9374
"12095013402",2586,366,165,76,468,86,2024,272,6043
"12095013403",2212,598,189,250,62,64,1493,585,5453
"12095013405",805,518,151,43,258,71,692,478,3016
"12095013406",1921,897,252,99,442,54,1404,727,5796
"12095013503",1082,806,250,72,83,38,820,676,3827
"12095013505",2487,1136,243,116,137,166,1507,1113,6905
"12095013507",3563,1369,711,218,640,277,2796,1273,10847
"12095013508",1289,873,207,114,204,81,1206,846,4820
"12095013509",902,148,131,0,34,36,380,109,1740
"12095013510",997,157,257,175,69,175,727,416,2973
"12095013511",3084,1254,99,50,431,99,1920,815,7752
"12095013512",2447,817,551,282,615,586,2386,1365,9049
"12095013603",3710,845,164,0,423,0,1783,447,7372
"12095013604",3809,795,544,197,595,114,1889,656,8599
"12095013605",2699,736,108,0,360,87,1180,423,5593
"12095013606",2308,612,187,53,443,290,1767,815,6475
"12095013607",4303,658,260,0,344,72,1278,526,7441
"12095013701",3417,1096,341,53,339,87,1427,962,7722
"12095013702",2856,862,661,146,663,127,1098,644,7057
"12095013801",1870,184,73,4,126,9,274,89,2629
"12095013802",2361,415,0,1,73,2,326,193,3371
"12095013803",2345,108,184,0,50,20,352,72,3131
"12095013900",3079,343,155,80,204,120,518,134,4633
"12095014000",5774,312,21,41,399,52,533,113,7245
"12095014100",4922,265,142,0,778,0,592,61,6760
"12095014200",4270,2210,1069,855,1498,175,2962,2283,15322
"12095014301",3030,496,825,341,573,92,1208,384,6949
"12095014302",1910,859,914,203,1283,171,2012,667,8019
"12095014400",1977,339,308,275,227,73,376,137,3712
"12095014502",806,435,1968,1439,186,38,655,341,5868
"12095014503",1101,286,652,570,121,17,487,194,3428
"12095014504",2438,281,967,53,322,67,1513,130,5771
"12095014601",552,178,3318,2096,620,493,859,689,8805
"12095014605",24,37,3124,1047,106,244,129,254,4965
"12095014606",2915,526,1450,775,1482,285,2256,472,10161
"12095014607",2424,307,1124,155,906,250,1280,255,6701
"12095014608",680,271,2370,894,265,2,362,14,4858
"12095014609",1804,291,2590,503,450,282,1034,285,7239
"12095014701",1509,442,1690,344,960,319,898,511,6673
"12095014702",2950,218,1333,147,507,114,632,228,6129
"12095014703",871,137,519,106,294,100,510,137,2674
"12095014704",6092,759,2193,264,2425,561,2388,258,14940
"12095014804",2465,837,1362,323,1441,258,823,363,7872
"12095014805",1736,103,1809,374,1272,289,1007,271,6861
"12095014806",3121,29,619,55,924,21,483,6,5258
"12095014807",3551,457,1511,67,1156,19,1115,64,7940
"12095014808",8904,163,794,21,1554,292,1017,191,12936
"12095014809",2217,35,124,0,287,21,66,0,2750
"12095014810",4124,353,421,13,587,23,457,92,6070
"12095014811",3992,747,326,0,517,35,468,193,6278
"12095014812",3582,605,752,38,783,63,974,145,6942
"12095014813",2507,476,286,44,569,98,565,292,4837
"12095014904",837,251,3308,1101,399,248,528,268,6940
"12095014906",3531,331,1450,263,814,71,917,85,7462
"12095014908",779,107,3702,438,573,214,469,222,6504
"12095014909",1000,43,1167,412,288,107,329,30,3376
"12095015001",970,218,139,28,83,323,578,447,2786
"12095015002",3063,591,252,248,1019,581,1690,685,8129
"12095015003",4054,429,530,10,550,307,877,477,7234
"12095015004",4708,228,2242,292,1471,23,1519,40,10523
"12095015103",3836,350,655,422,990,82,1093,146,7574
"12095015104",2706,338,1061,318,650,72,914,224,6283
"12095015105",1530,687,726,271,541,127,687,166,4735
"12095015106",1841,672,3198,902,973,174,581,581,8922
"12095015201",3694,696,1392,782,1480,85,1715,280,10124
"12095015202",2494,1216,716,1435,616,189,989,786,8441
"12095015300",2613,333,120,46,144,44,204,113,3617
"12095015402",1369,261,27,0,147,54,231,30,2119
"12095015501",3496,170,530,188,251,32,427,51,5145
"12095015601",2090,47,0,0,77,0,183,0,2397
"12095015602",2310,81,32,0,94,0,205,4,2726
"12095015701",1791,81,39,0,95,0,130,6,2142
"12095015702",1568,79,32,0,104,0,93,6,1882
"12095015801",1462,176,57,2,117,0,169,21,2004
"12095015802",2344,56,12,13,116,10,193,9,2753
"12095015901",916,152,580,323,19,18,204,42,2254
"12095015902",1166,99,58,22,111,67,115,29,1667
"12095016001",854,54,5,4,14,9,35,0,975
"12095016002",2130,75,0,0,244,11,259,11,2730
"12095016100",3423,207,178,0,382,0,123,120,4433
"12095016200",4470,870,577,294,249,11,726,116,7313
"12095016301",4046,760,327,74,800,161,904,160,7232
"12095016302",1992,829,305,184,573,133,932,441,5389
"12095016402",1592,333,288,104,280,64,872,344,3877
"12095016406",1028,298,64,36,409,78,514,86,2513
"12095016407",2558,842,273,819,571,169,1266,319,6817
"12095016408",1697,239,107,69,251,70,441,91,2965
"12095016409",2730,142,198,125,229,14,456,14,3908
"12095016410",4670,1209,788,167,1252,184,2943,579,11792
"12095016411",2034,497,327,28,220,73,847,312,4338
"12095016412",3405,618,329,5,509,43,1215,294,6418
"12095016503",2634,876,270,0,551,115,1026,118,5590
"12095016504",2816,743,331,127,751,227,1153,511,6659
"12095016505",1132,1022,174,49,383,7,261,300,3328
"12095016507",4681,840,636,51,601,204,1816,215,9044
"12095016508",3425,1762,659,217,680,555,1885,1170,10353
"12095016509",3090,658,28,14,229,8,634,80,4741
"12095016510",730,665,139,120,260,401,312,86,2713
"12095016511",1342,983,140,50,209,84,533,503,3844
"12095016601",7334,1223,420,336,1412,135,2421,163,13444
"12095016602",6604,1047,941,309,754,246,1790,110,11801
"12095016704",13755,841,1426,0,2477,115,7756,486,26856
"12095016709",3894,1433,578,10,466,675,3196,1614,11866
"12095016710",2894,602,502,28,689,267,2147,596,7725
"12095016712",4885,1577,445,86,838,629,3098,1490,13048
"12095016713",4917,1300,781,173,757,231,3564,1343,13066
"12095016714",2275,354,298,165,214,43,1273,384,5006
"12095016715",3368,1064,545,251,694,19,2413,720,9074
"12095016716",4744,149,409,22,257,34,1412,82,7109
"12095016717",1970,139,263,0,622,71,1409,71,4545
"12095016723",3284,435,609,16,591,114,1702,415,7166
"12095016724",3384,1452,598,13,599,49,2292,1199,9586
"12095016727",6829,2386,547,292,1761,227,3081,1654,16777
"12095016728",3754,400,405,25,383,16,806,92,5881
"12095016729",9092,1214,1643,79,2199,2625,4684,2174,23710
"12095016730",22715,863,2021,954,3480,175,9847,765,40820
"12095016731",2345,174,262,10,549,29,947,95,4411
"12095016732",10656,642,1810,0,2682,206,5803,494,22293
"12095016733",3798,288,622,58,1151,0,3018,211,9146
"12095016734",7014,1737,760,107,2755,12,4715,1465,18565
"12095016802",5502,358,371,0,1168,41,2735,102,10277
"12095016803",1445,257,252,72,536,124,998,239,3923
"12095016804",2301,524,421,12,734,224,1576,207,5999
"12095016806",6903,1581,1295,296,1715,308,5980,1371,19449
"12095016807",11200,2380,2247,159,3482,420,10527,2185,32600
"12095016902",1902,1333,837,303,688,100,1680,1187,8030
"12095016903",6363,1323,3321,1967,1719,801,4642,1495,21631
"12095016904",1362,196,1532,417,946,139,1470,255,6317
"12095016906",637,625,1798,849,161,101,531,489,5191
"12095016907",1524,1486,1959,817,297,317,1096,1508,9004
"12095017001",876,197,1571,384,173,0,349,115,3665
"12095017004",3387,440,149,0,702,102,490,146,5416
"12095017006",2272,89,171,275,1056,33,1188,241,5325
"12095017008",5108,654,913,18,2698,173,4282,615,14461
"12095017011",2569,378,804,83,1142,97,2057,358,7488
"12095017012",1763,83,297,113,760,187,767,18,3988
"12095017013",4097,1014,650,75,1131,543,2164,482,10156
"12095017014",7605,1114,1166,104,1712,167,4482,733,17083
"12095017015",5527,602,321,58,1052,0,2255,397,10212
"12095017016",6749,948,304,12,2086,334,2406,485,13324
"12095017017",3922,1239,163,315,645,295,1289,653,8521
"12095017103",9966,914,1757,131,2290,1761,2166,930,19915
"12095017104",15722,901,4716,191,4219,212,3816,123,29900
"12095017105",11886,314,510,0,2645,24,2158,9,17546
"12095017107",4356,436,239,0,2355,34,1178,54,8652
"12095017108",5225,1013,581,190,1328,192,1094,78,9701
"12095017109",4203,561,80,0,1243,83,439,0,6609
"12095017200",1921,270,657,114,318,92,436,141,3949
"12095017300",4925,701,1238,289,1822,1723,2275,1818,14791
"12095017400",5853,425,2109,85,2058,245,2549,331,13655
"12095017501",4937,767,1858,928,1028,59,1132,325,11034
"12095017503",3029,817,466,543,747,636,1616,1029,8883
"12095017504",4956,824,1950,279,984,246,2421,329,11989
"12095017600",1171,262,1905,871,354,140,717,238,5658
"12095017701",2905,575,1218,222,693,317,1113,691,7734
"12095017702",1740,108,162,7,161,16,284,13,2491
"12095017703",2241,910,488,235,615,116,1273,564,6442
"12095017802",9899,490,2073,727,1824,0,2646,370,18029
"12095017804",6424,618,1042,0,659,666,870,786,11065
"12095017805",1969,296,117,118,309,115,436,321,3681
"12095017806",3871,229,441,0,302,144,335,270,5592
"12095017807",2121,466,182,93,550,313,1108,446,5279
"12095017808",3144,126,321,2,244,0,554,0,4391
"12095017901",1869,320,341,79,336,148,646,235,3974
"12095017902",4461,1090,429,99,421,139,673,658,7970
"12095018000",788,302,988,290,275,101,187,115,3046
"12095018100",1745,166,579,120,341,191,238,32,3412
"12095018200",7375,746,496,797,806,20,1820,226,12286
"12095018300",515,197,955,411,478,107,520,133,3316
"12095018400",1522,288,50,7,147,237,576,111,2938
"12095018500",921,184,1188,901,302,28,311,14,3849
"12095018700",1245,258,1628,1771,225,33,351,69,5580
"12095018800",2513,234,193,69,302,55,373,40,3779
"12095018900",3420,759,1065,1497,440,106,631,244,8162
"12095990000",0,0,0,0,0,0,0,0,0
"12097040801",576,188,23,11,116,17,43,162,1136
"12097040802",4696,920,797,59,686,57,1758,347,9320
"12097040803",7171,609,117,117,371,28,689,51,9153
"12097040804",4277,810,70,99,461,280,1895,555,8447
"12097040901",3007,320,268,149,704,50,1691,121,6310
"12097040902",3640,2590,374,31,338,204,2715,1646,11538
"12097041001",6449,900,1110,2,1671,37,4907,527,15603
"12097041002",6615,1396,924,48,1203,184,5204,1115,16689
"12097041100",9110,2653,3919,1793,1834,497,7286,2739,29831
"12097041300",6846,2763,3470,745,1068,327,5834,2869,23922
"12097041500",7853,1825,1315,0,1792,140,5306,1458,19689
"12097041600",1604,952,357,416,218,134,884,632,5197
"12097041700",3287,1131,391,95,463,93,2072,736,8268
"12097041800",1256,900,140,331,262,76,913,551,4429
"12097041900",4029,1049,427,236,640,229,3619,1091,11320
"12097042000",3298,1802,781,186,725,1005,2998,2536,13331
"12097042100",5793,1293,637,384,1332,483,4669,1925,16516
"12097042200",5093,1578,569,305,755,657,3589,1815,14361
"12097042300",2533,798,782,281,1098,372,2170,867,8901
"12097042400",5681,799,664,215,993,169,3517,867,12905
"12097042500",5640,424,763,141,848,29,5009,432,13286
"12097042601",2415,221,501,18,315,219,2285,426,6400
"12097042602",6041,1968,1364,77,1442,772,6036,2314,20014
"12097042701",3936,988,997,414,1166,650,3937,1690,13778
"12097042702",4815,1304,214,285,1005,393,4823,1585,14424
"12097042800",6427,1691,560,98,1544,244,4262,1673,16499
"12097042900",9950,1970,971,659,2447,360,7493,1903,25753
"12097043100",2962,168,128,0,338,22,584,22,4224
"12097043201",40,0,0,0,4,3,16,0,63
"12097043202",428,7,0,0,15,0,46,0,496
"12097043203",3383,330,76,70,346,255,1538,234,6232
"12097043204",11515,1161,1851,76,405,1102,4856,918,21884
"12097043205",1419,122,0,0,69,0,129,18,1757
"12097043206",283,16,0,0,0,0,5,6,310
"12097043301",1495,76,0,0,49,5,157,0,1782
"12097043302",9265,639,952,320,1191,82,3053,461,15963
"12097043400",3821,910,55,44,72,197,701,522,6322
"12097043500",3648,1131,15,92,349,48,856,87,6226
"12097043600",4720,590,18,20,303,51,946,244,6892
"12097043700",4587,637,26,0,328,59,1419,147,7203
"12097043800",5259,1059,152,58,328,53,969,200,8078
"12099000101",6968,190,0,0,310,0,531,0,7999
"12099000102",2450,202,88,0,55,11,124,29,2959
"12099000202",5577,919,0,0,308,0,1689,574,9067
"12099000204",3371,484,43,0,193,221,461,278,5051
"12099000205",4576,456,38,132,194,24,1381,238,7039
"12099000206",5968,475,115,0,448,44,874,52,7976
"12099000208",4277,82,33,0,55,8,492,0,4947
"12099000209",5710,449,153,0,661,0,957,31,7961
"12099000210",3526,444,620,48,271,17,639,110,5675
"12099000211",3670,159,8,0,3,0,229,0,4069
"12099000213",1974,496,526,0,114,78,300,386,3874
"12099000214",6236,210,57,0,463,241,814,13,8034
"12099000215",6957,412,90,28,678,16,670,34,8885
"12099000301",3268,407,0,0,232,0,95,52,4054
"12099000303",4390,63,0,0,239,0,80,0,4772
"12099000304",4863,393,15,0,149,154,752,132,6458
"12099000405",2939,103,0,0,48,21,119,0,3230
"12099000406",2393,164,0,22,122,24,82,0,2807
"12099000407",1618,176,0,0,0,0,0,0,1794
"12099000408",3309,272,4,17,37,0,115,11,3765
"12099000410",3259,158,29,9,45,2,157,2,3661
"12099000505",2347,108,64,0,34,1,91,1,2646
"12099000507",740,28,0,0,0,0,0,0,768
"12099000509",1496,98,0,0,22,0,31,27,1674
"12099000511",2144,124,9,9,43,23,67,8,2427
"12099000600",1193,165,18,9,21,0,128,0,1534
"12099000702",2647,144,0,51,31,13,151,13,3050
"12099000703",3229,94,109,0,156,23,162,0,3773
"12099000802",2006,475,35,9,312,66,457,73,3433
"12099000803",2711,306,27,3,199,0,333,12,3591
"12099000804",2626,142,22,6,160,37,199,0,3192
"12099000902",1771,120,385,76,271,44,162,0,2829
"12099000903",3618,518,798,319,275,0,596,118,6242
"12099000904",2752,249,489,6,191,120,569,157,4533
"12099000905",3588,240,108,19,585,20,432,66,5058
"12099001002",881,350,3931,958,438,30,578,130,7296
"12099001003",3326,146,686,83,638,0,673,17,5569
"12099001004",3112,431,821,303,141,53,844,204,5909
"12099001101",1721,248,2302,1105,664,0,224,0,6264
"12099001102",2045,247,69,0,110,0,148,41,2660
"12099001200",804,152,2057,882,269,47,294,79,4584
"12099001301",846,240,2905,1022,357,134,423,250,6177
"12099001302",107,2,3103,1120,109,0,0,0,4441
"12099001402",160,210,1282,703,42,59,104,175,2735
"12099001403",0,19,1477,1731,0,5,0,0,3232
"12099001404",49,48,1967,1430,114,118,20,15,3761
"12099001500",372,76,2031,399,83,6,99,30,3096
"12099001600",1055,636,653,658,81,148,278,535,4044
"12099001700",2362,418,879,490,457,195,1052,389,6242
"12099001801",785,202,2640,1293,278,330,371,466,6365
"12099001802",2276,35,1352,221,271,0,547,28,4730
"12099001904",1315,232,1522,126,131,20,330,9,3685
"12099001907",1417,179,799,33,80,0,108,55,2671
"12099001908",3265,383,2495,376,610,39,1242,236,8646
"12099001909",935,559,370,276,200,106,596,490,3532
"12099001910",1246,170,54,107,41,17,316,61,2012
"12099001911",705,281,0,0,55,0,61,23,1125
"12099001912",1290,278,179,0,250,14,217,99,2327
"12099001913",1379,246,83,45,27,0,55,16,1851
"12099001914",1473,203,428,0,234,8,364,13,2723
"12099001915",3951,279,2020,76,490,36,1666,111,8629
"12099001916",1635,186,672,121,246,210,382,38,3490
"12099001917",1458,210,1520,461,242,74,454,132,4551
"12099002005",896,379,2098,397,154,104,400,188,4616
"12099002006",1154,275,1014,545,185,49,450,67,3739
"12099002100",106,83,2179,884,103,168,85,48,3656
"12099002200",8,43,887,779,110,32,96,34,1989
"12099002300",782,384,516,468,210,20,446,110,2936
"12099002400",209,39,1005,504,22,0,143,14,1936
"12099002600",952,159,22,25,34,6,180,82,1460
"12099002700",3379,679,287,61,127,163,318,137,5151
"12099002800",2120,442,481,67,383,29,658,330,4510
"12099002900",1238,1474,1085,876,433,176,1288,1481,8051
"12099003000",2669,859,938,677,454,434,1914,1133,9078
"12099003101",3798,1125,1143,781,414,196,2192,940,10589
"12099003102",1747,608,2021,1934,318,188,824,519,8159
"12099003201",2826,636,714,185,142,132,1688,489,6812
"12099003202",2358,606,1684,425,310,87,1433,415,7318
"12099003300",2926,1264,264,221,134,28,2255,1140,8232
"12099003400",2715,417,63,1,313,6,1028,216,4759
"12099003504",980,60,0,0,3,16,27,0,1086
"12099003507",2134,146,0,0,32,0,116,0,2428
"12099003509",2308,90,0,29,11,9,67,0,2514
"12099003511",1520,83,32,0,25,0,27,0,1687
"12099003600",4782,748,128,14,191,318,1787,732,8700
"12099003700",3349,1599,173,2,175,409,2259,1704,9670
"12099003800",4863,1170,458,75,350,84,3257,772,11029
"12099003901",3202,340,397,233,174,126,1203,204,5879
"12099003902",3697,913,1163,497,363,5,2320,660,9618
"12099004005",1998,244,449,19,445,0,1205,175,4535
"12099004007",2883,882,433,112,216,106,2026,632,7290
"12099004008",2716,658,1406,938,554,78,2522,472,9344
"12099004009",2031,1427,287,163,414,111,1930,1296,7659
"12099004010",1920,703,319,13,164,6,1030,609,4764
"12099004011",3493,1143,697,58,448,86,2284,1066,9275
"12099004012",2939,391,190,0,228,0,950,183,4881
"12099004013",2292,641,55,0,52,13,1029,305,4387
"12099004101",3475,797,532,159,182,33,2216,642,8036
"12099004102",2385,599,364,0,236,81,1900,521,6086
"12099004201",5768,1316,723,335,236,262,4038,1037,13715
"12099004202",2910,710,354,14,134,77,1604,520,6323
"12099004203",2064,340,221,71,92,7,872,223,3890
"12099004300",4938,443,294,0,232,1,1342,240,7490
"12099004401",2643,412,645,68,225,0,1515,361,5869
"12099004402",1840,1061,464,558,213,31,1302,886,6355
"12099004500",2460,1128,1002,783,257,170,1801,937,8538
"12099004601",2574,539,182,86,296,202,1606,491,5976
"12099004602",2365,1096,321,94,410,297,1891,1193,7667
"12099004702",3584,1245,502,229,272,151,2119,1055,9157
"12099004704",3574,1978,308,494,406,30,2822,1562,11174
"12099004705",2650,1065,665,166,367,160,1995,1083,8151
"12099004706",1270,364,674,26,156,0,459,303,3252
"12099004809",1108,183,77,0,44,26,166,46,1650
"12099004810",4251,417,12,0,214,9,806,253,5962
"12099004811",3228,57,142,26,128,2,645,29,4257
"12099004812",2809,320,3784,840,382,217,1698,342,10392
"12099004813",3126,91,1804,191,444,150,1533,35,7374
"12099004815",4042,375,1062,283,614,367,1480,368,8591
"12099004816",2730,404,148,6,138,26,368,119,3939
"12099004817",3266,742,39,13,5,16,874,567,5522
"12099004818",1453,260,246,9,251,8,316,38,2581
"12099004819",2355,620,684,144,330,203,1685,529,6550
"12099004902",1938,89,69,6,5,0,162,0,2269
"12099004903",1465,1491,1234,570,246,74,1308,1426,7814
"12099004904",2967,1408,812,221,391,47,2306,1080,9232
"12099005000",4261,718,48,41,357,67,2205,391,8088
"12099005101",1062,1010,253,123,218,155,966,935,4722
"12099005102",1895,929,1871,1212,345,173,1740,892,9057
"12099005202",1954,684,324,261,440,51,1325,400,5439
"12099005203",1236,378,110,113,252,12,311,207,2619
"12099005204",2443,465,240,288,104,42,996,369,4947
"12099005300",3384,552,206,30,81,38,390,140,4821
"12099005405",824,74,5,0,7,0,6,11,927
"12099005407",1430,136,13,0,60,4,25,6,1674
"12099005409",629,31,6,0,33,0,30,0,729
"12099005411",3027,233,3,3,15,21,150,14,3466
"12099005501",1893,713,525,331,139,38,427,298,4364
"12099005502",3371,636,1439,617,209,195,533,269,7269
"12099005601",2177,150,2547,233,475,35,1733,50,7400
"12099005602",2128,185,384,40,52,0,257,16,3062
"12099005701",1358,237,1224,978,201,10,295,84,4387
"12099005702",1372,453,2797,1286,390,117,343,106,6864
"12099005807",2797,589,524,103,291,0,955,107,5366
"12099005808",3189,359,645,57,497,89,486,38,5360
"12099005810",1388,396,11,0,35,0,78,127,2035
"12099005811",2696,231,179,0,266,0,260,12,3644
"12099005812",2387,463,446,52,129,185,812,320,4794
"12099005813",4157,509,343,265,492,26,1523,121,7436
"12099005814",2657,977,866,335,298,37,1979,716,7865
"12099005815",2504,159,1369,133,531,10,906,27,5639
"12099005816",4528,523,90,90,439,42,1415,107,7234
"12099005817",3068,138,1967,446,755,70,1157,106,7707
"12099005903",6567,381,531,0,845,22,1703,183,10232
"12099005915",3311,513,594,6,459,35,395,184,5497
"12099005916",4267,241,1399,510,972,29,1931,135,9484
"12099005917",3464,173,620,0,384,8,1153,83,5885
"12099005918",1944,295,293,164,281,0,545,29,3551
"12099005921",5989,305,599,46,452,10,649,0,8050
"12099005922",4634,314,216,0,139,0,565,18,5886
"12099005923",2714,405,149,37,64,9,120,192,3690
"12099005926",3235,301,510,207,44,308,136,0,4741
"12099005930",2613,372,399,26,124,100,246,68,3948
"12099005931",2454,424,33,19,10,0,66,37,3043
"12099005933",2575,247,0,0,27,0,110,53,3012
"12099005934",1961,184,193,97,15,10,112,0,2572
"12099005935",1737,227,8,0,61,0,65,0,2098
"12099005936",2377,210,311,321,0,43,198,13,3473
"12099005937",1417,165,0,0,69,0,41,5,1697
"12099005938",3147,191,53,0,162,0,270,0,3823
"12099005939",941,214,22,0,39,0,81,4,1301
"12099005940",1262,387,44,10,16,7,105,91,1922
"12099005942",1899,115,0,0,41,0,14,11,2080
"12099005943",1409,279,143,19,42,44,134,44,2114
"12099005944",1777,227,26,0,44,0,97,0,2171
"12099005945",4603,171,214,15,8,0,186,0,5197
"12099005946",6705,334,827,74,716,159,488,64,9367
"12099005947",4187,153,0,0,36,0,28,0,4404
"12099005949",3028,175,91,0,10,0,126,50,3480
"12099005950",3156,183,764,42,571,135,594,127,5572
"12099005951",2692,597,1589,303,54,72,774,83,6164
"12099005952",1306,31,6,0,6,0,6,0,1355
"12099005953",4101,211,165,266,149,0,432,0,5324
"12099005954",3388,321,239,0,0,0,29,0,3977
"12099005955",3737,199,123,0,158,12,308,0,4537
"12099005956",766,63,37,0,27,0,46,0,939
"12099006005",2848,157,425,44,72,16,269,40,3871
"12099006006",1935,278,126,0,0,0,76,0,2415
"12099006007",1342,230,1209,638,81,31,105,212,3848
"12099006008",2095,101,161,36,18,0,77,9,2497
"12099006009",1702,123,0,0,5,0,104,29,1963
"12099006010",1568,430,1242,49,157,40,563,132,4181
"12099006011",2085,144,310,130,158,15,416,33,3291
"12099006012",2940,248,645,56,194,9,738,99,4929
"12099006100",1038,249,1627,885,88,159,139,136,4321
"12099006201",1804,299,1589,876,161,15,546,48,5338
"12099006202",1622,424,106,100,114,32,413,30,2841
"12099006203",1223,155,394,126,20,170,40,170,2298
"12099006300",4131,403,513,506,388,0,1059,130,7130
"12099006401",1556,115,32,0,58,0,90,2,1853
"12099006402",3474,442,67,0,29,11,39,146,4208
"12099006501",921,151,430,107,200,82,306,131,2328
"12099006502",1621,502,975,432,82,81,80,75,3848
"12099006602",2999,157,0,0,171,23,234,0,3584
"12099006603",4244,236,116,0,22,0,276,0,4894
"12099006604",2074,245,1682,753,375,8,283,22,5442
"12099006605",3092,165,987,270,238,76,403,73,5304
"12099006700",276,61,1493,801,19,16,32,62,2760
"12099006801",867,211,2655,1236,415,200,813,310,6707
"12099006802",312,207,1783,1237,124,91,322,82,4158
"12099006906",3135,466,301,38,118,68,380,163,4669
"12099006907",2451,246,631,63,63,12,234,8,3708
"12099006908",2886,269,801,317,312,82,484,164,5315
"12099006909",1855,222,118,233,40,12,166,23,2669
"12099006910",1479,112,302,106,66,0,286,23,2374
"12099006911",2050,303,166,161,395,0,284,100,3459
"12099006912",2836,151,95,27,396,93,244,0,3842
"12099007002",3595,237,25,20,178,0,337,29,4421
"12099007005",3254,213,38,0,106,0,218,58,3887
"12099007006",3302,334,56,0,264,243,295,181,4675
"12099007007",3331,241,0,0,308,11,357,15,4263
"12099007008",3938,58,22,10,328,0,530,0,4886
"12099007009",2660,203,169,6,314,2,256,16,3626
"12099007010",1442,155,25,0,6,0,41,7,1676
"12099007011",2471,226,0,0,80,0,136,0,2913
"12099007100",10,107,0,59,0,19,0,38,233
"12099007201",5170,419,53,0,400,31,1039,222,7334
"12099007202",3167,418,63,22,430,90,272,173,4635
"12099007203",3751,971,493,105,440,157,761,399,7077
"12099007301",2706,228,351,139,332,62,271,99,4188
"12099007302",3951,350,190,28,386,128,677,50,5760
"12099007407",1447,94,68,0,14,0,45,0,1668
"12099007410",1442,71,7,8,57,0,92,0,1677
"12099007412",1141,89,0,0,36,0,61,22,1349
"12099007414",1734,201,44,0,52,0,83,9,2123
"12099007416",2734,213,90,0,61,0,193,11,3302
"12099007418",832,41,0,0,24,0,34,0,931
"12099007420",2561,228,0,0,69,37,71,0,2966
"12099007501",2139,179,441,159,162,129,268,142,3619
"12099007504",2603,243,87,56,75,45,200,146,3455
"12099007505",1864,314,196,58,39,0,72,11,2554
"12099007602",2413,371,522,118,892,124,1175,148,5763
"12099007603",2093,22,0,13,288,0,220,0,2636
"12099007604",6239,414,141,5,516,157,872,0,8344
"12099007605",3621,313,76,62,298,0,338,22,4730
"12099007607",4367,522,270,0,267,47,621,166,6260
"12099007610",4154,137,55,109,251,16,663,33,5418
"12099007612",3294,409,251,90,630,0,1186,180,6040
"12099007613",2936,329,123,16,394,10,971,168,4947
"12099007614",3485,276,0,7,432,2,509,60,4771
"12099007615",2823,459,236,109,540,33,610,317,5127
"12099007616",2746,174,0,7,27,6,164,26,3150
"12099007617",1308,81,0,0,36,0,29,0,1454
"12099007618",4328,247,190,0,30,0,294,15,5104
"12099007705",3941,157,194,19,191,26,804,33,5365
"12099007710",3178,263,497,66,468,19,439,94,5024
"12099007713",12564,256,1113,26,1512,10,2881,16,18378
"12099007716",3771,478,331,42,510,0,823,108,6063
"12099007721",3943,78,304,0,117,52,591,0,5085
"12099007723",2415,129,70,0,111,0,437,0,3162
"12099007724",4322,377,734,10,438,49,1001,148,7079
"12099007725",4502,368,524,8,359,67,823,168,6819
"12099007730",5402,156,0,0,734,31,1019,0,7342
"12099007731",3541,336,255,0,600,45,599,17,5393
"12099007732",3466,978,460,33,432,285,944,285,6883
"12099007733",2446,154,236,0,220,64,546,151,3817
"12099007734",2164,29,10,0,70,0,325,5,2603
"12099007735",4998,80,132,0,332,0,455,0,5997
"12099007736",3104,129,530,0,63,15,810,0,4651
"12099007738",2866,401,433,19,550,122,957,274,5622
"12099007739",2203,379,74,11,341,30,608,138,3784
"12099007740",3886,501,205,2,178,146,752,202,5872
"12099007741",3594,453,42,0,406,26,497,97,5115
"12099007742",3891,381,6,0,791,0,506,125,5700
"12099007743",3764,432,130,0,753,68,717,65,5929
"12099007744",2237,383,106,0,277,7,524,40,3574
"12099007746",812,169,41,16,6,101,38,157,1340
"12099007747",2576,270,0,0,14,0,77,15,2952
"12099007748",3725,348,102,0,526,0,536,0,5237
"12099007749",4044,405,276,0,514,28,509,78,5854
"12099007750",2778,581,825,21,251,0,1769,453,6678
"12099007751",2999,101,178,44,157,0,727,0,4206
"12099007752",5236,233,451,187,463,144,792,96,7602
"12099007753",5924,453,962,207,490,16,1287,16,9355
"12099007754",3937,191,130,21,113,105,255,0,4752
"12099007756",4384,215,214,0,331,1,381,71,5597
"12099007757",3357,215,372,0,258,0,343,10,4555
"12099007758",3647,846,564,445,317,189,1177,633,7818
"12099007759",1205,71,160,0,104,0,157,0,1697
"12099007760",2412,136,715,0,832,0,718,0,4813
"12099007762",1666,59,77,0,128,0,218,0,2148
"12099007763",4185,208,1727,460,405,0,990,24,7999
"12099007764",1551,32,34,0,87,0,190,19,1913
"12099007765",6422,124,1607,85,850,53,1844,0,10985
"12099007766",2127,522,288,189,254,117,353,314,4164
"12099007767",2582,157,383,114,485,72,895,46,4734
"12099007805",4781,209,173,17,271,0,515,24,5990
"12099007808",3843,486,717,46,491,0,930,141,6654
"12099007809",2797,208,55,3,38,72,282,71,3526
"12099007812",3252,513,1114,555,368,16,884,160,6862
"12099007813",4003,483,1171,143,753,99,1529,339,8520
"12099007814",1851,96,0,0,40,0,49,13,2049
"12099007817",5282,242,1815,78,343,146,1342,93,9341
"12099007818",955,97,92,0,70,0,30,0,1244
"12099007820",2221,425,129,39,74,18,446,38,3390
"12099007821",2497,152,108,0,61,4,503,38,3363
"12099007822",5458,361,175,0,36,0,340,203,6573
"12099007823",3477,222,145,0,83,0,343,0,4270
"12099007828",1410,33,101,0,86,0,304,6,1940
"12099007830",3229,67,35,14,150,0,320,13,3828
"12099007831",2672,190,329,0,364,35,283,26,3899
"12099007832",1683,276,416,118,48,7,525,165,3238
"12099007833",1152,444,1699,908,176,154,429,403,5365
"12099007834",1480,169,6,0,7,8,40,8,1718
"12099007835",3282,173,167,0,412,0,275,0,4309
"12099007836",4746,613,1685,0,566,17,1317,227,9171
"12099007837",4133,155,1219,39,459,0,752,68,6825
"12099007838",5438,240,1628,170,1006,29,1481,145,10137
"12099007839",4914,175,668,107,332,60,1130,39,7425
"12099007908",6330,316,1592,28,279,0,1495,26,10066
"12099007909",3473,87,109,34,180,22,73,9,3987
"12099007910",4875,549,1014,162,529,0,1356,1,8486
"12099007912",6287,853,1206,335,402,35,1278,207,10603
"12099008001",893,219,935,753,238,51,827,195,4111
"12099008002",1137,165,1406,1798,129,54,943,175,5807
"12099008101",3649,977,1045,246,261,12,2816,817,9823
"12099008102",0,0,0,0,0,0,0,0,0
"12099008201",227,218,1521,1577,19,24,166,167,3919
"12099008202",0,9,1144,1695,51,0,0,6,2905
"12099008203",1312,759,2126,863,236,96,1108,710,7210
"12099008301",362,252,346,552,73,0,435,264,2284
"12099008302",900,128,771,712,115,16,743,137,3522
"12099980000",0,0,0,0,0,0,0,0,0
"12099980100",0,0,0,0,0,0,0,0,0
"12099980200",0,0,0,0,0,0,0,0,0
"12099980400",0,0,0,0,0,0,0,0,0
"12099980500",0,0,0,0,0,0,0,0,0
"12099990000",0,0,0,0,0,0,0,0,0
"12099990100",0,0,0,0,0,0,0,0,0
"12101030101",1830,340,37,37,77,31,169,168,2689
"12101030102",1851,516,29,44,68,38,117,125,2788
"12101030202",2047,464,15,18,99,118,139,52,2952
"12101030203",1133,328,39,0,0,42,68,11,1621
"12101030204",704,260,38,18,65,30,47,23,1185
"12101030205",1725,358,0,0,73,23,85,21,2285
"12101030301",1648,376,20,0,46,12,207,213,2522
"12101030302",1599,343,149,19,140,0,262,53,2565
"12101030303",2648,469,49,13,268,14,78,245,3784
"12101030404",2292,440,19,11,90,12,195,10,3069
"12101030405",1363,433,0,67,100,13,106,24,2106
"12101030406",1533,409,8,7,103,0,218,37,2315
"12101030407",1894,534,0,11,0,51,63,72,2625
"12101030408",1687,489,0,0,158,0,106,58,2498
"12101030409",1896,422,200,0,110,45,357,36,3066
"12101030410",1237,270,38,0,155,11,88,36,1835
"12101030411",1999,313,167,59,268,40,254,32,3132
"12101030412",1679,528,115,87,11,0,600,140,3160
"12101030501",1080,242,0,1,46,55,94,115,1633
"12101030502",3160,859,54,130,223,17,369,88,4900
"12101030601",1729,240,4,0,67,0,107,15,2162
"12101030602",1525,739,181,43,211,41,376,224,3340
"12101030700",2818,945,247,11,67,132,567,181,4968
"12101030800",2373,492,132,16,143,23,308,57,3544
"12101030901",3029,692,35,15,38,9,259,133,4210
"12101030903",1742,524,8,0,154,9,103,55,2595
"12101030904",1887,496,0,176,166,43,181,42,2991
"12101030905",2674,283,69,0,75,0,159,108,3368
"12101031003",3827,1179,257,167,214,107,452,338,6541
"12101031005",2383,1036,34,63,214,47,421,73,4271
"12101031006",1033,604,32,78,98,25,174,191,2235
"12101031007",3651,874,20,0,152,106,575,82,5460
"12101031008",1541,543,18,0,69,0,98,105,2374
"12101031009",2163,733,123,0,112,19,310,29,3489
"12101031010",3142,985,66,0,219,241,444,280,5377
"12101031011",2158,328,0,19,38,3,138,58,2742
"12101031012",3517,671,95,0,287,231,490,229,5520
"12101031013",2394,487,236,148,47,25,359,44,3740
"12101031014",2482,438,45,1,105,89,243,148,3551
"12101031101",3189,868,0,0,49,94,161,318,4679
"12101031102",4007,508,56,0,60,23,122,88,4864
"12101031203",2010,218,0,0,0,36,11,24,2299
"12101031204",2523,103,84,0,81,0,49,0,2840
"12101031205",3283,441,0,0,103,79,155,77,4138
"12101031206",1909,951,0,0,78,32,186,174,3330
"12101031207",1534,444,0,0,113,0,75,11,2177
"12101031208",2781,233,100,14,271,13,329,0,3741
"12101031301",3006,244,25,0,139,5,143,29,3591
"12101031302",5312,336,0,0,317,6,384,47,6402
"12101031401",2032,1225,35,104,194,62,155,542,4349
"12101031404",2463,1224,57,28,79,119,207,172,4349
"12101031405",1397,349,52,7,65,29,207,73,2179
"12101031406",1745,563,18,59,25,116,79,78,2683
"12101031407",2050,267,12,0,84,43,136,36,2628
"12101031408",2068,420,0,0,7,0,59,127,2681
"12101031409",3875,1362,156,42,278,138,516,608,6975
"12101031503",2364,422,104,21,166,0,383,0,3460
"12101031504",1667,73,55,0,97,0,44,0,1936
"12101031505",5138,321,157,0,158,8,617,8,6407
"12101031506",3443,488,203,0,67,52,192,0,4445
"12101031507",5216,240,63,0,213,0,471,14,6217
"12101031508",3341,129,129,35,260,7,206,24,4131
"12101031601",3684,231,88,0,321,12,305,0,4641
"12101031602",5089,488,364,0,280,0,663,36,6920
"12101031603",6261,72,460,0,1097,87,2201,0,10178
"12101031604",4575,292,603,0,525,52,642,21,6710
"12101031605",2432,323,57,0,115,0,135,0,3062
"12101031701",1794,199,106,5,318,31,193,27,2673
"12101031703",3241,1204,37,31,224,89,58,26,4910
"12101031704",4883,241,149,0,60,0,487,0,5820
"12101031705",3536,201,0,0,205,0,312,11,4265
"12101031706",3025,88,51,0,105,0,149,0,3418
"12101031707",2883,312,21,5,96,0,284,0,3601
"12101031708",5116,272,114,25,115,19,577,0,6238
"12101031804",3073,463,0,1,55,0,22,88,3702
"12101031805",2725,588,14,0,94,10,162,96,3689
"12101031806",3967,662,0,0,79,29,398,27,5162
"12101031807",2181,865,73,26,34,11,164,48,3402
"12101031808",1589,671,46,27,110,11,120,30,2604
"12101031809",1712,803,40,28,73,9,124,9,2798
"12101031901",1855,206,7,0,70,0,183,4,2325
"12101031902",4527,419,188,0,510,20,698,0,6362
"12101031903",4313,336,589,19,552,66,1200,18,7093
"12101032001",4244,269,388,0,308,14,367,44,5634
"12101032005",2921,224,39,0,112,56,137,33,3522
"12101032006",5678,978,1004,49,465,42,1538,207,9961
"12101032007",2455,214,134,0,147,0,466,25,3441
"12101032008",3965,425,285,25,394,25,981,41,6141
"12101032009",5830,232,829,0,478,0,1428,12,8809
"12101032010",2673,116,69,0,260,14,514,61,3707
"12101032011",3824,181,547,31,347,8,776,88,5802
"12101032012",3284,171,177,159,224,33,1090,46,5184
"12101032013",4361,462,211,0,196,0,1123,131,6484
"12101032014",5441,152,741,28,711,0,1577,72,8722
"12101032103",4346,319,674,36,715,38,1332,110,7570
"12101032104",2891,397,492,58,596,0,795,272,5501
"12101032105",3335,60,951,158,809,119,928,52,6412
"12101032106",5785,252,549,29,1067,32,1509,246,9469
"12101032107",3621,78,375,20,762,10,999,0,5865
"12101032108",3212,464,29,0,317,7,460,59,4548
"12101032109",2263,94,335,14,455,97,652,41,3951
"12101032110",2811,57,59,0,307,0,373,23,3630
"12101032111",1998,76,675,211,172,0,403,0,3535
"12101032112",2898,129,522,140,404,76,669,0,4838
"12101032113",2587,201,703,0,733,0,678,63,4965
"12101032200",3095,217,79,16,121,13,163,13,3717
"12101032300",2033,139,120,11,21,48,289,29,2690
"12101032401",2176,317,37,0,68,8,416,18,3040
"12101032402",2047,1151,116,7,151,38,656,647,4813
"12101032500",3372,403,349,296,333,37,1520,98,6408
"12101032601",1907,685,482,446,68,45,902,499,5034
"12101032602",2013,552,206,204,72,141,393,270,3851
"12101032700",1638,732,264,58,54,11,237,113,3107
"12101032801",1407,145,19,21,164,0,163,5,1924
"12101032802",2374,386,47,73,123,103,150,19,3275
"12101032803",1521,590,46,17,35,0,18,470,2697
"12101032804",2046,171,0,148,128,7,34,13,2547
"12101032901",4050,497,155,1,606,4,1084,8,6405
"12101032902",1586,154,3,0,89,22,90,0,1944
"12101032903",2995,246,0,0,63,0,215,34,3553
"12101032904",1328,234,0,0,39,0,120,4,1725
"12101033005",3268,482,155,15,206,92,188,159,4565
"12101033006",1636,199,50,0,26,0,17,0,1928
"12101033007",1606,83,13,0,8,0,23,0,1733
"12101033008",1641,469,0,157,86,23,72,12,2460
"12101033009",2074,387,46,5,117,6,112,4,2751
"12101033010",2756,508,0,160,189,68,240,0,3921
"12101033011",1270,344,0,0,17,10,90,74,1805
"12101033012",1956,265,35,0,0,12,93,0,2361
"12101033013",2454,644,65,11,33,0,528,264,3999
"12101033014",3053,343,0,0,0,5,459,0,3860
"12101033101",2132,376,49,21,49,9,49,12,2697
"12101033102",1071,183,56,0,73,0,140,0,1523
"12101990000",0,0,0,0,0,0,0,0,0
"12103020101",778,245,2589,1073,91,35,142,98,5051
"12103020105",2772,254,371,63,214,37,236,0,3947
"12103020106",3038,194,32,0,95,0,162,0,3521
"12103020107",1416,59,8,0,58,0,17,0,1558
"12103020108",1684,490,35,0,53,25,46,0,2333
"12103020201",1523,130,2668,338,200,104,269,9,5241
"12103020202",1614,245,1414,237,49,19,53,101,3732
"12103020206",849,330,2160,241,449,26,173,63,4291
"12103020207",1414,196,767,117,38,9,153,8,2702
"12103020208",416,48,1390,390,27,0,49,0,2320
"12103020209",1135,56,2022,702,91,36,70,48,4160
"12103020301",980,88,1338,438,199,121,88,3,3255
"12103020302",1700,407,1234,293,146,51,342,84,4257
"12103020400",1586,101,557,279,70,0,124,16,2733
"12103020500",187,176,1541,1200,129,18,50,21,3322
"12103020600",163,88,2843,1116,25,65,61,0,4361
"12103020700",66,22,2620,675,40,8,0,0,3431
"12103020800",176,54,2191,2135,52,24,64,18,4714
"12103021200",64,160,1544,1355,44,213,27,15,3422
"12103021500",2080,515,211,212,69,41,50,61,3239
"12103021600",774,404,261,520,40,62,103,88,2252
"12103021800",1342,245,388,710,75,2,158,32,2952
"12103021900",1340,389,1153,264,164,0,205,146,3661
"12103022000",447,197,1697,459,50,6,0,30,2886
"12103022100",2664,804,1178,216,470,0,258,1,5591
"12103022200",1941,487,682,394,433,28,107,74,4146
"12103022301",2341,188,167,80,129,0,447,1,3353
"12103022302",2704,201,165,128,45,37,89,37,3406
"12103022401",3257,377,0,5,86,30,210,99,4064
"12103022402",4069,1351,126,8,68,6,278,22,5928
"12103022501",3701,576,91,103,365,0,844,53,5733
"12103022502",2977,376,380,2,179,7,893,7,4821
"12103022503",4241,190,128,283,675,0,234,0,5751
"12103022601",2649,225,35,118,159,0,168,119,3473
"12103022602",3705,391,54,93,247,50,387,114,5041
"12103022700",3016,413,314,7,199,236,218,11,4414
"12103022801",2946,770,250,180,308,113,765,150,5482
"12103022802",2593,135,124,0,699,27,408,24,4010
"12103022901",1552,151,308,91,489,231,114,0,2936
"12103022902",1549,231,137,63,405,70,315,8,2778
"12103023000",1674,308,8,61,375,67,58,13,2564
"12103023100",1486,208,79,48,123,427,97,22,2490
"12103023200",2217,437,88,24,95,29,256,29,3175
"12103023300",1814,155,161,70,83,62,112,11,2468
"12103023400",876,363,57,104,157,27,176,94,1854
"12103023500",1970,644,198,318,111,35,204,156,3636
"12103023600",2511,362,0,47,28,10,205,10,3173
"12103023700",2259,171,34,0,160,0,129,0,2753
"12103023800",2009,248,7,13,73,24,95,30,2499
"12103023900",1563,173,20,0,85,34,132,0,2007
"12103024001",2991,155,69,0,34,11,117,0,3377
"12103024002",4587,293,0,0,478,28,354,0,5740
"12103024004",4465,115,74,0,463,0,213,0,5330
"12103024005",2757,257,0,0,69,0,228,0,3311
"12103024100",3513,505,119,310,50,0,306,67,4870
"12103024200",3825,600,31,96,293,8,119,70,5042
"12103024301",3098,372,109,0,264,44,313,32,4232
"12103024302",3284,420,286,74,386,117,303,26,4896
"12103024403",2855,450,46,128,164,36,298,83,4060
"12103024406",2915,351,613,195,679,214,359,25,5351
"12103024408",3004,383,172,243,356,80,566,79,4883
"12103024409",2765,123,0,0,44,0,244,0,3176
"12103024410",2358,474,409,59,187,29,449,0,3965
"12103024411",3304,421,85,0,222,76,194,8,4310
"12103024412",2796,278,88,25,330,43,434,115,4109
"12103024413",3360,624,146,0,449,0,113,1,4693
"12103024505",5227,778,203,7,1246,244,483,350,8538
"12103024507",2712,359,52,62,177,103,189,67,3721
"12103024508",3606,848,1116,310,372,73,1049,520,7894
"12103024509",2640,195,27,0,476,14,197,43,3592
"12103024510",1133,586,306,118,230,95,603,281,3352
"12103024511",5524,355,1245,187,952,101,243,23,8630
"12103024512",2365,477,20,48,380,0,282,30,3602
"12103024513",2920,238,154,37,28,0,135,61,3573
"12103024514",2582,1057,244,143,388,88,452,503,5457
"12103024601",2573,370,39,44,442,89,207,77,3841
"12103024602",2714,1226,362,1341,422,109,340,70,6584
"12103024701",1951,807,66,58,290,203,188,62,3625
"12103024702",1148,503,108,39,186,91,189,128,2392
"12103024703",1534,570,289,19,417,74,276,63,3242
"12103024801",3393,557,19,0,503,96,300,12,4880
"12103024803",1647,344,175,61,371,18,316,0,2932
"12103024804",1317,137,65,39,390,188,314,116,2566
"12103024805",1774,356,64,17,471,11,376,185,3254
"12103024901",4230,457,55,79,798,16,146,103,5884
"12103024902",3377,1579,168,103,981,60,549,268,7085
"12103024904",2259,435,66,74,760,108,444,132,4278
"12103024905",4590,611,152,26,822,45,465,233,6944
"12103024906",2554,562,195,24,216,10,290,41,3892
"12103025004",4018,816,148,38,665,125,503,109,6422
"12103025007",3093,566,89,5,178,16,162,54,4163
"12103025009",2695,310,179,70,382,19,370,18,4043
"12103025010",3425,502,18,81,529,0,80,299,4934
"12103025011",4306,168,109,2,390,78,231,64,5348
"12103025012",4180,782,22,60,464,12,202,49,5771
"12103025013",2969,399,0,298,237,16,332,0,4251
"12103025014",3600,299,28,0,709,90,288,65,5079
"12103025015",2387,255,43,2,83,42,73,10,2895
"12103025016",1369,166,22,64,235,22,86,0,1964
"12103025017",2280,309,11,40,106,0,280,0,3026
"12103025018",1165,540,165,108,508,0,190,195,2871
"12103025019",1595,448,42,45,14,31,25,15,2215
"12103025106",2191,232,0,11,39,11,51,0,2535
"12103025107",3178,547,27,1,174,0,89,0,4016
"12103025108",1877,194,7,0,6,49,35,5,2173
"12103025109",2762,599,50,1,158,40,144,33,3787
"12103025110",5119,312,36,0,103,46,383,54,6053
"12103025111",1952,183,17,13,95,0,46,0,2306
"12103025112",2671,340,110,47,164,0,147,60,3539
"12103025113",2040,371,4,23,33,29,80,3,2583
"12103025114",2512,357,7,0,184,11,73,28,3172
"12103025115",2520,402,31,138,220,30,208,7,3556
"12103025116",1733,273,113,40,68,0,156,104,2487
"12103025119",5157,482,13,0,171,21,216,15,6075
"12103025120",3175,156,52,0,135,0,120,0,3638
"12103025121",4094,200,20,0,207,9,143,0,4673
"12103025122",4667,131,153,0,311,0,424,0,5686
"12103025123",1701,27,66,0,89,0,75,0,1958
"12103025203",4852,593,46,0,22,0,162,0,5675
"12103025204",2687,396,42,14,100,39,66,4,3348
"12103025205",3318,283,37,0,241,10,101,0,3990
"12103025207",4787,828,419,231,576,287,372,103,7603
"12103025208",1317,143,23,118,35,10,48,38,1732
"12103025209",3528,586,248,91,158,11,485,65,5172
"12103025303",3135,924,353,0,159,21,224,236,5052
"12103025304",2491,275,98,7,74,0,107,0,3052
"12103025305",1837,405,99,18,141,147,272,200,3119
"12103025306",1072,171,78,0,7,6,73,0,1407
"12103025307",2460,299,891,195,211,126,240,0,4422
"12103025308",1869,185,0,0,50,21,98,22,2245
"12103025401",3980,224,89,3,233,123,143,84,4879
"12103025405",2953,255,279,0,91,164,271,78,4091
"12103025407",4044,469,150,135,564,0,360,154,5876
"12103025408",4228,1464,111,209,458,21,864,384,7739
"12103025411",1240,445,83,25,205,96,383,114,2591
"12103025412",3791,407,187,33,192,22,190,0,4822
"12103025413",2451,505,37,0,228,34,212,124,3591
"12103025414",1714,307,120,113,176,25,118,58,2631
"12103025415",2649,398,49,44,319,13,441,83,3996
"12103025416",2438,442,70,17,292,175,470,48,3952
"12103025417",1856,381,0,68,5,0,21,5,2336
"12103025501",3661,231,118,12,32,11,259,20,4344
"12103025503",3188,576,341,68,274,52,374,13,4886
"12103025505",1196,654,294,193,59,62,451,363,3272
"12103025506",4428,593,191,14,443,100,587,151,6507
"12103025602",1867,714,135,37,274,0,456,152,3635
"12103025603",1909,337,14,0,148,28,138,70,2644
"12103025604",989,138,72,0,62,4,146,20,1431
"12103025700",3538,114,48,0,111,15,200,15,4041
"12103025800",2263,535,439,635,159,40,316,205,4592
"12103025900",2827,1110,396,144,112,219,162,653,5623
"12103026001",2656,228,21,0,34,0,118,0,3057
"12103026002",2190,357,9,0,198,0,43,43,2840
"12103026101",1019,481,864,80,189,169,253,157,3212
"12103026102",864,117,77,74,66,2,22,3,1225
"12103026200",81,228,849,625,83,77,45,161,2149
"12103026300",3258,1364,1751,534,82,135,697,687,8508
"12103026400",4216,833,438,74,433,295,1930,732,8951
"12103026500",4337,600,831,192,428,556,323,615,7882
"12103026601",2471,228,49,0,146,0,321,8,3223
"12103026602",1907,318,344,140,57,15,426,136,3343
"12103026701",3242,309,196,337,264,0,449,43,4840
"12103026702",5179,229,371,60,729,245,740,16,7569
"12103026703",4411,725,429,164,390,112,1025,218,7474
"12103026804",4272,444,205,71,344,124,363,201,6024
"12103026809",2336,237,73,0,100,60,164,0,2970
"12103026811",5893,85,0,0,297,16,381,0,6672
"12103026812",4484,169,19,0,92,0,296,0,5060
"12103026813",3169,439,0,4,140,231,691,496,5170
"12103026814",1992,101,0,129,48,0,256,4,2530
"12103026815",4055,309,17,0,408,0,227,24,5040
"12103026816",4170,561,133,173,474,0,200,330,6041
"12103026817",3883,389,290,54,345,10,219,145,5335
"12103026818",2149,611,271,335,345,225,686,307,4929
"12103026819",1534,223,37,4,127,68,452,68,2513
"12103026820",3856,427,37,0,47,25,390,33,4815
"12103026821",2512,409,57,2,48,6,246,156,3436
"12103026904",4337,618,23,8,164,13,523,301,5987
"12103026907",5130,315,311,0,179,60,305,21,6321
"12103026908",3710,198,181,7,88,0,130,0,4314
"12103026909",3744,336,141,0,167,0,299,0,4687
"12103026910",4710,313,160,4,129,0,385,3,5704
"12103026911",3150,203,0,1,166,0,460,0,3980
"12103026912",2381,629,360,0,272,80,160,344,4226
"12103026913",2295,465,170,0,110,51,144,61,3296
"12103027000",3496,284,214,46,585,134,413,108,5280
"12103027101",2632,395,97,85,165,12,64,0,3450
"12103027105",3142,179,61,0,52,12,160,0,3606
"12103027106",4166,208,0,2,8,0,429,0,4813
"12103027202",5019,307,48,2,353,0,166,104,5999
"12103027204",3692,370,111,0,257,11,29,2,4472
"12103027205",4779,639,452,0,90,0,263,123,6346
"12103027206",6255,164,0,34,191,0,475,4,7123
"12103027207",4364,462,38,11,208,13,260,38,5394
"12103027208",5813,889,18,28,153,0,264,238,7403
"12103027209",965,143,4,7,5,0,56,7,1187
"12103027210",3765,524,0,0,206,15,541,0,5051
"12103027308",2719,432,156,0,192,13,210,40,3762
"12103027309",1538,160,5,0,131,0,52,6,1892
"12103027310",7804,159,119,0,766,0,668,2,9518
"12103027314",2990,206,88,106,222,8,171,0,3791
"12103027315",4304,464,232,0,147,98,240,0,5485
"12103027316",3430,250,47,0,62,0,70,8,3867
"12103027317",4775,258,87,31,58,46,348,42,5645
"12103027318",3246,318,185,0,210,40,368,39,4406
"12103027319",4008,379,505,0,431,0,278,123,5724
"12103027320",3439,369,142,0,140,45,458,73,4666
"12103027321",1433,58,0,15,41,0,40,0,1587
"12103027322",5726,449,43,0,222,30,192,0,6662
"12103027323",2531,282,37,0,58,32,317,132,3389
"12103027324",3651,230,32,44,184,39,225,0,4405
"12103027325",2981,214,0,0,302,32,190,0,3719
"12103027326",2628,446,60,0,310,8,405,151,4008
"12103027327",3258,562,9,159,312,71,357,258,4986
"12103027401",1879,220,140,99,27,23,45,16,2449
"12103027402",4051,667,489,436,495,25,609,147,6919
"12103027403",1280,288,34,0,7,3,75,36,1723
"12103027501",4724,578,11,14,43,0,190,0,5560
"12103027502",6091,861,0,4,452,47,245,72,7772
"12103027603",2310,142,14,0,38,44,97,33,2678
"12103027604",2237,194,8,0,60,10,123,10,2642
"12103027605",1578,84,30,0,55,0,47,0,1794
"12103027606",1469,76,0,0,79,0,31,0,1655
"12103027701",2647,189,15,0,63,16,106,43,3079
"12103027703",1138,119,0,0,21,0,5,0,1283
"12103027704",2015,239,5,0,81,0,126,19,2485
"12103027801",1088,267,16,0,78,5,97,20,1571
"12103027802",2474,291,12,0,45,0,251,0,3073
"12103027901",1922,181,0,0,179,41,88,5,2416
"12103027903",1267,94,0,0,1,0,91,8,1461
"12103027904",2714,340,0,0,44,0,143,16,3257
"12103028002",3387,184,0,0,138,31,107,11,3858
"12103028003",2904,500,54,0,16,13,66,12,3565
"12103028004",1805,254,0,12,13,21,85,10,2200
"12103028102",2512,377,72,87,389,26,131,48,3642
"12103028103",1332,202,17,0,87,0,117,0,1755
"12103028104",2692,263,0,0,60,0,63,14,3092
"12103028200",2104,220,11,44,28,65,186,22,2680
"12103028300",2152,512,377,120,91,0,196,192,3640
"12103028401",1247,147,31,0,16,0,24,6,1471
"12103028402",1046,186,21,10,8,15,23,0,1309
"12103028500",1311,468,180,77,60,17,174,34,2321
"12103028600",2268,474,211,64,225,22,527,37,3828
"12103028700",106,19,1676,1036,32,94,79,0,3042
"12103990000",0,0,0,0,0,0,0,0,0
"12103990100",0,0,0,0,0,0,0,0,0
"12105010300",2245,823,522,171,437,34,469,365,5066
"12105010401",1500,262,0,0,49,0,73,0,1884
"12105010402",2035,520,265,0,486,14,173,20,3513
"12105010501",1496,162,121,10,49,0,227,0,2065
"12105010502",3400,449,40,49,22,0,206,235,4401
"12105010601",2935,399,215,44,189,156,146,85,4169
"12105010603",2915,171,71,2,170,0,208,1,3538
"12105010604",2823,349,299,0,87,21,498,104,4181
"12105010701",2626,539,777,56,104,31,295,32,4460
"12105010702",2915,120,211,0,67,0,661,24,3998
"12105010800",1654,764,678,276,227,119,524,514,4756
"12105010900",1945,672,823,556,58,251,375,357,5037
"12105011000",963,683,1096,299,67,26,279,364,3777
"12105011100",686,765,1009,803,19,103,370,571,4326
"12105011202",10,22,1014,689,13,11,33,6,1798
"12105011203",459,341,1445,1502,17,52,153,229,4198
"12105011204",138,27,571,734,67,8,53,20,1618
"12105011300",731,131,242,587,157,116,109,112,2185
"12105011400",2524,737,487,271,289,94,767,410,5579
"12105011501",3658,1174,447,379,176,87,608,256,6785
"12105011502",3610,202,651,176,599,85,778,57,6158
"12105011603",1888,179,24,152,108,0,177,84,2612
"12105011604",3739,558,29,139,431,39,373,309,5617
"12105011605",2454,256,81,0,150,3,152,92,3188
"12105011606",1457,137,46,30,0,10,145,11,1836
"12105011704",2166,1591,303,390,392,36,536,713,6127
"12105011721",1937,808,72,13,16,0,142,70,3058
"12105011722",2331,519,0,0,65,6,78,91,3090
"12105011731",1998,859,813,197,153,73,502,359,4954
"12105011732",1222,563,536,514,471,129,330,344,4109
"12105011821",2527,87,228,2,111,0,250,1,3206
"12105011822",3030,215,84,96,336,11,131,137,4040
"12105011832",3172,629,576,106,51,0,541,113,5188
"12105011833",6190,465,629,22,799,120,1216,282,9723
"12105011834",4562,449,478,38,782,27,560,0,6896
"12105011835",4071,238,78,0,127,0,593,97,5204
"12105011836",3460,79,96,0,124,0,276,7,4042
"12105011901",3447,644,236,171,122,0,845,72,5537
"12105011902",2441,229,99,166,155,0,502,0,3592
"12105011908",2744,104,452,84,169,53,438,0,4044
"12105011909",2522,12,33,0,122,0,165,0,2854
"12105011910",1364,261,0,4,59,3,371,51,2113
"12105011911",2777,29,103,97,89,31,576,31,3733
"12105011912",1201,186,131,11,110,71,100,14,1824
"12105011913",1677,306,357,94,22,36,505,103,3100
"12105012001",3104,605,1254,290,173,26,509,36,5997
"12105012002",1601,559,298,64,139,317,361,407,3746
"12105012003",3839,697,31,46,73,128,194,412,5420
"12105012004",2024,244,53,34,84,0,101,0,2540
"12105012111",5012,357,0,0,242,0,48,59,5718
"12105012113",5144,233,623,112,81,41,269,0,6503
"12105012124",3813,870,568,83,233,102,826,85,6580
"12105012125",1987,637,7,0,193,17,261,13,3115
"12105012126",2487,84,681,45,257,42,1208,30,4834
"12105012127",4504,176,832,0,686,57,1188,49,7492
"12105012128",3024,125,824,22,656,130,578,0,5359
"12105012129",5104,620,1159,58,233,47,1561,0,8782
"12105012203",1754,265,81,20,133,121,299,105,2778
"12105012204",3818,1237,394,17,221,144,604,322,6757
"12105012205",701,137,61,42,142,47,45,13,1188
"12105012206",3783,399,779,37,47,13,1080,31,6169
"12105012303",2724,509,103,0,168,0,206,0,3710
"12105012304",4768,250,374,0,292,22,467,0,6173
"12105012305",1118,537,17,0,34,28,61,181,1976
"12105012306",2162,139,0,75,94,5,337,90,2902
"12105012307",2364,646,0,0,87,344,38,0,3479
"12105012309",1006,303,0,0,72,0,20,0,1401
"12105012403",7547,943,774,257,1574,123,3006,557,14781
"12105012404",516,72,302,0,10,30,36,0,966
"12105012405",4300,566,121,0,455,69,1573,263,7347
"12105012406",3641,226,175,7,199,100,1098,130,5576
"12105012407",1051,30,148,17,4,19,58,0,1327
"12105012408",2346,868,120,0,139,9,320,75,3877
"12105012409",1194,329,528,9,59,0,207,40,2366
"12105012410",1715,270,436,45,255,37,832,212,3802
"12105012411",3943,962,463,68,251,59,1597,673,8016
"12105012502",4697,1080,578,154,416,145,1787,611,9468
"12105012503",9812,703,1132,1019,1917,578,6029,1119,22309
"12105012504",2856,1442,691,416,52,0,432,885,6774
"12105012506",4238,338,452,92,501,139,1390,151,7301
"12105012507",4280,497,380,0,145,177,959,233,6671
"12105012601",1831,386,1345,475,92,24,739,248,5140
"12105012602",2500,1932,592,461,561,327,2501,1686,10560
"12105012700",4010,1400,681,144,99,10,2130,966,9440
"12105012802",1980,165,382,271,93,73,286,57,3307
"12105012803",3421,236,0,0,0,0,75,69,3801
"12105012804",3067,490,283,38,463,16,547,242,5146
"12105012900",3026,1044,433,492,151,291,197,703,6337
"12105013001",3152,246,202,0,43,0,909,113,4665
"12105013002",2106,1058,163,298,119,233,409,372,4758
"12105013101",3824,230,105,0,112,19,349,0,4639
"12105013102",2299,607,75,210,121,0,283,273,3868
"12105013103",590,405,0,0,16,7,156,187,1361
"12105013200",1199,326,353,177,49,0,259,101,2464
"12105013300",706,694,457,298,42,60,128,110,2495
"12105013400",2364,867,875,681,237,87,494,23,5628
"12105013500",2381,685,349,27,46,62,229,79,3858
"12105013600",1421,223,2669,1372,186,0,67,12,5950
"12105013701",1012,231,122,282,15,52,249,47,2010
"12105013702",2744,193,1771,667,215,7,540,48,6185
"12105013801",1709,510,460,104,269,13,119,302,3486
"12105013802",3852,712,555,602,448,48,841,169,7227
"12105013901",1150,299,818,203,100,86,136,164,2956
"12105013902",4055,340,160,1,107,55,213,102,5033
"12105014001",3949,439,62,98,110,0,353,269,5280
"12105014003",1997,218,375,434,244,21,135,55,3479
"12105014005",3337,291,152,62,86,23,242,30,4223
"12105014006",2236,226,181,0,167,0,86,172,3068
"12105014103",3946,1764,3196,1491,591,196,3355,1431,15970
"12105014104",398,30,0,0,10,34,31,6,509
"12105014105",5790,928,154,0,334,80,2263,209,9758
"12105014121",1311,560,93,19,98,82,373,372,2908
"12105014123",4972,381,364,191,106,13,790,81,6898
"12105014124",1268,211,453,100,9,0,169,146,2356
"12105014125",3000,1242,972,44,190,0,536,8,5992
"12105014201",4223,413,158,203,108,134,503,96,5838
"12105014202",2197,169,135,8,159,9,334,0,3011
"12105014203",2245,240,0,26,0,17,80,10,2618
"12105014301",159,115,543,678,18,9,100,82,1704
"12105014302",3957,731,595,199,234,280,918,118,7032
"12105014400",5349,537,933,178,273,70,977,238,8555
"12105014501",5044,1739,233,98,421,58,1771,1145,10509
"12105014502",2812,1406,0,160,103,23,1746,1154,7404
"12105014600",2738,1175,251,25,293,3,1224,530,6239
"12105014701",3143,538,289,84,127,0,268,112,4561
"12105014702",5944,506,1686,175,357,0,449,182,9299
"12105014802",1785,265,551,83,126,257,784,66,3917
"12105014803",1922,19,146,6,95,0,168,10,2366
"12105014804",5544,488,767,15,478,0,456,76,7824
"12105014901",7903,466,967,0,441,0,2099,14,11890
"12105014902",4547,1198,131,0,190,270,1991,671,8998
"12105015000",2997,725,943,286,142,79,444,343,5959
"12105015101",2552,515,219,90,45,0,358,58,3837
"12105015102",1819,347,4,0,0,10,111,7,2298
"12105015200",1605,584,1387,1077,205,28,386,53,5325
"12105015301",2429,780,514,194,73,0,439,156,4585
"12105015302",1541,626,0,0,20,11,35,264,2497
"12105015401",1694,305,584,302,110,10,267,0,3272
"12105015402",2276,381,163,6,82,89,386,85,3468
"12105015404",903,145,6,35,16,0,0,22,1127
"12105015405",1664,320,153,39,84,35,285,138,2718
"12105015500",2117,1235,367,387,215,45,1146,969,6481
"12105015600",2407,297,188,0,7,5,172,78,3154
"12105015701",1557,125,310,208,37,94,184,4,2519
"12105015702",2093,613,56,24,76,12,154,348,3376
"12105015801",1503,431,0,9,75,45,338,300,2701
"12105015802",1432,926,27,6,56,81,405,742,3675
"12105015900",1674,331,93,42,50,5,508,223,2926
"12105016001",1552,191,98,0,198,11,378,13,2441
"12105016002",773,415,655,80,118,30,451,301,2823
"12105016003",1836,593,48,0,205,19,684,392,3777
"12105016100",467,54,201,90,66,31,42,60,1011
"12105016400",505,555,537,408,90,26,201,74,2396
"12105980000",0,30,0,0,0,0,0,24,54
"12107950100",3183,653,66,0,47,93,85,0,4127
"12107950201",3319,1528,267,106,108,85,58,22,5493
"12107950202",1699,823,0,0,240,0,86,0,2848
"12107950300",4468,1100,562,84,182,159,313,210,7078
"12107950400",2767,284,163,53,18,13,93,0,3391
"12107950500",4534,1613,69,90,132,24,460,480,7402
"12107950600",3036,1170,556,442,40,231,107,59,5641
"12107950700",878,612,819,1743,88,18,100,264,4522
"12107950800",812,278,1239,669,31,51,159,16,3255
"12107950900",2821,747,994,843,35,0,102,34,5576
"12107951000",2461,344,284,109,43,6,188,20,3455
"12107951100",3065,739,274,66,86,203,166,229,4828
"12107951200",3390,1517,89,12,184,30,248,77,5547
"12107951300",2221,347,433,217,536,259,475,260,4748
"12107951401",1337,775,500,528,186,347,314,647,4634
"12107951402",2138,877,18,209,377,300,713,817,5449
"12107980000",0,0,0,0,0,0,0,0,0
"12109020200",1970,384,0,41,46,46,92,0,2579
"12109020300",2511,685,308,635,258,21,385,46,4849
"12109020400",1046,683,326,37,12,13,39,98,2254
"12109020500",2990,321,26,14,192,0,39,0,3582
"12109020601",5025,335,0,0,88,0,261,0,5709
"12109020602",11549,718,341,0,836,0,250,0,13694
"12109020704",3312,135,0,0,170,0,100,0,3717
"12109020705",5281,273,176,105,96,0,161,55,6147
"12109020706",2927,54,28,0,219,0,100,0,3328
"12109020707",4632,434,356,0,297,67,444,0,6230
"12109020708",2791,185,102,0,112,12,131,12,3345
"12109020710",2136,109,0,1,74,0,99,9,2428
"12109020711",4624,388,41,0,268,0,138,0,5459
"12109020801",6745,326,837,27,350,281,795,63,9424
"12109020802",3688,40,27,0,240,0,644,0,4639
"12109020803",4410,92,0,12,54,34,240,0,4842
"12109020804",2659,471,141,22,164,0,170,7,3634
"12109020805",11640,258,698,0,626,29,1022,0,14273
"12109020806",5649,708,249,17,1184,0,548,10,8365
"12109020807",1489,33,24,0,94,0,29,0,1669
"12109020901",5925,1090,261,0,441,80,651,55,8503
"12109020902",22183,1306,1116,2,1447,61,1787,3,27905
"12109021002",2669,305,669,456,125,6,422,25,4677
"12109021003",2830,859,1280,78,323,173,219,0,5762
"12109021004",2416,126,98,0,133,0,18,0,2791
"12109021101",3230,577,487,417,189,6,218,106,5230
"12109021102",3791,493,232,418,185,19,176,59,5373
"12109021103",1452,309,0,23,14,0,130,0,1928
"12109021203",6346,686,280,4,171,108,284,111,7990
"12109021204",933,85,10,11,0,0,91,17,1147
"12109021205",947,110,0,0,26,0,54,0,1137
"12109021206",5462,651,119,7,153,0,115,8,6515
"12109021301",4537,1135,100,131,413,34,174,32,6556
"12109021302",4833,386,84,0,404,14,604,17,6342
"12109021403",2114,145,6,0,0,0,22,0,2287
"12109021404",3207,213,0,0,25,0,158,0,3603
"12109021405",4854,323,12,0,115,52,309,52,5717
"12109021406",4045,665,0,0,283,33,325,0,5351
"12109021407",1213,49,5,14,56,0,14,0,1351
"12109990100",0,0,0,0,0,0,0,0,0
"12109990200",0,0,0,0,0,0,0,0,0
"12111380100",173,422,93,314,7,50,13,108,1180
"12111380200",24,245,939,1488,10,183,21,180,3090
"12111380300",136,323,2291,3232,26,0,105,52,6165
"12111380400",2210,1227,1223,529,257,210,1499,872,8027
"12111380500",2529,759,1382,492,167,370,829,880,7408
"12111380600",2565,354,381,792,49,48,1306,136,5631
"12111380700",4184,953,1175,1022,278,265,860,599,9336
"12111380800",1548,335,259,16,118,8,93,81,2458
"12111380901",423,455,797,601,0,0,1,268,2545
"12111380902",836,166,2682,1727,237,14,439,45,6146
"12111381000",811,135,141,8,6,4,49,5,1159
"12111381101",5180,596,716,254,185,55,512,1,7499
"12111381102",3394,349,397,9,379,59,329,3,4919
"12111381204",3012,109,0,0,37,0,86,18,3262
"12111381300",3348,497,14,20,106,0,108,0,4093
"12111381401",3411,1101,209,366,25,96,497,125,5830
"12111381402",3802,1176,477,272,69,125,744,452,7117
"12111381502",7258,1595,1156,267,1718,39,1190,460,13683
"12111381503",6135,1160,1384,282,931,18,1468,317,11695
"12111381601",5278,583,0,181,117,45,75,51,6330
"12111381602",2929,277,234,9,180,5,364,17,4015
"12111381603",4993,306,227,0,116,199,399,193,6433
"12111381701",2818,205,0,0,16,0,32,0,3071
"12111381702",1832,120,0,0,7,28,117,0,2104
"12111381802",2105,599,311,369,371,190,808,168,4921
"12111381803",4117,425,408,80,231,41,965,34,6301
"12111381804",3742,508,280,0,189,22,390,151,5282
"12111381900",5064,311,91,0,825,19,873,19,7202
"12111382002",5469,1075,1368,101,291,430,1125,199,10058
"12111382003",6394,613,1485,618,646,120,1407,240,11523
"12111382006",5465,433,1587,0,889,0,766,88,9228
"12111382007",2810,409,614,665,445,211,847,282,6283
"12111382008",4711,651,929,167,357,60,1672,263,8810
"12111382009",2432,636,475,330,390,54,590,209,5116
"12111382010",1533,369,288,12,21,0,75,12,2310
"12111382106",13832,2417,3393,37,2568,286,6631,1853,31017
"12111382108",12749,2087,2204,1196,2001,113,1989,118,22457
"12111382109",8500,480,849,126,476,0,1230,0,11661
"12111382110",5177,92,1211,69,464,89,1622,0,8724
"12111382111",8572,1468,2216,603,993,178,2523,1028,17581
"12111382112",3905,2037,1168,132,490,44,855,1444,10075
"12111382113",7877,1710,1975,814,390,728,1065,1702,16261
"12111382200",5444,737,68,64,95,26,340,151,6925
"12111980000",0,0,0,0,0,0,0,0,0
"12111990000",0,0,0,0,0,0,0,0,0
"12113010100",2661,277,112,27,63,9,7,0,3156
"12113010200",3362,309,0,12,130,10,29,0,3852
"12113010300",9795,597,176,8,705,41,591,38,11951
"12113010400",1885,293,0,0,152,10,61,0,2401
"12113010502",5599,1228,387,406,481,214,209,51,8575
"12113010503",4496,532,211,64,460,42,33,42,5880
"12113010504",3592,397,28,34,400,17,208,0,4676
"12113010600",3987,776,484,253,589,122,384,88,6683
"12113010702",5441,656,187,112,456,58,269,3,7182
"12113010704",4468,414,406,11,390,18,321,24,6052
"12113010705",2016,582,56,32,496,389,127,189,3887
"12113010706",5779,1472,518,39,707,124,231,114,8984
"12113010707",4078,201,109,0,219,0,221,0,4828
"12113010708",4550,301,237,0,365,0,224,0,5677
"12113010802",3659,628,255,0,258,0,276,194,5270
"12113010808",3004,761,16,30,288,277,153,113,4642
"12113010809",2922,1520,259,20,38,298,0,0,5057
"12113010811",9992,757,851,0,1690,123,591,143,14147
"12113010812",4132,286,0,0,306,0,256,0,4980
"12113010813",3984,247,13,0,193,28,54,0,4519
"12113010814",5392,217,28,0,348,0,363,0,6348
"12113010815",6665,1155,119,16,531,122,311,8,8927
"12113010817",4363,284,323,0,248,86,502,86,5892
"12113010819",8605,1034,821,210,630,557,339,517,12713
"12113010900",5519,320,54,0,189,0,214,0,6296
"12113990000",0,0,0,0,0,0,0,0,0
"12115000101",3100,428,56,273,73,0,96,44,4070
"12115000102",2054,1242,207,33,34,0,364,765,4699
"12115000200",2174,515,997,528,167,110,574,293,5358
"12115000300",226,185,1942,1460,0,150,161,132,4256
"12115000401",3029,402,433,133,213,0,822,145,5177
"12115000404",1118,146,24,0,56,0,55,12,1411
"12115000405",2446,825,97,14,72,0,560,458,4472
"12115000406",2288,507,225,29,67,38,857,222,4233
"12115000407",2829,518,201,108,68,0,1075,354,5153
"12115000501",1462,136,8,0,91,18,94,0,1809
"12115000502",2486,289,92,18,398,190,595,201,4269
"12115000503",2604,396,46,80,50,18,233,54,3481
"12115000601",1836,299,9,0,215,20,101,0,2480
"12115000602",3152,388,16,0,38,27,19,18,3658
"12115000700",2683,125,55,0,51,0,89,0,3003
"12115000801",1918,107,0,0,24,0,0,0,2049
"12115000802",2309,158,0,0,76,0,116,0,2659
"12115000900",1683,231,165,118,75,0,150,53,2475
"12115001000",2002,199,252,178,101,65,242,116,3155
"12115001101",2915,363,468,497,135,11,389,11,4789
"12115001102",3116,581,721,471,134,0,1370,76,6469
"12115001201",6282,318,128,32,208,216,652,136,7972
"12115001202",3128,425,250,166,208,0,1207,212,5596
"12115001203",3685,106,116,0,17,0,89,0,4013
"12115001204",3639,215,91,0,120,33,410,31,4539
"12115001301",2311,127,137,13,93,8,436,8,3133
"12115001302",3381,373,10,0,140,64,368,114,4450
"12115001303",3028,33,0,0,206,7,109,0,3383
"12115001304",1768,80,27,11,84,0,160,0,2130
"12115001401",6990,501,36,39,323,38,515,15,8457
"12115001402",4234,198,219,0,78,10,451,0,5190
"12115001403",5799,461,31,0,113,0,93,111,6608
"12115001503",2811,444,76,12,0,0,479,128,3950
"12115001504",2939,199,12,0,84,49,460,79,3822
"12115001505",3605,476,24,15,349,64,490,160,5183
"12115001506",5286,588,103,0,57,0,513,36,6583
"12115001507",5387,649,35,0,384,50,547,78,7130
"12115001601",2749,479,47,0,144,52,190,43,3704
"12115001602",3284,196,0,52,109,11,164,1,3817
"12115001702",5257,331,18,0,75,0,298,0,5979
"12115001703",2731,410,24,0,95,0,308,32,3600
"12115001704",2360,374,217,5,47,46,256,0,3305
"12115001801",2879,315,0,53,98,19,115,0,3479
"12115001803",2118,502,78,51,77,36,454,280,3596
"12115001804",2025,333,35,35,141,11,330,39,2949
"12115001805",1516,122,22,0,74,0,136,16,1886
"12115001903",1591,130,0,0,24,0,66,0,1811
"12115001904",2911,269,11,0,60,0,102,0,3353
"12115001905",1135,58,10,0,13,0,18,0,1234
"12115001907",841,47,0,0,25,6,0,0,919
"12115001908",735,58,0,0,93,0,57,0,943
"12115002003",3208,358,23,77,174,66,786,66,4758
"12115002004",3096,293,0,0,125,0,368,25,3907
"12115002005",3855,393,16,0,34,0,191,0,4489
"12115002007",2251,188,25,0,70,0,68,0,2602
"12115002008",2646,199,0,0,42,0,58,0,2945
"12115002009",5916,487,165,0,369,122,256,20,7335
"12115002010",5463,376,0,30,7,0,378,0,6254
"12115002100",6020,398,0,0,301,25,606,0,7350
"12115002201",2932,152,0,0,134,13,51,0,3282
"12115002202",3953,298,0,83,201,22,171,13,4741
"12115002203",3064,428,78,5,284,64,119,5,4047
"12115002302",3461,277,55,0,52,0,206,0,4051
"12115002303",4209,389,13,0,30,58,26,112,4837
"12115002304",2239,212,20,26,43,0,59,37,2636
"12115002305",1265,173,51,0,7,16,26,16,1554
"12115002401",2344,258,14,3,31,5,39,1,2695
"12115002402",2985,254,0,0,247,7,89,0,3582
"12115002504",2484,325,11,1,80,1,131,80,3113
"12115002505",1907,117,0,2,302,73,286,48,2735
"12115002507",4736,403,0,0,306,67,218,77,5807
"12115002508",2838,175,53,6,151,0,31,6,3260
"12115002509",3888,521,0,0,19,0,368,128,4924
"12115002510",2909,511,0,0,33,18,46,25,3542
"12115002511",2473,112,0,0,187,0,21,0,2793
"12115002601",1936,97,0,0,186,17,87,0,2323
"12115002602",2277,76,0,0,101,14,25,0,2493
"12115002603",1427,174,34,0,43,0,27,0,1705
"12115002604",2057,288,0,0,27,126,19,172,2689
"12115002605",1967,324,12,0,57,0,151,0,2511
"12115002710",2077,327,69,33,88,23,91,52,2760
"12115002711",7556,600,199,0,469,110,482,111,9527
"12115002712",26261,3665,2328,1383,1552,113,1741,1278,38321
"12115002713",7335,364,0,0,146,25,139,0,8009
"12115002714",4046,468,0,0,111,85,69,0,4779
"12115002715",6193,339,0,37,273,41,14,0,6897
"12115002716",7036,426,0,18,45,34,58,0,7617
"12115002718",5463,391,38,25,146,0,221,28,6312
"12115002719",3337,223,0,0,45,0,77,0,3682
"12115002720",2628,149,0,0,104,0,73,0,2954
"12115002721",3235,672,180,27,241,50,161,0,4566
"12115002722",5988,382,530,158,527,40,583,14,8222
"12115002723",1981,208,3,0,198,0,87,40,2517
"12115002724",2148,119,0,0,50,0,35,0,2352
"12115990000",0,0,0,0,0,0,0,0,0
"12117020101",664,216,140,177,50,5,37,18,1307
"12117020102",557,112,306,225,11,7,108,13,1339
"12117020201",848,289,714,63,146,21,223,32,2336
"12117020202",1804,320,2061,374,245,110,241,204,5359
"12117020301",1535,393,207,143,136,0,380,45,2839
"12117020302",1062,222,400,158,95,13,302,96,2348
"12117020401",302,81,747,724,7,17,23,86,1987
"12117020402",1275,54,1506,136,215,0,139,0,3325
"12117020500",468,188,582,738,37,59,46,86,2204
"12117020600",8087,1227,1158,525,1306,505,2948,295,16051
"12117020701",10208,750,1055,576,1206,8,1342,59,15204
"12117020703",5844,127,414,0,901,0,696,14,7996
"12117020704",4658,323,296,27,824,7,818,27,6980
"12117020705",1794,109,413,25,445,36,371,51,3244
"12117020803",4678,384,209,26,500,182,552,131,6662
"12117020805",6442,241,368,0,755,0,975,68,8849
"12117020806",4638,556,1031,347,202,83,1561,220,8638
"12117020807",4197,852,1052,208,473,288,1623,357,9050
"12117020808",2896,249,400,51,534,27,620,27,4804
"12117020810",2827,344,11,7,426,2,406,4,4027
"12117020811",4533,280,260,58,290,0,901,105,6427
"12117020812",2326,146,260,189,232,154,904,108,4319
"12117020901",1886,576,332,296,67,16,681,450,4304
"12117020902",1183,142,175,288,145,7,335,50,2325
"12117020903",5779,1603,1407,636,817,181,1923,953,13299
"12117021000",2948,135,547,46,521,232,631,56,5116
"12117021100",1136,94,1356,343,241,49,362,52,3633
"12117021201",4660,456,76,35,222,0,590,28,6067
"12117021203",5907,62,183,0,375,9,1311,37,7884
"12117021204",7268,599,96,0,695,467,1051,464,10640
"12117021306",6863,623,75,0,337,0,849,164,8911
"12117021307",6414,382,425,70,739,110,1282,2,9424
"12117021311",2736,392,761,103,248,24,553,154,4971
"12117021312",2674,370,102,70,241,78,455,230,4220
"12117021313",4625,619,432,0,785,0,719,396,7576
"12117021314",3421,286,111,144,270,0,606,69,4907
"12117021315",5827,1209,533,131,439,132,1436,56,9763
"12117021316",2619,558,349,59,467,89,303,14,4458
"12117021317",5873,589,302,127,1545,498,1495,205,10634
"12117021318",6560,400,1084,114,670,109,2267,250,11454
"12117021319",1195,58,95,19,79,19,190,0,1655
"12117021320",4700,672,600,0,915,197,1113,226,8423
"12117021321",2152,351,332,10,203,33,681,157,3919
"12117021401",4918,904,623,45,258,203,1238,460,8649
"12117021403",6959,145,168,13,500,148,1029,129,9091
"12117021404",5274,635,424,159,931,190,1138,296,9047
"12117021502",3425,397,378,360,325,62,792,244,5983
"12117021503",1139,288,151,15,87,40,107,96,1923
"12117021504",2552,109,18,0,131,0,410,8,3228
"12117021505",3692,221,257,50,81,0,439,100,4840
"12117021506",2473,178,364,0,267,0,317,28,3627
"12117021604",3948,228,26,0,125,0,548,23,4898
"12117021606",4479,439,649,15,705,50,1481,108,7926
"12117021608",3362,1421,1307,77,424,37,1101,946,8675
"12117021609",2592,33,72,0,122,19,259,7,3104
"12117021611",5150,95,110,0,381,0,639,0,6375
"12117021612",3685,195,344,0,233,0,567,20,5044
"12117021613",1765,253,379,78,183,14,779,141,3592
"12117021614",3972,187,765,188,383,47,1598,64,7204
"12117021615",2319,110,198,0,170,25,378,55,3255
"12117021616",3051,211,53,0,144,0,370,31,3860
"12117021704",3515,563,161,57,144,31,932,59,5462
"12117021705",2819,384,723,329,160,62,1359,241,6077
"12117021706",2306,456,199,9,264,12,739,327,4312
"12117021707",3982,700,258,96,747,47,1135,320,7285
"12117021708",4838,619,944,243,619,118,1134,442,8957
"12117021802",3262,1009,648,126,410,7,610,597,6669
"12117021803",1659,384,489,8,140,69,261,227,3237
"12117021805",1794,52,13,0,25,0,89,0,1973
"12117021806",3928,133,244,0,63,14,884,0,5266
"12117021901",3350,397,109,31,669,12,515,62,5145
"12117021902",2246,300,877,397,300,15,585,58,4778
"12117022001",965,270,678,387,211,26,188,133,2858
"12117022002",3192,418,184,105,197,41,765,36,4938
"12117022004",1931,300,99,0,115,24,350,171,2990
"12117022005",5745,701,706,58,443,83,1047,193,8976
"12117022101",4582,922,474,148,284,67,1382,349,8208
"12117022104",5630,711,320,64,275,0,1287,345,8632
"12117022105",2905,224,8,9,261,0,425,45,3877
"12117022106",6899,366,766,49,662,108,1626,71,10547
"12117022201",3943,495,442,45,536,122,1113,403,7099
"12117022205",2625,135,163,39,176,0,515,23,3676
"12117022206",4478,454,682,120,394,163,994,343,7628
"12117022207",4142,826,128,69,547,124,813,450,7099
"12117022208",2835,814,536,113,55,76,864,0,5293
"12117022209",2906,667,34,0,246,49,661,346,4909
"12119910100",1587,634,378,206,99,0,77,216,3197
"12119910300",1448,167,0,8,0,10,36,8,1677
"12119910401",2307,474,0,0,56,0,63,25,2925
"12119910402",1945,591,47,42,184,0,377,71,3257
"12119910500",2986,473,539,116,403,24,332,123,4996
"12119910601",3066,703,23,4,339,112,202,73,4522
"12119910602",1953,686,91,129,96,0,157,133,3245
"12119910700",3297,1131,399,206,139,87,323,393,5975
"12119910800",4243,178,12,0,35,0,20,0,4488
"12119910900",0,0,0,0,0,0,0,0,0
"12119911000",116,222,67,183,26,80,28,119,841
"12119911200",35479,1672,425,82,487,0,411,125,38681
"12119911301",2528,218,2,11,68,23,1,7,2858
"12119911302",20,6,327,586,0,2,0,4,945
"12119911400",5967,596,355,204,225,0,122,29,7498
"12119911500",1232,231,337,23,7,0,29,37,1896
"12119911701",9925,429,74,0,132,0,144,36,10740
"12119911702",4785,253,50,0,22,0,127,0,5237
"12119980000",0,0,13,0,0,0,0,0,13
"12121970100",3401,612,1226,697,97,29,517,215,6794
"12121970200",2780,777,400,298,178,175,280,480,5368
"12121970301",1207,392,24,96,41,5,86,71,1922
"12121970302",4176,1407,377,39,261,40,105,73,6478
"12121970400",4295,1268,1007,630,76,16,451,527,8270
"12121970500",6579,1676,334,53,70,136,190,227,9265
"12121970600",4982,1342,112,140,249,184,173,293,7475
"12123950100",2676,484,205,327,22,5,30,26,3775
"12123950200",3959,331,341,101,116,37,93,0,4978
"12123950300",2797,451,1589,412,221,46,0,0,5516
"12123950400",3830,526,0,0,58,0,15,0,4429
"12123990000",0,0,0,0,0,0,0,0,0
"12125960100",1138,186,172,26,64,2,36,0,1624
"12125960200",2691,767,590,235,109,24,211,19,4646
"12125960300",2903,567,157,153,172,42,26,156,4176
"12127080100",7183,343,61,0,282,53,74,0,7996
"12127080201",2334,157,0,2,76,0,123,12,2704
"12127080202",2738,343,13,0,63,0,73,11,3241
"12127080300",2261,809,0,16,53,0,36,16,3191
"12127080400",2812,280,0,33,82,0,194,12,3413
"12127080500",1855,271,59,0,48,77,14,17,2341
"12127080600",2137,566,213,272,97,129,78,123,3615
"12127080700",3730,155,112,0,143,38,53,22,4253
"12127080803",4082,557,21,188,194,422,230,4,5698
"12127080804",4791,1034,266,40,598,18,237,93,7077
"12127080805",4724,740,121,0,387,62,717,110,6861
"12127080806",2142,325,129,10,53,0,4,0,2663
"12127080807",3634,390,223,0,628,107,601,126,5709
"12127080901",2231,500,586,446,249,132,172,0,4316
"12127080902",2115,500,644,105,21,0,15,0,3400
"12127081000",2363,921,193,283,23,48,73,167,4071
"12127081101",1790,186,93,0,9,61,61,46,2246
"12127081102",1505,241,28,0,70,36,108,18,2006
"12127081200",2523,1153,55,32,83,63,260,63,4232
"12127081300",1713,206,36,0,139,61,185,6,2346
"12127081500",854,679,141,265,0,119,12,123,2193
"12127081600",650,460,1023,271,29,63,107,255,2858
"12127081700",1660,677,2209,1875,169,206,155,105,7056
"12127081800",528,175,1503,773,137,34,9,0,3159
"12127081900",46,12,980,1028,0,153,0,121,2340
"12127082000",352,256,481,153,16,17,20,14,1309
"12127082100",98,129,1480,2508,147,35,122,35,4554
"12127082201",1417,477,245,828,41,121,39,110,3278
"12127082202",1136,226,239,15,63,7,88,28,1802
"12127082301",1943,805,1180,1355,364,391,354,468,6860
"12127082401",1756,481,548,457,249,211,211,132,4045
"12127082404",1531,516,88,56,171,33,165,26,2586
"12127082405",2692,362,116,154,209,0,56,10,3599
"12127082406",2473,114,241,0,74,0,225,0,3127
"12127082410",4476,764,191,110,420,135,298,30,6424
"12127082411",2674,548,136,0,261,79,175,0,3873
"12127082412",1672,297,380,133,108,0,98,0,2688
"12127082413",2271,684,98,61,371,163,241,169,4058
"12127082414",2322,682,145,64,89,43,53,132,3530
"12127082415",1685,353,459,100,165,251,61,280,3354
"12127082503",4307,1384,181,170,56,0,67,243,6408
"12127082506",3344,470,0,0,207,0,198,0,4219
"12127082507",5740,1018,339,2,218,0,101,2,7420
"12127082508",3964,331,176,2,277,0,219,2,4971
"12127082509",3760,143,87,0,87,0,53,0,4130
"12127082510",2945,485,59,14,186,34,283,0,4006
"12127082511",1893,371,33,0,115,0,132,0,2544
"12127082604",1828,478,0,0,341,18,10,0,2675
"12127082605",2751,256,29,0,58,0,70,0,3164
"12127082606",2831,179,0,0,41,26,141,0,3218
"12127082607",1947,274,0,20,38,12,42,0,2333
"12127082701",1814,86,0,0,24,0,56,0,1980
"12127082703",2493,241,0,0,32,0,133,0,2899
"12127082704",1884,286,0,0,19,0,19,0,2208
"12127082705",1867,380,0,0,54,0,39,0,2340
"12127082801",1941,280,45,0,110,7,51,0,2434
"12127082802",3125,607,2,77,7,2,51,86,3957
"12127082902",4274,878,125,0,69,34,43,44,5467
"12127082903",2628,850,980,182,37,10,366,83,5136
"12127082904",4249,453,26,0,21,89,114,58,5010
"12127083003",4332,728,255,22,132,4,35,15,5523
"12127083005",3220,390,120,20,70,1,182,2,4005
"12127083006",5539,341,135,170,36,340,160,110,6831
"12127083007",3866,588,193,33,231,22,32,49,5014
"12127083008",2010,335,0,1,93,19,71,22,2551
"12127083009",2993,632,21,0,194,0,173,0,4013
"12127083203",6529,321,144,0,289,30,488,9,7810
"12127083205",1975,260,70,0,220,32,78,42,2677
"12127083206",648,68,0,5,97,0,15,0,833
"12127083207",6042,510,109,14,125,0,130,24,6954
"12127083208",9827,726,442,414,545,127,497,0,12578
"12127083209",5259,209,191,164,257,41,80,0,6201
"12127090101",2747,322,28,0,171,0,271,79,3618
"12127090102",1683,521,32,12,532,1043,667,1273,5763
"12127090202",4567,828,435,42,134,0,325,138,6469
"12127090203",3411,997,296,88,200,261,517,856,6626
"12127090204",5665,748,219,37,320,261,484,88,7822
"12127090303",2064,507,0,264,50,66,76,304,3331
"12127090304",3304,518,130,63,347,140,600,101,5203
"12127090305",2882,362,0,85,51,0,144,38,3562
"12127090306",3470,343,84,0,534,26,87,56,4600
"12127090307",4432,413,414,60,154,147,876,134,6630
"12127090400",3258,732,48,12,131,5,273,170,4629
"12127090500",1126,391,114,37,0,9,60,81,1818
"12127090600",1788,1262,1398,429,528,542,583,1176,7706
"12127090701",4519,784,163,3,115,0,631,9,6224
"12127090702",2711,455,844,623,376,32,535,19,5595
"12127090803",3779,745,14,32,153,0,492,0,5215
"12127090804",5244,1405,368,49,389,87,706,461,8709
"12127090805",4725,816,115,0,80,13,273,75,6097
"12127090806",2524,710,285,35,384,97,995,280,5310
"12127090902",7947,953,262,118,655,85,1708,247,11975
"12127090903",3540,236,51,0,204,5,318,20,4374
"12127090904",4492,491,226,0,112,0,313,70,5704
"12127091001",4030,409,643,108,545,10,639,78,6462
"12127091005",1771,196,89,165,54,0,107,19,2401
"12127091013",6087,806,452,164,628,0,2285,152,10574
"12127091015",2806,970,258,208,247,30,1227,452,6198
"12127091016",3850,1091,426,93,325,321,1733,829,8668
"12127091017",2528,767,146,0,344,36,1285,555,5661
"12127091018",4174,1091,562,200,752,57,1709,212,8757
"12127091019",3087,681,786,180,110,0,670,429,5943
"12127091020",4157,653,432,231,509,17,1173,338,7510
"12127091021",1744,306,54,2,230,39,494,93,2962
"12127091022",5639,847,737,0,245,183,1975,712,10338
"12127091023",2139,411,70,32,435,12,1229,58,4386
"12127091024",5455,481,605,302,501,118,2431,249,10142
"12127091025",2480,940,789,216,456,69,1075,585,6610
"12127091026",4608,1261,422,1,206,149,1433,584,8664
"12127091027",4901,224,614,191,952,207,2099,179,9367
"12127091028",2869,311,456,70,637,113,1160,159,5775
"12127091029",3802,419,310,0,226,19,678,32,5486
"12127092500",2273,650,839,208,289,178,756,56,5249
"12127990000",0,0,0,0,0,0,0,0,0
"12129010100",3756,548,127,91,102,20,48,0,4692
"12129010201",6864,904,1053,147,430,80,338,19,9835
"12129010202",3314,1070,724,48,16,0,69,0,5241
"12129010203",6271,1078,668,91,68,24,208,98,8506
"12129990000",0,0,0,0,0,0,0,0,0
"12131950101",4168,1886,80,55,96,269,65,193,6812
"12131950102",2081,555,0,0,37,0,66,59,2798
"12131950200",1984,631,495,382,365,358,347,283,4845
"12131950301",3913,1451,479,1,217,93,194,77,6425
"12131950302",3771,376,392,9,513,173,201,104,5539
"12131950400",1772,868,109,113,209,36,59,0,3166
"12131950501",2627,1035,61,30,418,44,148,46,4409
"12131950502",3395,321,48,13,256,23,239,9,4304
"12131950601",8280,469,118,1,917,0,870,0,10655
"12131950602",2684,125,0,0,15,0,46,0,2870
"12131950603",7557,433,0,0,457,54,331,0,8832
"12131990000",0,0,0,0,0,0,0,0,0
"12133970102",1387,377,36,0,23,0,10,0,1833
"12133970103",2055,613,319,228,51,5,5,12,3288
"12133970104",1427,280,519,443,52,49,68,0,2838
"12133970200",2546,457,138,79,148,30,131,0,3529
"12133970301",2036,351,113,1,12,3,155,9,2680
"12133970302",2965,499,393,200,57,139,67,10,4330
"12133970303",2617,837,211,41,125,91,1,64,3987
"13001950100",2945,360,50,0,32,0,0,0,3387
"13001950200",1494,681,1442,457,187,60,129,342,4792
"13001950300",2805,718,360,364,455,45,547,40,5334
"13001950400",836,169,333,115,0,0,16,11,1480
"13001950500",3137,702,85,65,20,9,408,165,4591
"13003960100",947,307,294,126,96,315,210,331,2626
"13003960200",2360,710,792,155,326,533,573,750,6199
"13003960300",976,224,47,0,53,0,119,23,1442
"13005970100",2392,403,117,0,156,20,270,25,3383
"13005970201",2243,294,491,404,332,108,324,73,4269
"13005970202",2712,440,243,196,96,54,161,0,3902
"13007960100",694,209,802,447,52,0,31,6,2241
"13007960200",751,4,228,92,8,0,22,0,1105
"13009970100",2789,506,1246,457,37,123,0,123,5281
"13009970200",3273,465,1013,1431,143,199,68,170,6762
"13009970300",3234,219,1959,414,403,93,120,93,6535
"13009970400",1427,1121,1461,573,151,157,70,43,5003
"13009970500",1133,2006,964,786,155,70,0,170,5284
"13009970600",765,417,1394,811,31,67,0,0,3485
"13009970701",431,307,747,976,19,6,0,0,2486
"13009970702",487,209,759,328,26,14,3,6,1832
"13009970800",3492,746,1322,700,12,0,12,0,6284
"13011970100",4224,868,25,7,113,21,204,369,5831
"13011970200",3672,843,202,24,251,21,57,42,5112
"13011970300",3360,561,52,98,49,24,20,2,4166
"13011970400",2978,559,84,0,236,0,396,68,4321
"13013180103",3797,253,116,14,368,41,172,0,4761
"13013180104",1447,222,100,76,116,15,176,9,2161
"13013180105",1808,279,198,0,326,183,145,87,3026
"13013180106",2026,301,301,23,88,92,112,146,3089
"13013180107",2241,666,175,160,583,16,377,146,4364
"13013180108",2370,333,92,61,302,44,163,14,3379
"13013180203",1694,323,544,291,510,32,615,66,4075
"13013180204",1286,241,545,241,125,108,269,53,2868
"13013180205",2160,933,463,337,382,91,236,33,4635
"13013180206",2033,389,26,6,254,0,132,0,2840
"13013180301",1894,151,47,0,75,0,118,0,2285
"13013180302",4677,594,129,0,65,42,261,63,5831
"13013180303",3177,562,298,23,263,0,144,284,4751
"13013180401",4384,234,408,14,245,164,201,0,5650
"13013180402",3960,529,1500,41,40,13,638,111,6832
"13013180501",3870,473,575,494,271,10,697,10,6400
"13013180502",3228,781,213,39,273,14,160,151,4859
"13013180503",3636,789,550,164,441,0,196,708,6484
"13015960101",1411,63,0,0,0,0,21,0,1495
"13015960102",8040,549,202,305,88,9,421,16,9630
"13015960200",8338,1575,1114,341,289,33,296,317,12303
"13015960300",5217,580,226,208,199,210,297,210,7147
"13015960401",6677,319,1286,355,359,305,743,310,10354
"13015960402",5625,1414,752,174,191,255,361,0,8772
"13015960500",4872,1423,806,541,277,216,391,465,8991
"13015960600",5560,1514,1292,517,424,0,419,774,10500
"13015960700",4752,407,1377,110,273,83,751,152,7905
"13015960801",2373,662,173,7,241,0,282,0,3738
"13015960802",1610,836,20,1,355,1,356,134,3313
"13015960803",4190,889,67,62,420,73,207,42,5950
"13015960901",2445,649,46,0,96,0,129,88,3453
"13015960902",4670,445,632,34,523,0,404,64,6772
"13015961000",6365,559,347,0,311,95,263,45,7985
"13017960100",1601,685,188,174,16,0,0,0,2664
"13017960200",998,396,229,51,41,9,36,18,1778
"13017960300",1684,436,570,555,49,0,118,138,3550
"13017960400",1271,506,865,1025,136,106,235,447,4591
"13017960500",2334,539,895,1511,171,31,75,14,5570
"13019970100",1092,218,312,176,46,0,27,0,1871
"13019970200",2231,1048,381,49,107,40,376,93,4325
"13019970300",2431,447,53,37,168,5,189,5,3335
"13019970400",1630,575,193,398,11,56,0,56,2919
"13019970500",2342,549,192,87,58,150,77,49,3504
"13019970600",2361,944,155,98,133,46,46,5,3788
"13021010100",52,17,427,965,6,28,0,10,1505
"13021010200",1170,195,378,169,29,0,57,0,1998
"13021010300",126,12,463,155,0,0,0,0,756
"13021010400",0,75,824,1188,84,0,0,22,2193
"13021010500",7,51,426,1239,0,0,0,8,1731
"13021010800",870,321,173,40,50,9,13,45,1521
"13021011000",1189,334,1226,1557,183,63,116,63,4731
"13021011100",22,26,824,1054,7,0,0,0,1933
"13021011500",33,21,520,572,7,45,11,11,1220
"13021011701",228,38,1625,594,33,0,20,5,2543
"13021011702",219,36,3239,886,70,17,0,0,4467
"13021011800",2199,170,602,382,56,35,10,0,3454
"13021011900",712,255,657,208,25,3,0,17,1877
"13021012000",3034,163,906,163,110,3,112,0,4491
"13021012101",1107,56,397,46,97,0,0,0,1703
"13021012102",2847,325,1187,86,485,77,58,203,5268
"13021012200",519,158,807,754,133,9,38,0,2418
"13021012300",209,72,887,1363,0,6,0,17,2554
"13021012400",185,15,2028,1958,0,16,0,0,4202
"13021012500",148,40,1332,1365,102,19,46,19,3071
"13021012600",453,205,2233,1874,105,0,127,0,4997
"13021012700",107,33,721,1127,0,169,0,20,2177
"13021012800",352,169,1160,1868,9,24,55,11,3648
"13021012900",376,80,468,785,0,7,0,2,1718
"13021013101",895,439,2165,2191,13,28,37,359,6127
"13021013102",576,50,2025,1627,0,0,0,0,4278
"13021013201",776,191,3472,1487,120,0,239,0,6285
"13021013202",415,166,1257,933,27,86,123,209,3216
"13021013302",567,329,2218,539,30,48,0,0,3731
"13021013407",2416,324,1079,396,180,271,182,0,4848
"13021013408",3345,107,725,31,253,74,45,0,4580
"13021013409",2199,73,887,23,563,62,307,3,4117
"13021013410",4343,107,608,14,79,0,0,0,5151
"13021013411",2498,202,559,417,92,0,109,58,3935
"13021013502",1190,321,178,6,60,0,11,172,1938
"13021013503",1219,448,566,145,327,49,449,308,3511
"13021013504",5840,480,1377,341,349,33,33,45,8498
"13021013603",2409,586,483,0,0,202,76,219,3975
"13021013604",2568,496,1683,230,225,0,88,70,5360
"13021013605",2733,102,1700,87,105,0,188,0,4915
"13021013606",3992,346,1686,17,68,0,0,0,6109
"13021013700",540,170,685,459,19,25,26,12,1936
"13021013800",12,3,995,961,4,164,8,56,2203
"13021013900",275,472,565,448,85,10,34,135,2024
"13023790100",3728,393,170,264,55,11,24,11,4656
"13023790200",814,112,652,490,70,181,78,181,2578
"13023790300",2823,525,190,542,35,98,15,0,4228
"13025960100",5086,1585,243,0,282,46,29,6,7277
"13025960200",4304,1068,174,14,82,14,23,10,5689
"13025960300",4104,971,30,114,0,0,46,0,5265
"13027960200",893,122,185,97,206,76,162,57,1798
"13027960300",3215,640,466,779,64,330,59,354,5907
"13027960400",1298,293,926,752,79,0,78,43,3469
"13027960500",928,60,1021,639,101,0,43,6,2798
"13027960600",1324,346,476,131,0,0,0,48,2325
"13029920101",3839,628,295,176,131,16,76,33,5194
"13029920102",3309,955,672,385,86,306,28,180,5921
"13029920301",1390,201,237,17,148,20,164,14,2191
"13029920303",3129,689,1429,315,351,41,234,283,6471
"13029920305",3590,139,391,0,316,73,408,73,4990
"13029920306",7644,313,956,155,597,58,540,0,10263
"13029980000",0,0,0,0,0,0,0,0,0
"13031110100",2208,543,623,249,53,85,6,13,3780
"13031110200",3209,807,1172,1150,250,187,165,121,7061
"13031110300",4899,1256,1113,535,405,82,176,267,8733
"13031110401",804,528,1106,742,59,58,43,16,3356
"13031110403",1440,2589,1159,1413,42,358,187,101,7289
"13031110404",130,792,211,778,55,141,28,29,2164
"13031110500",1762,1449,570,505,168,298,133,76,4961
"13031110601",3239,863,1512,693,395,0,134,0,6836
"13031110602",1747,494,740,675,150,24,238,22,4090
"13031110700",5553,2008,1273,731,771,10,397,3,10746
"13031110800",1406,464,482,149,24,1,9,0,2535
"13031110900",5150,872,468,265,94,0,195,0,7044
"13033950100",2257,699,935,1110,122,0,145,58,5326
"13033950200",1516,618,303,294,16,12,65,12,2836
"13033950400",948,81,2161,1904,0,34,0,0,5128
"13033950500",2275,294,1268,1211,190,43,141,43,5465
"13033950700",1310,143,756,484,24,0,11,0,2728
"13033950900",647,86,753,118,97,0,176,6,1883
"13035150100",5827,1068,566,229,41,8,88,0,7827
"13035150200",3741,648,1674,1243,189,86,301,11,7893
"13035150300",3410,556,891,463,108,28,179,0,5635
"13037950100",635,126,574,497,90,28,80,52,2082
"13037950200",711,60,688,1152,0,61,0,51,2723
"13039010100",1702,229,450,103,61,0,26,6,2577
"13039010200",3083,326,915,392,169,39,104,50,5078
"13039010301",5545,874,1130,366,336,55,27,41,8374
"13039010302",2448,239,758,246,372,17,138,36,4254
"13039010401",8216,627,1751,476,833,70,915,69,12957
"13039010402",4632,92,178,0,294,0,773,0,5969
"13039010403",3028,173,502,264,112,15,61,0,4155
"13039010500",791,333,193,84,111,33,220,124,1889
"13039010601",3593,602,1003,525,383,75,39,142,6362
"13039010602",635,72,42,22,93,16,92,2,974
"13039990000",0,0,0,0,0,0,0,0,0
"13043950100",2051,787,1059,757,214,199,218,283,5568
"13043950200",2177,788,232,103,173,40,128,207,3848
"13043950300",936,397,336,84,102,243,162,241,2501
"13045910101",2827,689,997,867,442,118,126,0,6066
"13045910103",3315,341,797,48,391,40,389,39,5360
"13045910104",6030,1226,1588,320,290,202,612,284,10552
"13045910200",8780,1812,1137,357,0,0,233,0,12319
"13045910300",4088,923,622,80,118,28,218,92,6169
"13045910400",2589,495,113,40,21,11,12,6,3287
"13045910501",2405,1265,1402,957,327,112,553,201,7222
"13045910502",656,375,889,707,181,127,540,253,3728
"13045910600",3578,595,586,429,171,519,70,621,6569
"13045910701",5710,683,466,441,393,177,373,167,8410
"13045910702",5325,901,578,270,348,0,304,0,7726
"13045910703",5113,1324,1384,606,290,47,154,224,9142
"13045910800",3300,613,102,4,76,0,133,16,4244
"13045910900",3180,517,198,95,98,0,81,24,4193
"13045911000",3695,870,835,122,540,51,433,332,6878
"13045911100",4783,1436,910,167,110,138,47,491,8082
"13045911200",3836,745,445,323,133,228,27,0,5737
"13047030100",5217,1078,36,4,40,41,60,78,6554
"13047030201",3753,352,77,53,95,30,73,30,4463
"13047030202",5112,445,180,0,447,31,66,0,6281
"13047030301",6771,507,35,24,189,0,253,0,7779
"13047030303",2786,303,0,0,82,0,83,0,3254
"13047030304",3553,168,66,0,0,0,24,0,3811
"13047030401",5911,486,0,0,446,144,162,53,7202
"13047030402",4946,904,242,101,245,35,299,34,6806
"13047030500",4694,758,353,0,279,22,37,22,6165
"13047030600",4512,793,81,0,238,16,331,0,5971
"13047030700",5986,1309,53,430,248,27,86,0,8139
"13049010100",4145,984,2780,280,82,54,297,13,8635
"13049010200",2504,662,108,0,43,30,114,0,3461
"13051000100",3,0,23,869,7,0,7,0,909
"13051000300",1003,158,47,9,19,17,72,38,1363
"13051000601",31,76,1802,1010,46,11,0,0,2976
"13051000900",749,210,95,81,6,29,36,59,1265
"13051001100",674,229,572,509,5,64,29,16,2098
"13051001200",11,15,730,1206,0,0,0,15,1977
"13051001500",398,565,155,210,23,64,24,166,1605
"13051002000",270,274,438,240,22,21,28,16,1309
"13051002100",220,96,1320,491,19,0,5,0,2151
"13051002200",631,130,2560,697,18,53,37,0,4126
"13051002300",75,9,1104,787,20,0,0,0,1995
"13051002600",372,161,797,200,32,3,16,0,1581
"13051002700",404,135,1653,735,0,41,36,0,3004
"13051002800",153,30,1277,549,62,26,9,0,2106
"13051002900",2614,197,210,34,42,56,55,24,3232
"13051003000",1499,229,92,19,178,18,113,53,2201
"13051003301",0,10,1360,579,20,16,5,4,1994
"13051003302",99,0,1183,377,0,0,0,0,1659
"13051003400",2059,156,903,583,80,12,39,0,3832
"13051003501",602,122,1063,836,11,125,28,7,2794
"13051003502",1375,220,1467,858,186,0,0,22,4128
"13051003601",494,86,1452,912,60,0,169,7,3180
"13051003602",943,147,2146,1060,104,28,122,19,4569
"13051003700",404,64,829,421,38,7,40,0,1803
"13051003800",244,143,1183,402,96,0,16,0,2084
"13051003900",1218,76,1675,509,9,0,43,0,3530
"13051004001",3014,180,494,394,88,0,104,0,4274
"13051004002",1885,427,652,264,191,179,129,94,3821
"13051004100",1153,170,293,136,27,14,49,0,1842
"13051004207",683,202,1457,1117,19,94,20,33,3625
"13051004208",1516,280,2229,300,763,58,632,62,5840
"13051004209",1185,131,1093,466,152,354,116,147,3644
"13051004210",1549,296,1588,1144,354,71,453,16,5471
"13051004211",2547,415,1179,768,270,0,98,134,5411
"13051004212",2808,325,997,293,384,24,246,17,5094
"13051004300",1075,162,505,0,253,66,280,79,2420
"13051004400",54,9,1450,589,0,14,4,27,2147
"13051004500",137,43,2851,1225,0,0,0,66,4322
"13051010101",327,16,57,475,40,0,4,0,919
"13051010102",1652,199,894,346,128,37,192,33,3481
"13051010200",1529,350,1715,457,599,0,87,22,4759
"13051010501",1816,1617,483,256,570,506,840,1058,7146
"13051010502",732,88,1754,950,43,20,19,0,3606
"13051010601",1708,583,1347,415,58,82,319,243,4755
"13051010603",665,128,904,92,60,20,10,22,1901
"13051010605",10,0,0,0,0,0,0,0,10
"13051010700",8844,752,6843,300,2257,149,1584,22,20751
"13051010801",2062,282,209,29,51,14,85,35,2767
"13051010802",5690,369,2376,236,639,12,327,31,9680
"13051010803",6686,888,2522,383,406,28,467,0,11380
"13051010806",2622,765,1688,352,832,81,352,62,6754
"13051010807",2676,226,1556,2,433,28,391,53,5365
"13051010808",4310,1091,3705,239,635,741,669,1150,12540
"13051010809",6441,482,3501,342,919,88,582,73,12428
"13051010901",1496,536,1098,675,219,127,394,336,4881
"13051011003",4555,804,940,24,214,38,416,88,7079
"13051011004",3218,112,15,21,138,0,39,0,3543
"13051011005",4282,85,67,0,74,0,107,0,4615
"13051011006",3355,105,38,0,57,0,83,0,3638
"13051011103",2603,559,0,0,116,0,9,0,3287
"13051011104",4054,321,130,1,436,14,59,0,5015
"13051011106",4326,453,243,4,452,316,210,0,6004
"13051011107",2801,56,60,0,128,9,82,12,3148
"13051011108",2589,93,96,2,197,0,35,0,3012
"13051011109",5940,176,109,0,436,158,222,20,7061
"13051011200",1031,426,45,53,10,39,41,32,1677
"13051011300",566,646,706,449,40,58,41,18,2524
"13051011400",589,492,642,280,50,22,35,67,2177
"13051011500",1761,139,464,77,151,0,34,0,2626
"13051011600",109,79,1597,467,166,26,182,105,2731
"13051980000",0,0,0,0,0,0,0,0,0
"13051990000",0,0,0,0,0,0,0,0,0
"13053020100",1322,281,486,51,334,74,14,19,2581
"13053020201",715,85,37,0,187,0,144,4,1172
"13053020203",1437,29,247,14,187,35,342,42,2333
"13053020205",1896,201,303,52,248,138,531,36,3405
"13053020206",0,0,0,0,0,0,0,0,0
"13055010100",1568,322,35,20,27,5,19,5,2001
"13055010200",4565,1371,49,5,273,61,467,357,7148
"13055010300",2293,497,76,17,31,0,0,13,2927
"13055010400",3552,1211,122,209,26,93,0,0,5213
"13055010500",2583,767,617,156,165,19,97,19,4423
"13055010600",1517,701,213,4,0,30,65,21,2551
"13057090100",7593,821,157,22,268,26,294,6,9187
"13057090200",6533,457,147,58,206,174,99,15,7689
"13057090300",10576,979,274,38,391,31,422,46,12757
"13057090400",6035,1312,1147,196,601,459,1249,847,11846
"13057090501",5247,693,97,0,176,49,97,49,6408
"13057090502",11323,1376,272,4,928,29,1064,677,15673
"13057090601",4580,1245,273,2,262,703,749,1560,9374
"13057090602",5748,641,435,293,912,251,1292,228,9800
"13057090701",14975,1321,733,407,1374,0,1145,76,20031
"13057090702",5697,1103,308,297,235,48,566,388,8642
"13057090802",5704,371,74,443,178,114,322,68,7274
"13057090803",8636,617,285,0,673,44,412,44,10711
"13057090804",7809,744,427,4,462,0,372,267,10085
"13057090901",6527,616,254,112,273,0,624,0,8406
"13057090902",11973,496,855,0,1115,0,1041,122,15602
"13057090904",6112,708,205,40,921,547,1199,345,10077
"13057090905",2821,231,293,5,132,90,319,5,3896
"13057091001",2650,255,634,249,509,0,334,110,4741
"13057091003",4783,800,789,82,617,124,966,199,8360
"13057091005",5817,1394,593,0,162,0,698,924,9588
"13057091006",4263,150,196,100,185,0,253,0,5147
"13057091007",5978,155,267,18,182,0,260,56,6916
"13057091008",6644,350,544,0,633,21,231,32,8455
"13057091101",4126,329,850,133,336,75,53,45,5947
"13057091102",6333,1048,1120,0,348,62,979,489,10379
"13057091103",6722,711,752,0,472,0,665,37,9359
"13059000100",287,1299,10,71,10,78,0,43,1798
"13059000401",193,246,60,52,370,330,11,8,1270
"13059000402",83,525,7,3,10,87,14,6,735
"13059000600",716,866,175,401,11,151,89,146,2555
"13059000900",373,300,1007,1438,53,20,51,96,3338
"13059001200",1977,415,215,300,103,32,80,23,3145
"13059001700",1265,150,429,25,152,0,58,12,2091
"13059001800",1560,336,90,227,119,0,72,16,2420
"13059001900",1979,1177,260,596,62,83,174,63,4394
"13059002000",1390,371,120,99,77,11,11,18,2097
"13059002100",1257,1009,46,30,324,74,0,45,2785
"13059002200",1247,829,45,38,80,35,48,63,2385
"13059030100",655,1395,1468,1192,108,90,46,21,4975
"13059030200",645,647,1778,1412,54,222,196,33,4987
"13059130300",2171,1026,1299,978,118,343,1286,1202,8423
"13059130400",2756,539,1652,322,151,197,170,156,5943
"13059130500",1473,124,817,132,62,0,79,0,2687
"13059130600",3103,1246,880,767,237,347,671,505,7756
"13059130700",3118,736,514,171,614,50,343,128,5674
"13059140300",1677,856,1655,741,20,264,541,824,6578
"13059140400",962,1259,618,258,174,337,342,1336,5286
"13059140500",488,278,642,347,13,26,259,136,2189
"13059140600",2784,351,848,489,311,139,482,195,5599
"13059150300",1711,423,463,338,323,96,423,31,3808
"13059150400",792,3179,95,233,103,536,92,102,5132
"13059150500",1791,2004,312,145,87,238,267,124,4968
"13059150600",1162,761,374,214,306,81,271,100,3269
"13059150700",3124,650,734,689,398,55,229,20,5899
"13059150800",3542,496,1155,453,373,126,100,192,6437
"13059150900",2360,583,604,262,333,12,254,0,4408
"13061960300",735,210,804,1075,222,0,152,0,3198
"13063040202",231,10,1221,704,268,50,174,16,2674
"13063040203",117,0,2007,953,85,35,102,76,3375
"13063040204",56,148,2339,921,88,0,128,8,3688
"13063040302",1432,393,1316,939,602,108,934,428,6152
"13063040303",1071,1068,2006,1380,481,349,289,1088,7732
"13063040306",788,1036,826,570,534,303,774,1166,5997
"13063040307",1274,261,1174,409,1272,166,744,173,5473
"13063040308",1179,565,1115,522,443,163,996,436,5419
"13063040407",688,98,1703,285,1096,170,562,102,4704
"13063040408",1178,484,2760,975,1657,84,327,295,7760
"13063040409",1289,279,2954,142,1056,132,818,92,6762
"13063040410",1177,1177,3462,392,458,496,532,1331,9025
"13063040411",2094,127,8848,969,584,379,533,257,13791
"13063040412",1664,103,3276,1459,1272,214,706,29,8723
"13063040413",1026,669,3145,1148,868,56,529,420,7861
"13063040414",686,272,367,142,388,9,680,122,2666
"13063040415",752,811,2309,1516,236,359,527,947,7457
"13063040416",761,554,1649,401,538,274,643,331,5151
"13063040417",457,114,2129,1418,224,269,274,309,5194
"13063040509",259,126,3521,568,100,130,99,152,4955
"13063040510",225,84,2272,410,219,115,182,51,3558
"13063040512",203,55,3677,1111,191,99,150,47,5533
"13063040513",314,19,3279,425,707,0,26,0,4770
"13063040514",730,545,4250,1169,0,205,514,673,8086
"13063040515",1091,89,4083,1535,426,497,740,377,8838
"13063040516",468,163,2859,1988,445,109,410,92,6534
"13063040518",758,332,2461,1026,204,247,335,353,5716
"13063040519",60,39,2713,1163,83,125,42,153,4378
"13063040520",68,85,1971,1131,38,75,77,94,3539
"13063040521",503,39,1643,950,179,34,127,59,3534
"13063040522",441,284,2260,856,443,98,258,197,4837
"13063040523",168,3,1445,807,519,152,76,152,3322
"13063040524",841,269,4301,959,709,46,835,279,8239
"13063040525",181,53,1556,775,159,0,175,0,2899
"13063040526",514,335,3388,1819,79,123,232,240,6730
"13063040606",1355,133,978,220,78,237,397,217,3615
"13063040608",2026,107,7348,1260,321,206,366,173,11807
"13063040609",1464,84,3492,355,689,73,476,0,6633
"13063040611",1292,644,2434,1096,106,637,542,1015,7766
"13063040612",1034,495,1759,904,318,414,209,265,5398
"13063040613",2339,551,3882,1037,198,151,169,400,8727
"13063040614",2210,163,1339,327,704,84,256,52,5135
"13063040615",302,80,1381,192,134,1,131,0,2221
"13063040616",661,543,5006,1497,352,276,476,685,9496
"13063040617",887,353,0,9,229,206,697,327,2708
"13063040619",551,0,1828,666,288,107,251,86,3777
"13063040620",813,110,1711,516,127,0,104,189,3570
"13063040621",1422,418,6729,1311,388,28,394,290,10980
"13063040622",1318,545,4711,993,443,461,552,430,9453
"13063980000",0,0,0,0,0,0,0,0,0
"13065970100",2811,842,564,658,38,288,37,213,5451
"13065970200",709,137,138,410,79,4,25,10,1512
"13067030101",6332,452,401,268,226,120,534,109,8442
"13067030103",5362,293,2126,444,776,75,327,77,9480
"13067030104",2221,220,630,111,418,23,470,0,4093
"13067030106",3392,553,2229,221,1250,195,604,176,8620
"13067030107",2650,57,1521,42,460,89,504,0,5323
"13067030209",4439,58,1649,51,449,0,358,0,7004
"13067030214",5930,390,1263,5,494,117,497,16,8712
"13067030215",6205,333,1061,65,1316,446,949,372,10747
"13067030218",4163,146,670,0,662,0,485,44,6170
"13067030219",7518,156,790,130,641,0,553,0,9788
"13067030220",1125,18,466,69,188,0,134,0,2000
"13067030222",4631,435,326,89,357,47,228,38,6151
"13067030223",3717,88,1646,116,298,0,671,0,6536
"13067030224",4147,269,891,95,1137,98,877,130,7644
"13067030226",5644,260,1785,23,881,297,1155,0,10045
"13067030227",3761,217,2524,103,1105,171,1056,53,8990
"13067030228",3802,1365,1117,317,413,75,760,201,8050
"13067030229",1945,348,188,8,107,84,42,39,2761
"13067030230",8196,526,2421,749,831,102,1738,93,14656
"13067030231",6092,115,535,54,385,16,154,0,7351
"13067030232",3189,55,1849,43,507,29,565,0,6237
"13067030233",2834,66,918,96,332,0,324,0,4570
"13067030234",4268,121,1133,32,545,0,231,0,6330
"13067030235",3936,141,556,13,234,0,246,0,5126
"13067030236",4108,88,426,12,123,0,120,0,4877
"13067030238",5603,76,584,48,400,0,351,0,7062
"13067030239",7275,303,557,0,329,0,378,150,8992
"13067030310",5713,881,966,112,426,0,494,110,8702
"13067030311",4747,310,109,169,528,0,235,97,6195
"13067030312",4813,260,488,5,481,25,374,3,6449
"13067030313",5727,305,1504,92,773,0,511,0,8912
"13067030314",5789,465,763,5,831,63,515,161,8592
"13067030318",6759,209,302,0,717,0,205,0,8192
"13067030319",3648,164,60,0,393,0,95,0,4360
"13067030320",5212,387,834,130,1227,81,381,64,8316
"13067030322",2780,43,343,0,247,0,166,0,3579
"13067030324",2962,138,145,3,209,67,167,0,3691
"13067030326",3817,121,140,21,493,38,427,116,5173
"13067030327",3477,47,299,15,511,66,91,11,4517
"13067030328",5597,33,338,2,443,0,504,0,6917
"13067030329",3412,202,243,11,370,69,55,16,4378
"13067030330",4444,78,351,24,888,72,140,0,5997
"13067030331",4924,141,252,9,354,19,180,10,5889
"13067030332",2708,71,160,0,480,0,111,0,3530
"13067030333",4525,283,319,18,771,0,221,0,6137
"13067030334",2387,65,210,97,520,0,45,0,3324
"13067030335",4085,126,114,0,171,64,173,0,4733
"13067030336",6001,255,164,0,886,0,338,33,7677
"13067030337",3924,55,59,0,379,0,148,0,4565
"13067030339",3215,338,1201,101,966,41,462,34,6358
"13067030340",3300,24,225,0,385,0,452,0,4386
"13067030341",3362,154,542,0,369,10,237,59,4733
"13067030342",3891,124,279,1,369,58,97,15,4834
"13067030343",3949,73,185,0,348,38,57,0,4650
"13067030344",793,245,1629,378,289,267,211,196,4008
"13067030345",987,170,1047,329,2110,309,1016,262,6230
"13067030405",3100,564,1768,268,305,179,150,61,6395
"13067030407",3357,349,592,45,476,15,298,44,5176
"13067030408",1895,205,444,116,426,48,305,0,3439
"13067030409",2527,182,273,0,451,143,113,0,3689
"13067030410",3153,370,661,168,378,99,949,0,5778
"13067030411",743,263,1119,1010,216,238,550,371,4510
"13067030412",830,467,1827,535,358,431,445,473,5366
"13067030413",2031,558,1627,600,726,501,886,137,7066
"13067030414",428,146,1415,608,328,15,275,41,3256
"13067030502",4432,257,1256,24,739,1,657,0,7366
"13067030504",3554,428,1091,903,503,309,568,236,7592
"13067030505",3048,392,2038,313,1117,135,1613,130,8786
"13067030506",2657,199,877,49,363,37,406,131,4719
"13067030507",3520,462,670,34,347,0,393,0,5426
"13067030601",4083,675,2744,127,896,584,667,44,9820
"13067030602",5145,366,404,63,286,0,317,0,6581
"13067030700",1477,321,1151,332,389,175,477,258,4580
"13067030800",1800,651,475,130,168,402,846,852,5324
"13067030901",4392,295,1828,551,258,134,243,140,7841
"13067030902",3247,381,812,229,537,509,1228,560,7503
"13067030904",1740,756,2023,811,850,332,1148,835,8495
"13067030905",1672,323,1507,540,1157,555,1253,679,7686
"13067031001",1302,1256,966,543,755,671,1269,1484,8246
"13067031002",2180,942,2039,1071,2116,937,2762,1199,13246
"13067031004",2329,978,2207,652,734,597,1606,983,10086
"13067031005",1893,763,1415,300,941,171,1061,630,7174
"13067031101",1746,518,667,588,622,516,898,894,6449
"13067031106",3777,366,2911,527,1005,141,1270,243,10240
"13067031108",2146,271,1621,769,236,112,449,136,5740
"13067031110",1943,375,474,249,298,199,469,406,4413
"13067031111",1802,74,971,162,375,48,194,0,3626
"13067031112",3068,9,1336,40,629,221,171,221,5695
"13067031113",173,148,284,159,59,110,57,144,1134
"13067031114",2149,794,2377,349,1326,458,1086,831,9370
"13067031115",1794,410,1079,728,627,286,843,658,6425
"13067031116",1196,550,858,237,757,511,946,738,5793
"13067031117",3322,278,807,246,511,133,414,293,6004
"13067031118",2656,321,1367,155,1094,11,305,0,5909
"13067031205",3341,187,1460,262,559,0,866,19,6694
"13067031206",4574,338,3664,140,1259,0,416,0,10391
"13067031207",2248,152,475,49,859,185,75,0,4043
"13067031208",2601,293,1208,272,1968,0,392,68,6802
"13067031209",3118,107,402,23,522,0,280,38,4490
"13067031211",1544,104,1942,80,280,0,409,0,4359
"13067031212",2254,46,56,0,120,0,68,0,2544
"13067031306",1561,586,1192,321,249,75,225,127,4336
"13067031307",3400,229,1258,291,389,16,429,0,6012
"13067031308",1885,383,1961,681,345,251,1134,644,7284
"13067031309",2647,711,3464,965,503,61,1586,346,10283
"13067031310",971,766,3017,1847,786,255,1337,1089,10068
"13067031311",1350,949,4491,1950,544,63,759,711,10817
"13067031312",3085,745,4857,223,623,20,1044,549,11146
"13067031313",5210,238,3459,244,1179,0,1103,68,11501
"13067031404",2457,445,2512,81,252,10,484,135,6376
"13067031405",3074,403,3156,736,354,525,962,766,9976
"13067031406",2178,320,3067,1363,208,1,889,52,8078
"13067031408",1536,178,3096,489,316,10,282,24,5931
"13067031409",1580,559,1651,890,202,98,373,391,5744
"13067031503",3307,902,3895,964,987,12,976,510,11553
"13067031505",2366,274,2231,622,389,0,452,20,6354
"13067031506",1790,652,1401,234,374,153,472,355,5431
"13067031507",742,174,1741,696,88,89,227,133,3890
"13067031508",2310,282,1674,71,736,0,674,58,5805
"13067031509",3648,396,5032,372,661,0,679,141,10929
"13069010100",2528,449,244,175,20,20,244,96,3776
"13069010200",1934,731,52,0,66,134,125,348,3390
"13069010300",1756,471,280,256,271,17,257,2,3310
"13069010400",2754,375,567,558,100,44,129,0,4527
"13069010500",1821,553,184,720,72,92,150,336,3928
"13069010600",4560,537,393,44,109,6,146,120,5915
"13069010700",2987,769,994,356,266,722,651,913,7658
"13069010801",1938,648,2197,571,110,207,273,176,6120
"13069010802",1525,615,1453,882,20,23,300,23,4841
"13071970100",3390,783,498,43,576,63,814,181,6348
"13071970200",1943,263,153,368,104,89,11,74,3005
"13071970300",1326,353,1164,1962,153,0,192,176,5326
"13071970400",1533,808,377,312,124,0,331,323,3808
"13071970500",2565,169,228,98,237,70,340,147,3854
"13071970600",4367,885,364,70,515,234,1013,749,8197
"13071970701",3616,913,1088,765,87,287,276,668,7700
"13071970702",701,533,626,195,101,91,430,295,2972
"13071970800",1245,446,728,479,183,175,442,454,4152
"13071970900",4200,944,535,192,305,496,474,778,7924
"13073030102",7972,217,524,0,1158,0,296,0,10167
"13073030103",2329,154,347,0,509,0,144,0,3483
"13073030105",4039,253,874,0,212,107,101,84,5670
"13073030106",2707,379,282,86,244,145,94,32,3969
"13073030201",4518,174,1067,20,377,0,84,55,6295
"13073030202",2254,346,390,18,223,30,226,69,3556
"13073030203",4715,231,791,58,515,20,88,0,6418
"13073030302",8304,246,889,286,593,210,535,100,11163
"13073030304",5472,162,962,96,391,110,212,22,7427
"13073030306",3785,435,925,82,224,126,200,267,6044
"13073030307",5711,120,879,48,215,0,279,0,7252
"13073030308",7160,215,1020,227,1077,0,807,0,10506
"13073030309",8386,316,1582,2,638,30,102,29,11085
"13073030401",1483,169,272,212,55,10,43,0,2244
"13073030402",5999,1012,1600,33,919,100,804,253,10720
"13073030503",4780,892,1250,438,282,123,257,101,8123
"13073030504",2317,430,398,152,31,7,61,156,3552
"13073030505",3730,825,1642,106,325,294,1041,341,8304
"13073030506",6080,534,2947,622,879,243,890,298,12493
"13073030603",2813,713,665,474,166,179,25,11,5046
"13075960100",1333,483,165,115,22,6,102,37,2263
"13075960200",1722,594,662,789,50,58,152,95,4122
"13075960300",3450,642,1012,439,216,186,231,159,6335
"13075960400",2808,631,1200,300,0,1,202,22,5164
"13077170100",4810,1697,404,52,429,179,251,0,7822
"13077170200",4805,811,820,141,384,0,98,154,7213
"13077170303",4252,291,272,144,243,0,132,0,5334
"13077170304",4406,55,1774,260,125,0,259,0,6879
"13077170305",4246,2052,2115,1039,765,47,904,1237,12405
"13077170306",5206,329,1217,571,568,286,632,74,8883
"13077170402",7661,671,1210,33,109,93,688,299,10764
"13077170403",3710,67,440,0,255,0,185,0,4657
"13077170404",5009,96,370,0,319,21,180,0,5995
"13077170405",6069,651,233,13,371,15,608,87,8047
"13077170406",3306,95,170,0,55,0,63,0,3689
"13077170501",5723,356,520,64,233,17,738,22,7673
"13077170502",4869,374,469,90,185,0,140,0,6127
"13077170503",4445,517,497,62,294,0,513,8,6336
"13077170601",2447,591,2321,1891,231,17,304,332,8134
"13077170602",6849,263,1049,0,561,11,294,11,9038
"13077170603",4201,305,322,138,158,0,253,22,5399
"13077170700",2336,579,2431,1198,156,132,50,53,6935
"13077170801",3937,455,781,278,82,12,135,133,5813
"13077170802",3687,345,182,74,65,11,33,9,4406
"13079070100",1753,190,1345,458,36,45,0,3,3830
"13079070201",4101,646,261,89,83,20,50,0,5250
"13079070202",2062,432,421,239,148,3,9,3,3317
"13081010100",1745,463,641,1359,124,82,114,31,4559
"13081010201",2412,188,609,1388,46,0,96,0,4739
"13081010202",881,210,727,925,58,0,0,0,2801
"13081010300",2030,740,832,245,29,48,95,0,4019
"13081010400",2279,106,1360,1426,259,0,406,0,5836
"13081010500",1057,227,198,45,0,16,0,0,1543
"13083040101",3682,490,69,0,171,74,74,13,4573
"13083040102",2859,571,0,0,67,0,128,0,3625
"13083040200",3397,661,7,0,42,17,0,7,4131
"13083040300",2552,442,0,4,32,41,71,0,3142
"13085970100",6264,1072,10,10,175,131,50,83,7795
"13085970201",5700,957,65,0,400,0,531,27,7680
"13085970202",6310,937,0,0,209,49,151,31,7687
"13087970100",2283,364,356,131,154,127,11,133,3559
"13087970200",1555,543,283,316,26,135,24,261,3143
"13087970300",2145,388,1993,1082,55,0,51,0,5714
"13087970400",1290,337,1197,1698,112,50,103,0,4787
"13087970600",2826,571,1225,172,86,67,122,0,5069
"13087970700",929,138,193,193,344,0,445,0,2242
"13087970800",424,191,1089,806,147,109,161,130,3057
"13089020100",1702,77,38,0,91,0,19,58,1985
"13089020200",1793,86,70,29,49,32,124,0,2183
"13089020300",3001,337,113,79,277,12,173,0,3992
"13089020400",2028,184,94,25,254,0,105,0,2690
"13089020500",1004,99,1148,405,253,6,177,0,3092
"13089020600",671,104,580,582,112,0,45,20,2114
"13089020700",991,155,675,322,73,29,22,8,2275
"13089020801",1360,86,892,182,64,0,49,0,2633
"13089020802",1467,105,1840,610,122,97,112,113,4466
"13089020900",2073,212,2709,365,60,67,89,105,5680
"13089021101",3071,29,381,24,229,49,102,0,3885
"13089021102",3524,366,383,78,345,0,203,0,4899
"13089021202",5968,225,426,93,506,0,294,0,7512
"13089021204",1099,767,47,56,776,1238,1733,1761,7477
"13089021208",2230,322,412,48,675,345,81,329,4442
"13089021209",3889,314,422,74,907,151,216,76,6049
"13089021210",4792,120,77,18,511,0,97,0,5615
"13089021211",3966,85,176,0,534,21,142,0,4924
"13089021213",3191,137,0,0,127,0,89,7,3551
"13089021214",5418,227,95,0,514,0,274,0,6528
"13089021215",2626,219,347,92,2602,59,460,0,6405
"13089021216",5068,374,809,606,1567,116,369,413,9322
"13089021217",1588,53,274,141,401,9,82,38,2586
"13089021218",2090,279,1635,103,666,51,275,0,5099
"13089021301",1481,367,958,287,768,75,1144,114,5194
"13089021303",2598,1166,532,185,1439,568,2586,1173,10247
"13089021305",1894,1147,639,120,838,546,1020,1343,7547
"13089021306",2442,650,721,63,980,266,1978,542,7642
"13089021307",1999,615,354,98,958,352,1234,538,6148
"13089021308",1807,678,302,58,788,466,1014,871,5984
"13089021405",3164,452,213,1,314,115,349,292,4900
"13089021409",932,817,743,552,339,327,651,968,5329
"13089021410",3284,902,266,73,306,527,1525,1349,8232
"13089021411",2774,100,202,90,368,16,287,0,3837
"13089021412",3146,125,120,88,395,0,439,9,4322
"13089021413",1803,389,188,61,1238,802,2178,1092,7751
"13089021414",1298,447,899,146,621,558,1092,833,5894
"13089021415",2577,465,262,106,595,152,379,387,4923
"13089021416",1403,465,166,45,230,283,626,757,3975
"13089021417",1917,443,564,45,1125,1047,2018,1050,8209
"13089021502",2847,500,663,20,295,257,283,20,4885
"13089021503",2184,212,355,90,1023,263,687,246,5060
"13089021504",2943,743,237,96,491,275,144,37,4966
"13089021602",2761,409,233,106,486,9,110,9,4123
"13089021603",2984,185,641,104,544,63,198,23,4742
"13089021604",2541,19,253,11,304,9,83,0,3220
"13089021605",2998,470,657,398,395,606,378,507,6409
"13089021703",3906,197,62,3,475,147,282,34,5106
"13089021704",4089,148,275,1,596,468,118,0,5695
"13089021705",1804,285,1091,311,726,344,540,368,5469
"13089021706",3604,83,784,102,975,2,326,0,5876
"13089021805",3242,172,1574,243,834,335,633,132,7165
"13089021806",2009,159,1440,984,549,535,982,63,6721
"13089021808",2739,688,680,96,644,152,320,320,5639
"13089021809",5055,327,576,31,431,105,330,8,6863
"13089021810",3218,97,883,417,446,55,217,0,5333
"13089021812",1312,277,231,46,372,36,407,223,2904
"13089021813",784,407,1177,428,57,6,728,378,3965
"13089021814",1986,816,1332,523,709,270,1898,859,8393
"13089021906",942,98,3013,666,410,106,221,6,5462
"13089021907",1921,61,5303,948,475,94,434,62,9298
"13089021908",416,548,2937,1818,216,162,98,59,6254
"13089021909",862,162,3239,2201,142,0,140,125,6871
"13089021910",831,44,2944,630,332,39,258,10,5088
"13089021911",23,5,978,1183,0,0,31,13,2233
"13089021912",2033,102,882,200,242,0,85,0,3544
"13089021913",217,396,2562,1269,69,0,148,433,5094
"13089022001",2736,331,548,374,195,155,198,0,4537
"13089022004",630,152,3313,1052,747,132,35,8,6069
"13089022005",514,128,2273,637,514,525,116,9,4716
"13089022007",311,141,1640,615,244,1144,142,39,4276
"13089022008",799,147,1273,2049,2144,1955,70,57,8494
"13089022009",287,249,3023,1140,202,189,0,0,5090
"13089022010",538,106,488,301,398,833,109,0,2773
"13089022100",576,72,1442,1088,288,135,145,41,3787
"13089022203",840,143,481,111,327,188,36,70,2196
"13089022204",1864,1183,922,469,1726,740,616,547,8067
"13089022301",4094,552,250,73,592,329,84,168,6142
"13089022302",2899,556,257,123,662,67,419,91,5074
"13089022401",3027,323,204,0,105,100,36,13,3808
"13089022402",735,201,19,12,191,87,51,14,1310
"13089022403",3559,180,53,0,165,31,58,24,4070
"13089022500",3836,280,327,1382,384,44,188,0,6441
"13089022600",4148,298,722,66,279,111,188,5,5817
"13089022700",3017,113,601,316,226,27,143,0,4443
"13089022800",2018,56,567,201,319,22,45,0,3228
"13089022900",2169,196,745,248,297,6,184,0,3845
"13089023000",1635,71,158,75,157,0,48,0,2144
"13089023101",835,93,2476,945,146,104,136,104,4839
"13089023102",1008,58,1488,536,112,15,103,32,3352
"13089023107",675,254,2117,1159,198,106,79,226,4814
"13089023108",178,95,2456,1880,67,44,20,20,4760
"13089023111",150,10,1231,511,94,0,77,10,2083
"13089023112",114,176,2154,1516,159,146,149,189,4603
"13089023113",788,229,1379,811,190,0,88,96,3581
"13089023114",359,48,1378,398,120,137,54,24,2518
"13089023115",0,0,0,0,0,0,0,0,0
"13089023204",761,205,4571,1250,242,119,215,14,7377
"13089023206",727,32,5190,1454,191,59,167,37,7857
"13089023208",569,86,4578,1403,316,100,92,61,7205
"13089023209",465,5,4138,768,209,28,338,5,5956
"13089023210",258,26,4745,1171,305,4,61,0,6570
"13089023211",43,2,2616,205,112,23,11,38,3050
"13089023212",99,72,2988,312,111,22,96,0,3700
"13089023213",28,76,4808,586,358,111,29,35,6031
"13089023214",71,31,4578,1348,58,0,73,84,6243
"13089023303",277,172,3857,1070,1367,65,617,109,7534
"13089023306",119,4,5817,741,16,213,562,0,7472
"13089023309",167,13,7289,1230,667,0,236,0,9602
"13089023310",101,16,6314,2685,92,106,9,75,9398
"13089023311",145,74,3935,770,55,20,61,0,5060
"13089023312",501,171,6647,1658,173,30,267,155,9602
"13089023313",76,81,3380,1075,289,31,93,0,5025
"13089023314",167,3,4290,537,92,0,121,0,5210
"13089023315",260,9,4091,258,129,3,21,0,4771
"13089023316",245,23,6985,378,396,0,367,29,8423
"13089023410",50,0,2143,914,0,25,22,9,3163
"13089023411",154,44,3031,685,33,0,28,44,4019
"13089023412",106,166,5183,838,192,0,0,0,6485
"13089023413",174,58,2776,330,51,10,55,48,3502
"13089023414",82,38,4873,1065,132,250,11,0,6451
"13089023416",84,15,6551,1008,205,32,30,32,7957
"13089023418",380,218,16108,2402,41,0,200,73,19422
"13089023419",93,0,7733,1454,202,2,91,0,9575
"13089023421",496,1,4792,2124,284,92,11,33,7833
"13089023422",67,0,4081,580,205,0,173,0,5106
"13089023423",245,15,6400,508,212,3,133,56,7572
"13089023424",172,68,4846,680,69,0,161,0,5996
"13089023425",176,0,4764,653,180,0,32,0,5805
"13089023426",50,3,4334,387,51,0,44,0,4869
"13089023427",89,2,2313,246,177,11,0,0,2838
"13089023428",150,1,7343,2100,25,38,103,24,9784
"13089023501",205,98,1829,1104,21,11,6,20,3294
"13089023504",54,22,1585,1207,0,161,6,122,3157
"13089023505",96,13,1930,327,41,64,0,37,2508
"13089023506",236,18,3837,1458,196,0,0,8,5753
"13089023507",106,86,3129,472,33,30,21,14,3891
"13089023601",776,155,1597,486,73,1,47,0,3135
"13089023602",123,71,1780,526,58,33,11,9,2611
"13089023603",205,12,2221,929,25,35,16,0,3443
"13089023700",894,77,2629,1694,200,28,54,128,5704
"13089023801",1039,45,1911,478,105,0,148,0,3726
"13089023802",594,264,1642,911,108,157,37,132,3845
"13089023803",705,107,3227,982,188,111,157,148,5625
"13089980000",0,0,0,0,0,0,0,0,0
"13091960100",1444,141,229,135,6,7,56,0,2018
"13091960200",1779,687,333,249,57,0,17,74,3196
"13091960300",3267,218,1657,401,333,443,0,412,6731
"13091960400",1803,656,589,370,126,1,0,57,3602
"13091960500",1391,322,228,191,15,27,11,17,2202
"13091960600",1318,304,175,112,20,15,24,29,1997
"13093970100",1470,457,1169,758,198,17,215,68,4352
"13093970200",550,191,678,462,133,20,129,37,2200
"13093970300",2539,533,1787,1217,383,18,344,126,6947
"13095000100",669,218,2048,1439,106,89,0,102,4671
"13095000200",0,42,1385,1491,42,0,41,13,3014
"13095000400",1992,585,2302,921,160,0,107,14,6081
"13095000501",1698,344,2291,229,213,207,88,0,5070
"13095000502",2957,124,1167,149,465,0,282,0,5144
"13095000600",1661,276,631,237,51,33,0,64,2953
"13095000700",860,199,562,210,34,5,20,38,1928
"13095000800",62,64,379,987,18,22,13,28,1573
"13095000900",518,105,782,588,44,13,14,14,2078
"13095001000",252,81,908,760,62,16,22,0,2101
"13095001100",174,139,3338,2381,0,25,28,0,6085
"13095001403",0,0,1357,1076,28,10,0,0,2471
"13095001500",40,5,987,1626,20,78,0,115,2871
"13095010302",150,24,2528,2042,75,49,23,24,4915
"13095010401",3937,213,2966,104,175,0,92,82,7569
"13095010402",585,29,1760,612,34,6,56,0,3082
"13095010403",903,21,370,244,30,13,15,0,1596
"13095010500",360,102,1480,228,152,11,146,0,2479
"13095010601",118,53,1194,1032,54,0,0,5,2456
"13095010602",398,98,2238,1241,21,0,0,0,3996
"13095010700",429,439,2124,2219,53,48,122,252,5686
"13095010900",375,26,1028,199,32,5,0,0,1665
"13095011000",1254,175,843,101,129,7,78,0,2587
"13095011200",936,375,1432,1095,53,75,32,134,4132
"13095011300",751,117,489,617,97,58,82,0,2211
"13095011400",24,86,734,626,35,67,10,22,1604
"13095011600",928,195,708,58,0,73,27,84,2073
"13097080102",1275,670,4366,351,426,206,383,288,7965
"13097080103",1904,614,3302,787,173,165,445,535,7925
"13097080201",2683,449,813,604,210,1012,334,1012,7117
"13097080202",4090,795,3266,1102,824,180,1571,205,12033
"13097080301",1723,887,6673,2333,336,374,296,337,12959
"13097080303",1937,206,1090,462,214,0,517,75,4501
"13097080304",1836,274,1441,668,162,116,84,62,4643
"13097080402",6476,394,929,61,129,38,270,11,8308
"13097080403",2885,361,992,234,396,22,224,22,5136
"13097080404",4750,739,2352,213,541,22,1144,165,9926
"13097080505",2924,307,868,426,328,0,292,16,5161
"13097080506",3480,365,782,321,192,103,292,7,5542
"13097080507",2282,256,629,288,184,14,369,0,4022
"13097080508",2987,311,1562,88,194,67,285,92,5586
"13097080509",3544,24,1434,525,206,17,221,0,5971
"13097080510",3457,984,2313,393,470,88,522,203,8430
"13097080511",4316,142,3386,87,852,0,599,57,9439
"13097080602",2155,288,2475,306,260,34,118,0,5636
"13097080603",2143,407,2608,264,533,29,273,201,6458
"13097080604",3327,461,4386,903,293,281,375,1,10027
"13099090100",404,111,577,288,0,0,18,0,1398
"13099090200",795,152,963,493,0,7,0,0,2410
"13099090300",773,36,318,253,106,8,86,0,1580
"13099090400",1368,37,907,955,20,0,58,10,3355
"13099090500",990,322,265,210,11,44,0,42,1884
"13101880100",814,621,35,11,177,4,147,277,2086
"13101880200",1644,299,8,28,192,207,315,297,2990
"13103030100",2728,204,328,39,115,0,19,0,3433
"13103030202",4013,263,1131,255,35,36,54,54,5841
"13103030203",5637,798,962,0,241,128,402,0,8168
"13103030204",2183,194,762,780,25,0,4,34,3982
"13103030301",4058,225,248,0,58,11,31,11,4642
"13103030303",1867,265,48,5,136,0,140,0,2461
"13103030304",5674,733,524,157,196,33,388,0,7705
"13103030305",5594,113,1130,398,689,66,349,0,8339
"13103030401",4298,265,402,0,108,9,146,9,5237
"13103030402",5012,754,96,18,96,0,252,0,6228
"13105000100",2640,325,326,168,55,10,99,27,3650
"13105000200",2005,317,280,138,55,12,97,43,2947
"13105000300",1715,199,1059,613,0,104,185,110,3985
"13105000400",1884,426,648,874,203,8,367,50,4460
"13105000500",3218,214,1441,239,57,17,18,0,5204
"13107970100",2649,820,762,836,121,95,41,164,5488
"13107970200",947,149,363,162,0,0,0,0,1621
"13107970300",1290,513,1242,767,51,34,91,116,4104
"13107970400",1718,424,1420,889,45,81,0,51,4628
"13107970500",1024,171,61,34,3,0,0,0,1293
"13107970600",2684,1118,555,285,289,322,212,316,5781
"13109970100",1752,268,310,47,175,424,206,418,3600
"13109970200",2122,395,781,329,60,39,26,37,3789
"13109970300",1202,330,960,604,109,421,168,409,4203
"13111050100",2764,659,0,21,0,138,17,50,3649
"13111050200",5092,916,0,0,35,11,6,22,6082
"13111050300",2072,494,0,0,0,183,0,0,2749
"13111050400",4597,2015,0,4,223,37,302,0,7178
"13111050500",3139,915,0,8,48,3,55,10,4178
"13113140101",1643,536,3728,371,302,213,158,458,7409
"13113140102",2959,85,1598,282,532,161,176,0,5793
"13113140203",3557,264,1453,59,423,0,547,41,6344
"13113140204",2981,665,1496,131,238,32,663,358,6564
"13113140206",3558,342,263,0,324,0,248,0,4735
"13113140207",4192,104,383,0,552,34,207,50,5522
"13113140208",4785,623,912,409,1067,0,676,33,8505
"13113140303",3882,249,122,0,318,16,256,42,4885
"13113140304",4856,210,264,0,399,0,378,0,6107
"13113140305",3392,444,594,80,714,101,562,170,6057
"13113140306",5585,631,277,399,680,56,406,390,8424
"13113140307",4336,15,276,0,191,0,135,0,4953
"13113140403",2181,129,2771,18,258,0,381,14,5752
"13113140404",3741,297,1151,143,247,17,257,17,5870
"13113140405",2385,285,572,269,160,26,41,0,3738
"13113140406",1724,292,996,252,372,118,239,35,4028
"13113140407",4503,115,2004,183,845,0,282,0,7932
"13113140408",2276,75,432,2,268,0,99,0,3152
"13113140501",5248,215,332,0,120,0,57,15,5987
"13113140502",3240,157,120,3,69,21,93,59,3762
"13115000100",3216,776,333,0,204,15,141,0,4685
"13115000201",4482,1091,288,48,450,0,647,421,7427
"13115000202",3413,223,33,27,204,0,0,0,3900
"13115000300",971,97,19,40,109,34,126,68,1464
"13115000400",4263,2148,485,189,192,215,433,918,8843
"13115000500",1854,586,192,238,343,667,778,652,5310
"13115000600",1677,582,1533,510,58,127,57,140,4684
"13115000700",3879,405,328,58,57,0,33,11,4771
"13115000800",3669,209,717,140,8,0,0,0,4743
"13115000900",1651,234,85,422,86,27,0,11,2516
"13115001100",891,580,298,352,200,234,199,344,3098
"13115001200",1875,465,514,262,923,301,999,491,5830
"13115001300",2820,1107,979,184,890,19,837,468,7304
"13115001400",5515,471,208,0,450,12,290,0,6946
"13115001600",682,571,1076,755,215,168,241,180,3888
"13115001701",4954,1150,66,2,153,18,105,6,6454
"13115001702",4542,534,827,47,344,43,55,51,6443
"13115001800",3203,829,154,52,242,28,218,15,4741
"13115002000",3184,659,68,61,20,19,0,0,4011
"13115002100",1211,709,961,666,210,199,284,288,4528
"13117130101",3324,318,0,0,367,88,282,0,4379
"13117130102",2271,364,65,0,0,0,0,9,2709
"13117130103",3014,484,0,7,57,13,181,29,3785
"13117130104",3836,81,0,0,0,35,32,35,4019
"13117130105",1826,619,0,0,126,0,444,31,3046
"13117130201",4386,318,6,0,99,0,174,0,4983
"13117130202",3649,56,29,0,113,0,97,0,3944
"13117130203",4596,270,16,0,353,151,391,139,5916
"13117130204",3548,406,24,0,248,55,336,154,4771
"13117130205",1841,265,203,0,44,179,266,311,3109
"13117130301",4422,930,23,38,193,79,114,464,6263
"13117130302",5238,96,89,0,121,0,206,12,5762
"13117130303",3641,61,100,0,211,173,508,173,4867
"13117130304",4207,210,9,0,86,9,606,73,5200
"13117130305",4812,215,117,45,481,0,411,38,6119
"13117130306",3595,274,105,0,636,0,117,21,4748
"13117130307",3022,289,52,25,822,61,325,5,4601
"13117130403",4290,598,80,0,741,0,781,309,6799
"13117130404",3874,0,95,145,516,0,285,0,4915
"13117130405",3887,61,17,0,0,42,176,23,4206
"13117130406",3884,160,497,169,523,271,544,243,6291
"13117130408",2700,612,98,9,236,0,805,325,4785
"13117130409",2022,176,0,0,164,18,373,90,2843
"13117130410",2476,585,201,15,568,25,780,211,4861
"13117130503",2255,359,25,0,78,0,13,0,2730
"13117130504",3187,163,238,0,152,0,255,0,3995
"13117130505",2260,324,12,0,23,19,72,19,2729
"13117130506",3193,50,0,0,185,44,209,0,3681
"13117130507",2083,42,28,0,162,0,89,0,2404
"13117130508",4649,57,123,0,391,0,345,0,5565
"13117130509",3032,87,74,0,139,24,674,20,4050
"13117130510",4872,382,111,8,1038,66,330,289,7096
"13117130601",2660,674,238,0,1102,72,430,246,5422
"13117130602",3760,270,597,10,805,40,1594,158,7234
"13117130603",3494,317,202,5,989,37,451,187,5682
"13117130604",3673,64,65,0,1309,26,366,0,5503
"13117130605",3286,46,50,0,521,24,198,0,4125
"13117130606",3736,85,135,9,401,125,174,79,4744
"13117130607",4005,0,75,0,1446,40,90,0,5656
"13117130608",2524,56,429,0,2291,279,159,0,5738
"13117130609",3658,98,289,0,1309,44,402,31,5831
"13117130610",3423,121,170,0,611,60,373,0,4758
"13117130611",3337,61,7,0,581,15,134,15,4150
"13117130612",5324,72,339,0,841,0,168,0,6744
"13117130613",2278,149,40,1,622,22,104,22,3238
"13119890101",2266,482,532,179,82,306,153,295,4295
"13119890102",2904,809,223,36,115,0,64,84,4235
"13119890200",3258,1433,463,78,300,129,192,3,5856
"13119890300",2738,404,0,0,31,6,10,0,3189
"13119890400",3098,1046,284,184,52,30,42,61,4797
"13121000100",4192,269,33,16,139,1,185,2,4837
"13121000200",5486,240,172,34,219,14,225,28,6418
"13121000400",1226,66,86,11,44,11,21,0,1465
"13121000500",3056,524,793,13,672,71,143,2,5274
"13121000600",988,967,1066,390,433,961,304,74,5183
"13121000700",411,121,83,137,61,16,13,32,874
"13121001001",773,165,45,15,264,66,61,7,1396
"13121001002",210,207,147,45,179,123,5,14,930
"13121001100",2888,144,430,99,672,12,140,0,4385
"13121001201",2767,266,339,135,369,27,291,0,4194
"13121001202",2218,157,600,88,716,119,159,11,4068
"13121001300",2485,352,287,492,440,94,271,68,4489
"13121001400",1810,101,140,42,144,0,70,0,2307
"13121001500",3248,332,365,172,172,77,319,7,4692
"13121001600",1376,205,406,28,75,0,61,0,2151
"13121001700",1313,81,1176,841,292,28,147,42,3920
"13121001800",1734,179,937,1335,264,80,80,35,4644
"13121001900",940,194,588,533,155,15,83,0,2508
"13121002100",580,199,793,1067,92,54,23,0,2808
"13121002300",35,27,833,322,27,0,0,0,1244
"13121002400",4,24,1788,606,36,26,5,0,2489
"13121002500",40,38,1266,791,8,12,18,20,2193
"13121002600",122,41,591,325,30,96,5,103,1313
"13121002800",425,103,764,500,130,36,61,12,2031
"13121002900",1258,205,661,184,162,36,76,21,2603
"13121003000",2269,141,313,0,328,0,197,0,3248
"13121003100",875,128,548,248,80,8,27,6,1920
"13121003200",1296,102,468,53,217,14,107,54,2311
"13121003500",466,182,266,650,46,74,35,41,1760
"13121003600",129,5,812,236,81,16,45,0,1324
"13121003700",0,0,26,28,0,0,0,0,54
"13121003800",31,13,189,110,6,0,31,13,393
"13121003900",14,8,978,932,0,0,0,0,1932
"13121004000",16,0,1537,834,15,6,0,0,2408
"13121004100",99,0,1272,449,28,43,22,0,1913
"13121004200",120,89,1239,751,21,7,18,0,2245
"13121004300",69,28,586,441,52,5,39,14,1234
"13121004400",48,0,1414,1030,17,0,48,0,2557
"13121004800",170,45,350,336,11,136,9,50,1107
"13121004900",1262,96,609,679,230,0,182,5,3063
"13121005000",1244,240,310,39,67,0,85,34,2019
"13121005200",3005,333,965,290,355,50,346,43,5387
"13121005300",2130,141,993,340,82,11,89,16,3802
"13121005501",274,154,1129,917,42,17,39,89,2661
"13121005502",77,45,1066,1196,0,10,0,29,2423
"13121005700",53,11,825,757,9,0,17,11,1683
"13121005800",219,43,813,909,39,0,13,0,2036
"13121006000",80,84,1707,1333,25,31,29,166,3455
"13121006100",37,8,2370,1121,136,0,59,0,3731
"13121006200",95,3,977,337,28,35,16,0,1491
"13121006300",70,0,804,757,13,0,0,0,1644
"13121006400",157,104,386,238,285,5,321,57,1553
"13121006500",567,86,2418,979,224,9,127,29,4439
"13121006601",324,47,1178,623,38,7,39,5,2261
"13121006602",0,0,522,795,20,22,20,0,1379
"13121006700",235,107,1913,1386,64,36,35,31,3807
"13121006801",0,0,0,0,0,0,0,0,0
"13121006802",0,0,313,1636,0,43,0,0,1992
"13121006900",1037,435,995,677,343,52,402,221,4162
"13121007001",70,22,2884,1730,0,58,6,30,4800
"13121007002",79,45,1088,589,0,87,82,87,2057
"13121007100",10,8,1385,606,4,1,9,9,2032
"13121007200",20,2,1273,599,20,105,15,0,2034
"13121007300",110,29,3836,3788,144,45,53,0,8005
"13121007400",83,174,944,1045,333,74,351,137,3141
"13121007500",147,79,1508,1362,100,63,0,85,3344
"13121007602",7,2,1716,746,13,86,50,12,2632
"13121007603",64,32,1881,2365,29,59,0,37,4467
"13121007604",0,0,960,1363,0,8,0,0,2331
"13121007703",0,0,3545,566,11,0,0,0,4122
"13121007704",81,185,3480,1427,119,25,172,161,5650
"13121007705",19,59,3013,1885,45,0,50,11,5082
"13121007706",221,0,7663,1460,96,50,125,0,9615
"13121007802",36,0,7708,2074,107,89,18,89,10121
"13121007805",20,0,2133,762,7,18,6,0,2946
"13121007806",0,206,4255,2133,0,0,59,206,6859
"13121007807",45,0,1203,1506,44,373,89,373,3633
"13121007808",0,16,1281,2824,46,320,26,313,4826
"13121007900",31,0,4848,624,220,0,0,0,5723
"13121008000",157,56,3669,1475,65,0,61,0,5483
"13121008101",6,0,803,322,0,0,0,0,1131
"13121008102",161,308,4087,2168,0,307,191,615,7837
"13121008201",169,20,3754,1921,92,0,38,50,6044
"13121008202",17,0,1382,605,6,0,21,0,2031
"13121008301",82,45,1588,565,6,9,3,0,2298
"13121008302",13,0,1323,414,0,4,7,0,1761
"13121008400",10,154,1774,1083,31,6,0,17,3075
"13121008500",44,2,2089,871,29,0,0,0,3035
"13121008601",25,0,2406,1778,6,35,0,35,4285
"13121008602",107,0,641,301,4,10,11,0,1074
"13121008700",253,30,2737,1317,21,0,24,0,4382
"13121008800",3133,121,802,308,205,0,554,0,5123
"13121008902",3326,601,1400,333,599,278,348,100,6985
"13121008903",961,162,259,107,195,0,629,91,2404
"13121008904",3074,431,469,133,401,64,73,204,4849
"13121009000",4090,74,262,36,358,128,258,10,5216
"13121009101",3174,275,637,126,261,89,19,0,4581
"13121009102",1780,334,556,111,232,95,99,56,3263
"13121009200",3978,1294,655,167,667,322,815,927,8825
"13121009300",4134,54,372,19,64,15,369,0,5027
"13121009402",2737,654,722,124,666,119,999,359,6380
"13121009403",2389,228,790,449,737,379,760,0,5732
"13121009404",3203,252,775,0,569,22,441,20,5282
"13121009501",3633,57,51,0,53,0,15,0,3809
"13121009502",2236,158,284,56,113,0,83,10,2940
"13121009601",1893,164,106,17,233,4,25,64,2506
"13121009602",3579,96,623,0,296,16,43,0,4653
"13121009603",2929,250,407,167,421,20,408,0,4602
"13121009700",3535,115,148,0,125,0,98,0,4021
"13121009801",4339,216,26,17,190,16,41,0,4845
"13121009802",3659,111,107,93,480,34,104,24,4612
"13121009900",4433,22,46,0,245,22,70,0,4838
"13121010001",3758,61,169,18,452,46,82,0,4586
"13121010002",6384,31,303,0,588,37,313,0,7656
"13121010106",2718,170,751,133,281,14,163,0,4230
"13121010107",1810,30,5,19,53,0,31,4,1952
"13121010108",3072,177,168,0,182,0,103,55,3757
"13121010110",3477,494,756,11,691,54,222,191,5896
"13121010113",3575,754,829,34,793,763,1921,925,9594
"13121010114",5115,623,580,16,931,84,1420,425,9194
"13121010115",1718,13,183,0,212,0,36,0,2162
"13121010117",1568,215,1175,80,266,28,392,48,3772
"13121010118",2001,669,1261,975,398,130,785,403,6622
"13121010119",1430,359,1346,1347,383,199,457,306,5827
"13121010120",1162,177,699,76,175,0,282,17,2588
"13121010121",1644,122,88,31,304,10,40,0,2239
"13121010122",2986,208,682,0,2322,71,154,33,6456
"13121010123",3058,585,1491,329,371,64,1028,465,7391
"13121010204",4378,247,104,0,167,0,111,0,5007
"13121010205",4412,233,85,16,181,51,41,0,5019
"13121010206",4604,118,141,0,388,9,227,10,5497
"13121010208",2024,146,1534,146,234,109,102,0,4295
"13121010209",2251,193,2492,235,592,12,710,12,6497
"13121010210",3801,86,1223,257,413,8,213,0,6001
"13121010211",2831,182,43,0,201,0,206,69,3532
"13121010212",3085,811,500,85,213,327,1012,769,6802
"13121010301",1096,91,12823,1704,213,185,284,0,16396
"13121010303",35,34,8664,665,61,35,0,47,9541
"13121010304",516,69,13917,466,209,211,170,147,15705
"13121010400",4544,467,2129,798,256,176,1114,170,9654
"13121010507",325,0,5743,1962,178,172,263,0,8643
"13121010508",53,58,2493,1115,189,47,186,68,4209
"13121010510",1186,1034,10858,2135,117,487,718,1122,17657
"13121010511",382,129,6713,916,165,0,26,0,8331
"13121010512",284,0,4088,1961,150,166,34,0,6683
"13121010513",1739,488,8267,1915,347,281,1119,473,14629
"13121010514",1595,153,8578,777,556,52,835,52,12598
"13121010515",575,85,3359,734,56,0,117,0,4926
"13121010516",279,100,6061,2223,242,0,464,0,9369
"13121010601",1009,145,1229,1133,47,24,194,8,3789
"13121010603",0,31,2240,1467,29,42,0,27,3836
"13121010604",180,1,1560,543,294,185,390,190,3343
"13121010800",2505,261,2425,405,453,600,877,732,8258
"13121011000",486,191,1027,1217,132,0,488,145,3686
"13121011100",857,176,1069,104,96,7,136,7,2452
"13121011201",482,74,2243,1161,115,82,88,39,4284
"13121011202",1025,315,1917,981,157,428,388,502,5713
"13121011301",268,120,2894,534,118,296,331,319,4880
"13121011303",508,5,6096,1269,566,637,659,625,10365
"13121011305",91,0,2887,1979,100,0,22,21,5100
"13121011306",118,0,1748,470,88,0,98,0,2522
"13121011405",4688,1083,1293,350,283,151,1633,651,10132
"13121011410",5363,158,598,46,531,0,159,0,6855
"13121011411",6186,787,675,72,589,20,666,445,9440
"13121011412",6867,168,1082,54,909,169,969,148,10366
"13121011414",4984,97,1582,55,807,18,641,18,8202
"13121011416",4320,185,227,2,522,0,220,100,5576
"13121011417",3865,281,97,3,550,0,364,0,5160
"13121011418",5668,109,184,0,157,6,74,0,6198
"13121011419",4094,231,525,23,765,0,263,0,5901
"13121011420",2825,1959,1429,441,612,560,2549,2337,12712
"13121011421",1805,296,850,399,402,61,850,322,4985
"13121011422",2467,255,776,337,235,12,116,210,4408
"13121011423",4008,34,306,104,524,18,150,0,5144
"13121011424",4058,43,762,4,752,56,277,0,5952
"13121011425",5165,18,316,0,1739,0,150,18,7406
"13121011426",1780,225,228,0,315,7,400,126,3081
"13121011427",5850,84,448,0,1350,48,499,0,8279
"13121011503",8546,232,432,252,512,71,374,36,10455
"13121011504",10752,159,1283,0,627,0,893,0,13714
"13121011505",3804,48,446,70,263,0,227,0,4858
"13121011506",5225,165,543,0,355,29,63,28,6408
"13121011610",4100,518,340,241,585,66,136,163,6149
"13121011611",4273,463,1064,144,1043,181,1026,195,8389
"13121011612",2430,18,238,27,628,40,117,0,3498
"13121011613",4038,515,998,0,1304,64,269,309,7497
"13121011614",7235,945,2977,319,2825,176,1366,631,16474
"13121011615",7842,242,685,3,1206,0,558,14,10550
"13121011616",2397,71,765,113,1478,93,630,33,5580
"13121011617",5587,199,554,18,1298,22,267,0,7945
"13121011618",2746,307,330,25,984,0,157,0,4549
"13121011619",3937,115,783,74,3333,109,946,0,9297
"13121011620",7036,276,864,2,2200,256,832,101,11567
"13121011621",4855,243,196,0,1697,227,468,108,7794
"13121011622",4310,0,568,0,4845,291,338,0,10352
"13121011623",5838,287,1033,43,4332,404,384,0,12321
"13121011624",3016,34,278,7,924,0,90,0,4349
"13121011625",4154,102,696,169,2266,207,245,0,7839
"13121011626",4004,515,2009,30,2591,150,888,0,10187
"13121011800",204,302,747,1310,31,288,51,124,3057
"13121011900",763,250,882,564,11,39,47,9,2565
"13121012000",52,34,1009,1473,145,31,32,14,2790
"13121012300",913,90,932,342,178,0,115,95,2665
"13121980000",0,0,0,0,0,0,0,0,0
"13123080100",3091,857,15,0,19,25,37,173,4217
"13123080200",4522,805,0,8,364,16,347,8,6070
"13123080300",4019,1407,51,147,165,781,142,1445,8157
"13123080400",6231,1617,19,34,379,49,432,365,9126
"13123080500",2814,900,0,0,33,18,102,8,3875
"13125010100",2324,315,158,31,8,137,26,22,3021
"13127000101",1130,55,12,0,24,0,0,0,1221
"13127000102",2911,190,58,76,216,23,142,0,3616
"13127000200",4405,82,0,0,169,54,105,0,4815
"13127000300",5305,420,103,31,417,1,205,1,6483
"13127000401",5707,413,863,308,384,275,148,340,8438
"13127000403",2553,116,309,22,115,5,125,0,3245
"13127000404",7426,1155,1735,292,371,374,462,346,12161
"13127000501",1410,328,1242,616,36,64,204,140,4040
"13127000503",1534,317,972,475,561,127,236,178,4400
"13127000504",488,365,1396,924,257,10,234,50,3724
"13127000600",3992,583,471,341,149,203,112,203,6054
"13127000700",1965,704,3033,1439,122,434,78,220,7995
"13127000800",161,203,1428,1749,102,36,57,21,3757
"13127000900",1659,413,1111,547,561,153,839,280,5563
"13127001000",7246,660,359,398,800,0,582,35,10080
"13127990000",0,0,0,0,0,0,0,0,0
"13129970100",4969,1054,0,0,254,0,414,0,6691
"13129970200",5669,984,340,30,85,19,177,8,7312
"13129970300",6153,1644,169,423,190,116,1501,902,11098
"13129970400",3325,1140,193,80,135,10,425,104,5412
"13129970500",3173,723,206,215,269,181,1115,579,6461
"13129970600",3957,914,274,95,404,623,1491,880,8638
"13129970700",3245,848,22,19,130,0,73,19,4356
"13129970800",4685,616,115,25,308,25,304,0,6078
"13129970900",5389,1293,88,34,19,77,107,77,7084
"13131950100",1495,434,45,37,54,69,4,108,2246
"13131950200",1666,382,255,348,23,0,3,0,2677
"13131950300",1404,293,1229,1307,55,92,0,186,4566
"13131950400",3715,885,699,264,284,668,563,828,7906
"13131950500",3188,1038,1190,1282,126,83,173,587,7667
"13131950600",1438,245,405,95,22,126,56,98,2485
"13133950100",1128,309,613,151,62,7,18,0,2288
"13133950200",719,163,522,612,46,31,37,6,2136
"13133950301",2300,82,25,0,3,0,64,0,2474
"13133950302",1765,32,224,484,21,0,9,7,2542
"13133950303",1006,519,1132,970,271,257,250,599,5004
"13133950400",456,171,562,134,2,0,0,0,1325
"13133950500",944,22,321,89,24,0,17,0,1417
"13135050103",7033,491,1085,147,1048,610,1968,321,12703
"13135050105",2115,360,541,94,707,8,1328,85,5238
"13135050106",6550,1827,1021,178,1508,266,2220,1627,15197
"13135050107",5473,207,940,0,425,150,804,0,7999
"13135050108",6598,90,990,22,1467,468,577,403,10615
"13135050109",4612,191,1191,86,987,782,949,0,8798
"13135050205",1831,322,927,146,905,126,249,183,4689
"13135050208",3972,100,1268,150,974,73,1353,134,8024
"13135050209",3576,513,1897,117,3352,574,1242,364,11635
"13135050210",3561,423,889,38,1628,296,673,573,8081
"13135050211",1280,631,980,295,1691,375,1455,748,7455
"13135050212",9616,64,956,0,1843,226,544,49,13298
"13135050213",5971,637,1655,196,3937,612,1151,21,14180
"13135050214",4597,314,1252,60,2295,237,472,50,9277
"13135050215",600,135,902,45,1204,493,93,0,3472
"13135050216",3475,68,544,47,4401,489,372,40,9436
"13135050217",4426,91,1683,196,3465,300,656,0,10817
"13135050218",1937,204,415,133,1225,42,1434,115,5505
"13135050219",1610,109,754,231,927,136,194,16,3977
"13135050220",2314,121,1372,873,1153,402,770,181,7186
"13135050304",1875,568,935,202,1019,409,1618,679,7305
"13135050306",1367,585,494,188,1365,869,2011,1223,8102
"13135050308",3252,30,36,0,585,24,63,24,4014
"13135050309",3434,390,2367,143,1685,89,315,15,8438
"13135050310",3180,167,1144,53,679,84,361,38,5706
"13135050311",1564,226,503,15,414,10,86,139,2957
"13135050313",3317,907,1084,483,1495,815,1374,1130,10605
"13135050314",4083,407,2188,366,2396,657,2987,608,13692
"13135050315",2294,418,1567,432,438,557,677,835,7218
"13135050317",854,369,1178,222,783,287,995,544,5232
"13135050318",640,108,1232,331,641,41,526,108,3627
"13135050319",1511,897,1335,114,1285,1283,2247,1868,10540
"13135050320",1658,754,650,393,1868,928,2247,1234,9732
"13135050321",3797,184,60,0,451,11,169,0,4672
"13135050322",4199,78,55,0,374,0,29,0,4735
"13135050410",1725,617,738,357,1556,622,1305,775,7695
"13135050415",1502,34,1469,167,474,9,76,9,3740
"13135050416",905,284,1664,339,120,213,105,380,4010
"13135050417",1778,790,1050,329,1186,879,2140,1504,9656
"13135050418",1619,567,1308,169,1934,1657,2060,1928,11242
"13135050419",2338,490,1153,385,2335,1198,2198,1192,11289
"13135050421",1937,1030,1914,204,1151,1062,1382,1561,10241
"13135050422",2108,797,1061,479,2363,1647,2636,2179,13270
"13135050423",1930,297,1420,580,2401,674,2003,535,9840
"13135050424",2064,933,1839,428,1524,1123,2553,1680,12144
"13135050425",3288,223,608,143,1078,103,253,84,5780
"13135050426",4177,293,1047,172,903,224,391,0,7207
"13135050427",3631,214,789,111,1170,165,625,150,6855
"13135050428",3544,264,928,32,1910,84,456,49,7267
"13135050429",4542,198,1376,65,1065,58,658,0,7962
"13135050430",2724,350,1166,53,1050,100,551,75,6069
"13135050431",1681,401,2508,336,2462,950,1047,1125,10510
"13135050432",1931,209,1459,164,2164,132,1400,0,7459
"13135050433",976,156,534,69,448,131,709,111,3134
"13135050434",2070,856,1074,374,1992,1529,2546,2250,12691
"13135050435",1509,247,492,85,935,255,1027,326,4876
"13135050436",2097,588,1840,223,1557,256,1610,533,8704
"13135050511",3652,973,2653,590,3105,179,3209,661,15022
"13135050520",1795,356,1287,470,737,159,714,174,5692
"13135050521",2617,773,748,393,646,129,1048,290,6644
"13135050522",2003,407,991,588,769,576,618,461,6413
"13135050523",2344,278,2110,345,1791,33,1556,12,8469
"13135050524",1884,511,1446,231,1563,444,2189,645,8913
"13135050525",4348,266,1271,87,2166,65,1116,9,9328
"13135050526",1487,326,900,102,1340,686,1389,750,6980
"13135050527",3928,154,911,330,1010,0,1063,0,7396
"13135050528",2952,68,972,43,942,253,495,31,5756
"13135050529",2260,225,494,169,721,146,469,83,4567
"13135050530",2972,41,1047,201,1799,0,391,0,6451
"13135050531",3200,489,2546,406,1491,540,2635,774,12081
"13135050532",3087,371,2346,287,1695,104,1163,78,9131
"13135050533",1516,263,1698,27,3146,1289,1978,887,10804
"13135050534",2101,355,2048,50,3529,292,2875,154,11404
"13135050535",1961,327,1780,213,1938,898,1328,870,9315
"13135050536",1557,327,1070,508,1439,141,1041,294,6377
"13135050537",1102,178,1516,699,1146,194,1253,287,6375
"13135050538",3970,378,1352,97,2041,2,975,308,9123
"13135050539",976,596,1242,297,1145,741,1218,1131,7346
"13135050540",3243,53,2582,270,645,251,919,21,7984
"13135050541",1476,463,2068,373,1342,226,2317,587,8852
"13135050542",786,668,1586,564,951,243,593,515,5906
"13135050543",3124,92,2403,158,1310,45,1045,0,8177
"13135050544",4094,452,4100,291,2715,205,964,311,13132
"13135050545",5452,352,3903,492,1125,42,2825,93,14284
"13135050546",4909,1398,6754,637,1433,1726,1230,2482,20569
"13135050547",4771,406,1274,130,1189,393,472,344,8979
"13135050548",5254,705,1468,361,1053,92,748,262,9943
"13135050549",3205,42,844,62,956,87,780,41,6017
"13135050605",9589,1400,1478,137,1685,211,2146,866,17512
"13135050606",13967,674,3731,150,3579,42,2018,0,24161
"13135050607",12171,345,3389,91,476,525,2189,121,19307
"13135050608",10431,1017,3817,381,1103,606,3616,1096,22067
"13135050609",8369,691,882,472,1045,73,835,91,12458
"13135050610",11947,285,2288,208,2045,52,1594,0,18419
"13135050709",3662,596,6407,1090,446,397,828,757,14183
"13135050712",4336,741,958,2,681,61,434,372,7585
"13135050713",4694,508,1289,71,1057,33,53,401,8106
"13135050714",3000,290,1302,46,803,17,339,83,5880
"13135050715",3506,382,771,154,913,75,955,64,6820
"13135050718",5488,187,1500,110,833,78,484,0,8680
"13135050719",1641,346,2558,501,376,13,475,276,6186
"13135050720",5318,897,1460,31,139,0,254,53,8152
"13135050721",4222,333,3118,737,589,558,632,433,10622
"13135050722",859,455,1361,286,247,486,446,682,4822
"13135050723",2057,80,4004,612,418,199,388,79,7837
"13135050724",8094,595,4666,435,1713,359,865,1,16728
"13135050725",2182,74,2761,536,347,16,657,0,6573
"13135050726",6363,447,1348,262,747,181,756,246,10350
"13135050727",6117,777,2384,59,935,218,391,41,10922
"13135050728",4423,1475,6543,917,306,57,428,540,14689
"13135050729",960,165,1322,487,346,12,307,2,3601
"13135050730",3168,152,3389,0,348,0,501,121,7679
"13135050731",4773,278,3293,439,551,51,885,102,10372
"13137000100",3150,404,5,0,64,123,40,0,3786
"13137000201",3389,288,15,0,179,14,228,0,4113
"13137000202",4530,412,138,0,82,0,0,15,5177
"13137000300",3269,457,60,33,67,9,567,82,4544
"13137000400",4078,702,11,9,513,156,709,16,6194
"13137000500",3854,1136,254,40,659,156,446,27,6572
"13137000601",2972,621,26,0,289,22,516,211,4657
"13137000602",5364,1446,172,142,157,1050,1289,1627,11247
"13139000101",3606,482,260,12,225,0,393,0,4978
"13139000102",2849,422,90,0,77,17,322,24,3801
"13139000201",3837,1780,48,0,0,26,444,583,6718
"13139000203",4099,169,0,0,96,0,4,0,4368
"13139000204",3362,505,0,0,120,0,166,79,4232
"13139000302",5296,409,94,0,1010,31,752,0,7592
"13139000303",2166,440,0,0,0,119,29,214,2968
"13139000304",2753,708,1,2,16,2,39,355,3876
"13139000305",4122,320,173,52,218,0,565,1,5451
"13139000400",5596,487,139,240,115,129,1118,75,7899
"13139000500",5885,698,88,146,245,21,719,307,8109
"13139000600",3518,1218,266,39,248,164,806,595,6854
"13139000701",2561,543,1727,559,845,120,2389,204,8948
"13139000702",3029,983,445,37,835,316,2363,1094,9102
"13139000800",668,913,845,218,108,221,448,824,4245
"13139000900",3639,581,490,19,13,472,347,804,6365
"13139001002",4494,1209,393,25,679,68,2117,962,9947
"13139001003",2525,2138,502,515,655,277,2575,1963,11150
"13139001004",1684,217,213,257,600,224,584,98,3877
"13139001101",1190,1803,187,103,972,286,2109,1940,8590
"13139001102",1800,1116,10,50,997,411,1969,1289,7642
"13139001201",3752,1986,397,573,286,112,1872,1485,10463
"13139001202",3985,1149,372,209,996,10,3144,846,10711
"13139001301",4336,695,226,0,352,377,1340,404,7730
"13139001302",4406,404,110,61,214,22,429,21,5667
"13139001402",4383,392,258,54,270,177,667,242,6443
"13139001403",2005,356,159,221,734,144,1291,258,5168
"13139001404",3965,400,447,6,333,23,1334,131,6639
"13139001501",3642,328,149,16,472,0,398,0,5005
"13139001502",4165,499,152,0,113,0,947,0,5876
"13139001603",4037,408,52,2,673,141,971,157,6441
"13139001604",5423,624,301,54,284,28,605,386,7705
"13139001605",3895,239,533,243,320,123,414,93,5860
"13139001606",2371,511,432,32,273,113,476,71,4279
"13139001607",3737,492,167,37,270,75,291,49,5118
"13139001608",4865,422,127,43,129,0,433,11,6030
"13141480300",886,81,1044,237,35,0,0,0,2283
"13141480400",463,268,2398,1526,32,1,0,1,4689
"13143010100",2756,517,59,3,51,6,0,0,3392
"13143010200",4792,1084,72,63,167,39,55,0,6272
"13143010301",2270,758,219,19,58,8,0,0,3332
"13143010302",5665,1291,231,117,159,83,5,101,7652
"13143010400",5183,1520,432,86,324,130,202,0,7877
"13145120198",3037,248,1110,314,397,27,89,0,5222
"13145120200",2425,555,449,217,25,0,75,0,3746
"13145120300",6676,798,960,121,322,68,247,0,9192
"13145120401",5462,69,399,104,476,3,425,0,6938
"13145120402",5855,388,1378,71,356,8,173,4,8233
"13147960100",4392,765,159,225,31,108,11,115,5806
"13147960200",2656,379,111,98,32,24,2,5,3307
"13147960300",1881,669,332,333,40,0,25,50,3330
"13147960400",2915,954,665,500,120,14,196,207,5571
"13147960500",3925,737,1696,568,277,29,239,57,7528
"13149970100",2969,742,340,122,129,60,246,4,4612
"13149970200",3127,680,161,134,76,9,21,0,4208
"13149970300",1988,523,288,26,30,53,0,0,2908
"13151070104",3423,238,5696,893,1254,728,409,108,12749
"13151070106",2584,859,2207,313,460,17,97,282,6819
"13151070107",2147,105,4407,364,114,22,282,0,7441
"13151070108",1015,292,3267,384,207,0,294,59,5518
"13151070109",1764,129,1494,0,185,38,167,54,3831
"13151070110",3843,767,1991,573,305,0,112,0,7591
"13151070111",2179,238,4541,1292,537,157,971,207,10122
"13151070113",2109,324,696,110,447,139,611,83,4519
"13151070114",809,330,2777,487,800,44,47,0,5294
"13151070202",7927,449,1799,17,447,113,364,67,11183
"13151070203",9656,615,3050,233,998,0,804,0,15356
"13151070204",3011,72,1155,64,188,0,122,0,4612
"13151070205",4665,1470,2697,192,922,1061,511,1195,12713
"13151070304",3239,630,4556,2099,419,111,193,248,11495
"13151070305",4080,277,3435,152,1099,307,483,0,9833
"13151070306",3988,217,4188,281,977,0,455,0,10106
"13151070307",2156,66,1591,88,509,22,370,22,4824
"13151070309",3019,23,3259,141,802,85,558,11,7898
"13151070310",2658,124,849,28,109,118,160,85,4131
"13151070311",3034,554,6242,1540,415,278,622,360,13045
"13151070402",9379,922,1091,202,319,0,294,0,12207
"13151070403",7890,750,1806,36,102,42,732,51,11409
"13151070404",4037,132,1648,699,630,9,352,9,7516
"13151070501",2695,1155,2756,383,284,118,447,221,8059
"13151070502",7544,1248,3091,1196,944,0,432,1,14456
"13153020105",2325,935,1342,1221,188,49,228,0,6288
"13153020106",1726,246,813,43,275,20,91,0,3214
"13153020108",3725,793,919,151,397,0,302,122,6409
"13153020109",4483,528,2306,448,1308,18,913,76,10080
"13153020200",2283,915,1049,786,176,34,95,151,5489
"13153020300",1233,522,2560,1636,353,175,318,58,6855
"13153020400",618,363,1080,493,278,471,95,432,3830
"13153020600",722,71,110,0,149,16,146,0,1214
"13153020700",817,288,949,902,283,146,135,75,3595
"13153020800",839,268,752,190,252,111,126,110,2648
"13153020900",2232,434,1053,384,74,87,66,0,4330
"13153021000",3744,403,1127,727,974,77,628,28,7708
"13153021103",8060,472,1713,151,488,18,560,0,11462
"13153021104",3882,726,1657,226,676,161,543,372,8243
"13153021105",2966,596,1522,586,918,173,724,168,7653
"13153021107",4671,606,1941,881,525,15,477,91,9207
"13153021108",4320,757,801,127,168,0,127,44,6344
"13153021113",10226,1032,3818,268,1694,203,367,272,17880
"13153021201",5280,458,1294,23,1013,0,423,105,8596
"13153021202",3936,289,1484,458,119,0,242,58,6586
"13153021300",1745,266,1128,783,163,280,22,60,4447
"13153021400",5232,423,990,924,733,15,528,15,8860
"13153021500",3117,110,656,133,168,0,51,19,4254
"13155950100",1836,453,39,0,0,94,6,25,2453
"13155950200",3313,617,1281,1083,80,53,5,18,6450
"13157010101",4712,539,147,0,61,0,15,0,5474
"13157010102",6188,238,98,21,399,0,416,0,7360
"13157010103",4237,678,228,2,206,68,367,143,5929
"13157010200",3611,796,8,119,342,50,201,66,5193
"13157010300",2752,489,459,340,155,99,628,12,4934
"13157010400",3379,613,100,235,359,26,137,0,4849
"13157010500",4072,929,158,40,78,3,116,519,5915
"13157010600",6153,1411,827,234,145,13,410,327,9520
"13157010701",1677,106,167,5,12,6,15,0,1988
"13157010702",7854,634,233,415,525,76,444,76,10257
"13157010703",2794,126,377,3,39,0,234,0,3573
"13159010100",1322,483,381,68,68,31,28,36,2417
"13159010200",2161,377,46,21,53,39,21,0,2718
"13159010500",4683,916,1795,535,153,315,33,423,8853
"13161960100",4659,1005,183,73,142,449,285,514,7310
"13161960200",3613,540,1193,650,261,256,461,248,7222
"13161960300",1149,314,282,22,43,0,117,0,1927
"13163960100",2134,312,1173,1038,174,0,137,9,4977
"13163960200",1227,231,576,114,16,14,99,10,2287
"13163960300",1650,212,1580,1812,69,0,37,0,5360
"13163960400",904,240,1390,912,67,4,67,172,3756
"13165960100",2540,1242,1235,792,0,181,43,444,6477
"13165960200",1370,378,616,317,86,74,61,146,3048
"13167960100",1943,418,122,96,0,28,26,5,2638
"13167960200",1886,269,1604,867,137,43,0,0,4806
"13167960300",1053,286,289,76,27,42,5,0,1778
"13169030101",2201,35,185,2,168,0,74,0,2665
"13169030103",1669,344,373,46,24,18,11,0,2485
"13169030104",3173,1058,2377,776,42,28,37,0,7491
"13169030200",1785,370,821,476,10,0,0,0,3462
"13169030301",4811,95,1189,419,132,23,23,23,6715
"13169030302",4205,919,496,139,24,22,0,0,5805
"13171970100",5116,1074,462,269,200,5,285,24,7435
"13171970200",2794,518,1276,786,116,187,53,0,5730
"13171970300",1833,252,1171,617,139,5,11,5,4033
"13173950100",1198,482,197,0,31,58,20,44,2030
"13173950200",4688,1026,1181,1013,71,96,296,174,8545
"13175950100",1834,427,577,266,14,38,106,24,3286
"13175950201",3123,250,601,534,102,61,0,0,4671
"13175950202",2569,236,1000,183,326,30,156,59,4559
"13175950300",206,35,618,830,0,0,0,31,1720
"13175950400",1145,342,1200,1011,113,6,6,0,3823
"13175950500",2012,431,507,512,28,0,39,0,3529
"13175950600",1208,259,326,259,73,13,57,0,2195
"13175950700",1712,477,206,91,6,11,0,11,2514
"13175950800",1187,252,1242,858,104,19,0,38,3700
"13175950900",33,27,1153,1433,4,0,0,15,2665
"13175951000",3819,1329,1592,739,35,6,262,65,7847
"13175951100",2683,1145,510,172,127,2,115,46,4800
"13175951400",1650,463,152,51,45,25,21,118,2525
"13177020100",4562,490,875,256,240,0,117,0,6540
"13177020200",491,159,594,156,30,0,0,0,1430
"13177020300",3769,605,699,210,236,137,94,91,5841
"13177020402",6042,313,777,573,379,144,78,11,8317
"13177020403",4513,342,823,32,264,0,225,36,6235
"13179010101",3039,715,1144,471,832,248,1165,118,7732
"13179010102",456,10,123,122,47,0,37,0,795
"13179010103",551,37,487,8,190,17,176,0,1466
"13179010202",1242,338,1522,332,662,98,534,31,4759
"13179010204",468,194,1325,468,199,187,165,114,3120
"13179010205",2617,224,1469,712,682,106,554,127,6491
"13179010206",2426,374,1173,885,253,23,514,245,5893
"13179010207",1956,196,1757,906,580,17,648,47,6107
"13179010208",2101,418,2242,316,717,54,834,0,6682
"13179010300",2929,218,2214,728,758,48,709,197,7801
"13179010400",2640,324,2687,455,899,118,761,83,7967
"13179010501",2744,284,315,24,117,0,0,0,3484
"13179010502",2326,489,1611,379,278,15,172,10,5280
"13179010600",321,68,1072,421,20,0,23,0,1925
"13179990000",0,0,0,0,0,0,0,0,0
"13181970100",1674,622,823,510,31,24,4,0,3688
"13181970200",2318,462,845,294,35,0,38,7,3999
"13183970100",4879,916,2047,260,977,468,1118,535,11200
"13183970200",4296,568,891,545,347,179,176,115,7117
"13183980000",0,0,0,0,0,0,0,0,0
"13185010101",2022,523,750,407,321,25,160,15,4223
"13185010102",2905,461,885,536,242,74,252,54,5409
"13185010103",2174,152,695,48,217,136,205,0,3627
"13185010201",1859,153,221,0,52,71,11,0,2367
"13185010202",8921,408,1351,304,452,22,312,90,11860
"13185010301",3254,476,855,81,517,19,181,67,5450
"13185010302",2348,117,31,11,112,0,85,0,2704
"13185010401",1333,79,114,5,11,0,42,5,1589
"13185010402",1412,212,3381,1450,482,110,131,27,7205
"13185010500",508,160,2239,1813,64,11,151,71,5017
"13185010601",2046,913,1314,716,346,453,380,230,6398
"13185010604",2670,431,1178,427,457,33,435,0,5631
"13185010700",2490,563,574,44,117,56,149,0,3993
"13185010800",314,207,2783,2193,0,19,0,136,5652
"13185010900",168,147,663,721,13,3,0,0,1715
"13185011000",77,216,1374,1497,130,227,12,240,3773
"13185011100",1233,570,93,98,44,58,79,18,2193
"13185011200",2832,1558,228,187,273,56,428,163,5725
"13185011301",885,1203,999,1994,50,161,26,256,5574
"13185011302",420,402,962,712,78,45,10,92,2721
"13185011401",965,177,647,383,231,4,54,0,2461
"13185011402",725,333,335,226,151,55,137,137,2099
"13185011403",4832,1109,1138,1153,101,134,206,260,8933
"13185011500",2675,637,555,64,125,22,157,32,4267
"13185011600",3074,639,185,146,81,51,173,87,4436
"13187960101",5570,1145,0,359,54,28,276,36,7468
"13187960102",5062,525,0,0,81,44,149,44,5905
"13187960201",7352,1475,0,0,242,88,202,10,9369
"13187960202",5356,1620,61,97,169,178,347,287,8115
"13189950100",1963,210,181,56,23,0,0,0,2433
"13189950200",1995,161,1698,1303,0,133,40,117,5447
"13189950300",1311,128,1276,453,0,0,0,71,3239
"13189950400",1963,365,1218,1291,18,31,0,88,4974
"13189950500",3157,770,939,420,111,89,158,91,5735
"13191110100",2565,179,879,122,155,0,26,0,3926
"13191110200",2433,318,1009,924,29,0,29,0,4742
"13191110300",2502,554,1115,788,243,71,168,14,5455
"13191980000",0,0,0,0,0,0,0,0,0
"13191990000",0,0,0,0,0,0,0,0,0
"13193000100",608,32,835,432,51,0,31,0,1989
"13193000200",738,59,573,331,168,1,20,2,1892
"13193000300",963,265,1157,937,36,1,112,90,3561
"13193000400",1819,212,1567,1310,136,59,38,189,5330
"13195020100",3604,1325,42,0,0,237,14,237,5459
"13195020200",4124,477,113,50,91,42,57,3,4957
"13195020300",2766,491,513,195,65,201,15,0,4246
"13195020400",3986,344,634,24,461,29,536,29,6043
"13195020500",4188,629,479,324,344,48,307,43,6362
"13195020600",1671,266,24,62,80,54,0,0,2157
"13197920100",3086,510,241,56,230,12,168,0,4303
"13197920200",1325,140,1314,1114,601,4,465,0,4963
"13199970500",2559,462,1285,987,92,40,0,0,5425
"13199970600",1470,468,815,321,179,31,74,12,3370
"13199970700",3792,818,1735,471,250,154,105,115,7440
"13199970800",2091,334,1844,599,16,48,69,26,5027
"13201950100",889,319,138,264,0,0,0,0,1610
"13201950200",651,86,536,492,3,0,0,0,1768
"13201950300",1751,304,192,143,0,0,0,0,2390
"13205090100",1552,686,764,385,3,76,186,0,3652
"13205090200",1563,398,478,377,167,276,193,85,3537
"13205090300",498,92,945,819,0,0,127,24,2505
"13205090400",2166,279,2068,1365,129,0,101,25,6133
"13205090500",2637,448,1726,672,0,32,0,32,5547
"13207050101",4344,352,624,374,94,117,201,0,6106
"13207050102",2409,301,1068,213,10,5,92,5,4103
"13207050200",1966,339,1421,893,146,7,74,0,4846
"13207050301",3671,214,456,334,10,0,45,0,4730
"13207050302",5335,228,407,0,136,115,57,91,6369
"13209950100",1472,425,63,87,9,12,12,40,2120
"13209950200",1943,537,963,486,104,21,169,152,4375
"13209950300",1294,339,225,155,42,14,72,44,2185
"13211010100",2118,227,357,22,73,0,176,0,2973
"13211010200",2789,321,460,167,75,32,3,0,3847
"13211010300",3772,372,1585,728,171,0,110,0,6738
"13211010400",1985,361,391,190,45,19,39,106,3136
"13211010500",1101,86,114,3,114,1,84,0,1503
"13213010100",2293,760,13,0,200,0,103,74,3443
"13213010201",1467,430,0,0,39,4,0,73,2013
"13213010202",7083,1436,118,49,145,181,1588,454,11054
"13213010300",3293,518,35,11,19,0,62,30,3968
"13213010400",4458,1080,0,9,321,0,624,53,6545
"13213010500",4335,657,0,0,258,41,1142,181,6614
"13213010600",3033,812,0,57,171,0,186,48,4307
"13213010700",3776,1694,1,1,74,25,465,364,6400
"13215000200",1946,338,171,115,253,0,154,103,3080
"13215000300",391,175,278,178,181,176,230,206,1815
"13215000400",2183,119,153,0,300,6,58,0,2819
"13215000800",1296,450,320,151,147,25,179,0,2568
"13215000900",1078,310,610,193,195,37,175,10,2608
"13215001000",2218,269,368,270,358,53,231,7,3774
"13215001100",2319,66,134,6,67,42,33,31,2698
"13215001200",2221,213,463,371,118,22,86,19,3513
"13215001400",518,364,426,333,120,57,71,23,1912
"13215001600",408,258,393,1099,33,171,18,67,2447
"13215001800",462,231,212,246,45,6,48,40,1290
"13215002000",152,1,2422,769,178,0,117,0,3639
"13215002100",975,313,775,134,246,72,130,18,2663
"13215002200",65,150,1653,1361,22,96,0,32,3379
"13215002300",552,31,427,404,42,0,80,7,1543
"13215002400",52,67,511,776,36,73,0,38,1553
"13215002500",31,43,507,976,18,14,53,14,1656
"13215002700",44,67,600,1447,7,22,0,0,2187
"13215002800",28,7,1070,636,101,10,81,10,1943
"13215002901",463,85,1687,361,84,192,64,141,3077
"13215002902",151,123,1252,758,15,65,15,66,2445
"13215003000",273,0,1010,1079,81,157,0,181,2781
"13215003200",81,28,669,808,54,128,46,128,1942
"13215003301",129,66,913,230,84,6,0,23,1451
"13215003302",233,72,1320,945,95,0,98,0,2763
"13215003400",291,200,589,925,81,228,133,143,2590
"13215010104",3276,243,1890,176,821,136,607,19,7168
"13215010106",2817,225,1331,272,705,146,540,13,6049
"13215010107",5019,127,1733,32,825,19,502,61,8318
"13215010201",4605,208,823,0,906,196,440,40,7218
"13215010203",5346,513,1409,259,1041,250,455,225,9498
"13215010204",4423,274,1165,129,428,19,408,115,6961
"13215010205",2269,309,728,0,198,0,202,0,3706
"13215010301",2235,28,15,0,191,0,38,0,2507
"13215010302",4890,597,748,168,397,156,281,65,7302
"13215010401",5016,149,603,0,455,423,332,409,7387
"13215010402",2625,165,788,193,447,8,393,8,4627
"13215010501",3179,305,1704,443,389,11,243,0,6274
"13215010502",528,122,697,111,129,11,138,16,1752
"13215010602",939,235,2953,691,555,15,310,49,5747
"13215010605",131,8,3316,685,355,2,251,2,4750
"13215010606",3,0,7,7,0,0,0,0,17
"13215010607",681,76,3924,1032,220,21,29,28,6011
"13215010608",394,43,2986,989,83,51,50,59,4655
"13215010701",876,258,4114,742,96,0,334,39,6459
"13215010702",224,195,3301,917,137,52,136,28,4990
"13215010703",297,44,3810,1678,218,102,92,0,6241
"13215010801",897,79,284,126,176,34,230,13,1839
"13215010802",2893,70,793,63,1206,131,1013,184,6353
"13215011100",515,321,353,315,9,12,31,6,1562
"13215011200",803,171,371,653,166,58,48,64,2334
"13215011400",1027,592,194,281,95,72,81,139,2481
"13215011500",1645,542,2134,596,860,264,797,467,7305
"13217100100",6734,857,2680,304,293,0,75,30,10973
"13217100201",5061,234,266,389,64,1,78,13,6106
"13217100202",4240,322,232,11,84,81,103,0,5073
"13217100300",4244,945,2446,1240,204,47,232,567,9925
"13217100400",1262,300,679,407,204,6,200,0,3058
"13217100501",2297,1134,9955,1600,449,56,476,480,16447
"13217100502",2331,500,4429,799,296,0,495,137,8987
"13217100600",1987,555,2375,359,252,56,188,64,5836
"13217100700",1854,434,1954,1663,176,0,268,0,6349
"13217100800",6164,1131,1640,304,362,47,182,2,9832
"13217100901",5133,592,3276,370,589,61,227,0,10248
"13217100902",2770,277,1186,940,525,26,437,65,6226
"13217100903",2516,433,2087,770,299,30,222,267,6624
"13219030100",9402,288,902,16,903,70,530,125,12236
"13219030200",4371,530,202,138,243,29,93,294,5900
"13219030300",4433,331,128,35,89,76,180,22,5294
"13219030400",6089,521,144,42,220,32,168,0,7216
"13219030500",1903,30,121,18,46,0,38,0,2156
"13219030600",2267,287,147,0,19,44,155,0,2919
"13221960100",982,361,193,118,23,46,0,41,1764
"13221960201",4793,459,680,156,410,199,145,178,7020
"13221960202",2854,529,765,187,85,16,126,11,4573
"13221960300",1181,193,207,19,50,33,52,25,1760
"13223120101",8596,1500,1144,24,587,45,279,0,12175
"13223120102",8137,548,1072,310,1306,0,996,0,12369
"13223120103",8169,601,730,0,84,40,143,246,10013
"13223120104",2037,119,5,0,187,0,18,0,2366
"13223120202",4567,364,2073,124,420,196,367,0,8111
"13223120203",4369,346,273,0,26,19,104,22,5159
"13223120204",5153,447,583,293,173,12,201,0,6862
"13223120301",3349,267,536,693,444,0,314,0,5603
"13223120302",8304,1729,2199,1349,134,118,1313,682,15828
"13223120303",1367,238,87,13,56,11,36,0,1808
"13223120400",13643,1588,1873,649,550,0,309,12,18624
"13223120501",3231,832,1707,279,163,0,295,348,6855
"13223120502",6857,639,1012,279,194,0,363,152,9496
"13223120503",4001,270,731,31,223,0,113,0,5369
"13223120601",2646,57,833,126,704,26,489,0,4881
"13223120602",5784,1000,2079,689,165,0,262,148,10127
"13223120603",4180,436,1266,118,185,15,421,0,6621
"13223120604",3369,579,1267,357,61,0,60,214,5907
"13223120605",4429,718,571,105,111,246,54,90,6324
"13225040101",1274,109,281,6,25,0,0,0,1695
"13225040102",6403,665,2056,453,270,102,63,94,10106
"13225040200",1602,241,1155,881,281,406,432,539,5537
"13225040301",1140,65,811,240,385,4,537,2,3184
"13225040302",362,114,670,743,147,47,106,67,2256
"13225040400",376,10,2233,1347,0,38,0,71,4075
"13227050100",4735,294,54,0,24,0,150,0,5257
"13227050200",5133,357,147,28,386,3,481,0,6535
"13227050300",3639,456,87,0,92,3,33,0,4310
"13227050400",2852,1000,0,3,64,0,46,0,3965
"13227050500",3842,509,0,0,20,0,140,0,4511
"13227050600",4677,687,28,0,271,78,60,0,5801
"13229960100",1834,588,118,40,25,24,19,118,2766
"13229960200",1260,297,0,107,146,71,293,90,2264
"13229960300",3807,1109,392,753,390,104,271,0,6826
"13229960400",6040,1306,0,28,301,28,172,0,7875
"13231010100",5147,614,596,199,136,36,82,0,6810
"13231010200",3308,69,130,3,6,0,57,0,3573
"13231010300",2944,394,463,206,26,0,74,0,4107
"13231010400",2322,531,235,80,45,0,33,0,3246
"13233010100",3703,638,304,41,277,0,241,3,5207
"13233010200",4927,769,429,135,1334,323,1226,208,9351
"13233010300",2904,873,282,38,383,411,794,644,6329
"13233010400",3160,1162,465,495,626,179,720,376,7183
"13233010500",3500,669,690,250,384,35,790,35,6353
"13233010600",3643,950,736,333,225,14,0,66,5967
"13233010700",3577,625,426,790,35,37,3,78,5571
"13235950100",931,180,196,248,0,0,147,19,1721
"13235950200",3369,882,1944,483,375,0,94,228,7375
"13235950300",1000,66,289,70,22,0,13,0,1460
"13237960101",2572,397,126,90,28,0,117,0,3330
"13237960102",4357,380,394,0,289,76,412,141,6049
"13237960201",568,215,150,114,70,18,144,0,1279
"13237960202",1770,256,3064,1397,187,222,270,276,7442
"13237960300",3704,249,241,0,23,32,49,0,4298
"13239960300",959,195,789,356,20,7,0,0,2326
"13241970100",4073,937,5,108,246,242,251,408,6270
"13241970201",2396,584,10,0,148,31,161,79,3409
"13241970202",1972,418,68,19,16,0,290,12,2795
"13241970301",2603,472,1,15,4,77,21,11,3204
"13241970302",985,426,0,0,6,129,56,12,1614
"13243790100",857,125,470,325,0,0,0,31,1808
"13243790200",1190,254,2216,1441,230,0,33,0,5364
"13245000100",1862,272,908,672,209,0,90,23,4036
"13245000200",632,321,445,784,126,27,36,40,2411
"13245000300",211,153,430,170,3,1,10,0,978
"13245000600",438,132,628,1078,33,0,25,9,2343
"13245000700",9,24,532,450,0,0,9,0,1024
"13245000900",0,7,548,560,0,0,0,0,1115
"13245001000",833,501,482,293,84,17,55,78,2343
"13245001100",1563,101,34,48,75,0,40,0,1861
"13245001200",1486,532,1429,605,133,0,22,0,4207
"13245001300",636,77,648,148,40,19,65,0,1633
"13245001400",16,66,761,967,40,2,10,27,1889
"13245001500",41,3,471,238,0,0,0,0,753
"13245001601",922,189,1601,1260,32,50,0,47,4101
"13245001602",2732,321,533,251,113,16,71,0,4037
"13245010101",2430,215,462,38,272,32,374,12,3835
"13245010104",1999,95,733,535,582,0,101,14,4059
"13245010105",3257,340,754,269,156,24,87,114,5001
"13245010106",2326,258,1601,191,585,59,111,0,5131
"13245010107",987,278,491,206,100,400,74,24,2560
"13245010201",3546,313,439,95,102,0,63,0,4558
"13245010203",1250,313,1902,422,229,41,66,42,4265
"13245010204",4388,1007,5937,399,1074,61,809,565,14240
"13245010300",726,249,2695,1459,0,30,242,145,5546
"13245010400",392,51,1554,2205,18,52,25,80,4377
"13245010504",1586,622,2492,2359,48,72,26,256,7461
"13245010506",1183,295,1759,1537,58,86,160,12,5090
"13245010507",780,277,3641,720,256,0,127,0,5801
"13245010508",1165,123,1486,1319,145,62,94,29,4423
"13245010509",1398,82,1458,993,139,0,57,0,4127
"13245010510",1831,485,1469,934,178,36,29,7,4969
"13245010511",896,379,1264,881,20,71,16,10,3537
"13245010512",604,212,2294,1202,90,30,8,100,4540
"13245010513",321,128,2044,446,146,11,74,0,3170
"13245010600",172,26,2088,1914,10,139,48,58,4455
"13245010706",1384,478,2062,715,93,204,89,182,5207
"13245010707",121,91,1683,847,130,31,3,94,3000
"13245010708",697,68,3160,931,587,242,538,47,6270
"13245010709",232,4,4639,923,220,32,164,0,6214
"13245010710",1027,810,2275,1487,159,58,101,30,5947
"13245010711",550,305,1360,508,149,41,142,19,3074
"13245010712",906,83,6139,851,416,334,121,138,8988
"13245010800",1814,232,1181,77,918,95,712,62,5091
"13245010903",2633,649,1503,134,237,60,250,68,5534
"13245010904",1534,276,954,353,301,8,25,0,3451
"13245010905",3224,817,763,21,103,119,46,0,5093
"13245010906",4223,177,1822,438,431,96,709,64,7960
"13245011000",569,259,203,194,53,17,47,24,1366
"13247060101",2390,292,446,77,57,11,221,48,3542
"13247060102",2719,477,1543,154,343,19,223,0,5478
"13247060201",1924,955,1098,260,323,99,1543,909,7111
"13247060202",3282,71,4921,914,523,86,275,57,10129
"13247060304",1594,152,2573,774,30,78,330,8,5539
"13247060305",1263,863,1952,873,280,97,499,699,6526
"13247060306",645,134,2044,211,63,0,23,5,3125
"13247060307",2289,324,6281,466,917,106,400,126,10909
"13247060308",1423,642,3848,1190,490,578,726,645,9542
"13247060309",1497,342,2137,1146,175,0,270,151,5718
"13247060403",1572,64,1406,222,227,0,103,21,3615
"13247060404",3092,175,2089,361,226,62,210,140,6355
"13247060405",3679,153,2166,642,379,57,185,54,7315
"13247060406",3356,134,1602,264,297,0,464,17,6134
"13247060407",1953,490,582,140,36,0,169,35,3405
"13249960100",1553,398,518,425,41,35,56,124,3150
"13249960200",1652,134,114,158,9,37,9,37,2150
"13251970200",808,83,614,320,4,2,4,0,1835
"13251970300",1451,234,701,651,12,6,47,0,3102
"13251970400",2050,529,1069,677,38,165,95,48,4671
"13251970500",1295,306,734,299,33,0,11,0,2678
"13251970600",964,92,528,116,24,2,18,2,1746
"13253200100",2104,221,83,25,63,2,120,23,2641
"13253200200",1577,117,1106,715,83,39,21,31,3689
"13253200300",1498,41,530,435,19,0,57,0,2580
"13255160100",4648,667,304,29,105,35,615,35,6438
"13255160200",3879,686,1210,151,293,45,217,45,6526
"13255160300",558,406,1251,943,0,54,47,116,3375
"13255160400",1343,622,2167,1015,98,60,179,50,5534
"13255160500",3165,164,1747,518,697,12,212,30,6545
"13255160600",3216,436,104,3,39,98,41,28,3965
"13255160700",2196,563,2030,1486,267,123,149,0,6814
"13255160800",797,799,1554,1540,0,183,59,406,5338
"13255160900",1088,451,776,277,22,79,0,74,2767
"13255161000",3847,628,412,104,135,26,12,76,5240
"13255161100",3121,359,287,79,64,19,182,0,4111
"13255161200",5649,446,1186,1132,102,0,117,0,8632
"13257970100",4223,830,500,354,134,0,139,0,6180
"13257970200",4853,777,97,174,189,55,122,55,6322
"13257970301",1401,375,623,190,337,85,234,85,3330
"13257970302",1928,316,412,63,0,0,45,0,2764
"13257970400",5089,1240,380,248,32,0,33,1,7023
"13259950100",566,53,624,745,20,0,16,0,2024
"13259950400",789,104,554,743,84,0,10,0,2284
"13261950100",653,150,336,87,14,5,11,15,1271
"13261950200",1294,552,1123,1542,107,399,26,124,5167
"13261950300",1327,157,2692,2200,221,0,14,23,6634
"13261950400",1498,112,578,349,2,1,63,20,2623
"13261950500",2131,119,482,427,93,73,188,89,3602
"13261950600",763,88,494,564,209,20,81,20,2239
"13261950700",1666,346,1743,1482,95,426,148,597,6503
"13261950800",1316,372,697,270,80,0,164,21,2920
"13263960100",1019,40,1113,250,17,0,0,0,2439
"13263960200",668,83,1132,476,0,11,68,7,2445
"13263960300",684,187,499,244,39,0,50,0,1703
"13265010200",512,172,673,328,8,11,24,14,1742
"13267950100",2005,525,397,322,36,172,52,186,3695
"13267950201",1900,742,1053,548,108,121,58,123,4653
"13267950202",1410,684,71,101,304,1017,537,999,5123
"13267950300",2498,336,369,376,287,64,213,114,4257
"13267950400",2855,492,351,146,39,0,59,0,3942
"13269950100",886,161,345,26,0,0,0,0,1418
"13269950200",1003,202,645,383,89,0,95,27,2444
"13269950300",1996,568,857,952,21,59,6,59,4518
"13271950100",3530,970,1571,1480,138,1,334,0,8024
"13271950200",1322,231,60,95,67,0,67,0,1842
"13271950500",1570,390,684,398,7,0,139,0,3188
"13273120200",995,69,250,269,4,3,10,3,1603
"13273120300",426,45,1298,1171,28,4,0,0,2972
"13273120400",571,67,869,1158,17,0,0,0,2682
"13273120500",988,124,210,246,9,60,49,155,1841
"13275960100",454,113,232,328,13,72,54,116,1382
"13275960200",2611,757,268,100,60,158,4,74,4032
"13275960300",1404,173,409,185,31,37,65,25,2329
"13275960400",1379,295,279,192,6,0,20,30,2201
"13275960500",4152,689,948,541,325,50,50,63,6818
"13275960600",3149,551,1528,198,95,0,86,0,5607
"13275960700",2203,538,1741,1915,177,273,0,204,7051
"13275960800",1881,73,2211,1052,58,0,144,0,5419
"13275960900",1428,316,1318,344,44,77,7,26,3560
"13275961000",2360,499,529,194,53,0,134,157,3926
"13275961100",1111,121,1020,432,37,62,102,47,2932
"13277960100",2046,184,211,43,6,13,335,94,2932
"13277960200",2056,230,448,219,23,8,115,72,3171
"13277960300",3622,1098,714,224,332,367,61,176,6594
"13277960400",3628,896,795,550,102,48,557,69,6645
"13277960500",3501,592,355,0,62,31,35,0,4576
"13277960600",416,298,2078,2771,246,0,272,28,6109
"13277960700",1106,671,941,1157,589,193,826,529,6012
"13277960800",1355,878,92,111,121,0,523,474,3554
"13277960900",1733,611,727,107,207,72,34,146,3637
"13279970100",2227,869,654,957,601,146,674,369,6497
"13279970200",2687,436,571,780,29,0,278,0,4781
"13279970300",3396,392,1586,382,559,0,709,2,7026
"13279970400",1558,635,1079,477,281,106,141,87,4364
"13279970500",2338,842,77,105,191,19,236,329,4137
"13279970600",2152,349,148,45,83,134,139,134,3184
"13281960100",3037,660,5,22,24,0,23,22,3793
"13281960200",2304,311,0,0,0,97,0,97,2809
"13281960300",2630,696,0,0,126,76,29,55,3612
"13283960100",1049,45,39,0,8,0,50,0,1191
"13283960200",3061,367,913,821,16,9,0,0,5187
"13285960100",3501,870,933,636,45,59,23,2,6069
"13285960201",2478,154,177,0,218,0,57,0,3084
"13285960202",1686,133,441,50,32,0,37,0,2379
"13285960300",3226,155,93,0,87,0,118,11,3690
"13285960400",2915,395,1435,470,403,48,42,0,5708
"13285960501",1508,803,1381,766,201,21,163,246,5089
"13285960502",3634,929,1580,584,583,47,212,284,7853
"13285960600",1510,191,2235,1549,116,0,98,3,5702
"13285960700",2166,425,1510,647,764,8,420,0,5940
"13285960800",699,541,1071,885,37,228,164,2,3627
"13285960901",1235,272,1428,1040,239,65,296,92,4667
"13285960902",4786,459,1120,71,204,44,44,3,6731
"13285961000",2839,652,1741,841,35,0,35,17,6160
"13285961100",2280,199,118,130,6,21,39,0,2793
"13287970200",1806,303,1855,1125,96,86,221,62,5554
"13287970300",2034,358,115,116,51,39,2,46,2761
"13289060100",2519,694,951,602,163,14,0,0,4943
"13289060200",1135,331,1294,683,3,0,0,0,3446
"13291000101",2122,515,0,0,0,0,0,0,2637
"13291000102",4579,509,21,0,0,0,0,0,5109
"13291000201",2022,503,0,5,248,4,29,34,2845
"13291000203",1729,318,0,0,203,0,160,0,2410
"13291000204",2567,431,0,0,112,0,66,0,3176
"13291000205",4692,498,0,0,72,77,244,77,5660
"13293010100",2191,268,426,51,21,10,58,0,3025
"13293010201",2357,1301,962,429,32,10,16,507,5614
"13293010202",2067,404,36,56,75,0,0,0,2638
"13293010300",2563,378,116,46,0,22,0,0,3125
"13293010400",3187,466,1301,659,86,0,0,0,5699
"13293010500",1558,913,1777,872,0,64,0,28,5212
"13293010600",538,65,447,123,14,0,0,0,1187
"13295020100",4294,1707,218,59,250,61,136,0,6725
"13295020200",2141,998,231,154,308,79,38,26,3975
"13295020301",3097,985,292,44,69,232,65,263,5047
"13295020302",4042,725,13,0,264,0,222,0,5266
"13295020400",2635,493,26,4,55,0,21,2,3236
"13295020501",6453,945,264,16,180,15,27,0,7900
"13295020502",5145,1311,60,0,22,8,21,7,6574
"13295020601",5252,634,145,19,89,0,307,0,6446
"13295020602",3427,492,197,11,192,22,25,8,4374
"13295020700",4909,1299,287,246,121,31,38,0,6931
"13295020800",2674,356,94,74,13,0,0,9,3220
"13295020901",5607,471,81,27,0,40,0,0,6226
"13295020902",1473,240,79,20,3,0,19,0,1834
"13297110100",7024,727,432,95,536,58,6,134,9012
"13297110200",3157,591,383,15,62,0,26,20,4254
"13297110300",3232,520,1683,1274,130,90,276,0,7205
"13297110400",2311,566,1628,1604,214,48,52,12,6435
"13297110503",2944,350,100,42,30,0,181,0,3647
"13297110504",3344,436,318,0,503,268,266,205,5340
"13297110505",3603,298,245,0,77,0,73,8,4304
"13297110506",4401,306,255,19,135,0,184,0,5300
"13297110507",5554,368,914,151,607,18,539,27,8178
"13297110508",4115,391,437,66,69,32,387,18,5515
"13297110601",3582,471,366,55,71,99,36,0,4680
"13297110602",4294,411,475,17,115,0,93,0,5405
"13297110603",3746,525,117,6,128,16,181,0,4719
"13297110700",4743,852,935,405,31,33,97,0,7096
"13297110800",4844,197,1075,381,387,0,441,0,7325
"13299950100",1367,182,21,0,6,38,0,0,1614
"13299950200",4001,1170,193,0,182,13,190,181,5930
"13299950300",1242,308,164,193,5,11,0,0,1923
"13299950400",99,41,764,832,0,7,0,37,1780
"13299950500",2081,1047,1303,570,36,301,22,0,5360
"13299950600",4082,623,608,356,355,0,11,0,6035
"13299950700",162,92,452,473,12,30,28,28,1277
"13299950800",2288,638,988,1335,349,0,398,0,5996
"13299950900",2216,923,517,364,40,139,144,146,4489
"13301970400",875,56,820,886,109,6,0,0,2752
"13301970500",993,123,1146,383,55,31,13,30,2774
"13303950100",993,45,433,210,51,7,0,0,1739
"13303950300",1660,146,1326,975,76,45,0,0,4228
"13303950400",1970,160,1498,1461,25,0,12,40,5166
"13303950500",1848,289,1389,352,55,18,45,47,4043
"13303950700",1466,361,1322,892,55,0,41,205,4342
"13305970100",3200,322,107,61,108,204,80,132,4214
"13305970200",5112,978,908,421,235,74,196,42,7966
"13305970300",2762,270,968,724,119,65,278,107,5293
"13305970400",2713,314,306,71,171,24,339,3,3941
"13305970500",1403,862,649,558,152,9,50,121,3804
"13305970600",2962,452,117,216,111,8,38,28,3932
"13307960100",474,99,655,166,0,26,0,26,1446
"13307960200",524,77,447,240,0,0,0,0,1288
"13309780100",1301,223,211,304,0,19,8,0,2066
"13309780200",1336,378,295,253,0,0,0,0,2262
"13311950100",2229,300,71,19,121,0,15,0,2755
"13311950201",5979,2199,288,22,99,4,190,116,8897
"13311950202",2863,226,0,0,26,22,28,0,3165
"13311950203",4447,399,172,0,0,234,0,0,5252
"13311950300",5670,1593,69,0,120,177,209,226,8064
"13313000101",3467,458,1,5,61,0,185,0,4177
"13313000102",6661,943,250,12,428,63,1473,147,9977
"13313000200",3229,642,0,9,56,10,130,294,4370
"13313000301",2935,710,36,61,318,227,1274,484,6045
"13313000302",7976,780,227,0,212,56,1905,452,11608
"13313000400",4841,1147,288,163,955,413,3993,1039,12839
"13313000501",3152,399,32,45,406,131,850,126,5141
"13313000502",3227,1658,373,354,409,140,1931,706,8798
"13313000600",3441,521,110,15,106,60,233,339,4825
"13313000700",3698,713,189,1,60,106,25,98,4890
"13313000800",5836,679,146,315,759,65,790,34,8624
"13313000900",2844,424,169,113,161,0,656,203,4570
"13313001000",2960,979,233,67,137,108,2453,913,7850
"13313001100",3475,1289,87,3,90,88,1726,784,7542
"13313001200",4783,1692,369,18,525,420,2665,1392,11864
"13313001300",2036,1890,164,39,147,100,1664,1527,7567
"13313001400",5328,517,25,1,731,0,2581,312,9495
"13313001500",4794,493,69,0,154,128,577,91,6306
"13315960100",1124,286,313,290,44,0,0,0,2057
"13315960200",671,101,346,208,13,21,13,21,1394
"13315960300",851,263,154,98,57,2,14,26,1465
"13315960400",1202,154,554,161,5,15,27,0,2118
"13317010101",866,159,243,234,31,11,0,0,1544
"13317010102",624,196,207,308,21,244,38,244,1882
"13317010301",1483,74,421,303,12,0,20,0,2313
"13317010302",1615,195,1445,986,38,85,90,0,4454
"13319960200",1231,282,1257,387,0,2,184,2,3345
"13319960300",2548,294,957,471,236,1,30,0,4537
"13319960400",1121,65,282,134,1,4,23,4,1634
"13321950100",1711,328,369,383,37,0,49,0,2877
"13321950200",4452,782,1406,405,17,0,159,149,7370
"13321950400",3202,561,648,353,48,9,8,23,4852
"13321950500",1451,226,1445,921,58,30,13,13,4157
"13321950600",1383,419,263,28,34,0,29,0,2156
"15001020100",1384,267,12,29,2623,557,347,117,5336
"15001020202",492,86,4,0,912,229,123,21,1867
"15001020300",605,214,12,0,2169,712,323,67,4102
"15001020400",485,306,87,26,1591,1464,320,731,5010
"15001020500",532,339,0,19,2204,1376,262,331,5063
"15001020600",545,127,57,0,4724,784,398,108,6743
"15001020701",383,107,16,0,3509,320,124,87,4546
"15001020702",674,11,56,0,4405,243,772,13,6174
"15001020801",623,208,0,0,3758,187,295,28,5099
"15001020802",1306,135,0,0,3974,716,331,178,6640
"15001020900",1011,123,17,0,3370,670,403,29,5623
"15001021003",1499,486,33,32,3480,1589,795,716,8630
"15001021005",2710,963,236,0,5255,2276,763,1620,13823
"15001021010",2563,699,26,12,2119,1374,652,618,8063
"15001021011",1428,233,0,0,1331,625,344,175,4136
"15001021013",797,146,0,3,3401,671,308,57,5383
"15001021101",1541,527,0,0,712,324,158,181,3443
"15001021106",1420,816,30,41,3223,1491,742,537,8300
"15001021202",1995,602,8,7,3072,2207,458,754,9103
"15001021300",2201,471,7,0,3628,703,261,7,7278
"15001021402",923,90,21,0,2836,348,318,137,4673
"15001021502",1783,176,17,13,2151,284,396,83,4903
"15001021504",693,30,44,2,3192,845,379,9,5194
"15001021507",5287,661,0,0,4122,816,1620,244,12750
"15001021509",2596,394,0,0,1629,973,313,330,6235
"15001021601",3075,401,22,0,3341,556,690,17,8102
"15001021604",3148,344,61,73,3172,484,982,126,8390
"15001021702",3488,208,162,6,5905,1279,667,119,11834
"15001021704",3751,332,14,0,3283,303,370,33,8086
"15001021800",1177,283,5,0,3883,1121,618,185,7272
"15001021902",1126,324,2,0,2333,315,258,10,4368
"15001022000",950,64,0,0,1978,273,125,35,3425
"15001022102",520,49,0,0,912,156,223,0,1860
"15001990000",0,0,0,0,0,0,0,0,0
"15001990100",0,0,0,0,0,0,0,0,0
"15001990300",0,0,0,0,0,0,0,0,0
"15001990400",0,0,0,0,0,0,0,0,0
"15001990500",0,0,0,0,0,0,0,0,0
"15001990600",0,0,0,0,0,0,0,0,0
"15001990700",0,0,0,0,0,0,0,0,0
"15001990800",0,0,0,0,0,0,0,0,0
"15001990900",0,0,0,0,0,0,0,0,0
"15001991000",0,0,0,0,0,0,0,0,0
"15001991100",0,0,0,0,0,0,0,0,0
"15001991200",0,0,0,0,0,0,0,0,0
"15001991300",0,0,0,0,0,0,0,0,0
"15001991400",0,0,0,0,0,0,0,0,0
"15001991500",0,0,0,0,0,0,0,0,0
"15001991600",0,0,0,0,0,0,0,0,0
"15001991700",0,0,0,0,0,0,0,0,0
"15003000106",2228,127,141,0,5245,180,566,65,8552
"15003000107",654,0,0,0,2110,21,88,0,2873
"15003000108",1196,59,74,0,1667,100,144,0,3240
"15003000110",1364,111,0,0,2782,68,148,0,4473
"15003000111",716,44,0,0,3902,116,201,0,4979
"15003000112",1120,208,40,0,3536,148,171,31,5254
"15003000114",534,5,0,0,841,23,35,0,1438
"15003000200",1124,45,0,22,4460,116,285,11,6063
"15003000301",566,48,13,0,2489,65,132,0,3313
"15003000302",460,0,0,0,2274,104,105,0,2943
"15003000401",590,46,7,0,1803,73,50,13,2582
"15003000402",931,58,0,0,2681,64,182,0,3916
"15003000500",1269,125,15,0,2003,125,168,0,3705
"15003000600",442,76,0,0,801,16,0,0,1335
"15003000700",168,0,0,13,2594,138,211,0,3124
"15003000800",361,15,22,0,3121,145,88,0,3752
"15003000901",476,32,0,0,2001,208,46,0,2763
"15003000902",1247,52,15,15,2384,144,352,45,4254
"15003000903",541,33,19,0,2155,104,172,13,3037
"15003001000",558,69,53,0,2427,160,355,26,3648
"15003001100",315,35,17,0,2944,773,244,20,4348
"15003001201",162,34,0,0,2770,72,294,13,3345
"15003001202",220,11,0,0,2478,161,233,26,3129
"15003001300",528,117,17,0,3786,257,205,0,4910
"15003001400",308,23,48,0,2047,144,47,0,2617
"15003001500",567,87,0,0,2742,146,96,0,3638
"15003001600",624,98,30,0,2883,180,189,0,4004
"15003001700",1175,70,36,0,717,86,117,0,2201
"15003001801",392,105,8,5,476,204,92,34,1316
"15003001803",1067,59,263,0,1264,192,246,18,3109
"15003001804",740,51,35,0,821,59,99,13,1818
"15003001901",191,17,0,8,120,19,32,0,387
"15003001903",1152,157,0,0,1601,283,142,31,3366
"15003001904",1539,201,46,0,1380,129,181,0,3476
"15003002003",702,23,89,0,656,114,70,10,1664
"15003002004",421,170,0,0,632,81,52,8,1364
"15003002005",674,222,82,20,680,119,176,0,1973
"15003002006",630,164,42,0,652,183,56,10,1737
"15003002100",534,44,68,0,2606,282,201,48,3783
"15003002201",558,78,0,0,2207,651,47,68,3609
"15003002202",966,50,20,0,2023,109,125,0,3293
"15003002300",583,202,32,0,3390,694,375,66,5342
"15003002401",297,106,237,0,2369,324,207,8,3548
"15003002402",355,67,0,0,1979,769,36,0,3206
"15003002500",391,119,32,0,3192,803,257,45,4839
"15003002600",530,168,10,0,2865,279,138,43,4033
"15003002701",212,40,0,0,1218,119,9,8,1606
"15003002702",863,170,36,12,3307,518,115,80,5101
"15003002800",1017,57,0,0,2643,84,227,19,4047
"15003002900",768,61,10,0,1437,119,44,14,2453
"15003003000",1413,107,0,0,3031,229,153,31,4964
"15003003101",585,64,21,0,3180,96,65,14,4025
"15003003102",678,99,0,0,2749,49,0,6,3581
"15003003200",290,0,9,0,453,59,6,0,817
"15003003300",151,15,5,0,964,34,33,0,1202
"15003003403",1092,168,152,27,3835,511,504,23,6312
"15003003404",550,109,25,0,3465,346,215,102,4812
"15003003405",815,214,27,0,2015,400,202,29,3702
"15003003406",660,265,41,0,3908,912,543,13,6342
"15003003407",189,0,0,0,512,44,18,0,763
"15003003501",412,27,77,0,1601,159,71,0,2347
"15003003502",357,16,16,0,2913,381,115,0,3798
"15003003601",726,148,61,13,2665,383,288,0,4284
"15003003603",427,73,0,0,1933,667,55,0,3155
"15003003604",363,13,42,0,1623,175,60,0,2276
"15003003700",1718,142,0,0,3628,254,138,17,5897
"15003003800",928,0,39,15,2670,162,114,0,3928
"15003003900",76,4,38,0,161,51,11,4,345
"15003004000",455,160,71,25,537,52,71,5,1376
"15003004100",581,33,176,0,2951,562,205,38,4546
"15003004200",644,25,35,0,2228,237,47,0,3216
"15003004300",668,129,171,21,3963,547,93,91,5683
"15003004400",297,1,8,0,5076,370,342,36,6130
"15003004500",1124,46,26,0,3621,96,336,0,5249
"15003004600",290,25,0,0,3467,110,133,0,4025
"15003004700",505,80,14,0,3918,251,153,14,4935
"15003004800",321,84,0,0,5562,971,476,148,7562
"15003004900",113,31,27,0,2622,351,209,92,3445
"15003005000",297,76,44,0,3521,350,150,18,4456
"15003005100",682,44,0,0,1807,618,79,32,3262
"15003005200",148,42,128,46,1947,592,61,0,2964
"15003005300",309,118,191,76,2464,818,260,127,4363
"15003005400",16,4,0,7,733,675,14,59,1508
"15003005500",84,52,45,0,1421,538,24,52,2216
"15003005600",128,23,0,0,6063,1243,681,231,8369
"15003005700",151,147,22,32,1455,481,107,48,2443
"15003005800",46,26,0,0,2792,618,125,50,3657
"15003005900",120,8,7,0,1817,267,16,0,2235
"15003006000",108,36,21,20,5712,344,335,0,6576
"15003006100",204,3,0,10,3719,593,274,95,4898
"15003006201",137,26,6,0,4693,1231,361,111,6565
"15003006202",10,6,3,5,397,1444,26,34,1925
"15003006301",144,17,13,0,3598,248,481,27,4528
"15003006302",31,0,0,0,1544,1004,11,189,2779
"15003006401",15,11,0,0,2465,188,182,7,2868
"15003006402",221,40,63,22,6355,892,597,75,8265
"15003006500",374,47,30,0,4028,155,246,30,4910
"15003006600",273,0,69,0,504,0,0,0,846
"15003006701",548,53,65,0,4955,298,67,10,5996
"15003006702",796,12,213,0,1075,133,292,12,2533
"15003006802",423,39,380,0,6383,874,522,33,8654
"15003006804",2250,222,1033,126,882,301,627,10,5451
"15003006805",573,76,288,0,4571,271,249,28,6056
"15003006806",67,1,0,0,1847,40,23,0,1978
"15003006808",488,6,133,0,3476,571,62,5,4741
"15003006809",323,30,17,0,4099,677,337,269,5752
"15003006900",2651,179,346,0,970,0,711,53,4910
"15003007000",2365,278,479,17,1207,209,821,73,5449
"15003007100",2769,89,239,73,464,53,697,21,4405
"15003007302",3568,228,334,20,812,159,593,0,5714
"15003007303",0,0,0,0,0,0,0,0,0
"15003007400",1791,82,312,27,557,52,276,11,3108
"15003007502",191,2,53,4,141,5,63,0,459
"15003007503",582,34,28,0,4039,396,221,214,5514
"15003007504",154,21,38,0,2683,546,338,190,3970
"15003007505",780,15,22,0,4555,403,352,116,6243
"15003007506",168,0,42,0,80,0,16,0,306
"15003007701",940,11,0,0,3057,408,469,12,4897
"15003007702",765,61,0,0,3936,64,137,10,4973
"15003007804",87,0,0,0,2024,39,295,0,2445
"15003007805",347,25,33,0,4386,309,616,165,5881
"15003007807",1007,19,348,33,3404,450,479,0,5740
"15003007808",211,23,52,0,3005,130,484,0,3905
"15003007809",172,11,0,0,3089,57,228,0,3557
"15003007810",677,9,22,0,4435,61,174,15,5393
"15003007811",638,0,103,25,3676,193,180,46,4861
"15003008001",42,16,0,0,1594,253,245,116,2266
"15003008002",180,7,6,0,2392,225,113,3,2926
"15003008003",1088,0,64,0,3299,538,789,15,5793
"15003008005",800,78,28,0,5279,272,682,0,7139
"15003008006",216,12,22,188,4377,165,460,0,5440
"15003008007",250,39,30,0,5616,109,187,0,6231
"15003008301",2011,234,568,60,2491,205,982,137,6688
"15003008302",406,33,49,0,5728,863,523,76,7678
"15003008402",545,61,36,25,5333,991,782,222,7995
"15003008405",722,0,82,0,3439,99,457,28,4827
"15003008406",1302,29,511,0,4640,115,612,0,7209
"15003008407",1058,46,623,24,1682,177,368,41,4019
"15003008408",2965,59,361,85,3156,0,932,35,7593
"15003008410",781,17,162,0,2602,64,515,6,4147
"15003008411",499,61,130,0,2348,93,327,60,3518
"15003008412",1079,85,44,13,4577,150,912,68,6928
"15003008502",833,128,116,28,1290,618,237,192,3442
"15003008606",1083,105,449,0,9075,328,1084,0,12124
"15003008609",627,26,33,0,1279,33,189,33,2220
"15003008610",808,10,25,0,218,27,63,0,1151
"15003008611",36,0,0,0,24,64,12,0,136
"15003008612",1922,111,138,21,3724,144,803,0,6863
"15003008613",103,14,0,0,869,132,36,0,1154
"15003008614",1614,57,894,0,7209,341,952,80,11147
"15003008617",570,139,141,0,9671,255,1952,0,12728
"15003008622",752,46,34,0,3343,91,330,0,4596
"15003008701",323,30,29,28,7731,481,741,30,9393
"15003008702",157,9,0,0,5508,655,468,44,6841
"15003008703",524,59,0,16,4429,1702,809,116,7655
"15003008800",284,104,0,15,7769,752,161,137,9222
"15003008906",791,78,37,0,2996,152,307,0,4361
"15003008907",777,58,154,7,3162,363,689,187,5397
"15003008908",1046,34,19,0,4649,57,544,0,6349
"15003008909",849,25,127,0,2609,266,550,64,4490
"15003008912",15,40,0,0,2182,163,105,6,2511
"15003008913",169,8,0,0,4214,175,508,0,5074
"15003008914",206,88,193,50,3547,1118,265,270,5737
"15003008915",930,74,142,0,3077,738,471,74,5506
"15003008917",714,8,49,0,3382,44,226,0,4423
"15003008918",911,134,105,0,4210,183,435,175,6153
"15003008920",527,49,84,0,3288,350,477,89,4864
"15003008921",159,45,24,0,2135,126,381,14,2884
"15003008922",940,0,400,0,6368,78,581,28,8395
"15003008923",580,0,86,57,3681,92,452,0,4948
"15003008924",962,0,12,19,6659,113,371,18,8154
"15003008925",791,15,296,0,5102,229,366,15,6814
"15003008926",688,52,245,7,718,66,41,0,1817
"15003008927",778,8,95,0,4104,64,227,0,5276
"15003008928",586,0,40,0,3553,0,519,0,4698
"15003008929",523,0,172,0,3950,107,569,0,5321
"15003008930",523,0,10,0,1775,5,6,0,2319
"15003008931",320,34,32,0,2527,43,103,16,3075
"15003009000",1413,279,318,40,584,38,515,68,3255
"15003009100",372,45,89,0,4284,492,378,38,5698
"15003009200",721,87,0,0,5855,428,639,169,7899
"15003009300",527,153,124,9,3290,703,293,59,5158
"15003009400",701,150,180,17,3399,1052,466,79,6044
"15003009501",3369,247,1115,0,1464,150,1817,164,8326
"15003009502",3135,265,906,173,712,121,973,121,6406
"15003009503",410,33,137,20,189,0,108,14,911
"15003009504",1105,61,111,0,136,12,198,0,1623
"15003009507",1362,147,520,32,423,159,433,49,3125
"15003009603",1164,338,65,30,5539,1817,1129,223,10305
"15003009608",446,61,15,0,4049,941,912,480,6904
"15003009701",511,177,55,27,3111,2687,759,565,7892
"15003009703",293,66,93,0,5201,1072,521,248,7494
"15003009704",233,72,3,0,2828,471,266,79,3952
"15003009801",687,156,99,70,859,431,196,141,2639
"15003009802",642,317,10,110,4339,1414,1051,681,8564
"15003009902",916,110,38,11,2110,244,488,31,3948
"15003009904",2069,269,35,0,2854,226,672,76,6201
"15003010000",2310,152,490,0,816,160,551,46,4525
"15003010100",3343,321,94,0,4313,461,455,82,9069
"15003010201",1432,158,36,8,2916,432,572,88,5642
"15003010202",1315,204,62,0,3641,522,323,37,6104
"15003010303",687,99,44,0,3426,350,302,11,4919
"15003010305",861,70,0,0,2881,614,877,0,5303
"15003010306",1357,187,64,0,4637,126,596,0,6967
"15003010308",443,55,0,0,2596,35,35,4,3168
"15003010503",145,6,33,0,1330,79,68,11,1672
"15003010504",512,59,63,0,3727,322,508,9,5200
"15003010505",816,19,0,0,2190,29,192,0,3246
"15003010507",1269,101,14,0,3688,505,853,130,6560
"15003010508",1141,71,54,0,1347,84,207,28,2932
"15003010601",493,37,30,0,2420,217,192,1,3390
"15003010602",709,47,71,0,4126,155,356,65,5529
"15003010701",1599,92,0,0,2362,41,68,0,4162
"15003010702",838,43,35,0,2074,135,91,6,3222
"15003010801",1568,56,68,0,706,132,430,62,3022
"15003010802",4034,285,440,0,607,141,721,136,6364
"15003010901",1991,104,0,0,1163,0,190,0,3448
"15003010903",1110,253,73,0,2773,132,380,14,4735
"15003010904",1571,197,41,4,1421,103,229,33,3599
"15003010905",754,82,46,0,1453,114,340,21,2810
"15003011000",1307,16,26,0,2068,50,185,0,3652
"15003011103",1090,13,18,0,2432,85,115,27,3780
"15003011104",1699,123,0,6,2741,102,422,3,5096
"15003011105",1882,107,109,14,1194,2,145,32,3485
"15003011106",2090,106,12,0,3767,57,290,0,6322
"15003011201",3080,186,0,0,1172,57,356,4,4855
"15003011202",961,83,0,0,574,22,54,6,1700
"15003011300",657,133,16,0,3972,1357,303,247,6685
"15003011400",1304,62,169,0,659,181,281,7,2663
"15003011500",792,67,449,0,6002,246,1538,50,9144
"15003940001",480,34,0,0,3592,354,339,40,4839
"15003940002",155,77,31,19,5653,1178,731,196,8040
"15003980000",0,0,0,0,0,0,0,0,0
"15003980200",0,0,0,0,0,0,0,0,0
"15003980300",0,0,0,0,0,0,0,0,0
"15003980600",87,0,0,0,0,0,0,0,87
"15003980700",0,0,0,0,0,0,0,0,0
"15003980800",0,0,0,0,0,0,0,0,0
"15003981000",0,0,0,0,0,0,0,0,0
"15003981100",16,0,0,0,0,0,0,0,16
"15003981200",0,0,0,0,0,0,0,0,0
"15003981300",0,0,0,0,0,0,0,0,0
"15003981400",0,0,0,0,0,0,0,0,0
"15003990001",0,0,0,0,0,0,0,0,0
"15005031900",29,2,0,0,38,10,3,0,82
"15005990000",0,0,0,0,0,0,0,0,0
"15007040103",3941,549,34,0,1781,207,383,54,6949
"15007040104",390,73,0,0,206,37,34,0,740
"15007040204",2444,230,23,0,2902,200,318,7,6124
"15007040205",1292,161,10,0,2294,172,339,121,4389
"15007040300",2660,265,182,0,4372,924,794,235,9432
"15007040400",1214,215,40,34,8030,468,1095,15,11111
"15007040500",1608,217,45,7,4489,796,484,18,7664
"15007040603",956,79,8,0,1576,230,362,41,3252
"15007040604",1257,140,5,0,1450,269,311,84,3516
"15007040700",2285,242,4,0,5231,710,1330,162,9964
"15007040800",683,73,0,4,3002,160,565,12,4499
"15007040900",1048,75,10,7,3413,289,232,17,5091
"15007041200",0,0,0,0,0,0,0,0,0
"15007940000",679,230,1,16,1945,305,203,93,3472
"15007990100",0,0,0,0,0,0,0,0,0
"15007990200",0,0,0,0,0,0,0,0,0
"15007990300",0,0,0,0,0,0,0,0,0
"15009030100",487,87,0,0,1091,176,51,0,1892
"15009030201",1304,203,0,0,577,82,68,125,2359
"15009030202",3983,421,19,65,2856,306,478,91,8219
"15009030301",4488,658,12,20,3848,550,527,223,10326
"15009030303",2428,254,19,1,712,209,144,19,3786
"15009030402",2737,427,0,0,5274,239,942,0,9619
"15009030403",1267,197,2,0,1834,167,299,0,3766
"15009030404",1166,595,11,0,3079,575,692,130,6248
"15009030501",1197,108,0,0,1186,85,106,24,2706
"15009030705",895,95,9,0,2657,192,701,140,4689
"15009030706",844,211,26,32,1147,316,131,274,2981
"15009030707",4990,438,108,0,3570,188,1616,2,10912
"15009030708",1343,230,14,0,1304,26,356,58,3331
"15009030709",2078,371,66,0,1053,33,231,68,3900
"15009030710",1259,245,0,0,350,233,44,224,2355
"15009030800",1616,131,11,0,5555,236,710,47,8306
"15009030901",216,317,32,12,1611,414,118,90,2810
"15009030902",397,38,22,2,2298,436,408,114,3715
"15009030903",591,62,53,0,5488,500,603,112,7409
"15009031000",2168,197,0,0,6039,555,1085,254,10298
"15009031101",677,315,0,153,6641,931,1026,305,10048
"15009031102",648,65,0,0,4650,298,496,61,6218
"15009031103",733,9,14,0,6554,503,222,34,8069
"15009031402",779,50,0,20,2103,90,197,20,3259
"15009031404",1612,234,0,23,1314,156,293,22,3654
"15009031405",737,203,6,0,4392,346,364,6,6054
"15009031501",1031,93,0,0,1153,40,110,0,2427
"15009031502",3019,46,32,12,1356,57,603,18,5143
"15009031503",1536,237,0,41,611,11,391,113,2940
"15009031601",402,13,24,11,2748,304,483,36,4021
"15009031700",821,33,0,2,2837,600,246,77,4616
"15009031801",270,30,7,11,1924,572,179,28,3021
"15009031900",598,67,41,24,3849,811,343,36,5769
"15009032000",673,33,7,0,141,9,41,3,907
"15009980000",0,0,0,0,0,0,0,0,0
"15009990000",0,0,0,0,0,0,0,0,0
"15009990200",0,0,0,0,0,0,0,0,0
"15009991200",0,0,0,0,0,0,0,0,0
"16001000100",2086,1323,0,9,255,219,135,185,4212
"16001000201",2682,300,33,0,65,0,41,0,3121
"16001000202",4912,199,71,0,247,79,248,27,5783
"16001000302",2619,343,10,0,277,68,103,80,3500
"16001000303",1327,263,23,0,54,95,118,128,2008
"16001000304",5130,618,264,72,570,39,401,0,7094
"16001000400",3761,1241,56,0,395,148,261,196,6058
"16001000500",4691,835,44,0,285,44,218,155,6272
"16001000600",4603,527,9,12,264,0,534,30,5979
"16001000701",3937,229,0,21,207,67,141,20,4622
"16001000702",2505,62,23,0,230,0,67,7,2894
"16001000802",4626,555,24,0,372,24,239,57,5897
"16001000803",3689,301,111,30,373,61,110,0,4675
"16001000804",4342,1216,193,107,726,51,136,14,6785
"16001000805",2771,85,0,0,243,0,88,0,3187
"16001000900",2344,1635,39,50,278,305,505,131,5287
"16001001000",4632,1383,42,0,619,140,327,109,7252
"16001001100",2386,1243,19,0,221,375,633,599,5476
"16001001201",2789,319,16,0,211,68,179,40,3622
"16001001202",4817,979,129,202,321,168,588,66,7270
"16001001400",2738,1223,0,0,543,359,343,425,5631
"16001001500",2736,740,0,0,22,54,107,186,3845
"16001001600",3304,698,0,0,319,136,174,37,4668
"16001001700",3712,1071,0,190,396,81,488,100,6038
"16001001800",3283,686,38,7,231,91,126,18,4480
"16001001900",3689,795,59,0,272,86,244,137,5282
"16001002000",2630,643,65,332,154,267,558,138,4787
"16001002100",1881,86,0,0,149,15,117,4,2252
"16001002221",7244,868,4,59,491,14,146,284,9110
"16001002222",4485,521,76,0,631,107,276,140,6236
"16001002223",4598,73,0,0,197,15,149,0,5032
"16001002224",5343,397,107,0,593,40,420,0,6900
"16001002302",7212,1469,170,0,714,67,1612,245,11489
"16001002310",8507,992,0,64,1148,146,1243,336,12436
"16001002312",4093,530,132,0,330,145,527,173,5930
"16001002313",2928,538,32,0,450,67,342,215,4572
"16001002410",6216,242,25,0,437,0,570,0,7490
"16001002411",4357,465,0,0,311,22,206,171,5532
"16001002412",3214,452,0,0,55,22,117,25,3885
"16001002413",7395,703,0,164,512,157,552,145,9628
"16001010100",5454,146,46,0,315,10,133,0,6104
"16001010201",9053,515,68,0,239,166,532,136,10709
"16001010221",6208,196,0,0,314,0,236,1,6955
"16001010223",5569,600,19,0,314,0,298,38,6838
"16001010224",4316,33,0,0,115,68,31,25,4588
"16001010225",7659,762,0,0,401,69,293,175,9359
"16001010313",19638,628,105,50,458,231,1127,106,22343
"16001010321",5852,671,19,0,356,135,809,147,7989
"16001010322",5329,1255,104,0,59,168,849,36,7800
"16001010331",17804,1249,107,0,1151,327,422,0,21060
"16001010332",11506,1188,54,0,1067,339,757,409,15320
"16001010333",9150,972,691,0,351,27,509,154,11854
"16001010334",5453,554,38,0,238,79,490,1,6853
"16001010335",20377,1874,79,1,1089,190,1389,268,25267
"16001010401",16671,4036,0,0,1270,104,1368,1,23450
"16001010402",9507,681,38,0,705,361,573,119,11984
"16001010501",1953,272,0,0,79,40,219,28,2591
"16001010503",3657,110,0,0,699,11,228,0,4705
"16001010504",6066,335,66,0,738,89,560,31,7885
"16003950100",1211,176,0,0,87,0,110,0,1584
"16003950200",2028,302,0,0,27,17,7,3,2384
"16005000200",3458,226,10,0,108,0,20,0,3822
"16005000300",7102,1407,0,11,496,213,787,46,10062
"16005000400",4631,465,9,0,340,6,272,41,5764
"16005000500",1738,114,0,0,59,0,63,27,2001
"16005000600",2210,808,0,0,192,219,30,73,3532
"16005000700",2408,582,7,28,82,70,161,45,3383
"16005000800",879,1188,45,62,202,195,201,194,2966
"16005000900",1238,1065,0,57,86,53,78,67,2644
"16005001000",2492,645,12,0,149,84,219,80,3681
"16005001101",6664,406,0,0,351,49,661,61,8192
"16005001102",2544,601,115,0,216,96,265,145,3982
"16005001200",2228,724,37,0,117,0,195,43,3344
"16005001300",2089,236,12,0,149,92,385,69,3032
"16005001400",2577,869,6,22,333,167,271,73,4318
"16005001500",4418,1065,0,0,235,60,194,132,6104
"16005001601",1589,801,8,11,176,52,265,171,3073
"16005001602",2469,830,59,0,191,74,149,92,3864
"16005001603",1815,500,0,0,78,76,9,64,2542
"16005001700",3015,127,10,0,141,0,114,0,3407
"16005001900",3953,550,16,4,98,27,94,7,4749
"16005940000",674,72,0,0,1300,230,170,93,2539
"16005981800",197,39,0,0,0,10,0,0,246
"16007950100",2806,473,0,9,75,103,66,91,3623
"16007950200",2194,169,19,0,34,5,83,5,2509
"16009940000",2883,543,21,8,629,411,175,59,4729
"16009950100",3843,515,0,13,116,0,33,13,4533
"16011940000",261,117,0,0,1732,626,202,80,3018
"16011950100",7160,641,42,0,386,10,823,0,9062
"16011950200",3046,367,0,0,260,17,297,45,4032
"16011950300",4234,542,0,0,650,150,1182,398,7156
"16011950400",5363,799,4,0,431,4,740,358,7699
"16011950500",5661,1006,54,0,441,141,1160,285,8748
"16011950600",4413,734,4,9,357,109,1009,495,7130
"16011950700",4137,540,0,20,335,261,677,244,6214
"16013960100",4026,447,0,0,284,122,523,347,5749
"16013960200",7573,934,6,0,1371,60,2672,324,12940
"16013960300",3078,321,1,0,136,1,173,90,3800
"16013960500",2380,328,6,0,170,5,74,159,3122
"16015950200",5601,911,26,8,221,72,154,85,7078
"16017950100",1448,421,0,0,75,11,8,18,1981
"16017950200",7564,862,37,0,327,34,255,0,9079
"16017950300",2685,610,0,0,55,36,102,53,3541
"16017950400",5287,1156,0,0,126,68,179,14,6830
"16017950500",2624,651,0,0,139,2,127,0,3543
"16017950600",1641,238,0,0,152,0,67,0,2098
"16017950700",3829,558,0,0,221,25,8,0,4641
"16017950800",4245,873,26,0,241,55,8,0,5448
"16017950900",3293,516,0,0,110,29,195,0,4143
"16019970100",4565,383,2,0,39,3,141,0,5133
"16019970300",5810,601,0,0,245,86,331,100,7173
"16019970401",1981,175,42,0,282,19,190,12,2701
"16019970402",3495,281,0,0,15,4,130,55,3980
"16019970403",8539,744,136,0,1592,753,2133,653,14550
"16019970501",6843,421,42,0,524,45,805,135,8815
"16019970502",4252,409,27,0,373,89,320,66,5536
"16019970503",4574,198,7,0,154,54,311,43,5341
"16019970601",2352,333,0,0,212,50,435,60,3442
"16019970602",3622,975,34,0,468,314,376,357,6146
"16019970603",1731,243,9,0,24,4,117,35,2163
"16019970700",3284,581,0,0,120,763,519,704,5971
"16019970800",2923,762,0,44,64,6,135,90,4024
"16019970900",3995,470,18,0,197,11,154,124,4969
"16019971000",4325,662,0,0,318,30,521,121,5977
"16019971100",2512,478,0,56,168,49,207,41,3511
"16019971200",2654,848,22,0,482,283,617,274,5180
"16019971301",5537,824,10,0,292,345,888,148,8044
"16019971302",3845,392,20,11,377,202,449,172,5468
"16019971400",7302,582,0,0,622,70,805,8,9389
"16019971500",1254,267,0,0,49,105,86,154,1915
"16021970100",4591,630,0,2,119,125,123,70,5660
"16021970200",4069,872,24,0,343,18,213,7,5546
"16023970100",2068,359,52,0,33,101,137,25,2775
"16025970100",786,197,0,0,37,32,78,41,1171
"16027020100",518,340,11,0,88,14,95,35,1101
"16027020200",1980,1446,25,7,382,299,975,981,6095
"16027020300",2767,1284,10,0,502,278,1206,526,6573
"16027020401",5491,2075,215,0,1132,380,2721,797,12811
"16027020402",3505,1148,88,0,172,375,727,383,6398
"16027020501",2672,652,0,5,209,72,577,155,4342
"16027020503",2480,472,5,0,296,28,174,51,3506
"16027020504",2833,2106,0,0,113,372,434,556,6414
"16027020601",4293,929,0,0,398,13,676,229,6538
"16027020602",4426,1944,14,0,554,306,1273,873,9390
"16027020700",3127,161,0,0,110,17,303,41,3759
"16027020901",10003,1743,0,0,909,38,2216,151,15060
"16027020902",11408,1854,0,0,1268,152,2072,180,16934
"16027021001",11225,1564,32,0,1050,221,3815,862,18769
"16027021002",7761,1116,33,0,388,329,1268,978,11873
"16027021100",12783,1540,32,0,1167,211,2137,346,18216
"16027021200",4518,975,0,0,964,639,1932,1065,10093
"16027021300",846,1125,7,16,148,98,589,860,3689
"16027021500",2413,1173,31,59,409,107,609,400,5201
"16027021600",2608,978,15,6,203,180,695,516,5201
"16027021700",9491,2119,114,22,317,0,4015,1208,17286
"16027021800",4971,532,0,0,228,32,870,134,6767
"16027021901",4409,662,0,0,431,174,384,212,6272
"16027021903",8431,999,0,0,311,51,460,0,10252
"16027021904",2475,1147,0,0,145,39,621,939,5366
"16027022100",3676,905,0,0,484,58,964,313,6400
"16027022200",4039,796,0,0,295,215,1257,461,7063
"16027022300",4927,901,0,0,183,15,1000,309,7335
"16027022400",3921,415,30,0,62,16,127,214,4785
"16029960100",3533,303,7,0,70,18,217,97,4245
"16029960200",2488,230,0,0,0,0,33,2,2753
"16031950100",2697,450,0,0,104,0,375,127,3753
"16031950200",2705,145,7,0,260,99,506,99,3821
"16031950300",3513,898,30,0,279,5,616,426,5767
"16031950400",2553,933,7,0,306,129,1408,563,5899
"16031950500",4407,464,0,0,84,153,660,333,6101
"16031950600",2021,314,0,0,224,55,646,183,3443
"16033950100",709,146,0,0,29,17,288,85,1274
"16035940000",3611,603,3,0,249,48,100,12,4626
"16035970100",2623,280,3,0,38,54,30,35,3063
"16037960200",3289,796,0,0,95,10,100,10,4300
"16039960100",2090,297,0,0,51,120,349,92,2999
"16039960200",6749,972,65,0,501,668,664,780,10399
"16039960300",2449,595,93,0,280,261,257,127,4062
"16039960400",5422,869,155,0,724,114,1258,300,8842
"16039960500",1828,102,222,0,428,48,135,7,2770
"16041970100",5063,521,0,10,231,155,208,174,6362
"16041970200",5817,999,0,0,57,11,272,228,7384
"16043970100",1068,146,0,0,41,0,15,0,1270
"16043970200",2712,415,22,14,109,155,337,236,4000
"16043970300",6671,506,10,0,374,30,674,159,8424
"16045960100",3349,559,0,0,152,19,125,22,4226
"16045960200",3966,1065,0,0,224,93,272,59,5679
"16045960300",5418,1244,0,0,454,0,453,381,7950
"16047960100",4807,1360,0,0,706,283,1398,669,9223
"16047960200",5826,951,11,0,738,317,1886,403,10132
"16049940000",3285,649,0,0,352,231,98,59,4674
"16049960100",1559,402,0,0,90,11,61,0,2123
"16049960200",5259,881,1,0,84,0,102,58,6385
"16049960300",1384,211,3,6,90,31,0,40,1765
"16049960400",1131,106,0,0,7,0,18,0,1262
"16051960100",2771,539,20,13,218,128,803,390,4882
"16051960200",3381,468,0,0,259,90,222,82,4502
"16051960300",6151,1011,19,0,224,34,64,272,7775
"16051960400",9680,913,0,0,471,296,677,239,12276
"16053970100",2621,355,2,17,128,71,737,161,4092
"16053970200",3510,496,0,0,219,34,1485,290,6034
"16053970300",3472,1063,0,0,390,119,976,326,6346
"16053970400",1926,747,0,0,362,145,1134,693,5007
"16053970500",5776,606,0,0,320,23,1538,94,8357
"16055000100",5168,818,0,0,232,70,174,18,6480
"16055000200",7469,737,10,0,156,240,166,11,8789
"16055000301",4812,525,25,1,291,40,251,55,6000
"16055000302",5047,1349,32,0,216,117,294,194,7249
"16055000401",4711,791,13,0,488,53,388,68,6512
"16055000402",6328,787,42,0,460,0,178,30,7825
"16055000500",10143,1261,22,4,268,15,382,26,12121
"16055000601",4119,301,0,0,21,37,242,45,4765
"16055000602",4245,1222,0,81,147,172,161,90,6118
"16055000700",13745,1153,0,0,1441,53,924,3,17319
"16055000800",3788,362,28,19,306,8,108,2,4621
"16055000900",2860,1448,0,0,284,51,70,40,4753
"16055001001",6033,304,39,27,113,53,64,0,6633
"16055001002",3523,711,0,0,106,0,80,15,4435
"16055001100",1866,139,0,0,51,3,63,0,2122
"16055001200",5192,1030,58,0,66,74,126,68,6614
"16055001300",3488,804,0,4,175,19,485,0,4975
"16055001400",2044,409,31,0,118,30,111,10,2753
"16055001500",2420,532,0,0,88,66,140,40,3286
"16055001600",2078,643,0,25,56,61,2,14,2879
"16055001700",4222,308,11,0,206,0,266,0,5013
"16055001800",7793,510,15,0,109,26,218,0,8671
"16055001900",2098,405,35,0,45,1,53,14,2651
"16055002000",3120,269,0,0,161,56,45,67,3718
"16055940000",1806,153,0,0,436,257,56,50,2758
"16057005100",5168,2499,0,0,366,270,87,290,8680
"16057005200",5207,724,0,0,280,139,109,0,6459
"16057005300",4853,1350,16,80,90,141,307,92,6929
"16057005400",1994,1111,35,25,157,116,50,61,3549
"16057005500",3338,381,2,0,118,2,22,2,3865
"16057005600",3014,334,11,0,192,3,104,0,3658
"16057005700",2556,365,4,4,109,53,70,4,3165
"16059970100",2137,326,0,0,109,0,49,5,2626
"16059970200",1950,772,27,0,27,22,41,25,2864
"16059970300",1899,254,0,0,70,56,81,20,2380
"16061940001",1226,335,3,0,176,112,73,27,1952
"16061940002",1590,178,0,0,80,27,40,6,1921
"16061950300",23,0,0,0,0,0,0,0,23
"16063950100",4085,526,0,0,408,183,1280,274,6756
"16065950100",5030,510,0,0,138,32,474,61,6245
"16065950200",1957,1400,0,0,215,132,218,76,3998
"16065950301",843,3056,0,78,51,296,11,68,4403
"16065950302",6549,5150,83,0,141,128,313,283,12647
"16065950400",4389,1476,79,0,32,222,144,191,6533
"16065950500",4343,713,12,0,18,39,411,173,5709
"16067970100",2517,402,0,0,413,147,972,197,4648
"16067970200",3813,955,1,0,173,90,1211,400,6643
"16067970300",2609,226,9,5,135,108,643,127,3862
"16067970400",3022,534,32,9,333,90,981,231,5232
"16067970500",3161,685,0,2,361,248,1534,430,6421
"16069940000",2381,388,16,11,1628,441,329,88,5282
"16069960200",288,20,0,0,25,0,0,0,333
"16069960300",3038,894,13,30,293,153,47,20,4488
"16069960400",2658,294,0,0,190,128,176,82,3528
"16069960500",2824,290,23,0,90,0,26,34,3287
"16069960600",4026,484,0,0,116,18,0,18,4662
"16069960700",4735,277,5,0,137,43,88,0,5285
"16069960800",3204,323,16,0,188,0,118,68,3917
"16069960900",2674,444,10,0,92,75,93,37,3425
"16069961000",5193,259,17,0,171,9,82,1,5732
"16071960100",3498,585,0,0,99,30,89,60,4361
"16073950101",2452,1201,0,0,254,275,678,803,5663
"16073950102",2452,591,0,0,90,86,345,399,3963
"16073950200",2543,695,0,0,337,243,328,401,4547
"16075960100",4007,1237,0,0,327,79,696,477,6823
"16075960200",2138,900,0,20,153,183,526,250,4170
"16075960300",6943,786,77,0,387,40,1016,258,9507
"16075960400",3864,889,0,0,213,18,347,27,5358
"16077960100",1420,180,3,0,271,37,89,70,2070
"16077960200",4357,567,22,0,552,250,1899,363,8010
"16079960200",3451,514,21,0,41,37,119,0,4183
"16079960300",2598,765,19,0,227,67,96,42,3814
"16079960400",3684,684,0,0,137,41,48,96,4690
"16081960100",8459,1032,13,11,696,67,1439,353,12070
"16083000200",5253,636,0,0,293,123,542,112,6959
"16083000300",4518,561,0,0,151,21,686,185,6122
"16083000400",3053,717,9,0,209,194,759,312,5253
"16083000500",4394,610,12,0,162,67,151,151,5547
"16083000600",2522,347,2,0,93,0,115,0,3079
"16083000700",9352,1937,62,0,597,110,589,886,13533
"16083000800",5129,911,0,0,193,26,741,133,7133
"16083000900",4090,329,89,40,242,41,146,51,5028
"16083001000",6201,1611,0,0,636,454,1078,438,10418
"16083001100",2071,679,140,35,333,95,282,148,3783
"16083001200",5516,1151,0,0,676,196,1614,583,9736
"16083001300",6804,881,0,0,189,15,881,239,9009
"16083001400",884,131,0,0,44,8,249,85,1401
"16083001500",2277,486,11,0,21,6,413,126,3340
"16085970100",2468,368,0,0,78,3,13,0,2930
"16085970200",2254,157,0,1,31,0,41,0,2484
"16085970300",3276,905,0,0,39,0,72,3,4295
"16087970100",1229,227,0,0,56,29,29,0,1570
"16087970200",2925,636,0,0,154,103,504,200,4522
"16087970300",3511,767,0,0,167,36,781,164,5426
"17001000100",3864,389,92,9,204,0,219,0,4777
"17001000201",1468,320,34,22,54,0,14,0,1912
"17001000202",2034,400,43,0,131,38,60,0,2706
"17001000400",1997,733,267,109,40,32,9,0,3187
"17001000500",1363,270,197,249,35,0,38,0,2152
"17001000600",3085,359,21,104,42,5,0,0,3616
"17001000700",563,343,102,0,0,101,0,0,1109
"17001000800",1327,872,136,292,87,58,49,82,2903
"17001000900",1705,663,18,115,102,0,0,0,2603
"17001001001",3253,385,34,24,41,0,16,21,3774
"17001001002",2745,393,94,0,153,0,92,0,3477
"17001001100",6679,634,89,41,346,228,28,3,8048
"17001010100",3792,415,3,0,7,15,46,23,4301
"17001010200",2908,397,0,0,73,31,40,0,3449
"17001010300",5520,438,33,1,34,1,73,0,6100
"17001010400",2980,226,0,0,6,0,23,0,3235
"17001010500",2900,25,36,26,53,0,0,0,3040
"17001010600",5085,625,80,27,101,18,44,14,5994
"17003957600",1272,598,177,47,67,8,1,0,2170
"17003957700",1316,313,118,99,30,8,24,42,1950
"17003957800",542,83,404,624,20,34,3,18,1728
"17003957900",255,87,401,494,63,29,3,7,1339
"17005951200",2346,343,107,31,21,8,0,0,2856
"17005951300",3683,1041,156,47,254,16,21,183,5401
"17005951400",2764,336,52,0,11,16,10,71,3260
"17005951500",3618,705,3,23,94,27,112,9,4591
"17007010100",4334,1540,110,122,1705,423,2194,1277,11705
"17007010200",5038,439,0,0,283,24,1068,141,6993
"17007010300",4853,851,124,0,586,192,912,242,7760
"17007010400",5767,359,152,0,727,30,1097,59,8191
"17007010500",8234,312,479,16,662,0,704,67,10474
"17007010601",3212,378,4,0,300,120,695,169,4878
"17007010602",10339,1032,125,0,514,3,2275,35,14323
"17009970400",2537,187,0,0,224,28,56,0,3032
"17009970500",1745,334,47,11,78,5,0,0,2220
"17011964700",2638,212,2,0,85,13,24,0,2974
"17011964800",3092,390,0,0,7,11,161,2,3663
"17011964900",2210,234,21,1,14,10,19,0,2509
"17011965000",3002,327,1,7,340,150,1155,220,5202
"17011965100",3330,366,43,0,270,19,401,141,4570
"17011965200",2575,478,69,18,226,21,253,51,3691
"17011965300",2655,601,3,0,31,4,5,0,3299
"17011965400",2760,478,0,0,168,35,177,5,3623
"17011965500",3236,455,0,0,63,6,103,20,3883
"17011965600",2465,345,7,0,58,10,71,1,2957
"17013951200",2138,344,0,0,14,46,8,0,2550
"17013951300",2031,212,0,3,27,1,3,3,2280
"17015960100",2942,322,21,0,161,3,145,0,3594
"17015960200",1757,296,0,0,26,0,0,0,2079
"17015960300",2233,539,49,86,141,0,239,32,3319
"17015960400",1795,212,6,0,51,0,16,0,2080
"17015960500",2298,203,7,1,40,24,21,1,2595
"17015960600",1300,157,9,0,0,0,35,0,1501
"17017960100",2164,179,36,0,46,4,54,0,2483
"17017960200",2074,213,14,0,66,22,100,2,2491
"17017960300",2579,68,124,19,93,2,371,16,3272
"17017960400",1709,471,123,4,169,114,597,231,3418
"17017960500",1747,481,62,56,363,55,811,247,3822
"17019000200",217,86,690,415,74,0,55,0,1537
"17019000301",498,2788,0,367,132,733,105,206,4829
"17019000302",237,1021,105,26,587,1435,111,157,3679
"17019000401",151,899,8,15,29,151,30,8,1291
"17019000402",417,2368,20,220,43,451,34,219,3772
"17019000500",2348,636,190,148,312,228,118,0,3980
"17019000700",1482,362,686,497,255,168,715,213,4378
"17019000800",1802,376,1055,752,1804,38,185,186,6198
"17019000901",1237,468,1222,1103,182,258,49,295,4814
"17019000902",4470,464,879,241,574,162,94,89,6973
"17019001000",3000,206,109,648,259,158,43,0,4423
"17019001100",3387,125,232,10,199,14,244,83,4294
"17019001201",3347,379,956,764,913,185,476,0,7020
"17019001203",3568,242,303,114,429,66,36,39,4797
"17019001204",2888,50,66,0,849,0,77,0,3930
"17019001205",4096,210,390,77,1168,316,294,99,6650
"17019001206",1561,14,76,0,113,0,16,0,1780
"17019001301",4826,301,267,64,403,84,82,95,6122
"17019001302",2942,128,180,12,455,77,110,0,3904
"17019001400",2107,425,83,94,942,191,185,118,4145
"17019005300",814,1268,1246,697,447,1770,33,207,6482
"17019005401",2316,579,170,488,307,79,289,377,4605
"17019005402",2369,562,92,0,273,0,182,49,3527
"17019005500",3322,362,523,176,419,74,53,0,4929
"17019005600",3490,520,1116,716,535,46,289,0,6712
"17019005701",2669,439,154,361,557,297,131,13,4621
"17019005702",2026,266,377,203,160,20,18,0,3070
"17019005800",2125,1018,63,157,372,189,307,10,4241
"17019005900",293,846,133,184,188,553,9,125,2331
"17019006000",259,124,20,7,469,418,9,14,1320
"17019010100",2580,683,563,268,470,132,557,109,5362
"17019010204",2395,928,517,315,359,36,247,440,5237
"17019010300",1708,434,881,372,195,39,223,9,3861
"17019010400",3935,421,79,44,69,16,119,35,4718
"17019010500",4138,305,5,0,48,3,11,0,4510
"17019010601",5693,371,0,0,21,0,307,0,6392
"17019010603",5854,579,315,0,326,43,127,14,7258
"17019010604",1938,348,78,45,148,44,35,5,2641
"17019010700",7495,309,0,2,277,1,53,42,8179
"17019010800",4113,382,24,0,60,14,74,0,4667
"17019010900",8473,858,149,102,281,34,360,67,10324
"17019011000",2465,481,159,332,290,17,168,17,3929
"17019011100",628,465,11,12,589,600,117,190,2612
"17021958100",2404,326,5,1,15,0,20,0,2771
"17021958200",3166,547,0,0,124,36,149,0,4022
"17021958300",3699,353,0,0,0,0,0,0,4052
"17021958400",3024,630,8,6,54,0,0,5,3727
"17021958500",1961,580,23,0,39,52,27,0,2682
"17021958600",1911,311,14,0,10,8,46,68,2368
"17021958700",2724,350,2,4,187,0,18,2,3287
"17021958800",2213,619,0,0,14,0,14,0,2860
"17021958900",1851,628,0,73,53,0,0,0,2605
"17021959000",4035,190,4,0,14,0,98,0,4341
"17023060100",4154,463,6,0,200,0,92,0,4915
"17023060200",2973,945,0,6,53,6,11,8,4002
"17023060300",4455,663,14,0,91,8,60,21,5312
"17023060400",1581,269,4,0,0,0,4,0,1858
"17025971900",2203,200,0,0,9,0,120,0,2532
"17025972000",2327,281,6,15,17,1,0,0,2647
"17025972100",4147,804,6,23,38,130,0,0,5148
"17025972200",2674,383,0,2,28,0,56,8,3151
"17027900100",5704,268,0,13,112,24,85,28,6234
"17027900200",1961,133,7,4,9,0,3,0,2117
"17027900300",6191,442,0,0,201,0,208,0,7042
"17027900401",1192,76,0,0,14,11,74,0,1367
"17027900402",4113,644,105,74,127,62,152,0,5277
"17027900500",4513,700,63,10,108,59,53,0,5506
"17027900601",2321,79,0,0,31,0,28,0,2459
"17027900602",5855,385,58,121,114,88,174,46,6841
"17029000100",2408,566,0,0,28,5,77,3,3087
"17029000200",5544,545,69,0,27,0,114,0,6299
"17029000300",3680,543,19,43,49,16,60,0,4410
"17029000400",1720,609,25,0,34,32,0,6,2426
"17029000500",4357,1718,2,28,202,78,45,15,6445
"17029000600",3335,226,15,0,59,10,26,3,3674
"17029000700",3596,2104,179,272,270,138,229,50,6838
"17029000800",580,778,68,240,93,195,41,29,2024
"17029000900",3597,482,84,91,129,17,66,6,4472
"17029001000",2745,512,9,6,96,43,37,52,3500
"17029001100",2382,635,95,84,55,34,36,11,3332
"17029001200",2537,850,0,3,55,48,22,24,3539
"17031010100",1676,442,953,585,215,116,197,269,4453
"17031010201",2575,808,1755,1532,484,62,1395,595,9206
"17031010202",779,205,324,258,297,125,375,177,2540
"17031010300",2472,379,834,441,786,199,839,67,6017
"17031010400",2126,479,515,57,327,119,291,49,3963
"17031010501",1881,617,890,145,242,53,206,28,4062
"17031010502",1235,719,421,188,367,396,370,138,3834
"17031010503",950,461,116,82,188,236,321,25,2379
"17031010600",3428,457,1489,202,350,475,1246,527,8174
"17031010701",2266,161,605,101,532,334,1196,345,5540
"17031010702",2082,1105,615,382,520,448,1207,1202,7561
"17031020100",1475,158,715,483,919,149,465,51,4415
"17031020200",3441,609,751,59,1342,432,535,133,7302
"17031020301",3660,473,273,58,623,32,292,141,5552
"17031020302",2818,195,375,176,514,392,737,92,5299
"17031020400",2393,330,463,224,810,287,837,36,5380
"17031020500",1891,570,727,390,1359,607,1124,387,7055
"17031020601",3131,984,346,27,1472,362,153,496,6971
"17031020602",1582,390,128,255,1111,626,647,342,5081
"17031020701",993,59,10,6,408,159,189,17,1841
"17031020702",3645,1052,220,70,2299,401,839,507,9033
"17031020801",2277,967,135,1,1317,63,855,584,6199
"17031020802",2232,742,441,0,2641,1441,818,305,8620
"17031020901",1675,679,652,426,1264,308,773,734,6511
"17031020902",1772,643,471,206,639,199,359,113,4402
"17031030101",1792,549,613,130,449,80,417,280,4310
"17031030102",1342,249,530,107,548,53,367,65,3261
"17031030103",606,335,351,13,509,6,301,17,2138
"17031030104",668,297,114,185,335,258,94,87,2038
"17031030200",4139,378,57,110,249,35,658,169,5795
"17031030300",1753,381,325,9,353,410,684,573,4488
"17031030400",1428,463,186,162,285,108,530,312,3474
"17031030500",4068,850,268,50,749,48,1068,675,7776
"17031030601",1744,479,751,206,332,84,92,190,3878
"17031030603",626,209,452,231,201,265,137,34,2155
"17031030604",1340,234,483,119,442,292,89,7,3006
"17031030701",700,191,164,67,200,220,99,117,1758
"17031030702",997,86,113,21,234,6,25,0,1482
"17031030703",1652,241,395,60,314,74,230,0,2966
"17031030706",1846,230,342,394,611,155,180,65,3823
"17031030800",2823,197,67,26,846,78,450,62,4549
"17031030900",2160,39,310,53,617,9,525,9,3722
"17031031000",2744,184,179,7,641,29,438,58,4280
"17031031100",2881,256,60,114,1107,13,978,19,5428
"17031031200",1896,535,749,701,465,431,330,144,5251
"17031031300",2505,623,1713,732,1400,381,520,190,8064
"17031031400",3596,229,344,95,523,72,492,46,5397
"17031031501",1074,603,352,879,374,371,121,45,3819
"17031031502",1311,244,1013,794,394,271,268,12,4307
"17031031700",3293,884,537,1022,540,323,463,371,7433
"17031031800",1324,257,33,6,126,16,237,136,2135
"17031031900",1747,261,40,45,191,77,136,184,2681
"17031032100",4503,960,427,134,523,119,536,168,7370
"17031040100",2692,488,262,37,277,81,588,273,4698
"17031040201",4326,423,202,3,1009,351,1097,237,7648
"17031040202",3393,927,136,0,1482,675,1032,308,7953
"17031040300",1714,91,65,3,849,107,271,0,3100
"17031040401",2162,117,105,0,455,170,416,167,3592
"17031040402",3396,307,181,36,1043,79,894,133,6069
"17031040600",2365,143,38,32,92,26,422,35,3153
"17031040700",2696,159,38,27,328,135,658,71,4112
"17031040800",1385,67,0,0,281,38,161,4,1936
"17031040900",1832,105,2,2,211,0,80,34,2266
"17031050100",2193,65,83,0,207,16,425,10,2999
"17031050200",4531,123,137,0,413,26,942,11,6183
"17031050300",1824,242,0,17,410,6,472,94,3065
"17031050500",4749,117,34,20,621,0,552,0,6093
"17031050600",1839,274,57,0,194,7,161,35,2567
"17031050700",1476,13,0,12,78,8,78,0,1665
"17031050800",1224,61,5,8,62,30,122,30,1542
"17031050900",1283,92,0,0,152,19,109,9,1664
"17031051000",1355,66,11,19,188,38,315,11,2003
"17031051100",1201,99,7,7,140,0,195,48,1697
"17031051200",1308,57,108,13,116,0,208,0,1810
"17031051300",2491,62,39,14,171,17,196,0,2990
"17031051400",1297,181,48,0,340,7,299,9,2181
"17031060100",2182,142,173,46,96,36,286,37,2998
"17031060200",1554,328,25,44,127,10,275,209,2572
"17031060300",2920,106,37,0,185,0,179,0,3427
"17031060400",3148,254,26,0,380,40,371,28,4247
"17031060500",840,159,26,37,86,94,130,26,1398
"17031060800",3759,231,238,15,672,65,220,15,5215
"17031060900",5325,423,278,0,739,84,996,50,7895
"17031061000",1422,122,27,0,99,104,193,5,1972
"17031061100",1145,183,33,0,66,15,12,20,1474
"17031061200",1691,244,17,14,153,3,86,22,2230
"17031061500",1588,131,14,0,110,0,112,25,1980
"17031061800",698,140,50,16,115,55,96,6,1176
"17031061901",2826,247,63,26,650,30,342,37,4221
"17031061902",3029,342,87,44,465,48,120,24,4159
"17031062000",2332,201,142,17,268,43,103,13,3119
"17031062100",2867,353,44,35,228,68,186,9,3790
"17031062200",2095,259,113,0,202,8,108,0,2785
"17031062300",1371,67,7,0,166,0,66,0,1677
"17031062400",1337,30,28,0,116,6,68,11,1596
"17031062500",1146,99,0,0,134,4,37,44,1464
"17031062600",1828,57,34,0,392,6,243,41,2601
"17031062700",2138,409,5,5,266,37,146,35,3041
"17031062800",2963,229,57,6,236,9,152,32,3684
"17031062900",3328,443,97,0,340,9,148,0,4365
"17031063000",2305,262,113,13,313,144,232,77,3459
"17031063100",2028,125,18,0,233,50,87,19,2560
"17031063200",5067,549,223,21,565,429,140,81,7075
"17031063301",1706,430,155,47,198,101,191,15,2843
"17031063302",3145,367,32,0,675,0,214,0,4433
"17031063303",987,50,31,0,92,6,86,0,1252
"17031063400",1504,202,50,69,109,24,98,25,2081
"17031070101",3133,444,67,13,394,35,78,0,4164
"17031070102",2083,211,108,30,201,73,304,18,3028
"17031070103",1258,183,53,24,100,11,59,34,1722
"17031070200",2955,427,122,28,423,27,228,17,4227
"17031070300",2426,466,34,13,361,126,95,29,3550
"17031070400",2788,207,108,73,118,121,205,64,3684
"17031070500",2535,107,78,7,145,26,103,26,3027
"17031070600",2985,110,42,0,61,20,321,13,3552
"17031070700",3123,358,47,192,458,43,368,281,4870
"17031071000",1782,334,36,3,82,4,0,27,2268
"17031071100",1972,254,46,0,162,9,100,0,2543
"17031071200",1588,247,8,55,192,28,170,34,2322
"17031071300",2955,167,51,13,235,25,50,0,3496
"17031071400",3367,458,90,185,404,75,220,71,4870
"17031071500",4625,234,103,56,770,19,216,74,6097
"17031071600",1328,87,61,56,115,19,31,12,1709
"17031071700",1277,43,209,93,196,1,120,0,1939
"17031071800",2004,32,381,105,192,0,119,0,2833
"17031080100",5902,417,277,0,482,0,342,0,7420
"17031080201",2838,166,166,0,114,13,0,13,3310
"17031080202",3062,192,49,17,320,24,91,0,3755
"17031080300",3571,357,208,159,396,42,217,7,4957
"17031080400",1498,232,573,2339,349,8,68,51,5118
"17031081000",3518,759,398,295,821,373,335,188,6687
"17031081100",2556,371,165,225,362,87,175,90,4031
"17031081201",3185,160,74,0,474,163,210,87,4353
"17031081202",2639,61,16,8,281,0,157,0,3162
"17031081300",3708,322,183,0,887,132,242,0,5474
"17031081401",1513,255,335,0,300,35,45,0,2483
"17031081402",3240,219,272,0,866,161,181,41,4980
"17031081403",5056,193,204,28,1826,136,510,28,7981
"17031081500",2860,232,90,15,1096,96,124,0,4513
"17031081600",2117,377,129,0,643,93,149,0,3508
"17031081700",2157,133,115,0,772,57,126,45,3405
"17031081800",6023,404,152,25,721,0,288,14,7627
"17031081900",436,15,213,154,214,16,24,5,1077
"17031090100",2982,68,0,0,216,0,351,0,3617
"17031090200",6419,82,120,0,128,18,669,0,7436
"17031090300",1214,49,0,0,56,4,39,4,1366
"17031100100",4508,414,0,1,354,8,397,106,5788
"17031100200",5400,211,164,1,380,88,612,123,6979
"17031100300",4410,487,0,10,576,19,412,23,5937
"17031100400",2749,137,0,1,174,0,316,30,3407
"17031100500",4635,19,16,4,943,0,706,4,6327
"17031100600",4250,245,36,15,518,61,740,143,6008
"17031100700",3647,375,8,2,629,105,557,59,5382
"17031110100",4602,333,0,0,872,213,1023,280,7323
"17031110200",2104,143,40,17,648,103,608,22,3685
"17031110300",4040,243,44,0,753,177,901,130,6288
"17031110400",3381,215,17,8,828,6,1122,0,5577
"17031110501",3528,283,31,2,973,19,1178,38,6052
"17031110502",2331,463,44,43,411,292,601,310,4495
"17031120100",3321,94,0,1,364,20,118,11,3929
"17031120200",3683,57,108,0,771,0,433,18,5070
"17031120300",4709,193,55,13,1366,11,583,76,7006
"17031120400",2287,131,0,0,992,261,784,181,4636
"17031130100",3192,436,39,28,1096,161,414,17,5383
"17031130200",1207,92,15,8,280,18,256,0,1876
"17031130300",2308,461,182,37,2169,169,966,126,6418
"17031140100",1403,649,124,207,700,560,908,971,5522
"17031140200",1908,571,74,87,1716,415,2139,557,7467
"17031140301",814,185,48,7,1291,453,1247,442,4487
"17031140302",1716,221,126,22,1199,641,1192,468,5585
"17031140400",3699,542,11,0,2917,150,1523,470,9312
"17031140500",2015,393,87,88,1486,283,1759,314,6425
"17031140601",966,88,23,12,1414,448,1520,223,4694
"17031140602",2119,448,272,71,1762,684,2594,892,8842
"17031140701",1141,275,96,11,966,153,1000,248,3890
"17031140702",3260,678,180,215,1159,565,3084,1002,10143
"17031140800",4280,418,196,75,1405,202,1799,333,8708
"17031150200",4811,574,112,4,1459,458,1676,282,9376
"17031150300",4937,703,227,37,2136,257,2986,126,11409
"17031150401",3572,367,53,0,801,172,795,275,6035
"17031150402",2464,185,0,1,956,34,1435,64,5139
"17031150501",2804,249,118,4,568,164,1089,51,5047
"17031150502",2587,352,17,7,1426,305,1759,159,6612
"17031150600",2604,314,0,0,1073,121,1516,167,5795
"17031150700",3100,548,18,0,809,93,1735,383,6686
"17031150800",2887,322,69,9,1914,211,2783,388,8583
"17031151001",1007,509,112,7,563,173,741,536,3648
"17031151002",2265,185,0,15,1404,289,2138,384,6680
"17031151100",2827,594,8,2,1718,261,2422,480,8312
"17031151200",2509,327,8,0,686,11,1240,86,4867
"17031160100",1703,121,12,1,773,73,624,69,3376
"17031160200",2550,68,72,0,548,22,784,0,4044
"17031160300",2145,525,140,125,638,132,835,83,4623
"17031160400",2769,858,164,47,775,482,1432,957,7484
"17031160501",2722,538,106,0,1158,138,2617,628,7907
"17031160502",2837,313,51,12,798,228,2500,393,7132
"17031160601",2915,515,2,4,926,21,2305,364,7052
"17031160602",2606,319,83,0,834,114,1601,172,5729
"17031160700",3490,778,303,5,1397,27,1558,582,8140
"17031160800",3703,403,17,0,1267,20,2702,267,8379
"17031160900",1823,145,23,1,391,0,551,23,2957
"17031161000",1265,189,12,2,234,15,530,99,2346
"17031161100",1525,76,43,0,267,8,351,64,2334
"17031161200",1939,202,18,0,566,87,1541,158,4511
"17031161300",2972,500,29,57,285,12,2153,349,6357
"17031170100",1394,221,41,0,82,0,155,34,1927
"17031170200",2963,372,0,0,768,63,1450,259,5875
"17031170300",3433,503,0,0,649,341,1018,487,6431
"17031170400",2813,603,51,0,131,5,300,47,3950
"17031170500",4242,400,166,13,412,12,954,70,6269
"17031170600",2156,79,41,107,394,41,538,60,3416
"17031170700",2015,400,8,0,432,37,487,175,3554
"17031170800",3163,287,12,0,272,20,775,122,4651
"17031170900",1244,100,73,0,167,129,428,119,2260
"17031171000",6131,470,242,169,785,45,2437,23,10302
"17031171100",2944,387,86,0,682,59,1327,165,5650
"17031180100",3510,438,105,16,1307,317,2783,455,8931
"17031190100",817,174,22,16,1118,478,1629,567,4821
"17031190200",1914,374,16,100,2479,708,3627,892,10110
"17031190300",2885,458,65,10,1657,294,2819,554,8742
"17031190401",2457,339,0,0,1008,320,2028,371,6523
"17031190402",2479,531,74,18,1828,248,3212,694,9084
"17031190601",1858,449,308,11,1435,596,2831,920,8408
"17031190602",1959,153,28,4,2464,501,3611,560,9280
"17031190701",1393,150,18,67,1091,262,1873,382,5236
"17031190702",2034,624,178,126,1713,811,3223,1205,9914
"17031190800",1915,310,28,41,3365,1080,4507,1136,12382
"17031190900",517,59,86,0,953,401,1320,448,3784
"17031191000",893,397,82,23,927,420,1706,812,5260
"17031191100",1791,796,245,19,3687,1020,5184,1718,14460
"17031191200",819,310,46,1,1770,991,2420,1235,7592
"17031191301",1083,623,309,94,2809,759,3709,1315,10701
"17031191302",2103,490,437,31,1952,412,3912,892,10229
"17031200100",2002,241,128,0,2304,377,3440,476,8968
"17031200200",1406,380,80,28,2101,813,3053,1123,8984
"17031200300",471,371,23,0,1187,347,1497,697,4593
"17031200401",1423,200,77,0,1661,740,2900,924,7925
"17031200402",1042,289,34,16,2114,642,2956,915,8008
"17031210100",2005,564,90,10,582,165,1182,231,4829
"17031210400",1958,663,68,5,229,123,1530,699,5275
"17031210501",2847,775,125,0,432,83,2387,576,7225
"17031210502",3009,1400,79,39,296,82,2333,1007,8245
"17031210601",1737,397,71,1,453,92,1684,335,4770
"17031210602",2836,891,48,112,326,36,1936,834,7019
"17031210700",2865,788,28,0,408,56,1980,500,6625
"17031210800",807,60,5,2,195,6,569,35,1679
"17031210900",2060,537,140,0,377,27,986,483,4610
"17031220300",1780,190,88,7,276,40,636,118,3135
"17031220400",2053,160,0,0,314,26,698,78,3329
"17031220500",2091,307,156,26,144,32,513,193,3462
"17031220601",1171,302,164,5,121,11,672,259,2705
"17031220602",2776,1102,177,38,501,90,834,1026,6544
"17031220701",1862,814,172,15,371,82,1527,714,5557
"17031220702",2557,485,205,126,436,274,2407,521,7011
"17031220901",1160,882,63,179,522,363,1317,1072,5558
"17031220902",2148,717,28,0,350,6,2113,605,5967
"17031221000",1641,697,212,11,309,121,1384,768,5143
"17031221100",2890,816,197,397,531,154,1787,667,7439
"17031221200",2143,289,126,7,491,107,1254,227,4644
"17031221300",1724,321,53,94,385,94,734,234,3639
"17031221400",2347,374,63,0,188,62,1432,338,4804
"17031221500",1869,329,107,0,246,59,899,231,3740
"17031221600",2318,202,86,0,328,26,601,28,3589
"17031222200",1741,62,37,29,220,9,148,7,2253
"17031222500",1014,213,96,43,64,62,675,255,2422
"17031222600",1079,199,77,5,241,24,641,115,2381
"17031222700",1665,580,200,131,135,52,1105,587,4455
"17031222800",608,360,81,8,24,65,569,420,2135
"17031222900",487,172,74,0,83,0,502,135,1453
"17031230100",493,84,188,192,440,156,550,210,2313
"17031230200",544,125,340,104,654,367,1053,459,3646
"17031230300",267,108,15,28,598,165,807,222,2210
"17031230400",1032,109,60,29,924,305,1802,392,4653
"17031230500",781,215,131,159,1488,849,2138,1021,6782
"17031230600",945,314,1327,1128,1863,1092,2382,1373,10424
"17031230700",1040,304,356,342,2517,593,3398,858,9408
"17031230800",456,27,97,25,472,161,845,192,2275
"17031230900",1444,217,671,649,1344,971,2202,1044,8542
"17031231100",303,24,511,211,40,138,233,155,1615
"17031231200",308,144,1824,1249,1102,675,1307,810,7419
"17031231500",151,93,4136,2281,94,272,74,281,7382
"17031240200",1212,138,9,11,125,12,202,70,1779
"17031240300",1129,50,0,0,156,0,86,0,1421
"17031240500",1749,78,0,9,239,6,239,0,2320
"17031240600",1019,235,115,16,71,23,282,197,1958
"17031240700",769,244,52,120,165,33,295,244,1922
"17031240800",928,363,113,44,215,68,767,396,2894
"17031240900",583,49,52,73,326,180,574,157,1994
"17031241000",891,182,273,269,197,115,647,281,2855
"17031241100",2160,483,313,75,606,374,856,556,5423
"17031241200",1184,178,47,114,307,65,260,151,2306
"17031241300",1294,86,78,20,92,178,177,205,2130
"17031241400",3381,454,297,354,700,139,221,343,5889
"17031241500",2176,253,23,65,245,129,310,202,3403
"17031241600",2485,437,56,23,556,41,770,230,4598
"17031242000",2651,471,439,279,1015,65,1376,278,6574
"17031242100",2779,135,89,32,412,62,656,43,4208
"17031242200",2718,470,54,84,318,37,546,324,4551
"17031242300",2517,138,105,17,319,44,413,44,3597
"17031242400",2373,185,48,20,216,0,162,18,3022
"17031242500",2650,350,103,56,608,243,1126,461,5597
"17031242600",3552,456,501,681,816,468,1568,340,8382
"17031242700",741,210,219,220,242,119,427,274,2452
"17031242800",1032,168,8,1,134,17,255,18,1633
"17031242900",1091,117,115,9,293,31,316,78,2050
"17031243000",1653,182,33,36,555,13,846,179,3497
"17031243100",1723,277,108,8,543,0,946,206,3811
"17031243200",1598,255,12,0,343,29,655,176,3068
"17031243300",1831,230,67,12,234,63,494,232,3163
"17031243400",1929,159,142,62,477,150,948,182,4049
"17031243500",2223,137,188,149,318,25,238,37,3315
"17031250200",431,104,1187,409,414,271,763,382,3961
"17031250300",254,14,2492,815,360,861,460,817,6073
"17031250400",314,18,2871,1237,456,375,693,426,6390
"17031250500",3430,537,2143,396,884,215,1813,187,9605
"17031250600",110,0,3320,654,204,63,259,63,4673
"17031250700",28,0,3366,2003,183,0,208,113,5901
"17031250800",108,26,1311,440,225,238,295,224,2867
"17031251000",123,16,661,260,60,0,179,0,1299
"17031251100",35,6,2338,1492,374,108,381,131,4865
"17031251200",70,6,2953,760,130,351,60,351,4681
"17031251300",361,90,2824,1204,290,102,552,121,5544
"17031251400",124,35,2875,1238,49,0,74,2,4397
"17031251500",113,34,2321,1168,50,139,180,148,4153
"17031251600",76,12,2124,1068,237,89,189,80,3875
"17031251700",51,35,625,508,110,149,130,184,1792
"17031251800",33,145,3237,1679,0,0,0,136,5230
"17031251900",18,23,2765,2479,117,39,117,62,5620
"17031252000",99,55,3978,2038,7,0,70,22,6269
"17031252101",21,0,1164,356,121,0,95,0,1757
"17031252102",0,0,4584,1774,0,0,0,0,6358
"17031252201",0,0,1531,1012,6,0,6,0,2555
"17031252202",127,10,3301,1599,0,23,88,23,5171
"17031260100",34,58,417,499,6,0,7,0,1021
"17031260200",25,0,623,557,0,0,34,0,1239
"17031260300",16,10,935,476,48,0,48,0,1533
"17031260400",0,12,582,938,0,0,0,0,1532
"17031260500",3,6,1094,642,0,49,0,48,1842
"17031260600",23,66,999,1058,38,0,9,8,2201
"17031260700",28,0,733,1104,135,10,110,10,2130
"17031260800",17,0,1240,1192,4,0,0,0,2453
"17031260900",31,76,873,506,0,28,0,66,1580
"17031261000",3,0,1324,1040,19,0,9,0,2395
"17031270500",16,28,697,931,34,99,0,113,1918
"17031271200",30,17,623,555,0,29,0,29,1283
"17031271300",7,4,600,568,4,0,0,4,1187
"17031271400",25,18,597,520,0,25,0,0,1185
"17031271500",20,16,695,649,14,11,5,11,1421
"17031271800",11,0,485,849,0,0,0,0,1345
"17031280100",5336,202,250,35,860,128,353,0,7164
"17031280400",71,17,694,869,48,4,5,9,1717
"17031280800",52,0,505,340,18,8,22,8,953
"17031280900",105,13,317,402,51,0,43,0,931
"17031281900",2028,299,320,42,1524,675,360,53,5301
"17031282700",561,145,907,559,300,77,658,80,3287
"17031282800",627,72,336,38,345,99,340,37,1894
"17031283100",629,219,933,285,436,415,94,7,3018
"17031283200",408,240,265,264,406,19,57,9,1668
"17031283800",1164,99,938,572,576,65,286,78,3778
"17031290900",0,31,1901,1792,12,0,0,12,3748
"17031291200",56,9,1347,1055,0,0,0,0,2467
"17031291600",257,140,153,0,256,53,491,110,1460
"17031292200",131,5,1451,1323,24,8,86,0,3028
"17031292400",109,2,913,986,5,0,32,0,2047
"17031292500",64,0,2400,1496,150,33,71,121,4335
"17031300500",1520,680,99,64,759,151,2175,831,6279
"17031300600",1283,648,243,156,880,106,2066,744,6126
"17031300700",1494,1699,0,41,1043,633,2481,2332,9723
"17031300800",1590,1087,0,20,1059,493,2636,1580,8465
"17031300900",1411,1396,86,12,619,609,1938,1994,8065
"17031301100",978,631,26,72,682,567,1604,1193,5753
"17031301200",1150,670,251,35,808,471,1713,1101,6199
"17031301600",2126,1143,0,104,719,563,2844,1703,9202
"17031301701",2085,1255,2,0,288,294,2284,1548,7756
"17031301702",1645,1168,0,0,1169,284,2733,1452,8451
"17031301801",2047,918,0,82,842,191,2777,1072,7929
"17031301802",1241,771,9,11,940,175,2130,932,6209
"17031301803",1855,1438,0,111,1667,203,3445,1612,10331
"17031310200",784,189,71,19,411,47,592,191,2304
"17031310300",702,102,16,17,570,260,808,210,2685
"17031310400",661,63,50,27,357,174,708,201,2241
"17031310500",759,241,8,0,433,119,1026,333,2919
"17031310600",1597,1097,327,74,1314,726,2318,1434,8887
"17031310700",570,245,13,47,452,113,789,257,2486
"17031310800",1997,534,10,1,1729,238,3278,694,8481
"17031310900",1926,940,95,19,1447,607,2924,1490,9448
"17031320100",7676,451,517,1,1590,612,937,158,11942
"17031320400",715,23,8,12,158,55,21,7,999
"17031320600",2565,205,559,355,925,168,188,0,4965
"17031330100",8461,513,3122,843,4470,350,1270,0,19029
"17031330200",1622,94,919,172,695,204,81,24,3811
"17031340300",351,37,10,16,925,444,54,17,1854
"17031340400",136,39,0,2,1155,673,73,1,2079
"17031340500",870,120,46,39,176,378,196,13,1838
"17031340600",0,2,317,573,24,1,0,2,919
"17031350100",142,8,832,160,379,420,54,8,2003
"17031350400",0,20,471,1071,28,57,32,21,1700
"17031351000",123,65,2399,501,459,562,0,0,4109
"17031351100",28,16,466,1410,9,17,0,0,1946
"17031351400",93,20,524,967,28,19,0,0,1651
"17031351500",37,62,193,21,78,56,0,10,457
"17031360200",3,0,782,724,35,0,0,0,1544
"17031380100",60,10,1035,764,10,27,0,0,1906
"17031380200",73,26,1014,576,9,88,9,58,1853
"17031380500",2,2,422,405,3,3,0,2,839
"17031380700",104,7,595,235,19,6,10,1,977
"17031381200",60,0,1455,349,136,10,22,0,2032
"17031381400",6,0,1139,610,0,0,6,0,1761
"17031381500",25,7,126,84,5,5,13,0,265
"17031381700",0,0,0,0,0,0,0,0,0
"17031381800",30,1,608,371,173,19,154,8,1364
"17031381900",104,0,879,339,17,0,24,6,1369
"17031390100",55,0,1224,119,90,3,79,0,1570
"17031390200",154,40,1008,312,107,0,20,1,1642
"17031390300",154,9,1325,991,67,15,17,0,2578
"17031390400",218,59,1551,782,62,0,72,0,2744
"17031390500",323,38,828,146,116,14,62,5,1532
"17031390600",736,45,675,123,243,37,75,23,1957
"17031390700",1079,403,2709,96,818,659,193,120,6077
"17031400300",92,0,675,519,25,7,66,7,1391
"17031400400",0,0,1070,705,0,0,19,0,1794
"17031400500",0,0,1054,1291,6,13,0,0,2364
"17031400800",0,0,1287,1732,97,48,0,0,3164
"17031410100",480,109,698,154,237,118,185,65,2046
"17031410200",360,142,113,79,223,131,36,18,1102
"17031410500",625,180,910,371,263,147,91,62,2649
"17031410600",773,386,593,148,199,98,69,32,2298
"17031410700",888,340,424,79,268,63,45,25,2132
"17031410800",882,270,938,295,748,145,328,62,3668
"17031410900",1158,317,626,300,318,154,154,181,3208
"17031411000",1466,146,879,142,213,91,147,47,3131
"17031411100",1248,139,89,16,345,36,26,9,1908
"17031411200",844,173,187,21,303,126,21,19,1694
"17031420100",46,0,721,525,26,11,26,0,1355
"17031420200",199,13,889,410,69,0,0,0,1580
"17031420300",118,100,647,328,99,83,46,21,1442
"17031420400",227,37,251,561,153,78,62,15,1384
"17031420500",0,12,969,831,93,58,118,0,2081
"17031420600",5,108,710,1282,0,24,15,13,2157
"17031420700",48,51,1668,1684,0,46,1,1,3499
"17031420800",125,1,1196,927,38,6,90,6,2389
"17031421200",0,0,1120,588,14,16,14,16,1768
"17031430101",40,56,2435,1182,334,8,8,48,4111
"17031430102",45,3,1894,1016,97,9,67,1,3132
"17031430200",108,2,2949,1812,65,4,0,2,4942
"17031430300",5,0,1140,972,7,5,0,0,2129
"17031430400",8,20,1541,1669,77,47,0,26,3388
"17031430500",50,3,1746,1553,61,7,75,11,3506
"17031430600",64,0,1025,452,72,6,4,0,1623
"17031430700",37,43,1267,829,19,86,10,10,2301
"17031430800",29,20,1134,433,47,0,4,0,1667
"17031430900",0,18,856,525,12,0,0,0,1411
"17031431200",25,1,2513,573,106,0,61,0,3279
"17031431301",57,15,1790,1048,85,0,5,5,3005
"17031431302",45,2,2353,1354,154,43,105,40,4096
"17031431400",159,138,3187,2055,117,18,72,81,5827
"17031440101",39,23,2292,1426,104,68,127,0,4079
"17031440102",14,17,1767,1185,20,16,16,0,3035
"17031440201",74,28,3455,1557,15,41,58,13,5241
"17031440202",13,7,2591,1000,78,0,40,0,3729
"17031440300",126,20,3814,589,35,0,0,0,4584
"17031440600",27,0,1512,439,9,0,12,0,1999
"17031440700",19,0,1192,410,27,2,0,0,1650
"17031440800",0,0,943,653,3,20,0,20,1639
"17031440900",0,2,1872,501,68,11,0,0,2454
"17031450300",0,0,3052,727,18,8,0,0,3805
"17031460100",570,54,1917,968,197,27,521,225,4479
"17031460200",750,211,532,799,157,48,817,257,3571
"17031460301",554,38,1141,607,166,89,709,121,3425
"17031460302",61,32,1884,1475,167,0,141,10,3770
"17031460400",66,11,2386,578,21,0,21,0,3083
"17031460500",80,45,3776,731,117,0,40,0,4789
"17031460600",200,54,502,174,18,0,114,39,1101
"17031460700",661,171,380,1023,137,180,751,302,3605
"17031461000",389,311,422,481,121,63,522,325,2634
"17031470100",0,0,1672,929,0,0,0,0,2601
"17031480100",54,0,1947,80,10,4,0,0,2095
"17031480200",0,0,900,284,19,0,0,0,1203
"17031480300",21,5,866,276,33,0,75,3,1279
"17031480400",122,26,5478,545,83,47,44,28,6373
"17031480500",231,75,2183,355,82,0,229,63,3218
"17031490300",25,0,1697,380,111,20,28,22,2283
"17031490400",0,0,872,34,23,0,0,0,929
"17031490500",0,5,1785,199,21,0,64,5,2079
"17031490600",4,8,1263,158,0,0,0,1,1434
"17031490700",30,0,1888,754,11,11,0,0,2694
"17031490800",37,10,2804,917,63,23,28,0,3882
"17031490901",76,84,3151,1055,57,0,0,11,4434
"17031490902",38,6,4123,922,57,0,0,6,5152
"17031491000",9,19,2577,2129,13,1,0,0,4748
"17031491100",27,10,3426,860,85,0,22,52,4482
"17031491200",13,0,1557,646,70,0,19,0,2305
"17031491300",7,66,939,1151,35,15,25,45,2283
"17031491400",15,38,1387,973,23,0,46,2,2484
"17031500100",11,22,2339,688,24,0,17,0,3101
"17031500200",22,8,1307,585,27,14,9,8,1980
"17031500300",659,128,391,88,137,19,463,54,1939
"17031510100",1742,227,328,153,500,215,2198,409,5772
"17031510200",462,98,1600,287,0,153,328,211,3139
"17031510300",32,18,4525,1278,54,64,0,12,5983
"17031520100",1141,522,150,44,186,108,1259,610,4020
"17031520200",2300,1110,61,270,130,226,2033,1362,7492
"17031520300",3655,1276,18,134,615,235,3641,1366,10940
"17031520400",3023,202,215,27,707,49,3289,202,7714
"17031520500",3605,525,0,25,372,38,2672,314,7551
"17031520600",2113,337,0,0,329,46,1925,319,5069
"17031530100",588,275,555,395,176,145,774,341,3249
"17031530200",0,0,2523,2121,8,23,0,0,4675
"17031530300",86,10,3349,1104,48,0,38,0,4635
"17031530400",23,0,1573,343,18,23,18,4,2002
"17031530501",26,43,2966,1605,43,0,13,0,4696
"17031530502",10,0,997,455,0,5,0,0,1467
"17031530503",11,26,3618,1681,49,15,21,26,5447
"17031530600",10,79,1574,1192,13,0,9,79,2956
"17031540101",94,32,1049,2545,17,30,112,74,3953
"17031540102",23,54,1276,1832,18,8,18,0,3229
"17031550100",3954,1103,501,112,242,256,2071,848,9087
"17031550200",2453,108,0,0,205,6,1248,76,4096
"17031560100",552,119,49,32,432,36,798,112,2130
"17031560200",277,49,884,226,98,7,283,0,1824
"17031560300",1750,145,111,0,1243,173,1892,241,5555
"17031560400",900,199,15,0,390,0,818,155,2477
"17031560700",2510,217,10,2,687,75,1836,148,5485
"17031560800",4593,155,16,21,1246,33,3043,100,9207
"17031560900",4118,325,33,1,854,1,1550,127,7009
"17031561000",4411,130,40,0,472,219,1780,218,7270
"17031561100",4736,177,0,0,736,14,2249,66,7978
"17031570100",642,144,0,4,393,54,696,126,2059
"17031570200",1200,121,13,0,421,90,1219,166,3230
"17031570300",2921,461,11,0,1825,731,3680,1016,10645
"17031570400",808,177,12,2,682,97,1274,235,3287
"17031570500",1127,257,91,0,923,20,1404,244,4066
"17031580100",1143,505,12,1,1071,311,1594,623,5260
"17031580200",965,342,23,79,1159,413,1761,538,5280
"17031580300",822,274,73,0,1061,151,1662,385,4428
"17031580400",1954,278,48,182,1060,376,2315,552,6765
"17031580501",2456,837,117,72,1280,703,3272,1420,10157
"17031580502",2562,622,0,28,1269,822,3186,1267,9756
"17031580600",2893,536,0,72,1717,332,4297,734,10581
"17031580700",2783,1372,186,0,1350,379,3713,1654,11437
"17031580800",742,597,0,5,438,64,1087,630,3563
"17031590500",652,223,36,10,560,291,582,257,2611
"17031590600",1476,244,28,0,1700,420,1981,614,6463
"17031590700",1373,490,45,95,960,376,1636,680,5655
"17031600400",1643,121,8,39,2303,964,626,323,6027
"17031600600",804,521,30,53,1231,308,663,516,4126
"17031600700",907,292,103,50,861,141,635,39,3028
"17031600900",1599,286,344,43,1148,242,869,336,4867
"17031610300",2537,1202,163,61,1365,488,3564,1609,10989
"17031610400",616,573,0,23,503,325,1090,868,3998
"17031610800",1192,254,17,0,155,0,305,73,1996
"17031611000",266,108,196,268,42,51,259,156,1346
"17031611100",801,673,158,113,299,267,1043,918,4272
"17031611200",1183,306,154,258,226,289,1289,539,4244
"17031611300",1180,388,153,137,459,378,1641,729,5065
"17031611400",1088,833,0,82,956,446,1936,1207,6548
"17031611500",1286,543,122,67,629,234,1832,736,5449
"17031611600",224,32,634,480,150,80,335,112,2047
"17031611700",318,163,460,115,59,152,362,315,1944
"17031611800",119,422,786,407,310,487,399,828,3758
"17031611900",228,50,808,767,107,0,287,0,2247
"17031612000",5,1,848,565,90,14,104,0,1627
"17031612100",76,16,669,299,0,33,27,8,1128
"17031620100",1632,633,0,10,1704,601,2619,1186,8385
"17031620200",1575,275,9,0,470,83,1399,321,4132
"17031620300",3546,652,64,145,2440,480,4610,912,12849
"17031620400",2184,225,7,43,1863,461,3585,664,9032
"17031630100",538,88,108,51,154,106,700,188,1933
"17031630200",737,295,55,23,626,355,1284,589,3964
"17031630300",2322,563,0,16,2356,467,4527,871,11122
"17031630400",2266,838,5,0,2798,1252,4625,2072,13856
"17031630500",1925,558,125,25,3168,562,4921,1054,12338
"17031630800",2309,946,122,141,3404,645,5580,1524,14671
"17031630900",1312,216,77,1,2893,758,4048,933,10238
"17031640100",690,28,0,61,530,33,849,33,2224
"17031640300",4300,247,0,0,2403,67,3126,134,10277
"17031640400",2645,121,0,0,902,151,1344,183,5346
"17031640500",2654,143,55,1,461,74,1197,163,4748
"17031640600",2624,494,0,0,676,549,1224,686,6253
"17031640700",1937,173,0,23,859,229,1689,312,5222
"17031640800",892,184,6,0,613,108,1254,157,3214
"17031650100",1242,448,10,54,2307,454,3222,786,8523
"17031650200",3900,868,66,32,2305,482,4771,1206,13630
"17031650301",2901,357,0,2,2319,219,4213,543,10554
"17031650302",1624,204,172,0,1780,332,2972,511,7595
"17031650400",2339,353,336,61,3039,447,4502,738,11815
"17031650500",1891,215,219,115,1439,208,2539,383,7009
"17031660301",169,54,131,513,733,388,897,316,3201
"17031660302",819,411,482,286,2761,857,3406,1210,10232
"17031660400",2013,182,170,47,2813,1071,4581,1171,12048
"17031660500",1157,712,307,380,2307,475,3188,1157,9683
"17031660600",528,276,2119,1584,1235,272,1427,513,7954
"17031660700",59,43,1209,956,120,11,31,24,2453
"17031660800",460,27,1818,972,1552,797,1794,824,8244
"17031660900",243,43,2091,1569,156,264,237,11,4614
"17031661000",244,0,3541,1399,317,0,254,0,5755
"17031661100",1351,261,2088,715,1375,435,2439,660,9324
"17031670100",15,58,708,467,45,0,55,0,1348
"17031670200",42,0,399,388,0,39,42,39,949
"17031670300",17,30,617,430,0,91,0,100,1285
"17031670400",17,0,756,692,54,75,66,75,1735
"17031670500",3,56,572,314,65,62,62,108,1242
"17031670600",24,2,771,572,77,10,92,10,1558
"17031670700",29,0,900,409,18,9,66,0,1431
"17031670800",15,0,807,921,0,0,15,0,1758
"17031670900",16,5,1004,456,8,17,8,12,1526
"17031671100",4,0,582,851,0,0,0,0,1437
"17031671200",0,0,458,538,9,24,0,0,1029
"17031671300",1,0,1260,628,85,11,73,0,2058
"17031671400",23,0,1086,682,0,18,23,38,1870
"17031671500",83,21,1520,1134,63,173,132,115,3241
"17031671600",10,24,1237,581,128,50,98,50,2178
"17031671800",0,0,665,420,124,51,8,51,1319
"17031671900",4,0,928,253,5,0,4,0,1194
"17031672000",8,0,2970,624,145,0,111,0,3858
"17031680500",0,44,434,750,0,40,0,40,1308
"17031680600",0,15,619,776,18,16,0,0,1444
"17031680900",0,22,1549,1535,34,33,17,8,3198
"17031681000",23,1,1465,1466,0,92,0,83,3130
"17031681100",5,20,1679,1608,23,81,21,96,3533
"17031681200",0,0,1266,962,115,81,98,26,2548
"17031681300",0,0,1325,735,134,61,101,28,2384
"17031681400",0,0,1919,705,0,0,0,0,2624
"17031690300",0,16,931,1067,4,18,0,0,2036
"17031690400",19,22,2247,1270,53,13,52,20,3696
"17031690500",0,0,455,319,0,4,0,0,778
"17031690900",0,62,2508,1831,30,0,52,0,4483
"17031691000",24,12,1990,539,9,25,9,0,2608
"17031691100",12,12,1769,1375,12,81,30,18,3309
"17031691200",82,15,1561,1250,64,132,0,0,3104
"17031691300",8,12,1979,569,11,0,16,0,2595
"17031691400",0,0,2062,626,22,10,9,10,2739
"17031691500",0,21,1082,654,5,18,13,18,1811
"17031700100",392,7,1887,301,308,349,476,349,4069
"17031700200",1926,317,913,17,3147,465,4082,639,11506
"17031700301",2884,353,576,102,1512,724,3270,967,10388
"17031700302",3049,221,576,342,937,189,2188,351,7853
"17031700401",1088,238,3415,250,1087,69,1629,269,8045
"17031700402",530,169,2484,466,509,10,750,48,4966
"17031700501",316,72,6332,284,400,3,230,22,7659
"17031700502",84,7,2535,92,62,177,0,177,3134
"17031710100",60,6,469,755,0,0,60,6,1356
"17031710200",143,0,2922,2224,108,0,140,0,5537
"17031710300",0,0,897,371,10,23,10,0,1311
"17031710400",57,0,3236,1496,93,30,33,0,4945
"17031710500",9,43,2442,1192,123,98,85,0,3992
"17031710600",16,0,1255,598,0,0,0,0,1869
"17031710700",10,2,1944,630,64,1,27,0,2678
"17031710800",0,2,4214,418,75,28,103,1,4841
"17031710900",7,32,1175,1122,4,9,29,32,2410
"17031711000",6,0,2221,895,31,0,18,0,3171
"17031711100",0,0,2263,390,5,0,0,0,2658
"17031711200",0,0,3918,1091,12,0,0,0,5021
"17031711300",41,0,1257,421,0,17,70,14,1820
"17031711400",1,1,1454,850,6,1,0,0,2313
"17031711500",0,0,1615,660,36,63,0,53,2427
"17031720100",2016,2,1164,1,147,36,490,18,3874
"17031720200",1510,176,2178,256,173,19,233,0,4545
"17031720300",2488,40,1370,1,123,1,367,10,4400
"17031720400",1748,24,38,1,101,21,90,11,2034
"17031720500",2053,43,62,0,51,0,114,0,2323
"17031720600",1369,50,237,23,29,8,33,0,1749
"17031720700",1107,49,1737,192,151,0,48,0,3284
"17031730100",0,0,2026,418,50,10,17,12,2533
"17031730201",124,1,4425,1446,270,0,150,0,6416
"17031730202",7,0,2656,451,6,0,0,0,3120
"17031730300",6,0,991,157,18,0,6,0,1178
"17031730400",19,1,3217,638,132,0,42,0,4049
"17031730500",141,1,3512,467,31,0,30,0,4182
"17031730600",0,0,3051,193,32,0,0,0,3276
"17031730700",0,7,1673,579,58,6,18,0,2341
"17031740100",2746,120,0,0,79,0,183,0,3128
"17031740200",5352,299,0,2,133,17,245,17,6065
"17031740300",4201,113,120,1,80,0,243,7,4765
"17031740400",3813,198,397,54,348,47,364,47,5268
"17031750100",39,0,3169,856,245,21,137,0,4467
"17031750200",1155,41,1383,273,176,22,0,9,3059
"17031750300",2263,32,144,52,53,0,181,0,2725
"17031750400",1847,120,1084,16,83,0,71,5,3226
"17031750500",923,164,3435,1045,76,177,30,188,6038
"17031750600",0,4,2107,1233,137,39,8,0,3528
"17031760801",2538,988,41,0,772,138,140,0,4617
"17031760802",2027,266,28,0,53,0,169,0,2543
"17031760803",3806,1172,34,1,1183,436,841,0,7473
"17031770201",4052,285,30,40,1077,80,778,0,6342
"17031770202",4134,301,47,1,498,0,459,0,5440
"17031770300",6360,283,19,0,659,0,692,14,8027
"17031770400",3152,295,63,14,1146,205,810,205,5890
"17031770500",1678,485,21,16,1631,291,2907,633,7662
"17031770601",2154,159,7,1,372,159,395,159,3406
"17031770602",2928,480,44,0,994,385,1683,759,7273
"17031770700",2057,234,44,17,209,5,286,15,2867
"17031770800",4143,210,71,19,1229,35,1441,132,7280
"17031770901",4464,503,0,0,363,0,305,159,5794
"17031770902",3188,152,19,3,186,12,153,30,3743
"17031800100",2405,61,0,0,111,0,19,7,2603
"17031800200",5750,203,44,27,246,34,310,58,6672
"17031800300",3071,15,15,0,231,0,87,0,3419
"17031800400",3246,31,0,0,366,77,98,0,3818
"17031800500",4824,79,0,15,383,0,155,0,5456
"17031800600",2421,43,26,0,108,5,48,0,2651
"17031800700",4475,73,0,0,494,0,187,3,5232
"17031800800",1673,93,0,0,375,0,34,0,2175
"17031800900",2821,128,118,0,1505,61,406,0,5039
"17031801000",3537,136,27,0,973,81,60,0,4814
"17031801100",4267,45,32,1,355,0,170,0,4870
"17031801200",2983,119,14,0,279,0,110,0,3505
"17031801300",3923,105,31,11,468,13,124,13,4688
"17031801400",2288,10,10,0,634,106,225,0,3273
"17031801500",5367,131,30,0,496,42,163,0,6229
"17031801601",3590,10,7,0,708,0,56,10,4381
"17031801603",2137,115,158,22,1118,309,254,78,4191
"17031801605",4300,163,0,1,945,20,112,0,5541
"17031801606",4786,234,0,0,748,29,127,0,5924
"17031801607",3696,255,97,18,1242,196,194,11,5709
"17031801608",5193,111,11,0,1129,72,254,0,6770
"17031801701",3173,59,0,0,483,0,97,0,3812
"17031801702",4131,44,0,0,703,9,65,0,4952
"17031801800",5103,244,0,0,363,55,46,4,5815
"17031801901",3191,116,0,0,685,0,665,0,4657
"17031801902",2878,6,136,0,290,74,152,0,3536
"17031802002",3906,144,68,0,808,42,198,0,5166
"17031802003",1836,289,63,2,487,5,226,278,3186
"17031802004",3214,175,139,0,1574,245,923,0,6270
"17031802100",3047,113,0,2,282,0,66,0,3510
"17031802200",3809,126,37,0,263,0,216,0,4451
"17031802300",3693,458,56,3,1017,0,167,10,5404
"17031802402",2911,1314,65,21,814,204,908,1236,7473
"17031802403",1153,54,3,0,215,27,42,18,1512
"17031802404",3939,882,79,0,1994,476,2422,605,10397
"17031802503",3562,290,0,0,1347,550,259,430,6438
"17031802504",4372,206,41,0,1882,43,2393,156,9093
"17031802505",3012,527,135,116,2579,404,2946,523,10242
"17031802506",1408,355,21,0,991,50,1410,209,4444
"17031802605",5227,216,278,4,1296,1,527,1,7550
"17031802607",1257,20,0,0,150,0,52,0,1479
"17031802608",5659,178,21,0,464,52,118,0,6492
"17031802609",3166,983,40,0,2127,69,2158,656,9199
"17031802610",1237,13,0,0,453,21,85,0,1809
"17031802701",4663,169,36,0,1534,233,1330,279,8244
"17031802702",3122,136,37,21,1291,71,332,19,5029
"17031802801",4001,325,86,6,712,0,272,204,5606
"17031802802",5580,135,46,0,637,0,140,0,6538
"17031802900",5448,126,0,0,461,13,49,13,6110
"17031803005",2367,176,43,45,169,0,19,0,2819
"17031803007",3849,172,0,2,557,0,228,0,4808
"17031803008",3753,121,87,1,531,1,352,1,4847
"17031803010",4056,156,0,0,629,0,385,0,5226
"17031803012",1903,50,48,0,223,54,237,0,2515
"17031803013",4644,137,74,0,495,88,188,0,5626
"17031803014",2554,177,19,0,653,0,622,25,4050
"17031803015",3904,116,92,24,434,78,398,66,5112
"17031803016",1420,94,26,0,1037,19,134,0,2730
"17031803017",4191,171,0,20,1107,114,568,38,6209
"17031803100",3118,100,81,5,69,14,82,0,3469
"17031803200",4886,150,65,20,173,44,334,44,5716
"17031803300",4721,252,20,6,606,47,143,12,5807
"17031803400",5396,288,41,4,336,41,348,129,6583
"17031803500",5786,302,0,4,216,23,139,2,6472
"17031803603",5258,149,44,0,1215,29,51,64,6810
"17031803604",3525,156,80,27,512,0,213,39,4552
"17031803605",5077,363,248,3,1374,415,976,509,8965
"17031803606",3136,1016,243,222,2969,1440,3476,1887,14389
"17031803607",4451,54,63,0,403,17,314,0,5302
"17031803608",5059,208,275,169,1641,417,927,314,9010
"17031803610",4655,380,351,0,1536,250,501,220,7893
"17031803611",2842,284,143,0,1903,935,1912,818,8837
"17031803612",1319,629,105,85,1087,471,884,938,5518
"17031803701",2121,232,19,0,367,0,110,0,2849
"17031803702",3964,353,12,0,1229,56,318,0,5932
"17031803800",4012,181,2,1,614,112,587,112,5621
"17031803901",2606,299,80,3,339,67,252,105,3751
"17031803902",3150,202,28,0,62,4,353,3,3802
"17031804000",3645,105,68,1,639,33,541,8,5040
"17031804102",5352,132,0,13,1021,32,248,0,6798
"17031804104",3309,152,168,5,1388,1,186,2,5211
"17031804105",3483,88,48,0,738,0,229,0,4586
"17031804106",4895,213,103,16,1969,0,400,46,7642
"17031804108",1280,152,359,31,1943,172,188,37,4162
"17031804109",2108,122,167,19,382,14,276,24,3112
"17031804201",5619,479,12,7,1695,30,235,66,8143
"17031804202",6496,105,0,0,1116,134,555,0,8406
"17031804305",4834,122,402,0,2303,65,2464,120,10310
"17031804306",3459,275,17,74,2030,131,2553,200,8739
"17031804308",2929,114,94,0,1898,62,998,11,6106
"17031804309",1489,159,96,1,1265,89,1257,182,4538
"17031804310",5424,186,244,1,3218,43,1922,19,11057
"17031804311",3784,370,0,0,3992,130,1909,85,10270
"17031804403",3549,1100,303,53,1751,100,2006,994,9856
"17031804404",2741,298,68,0,2282,36,2992,236,8653
"17031804405",1051,297,146,319,1065,290,1394,489,5051
"17031804406",2959,181,172,35,2876,398,2742,443,9806
"17031804505",2758,148,88,0,549,18,615,41,4217
"17031804506",4105,80,151,0,702,16,443,0,5497
"17031804507",8121,242,236,2,4043,118,1163,38,13963
"17031804508",996,77,41,194,676,494,643,411,3532
"17031804509",2483,88,44,13,2744,55,2750,107,8284
"17031804510",1860,77,306,109,3498,838,4084,906,11678
"17031804511",627,181,102,0,1385,544,1158,609,4606
"17031804603",2667,330,220,20,1928,92,1071,62,6390
"17031804606",5659,77,25,0,1527,0,332,0,7620
"17031804607",5253,79,126,0,1250,60,209,60,7037
"17031804608",2144,192,101,26,1085,19,415,0,3982
"17031804609",3086,469,76,0,2156,0,358,21,6166
"17031804610",1843,80,6,0,472,20,132,0,2553
"17031804611",3417,58,79,0,594,160,87,0,4395
"17031804701",2376,326,865,184,2677,63,1126,43,7660
"17031804705",2043,340,184,51,1456,73,668,96,4911
"17031804706",2118,37,0,0,470,72,166,0,2863
"17031804709",3158,192,133,42,2133,154,977,111,6900
"17031804710",3516,107,0,0,759,0,672,0,5054
"17031804711",3645,250,359,63,3660,456,1390,410,10233
"17031804712",3472,94,127,18,1466,0,717,0,5894
"17031804713",2108,63,121,38,2112,170,396,51,5059
"17031804714",2713,43,102,0,749,59,496,0,4162
"17031804715",1318,87,65,60,1491,241,1463,55,4780
"17031804716",2946,78,130,0,2245,91,1153,0,6643
"17031804803",4083,314,219,0,1149,0,290,0,6055
"17031804804",3750,443,395,0,2209,35,1065,116,8013
"17031804805",5169,90,575,67,1121,106,890,44,8062
"17031804806",1940,83,227,220,1116,121,880,17,4604
"17031804807",3352,115,407,48,769,0,416,0,5107
"17031804808",2065,91,23,0,336,109,170,109,2903
"17031804809",3478,65,45,6,574,0,44,0,4212
"17031804810",4628,271,256,16,1497,416,911,33,8028
"17031804901",5534,342,0,38,293,77,281,23,6588
"17031804902",4189,73,2,0,1329,0,777,0,6370
"17031805001",4543,75,22,0,238,0,491,0,5369
"17031805002",4003,336,308,73,1831,258,461,72,7342
"17031805105",3203,405,848,83,1925,806,2079,762,10111
"17031805106",2248,171,92,7,198,109,106,0,2931
"17031805107",3426,202,224,0,2573,275,1765,220,8685
"17031805108",3227,241,308,11,2959,106,2110,225,9187
"17031805109",3677,229,88,0,355,0,108,10,4467
"17031805110",3343,193,32,0,595,0,85,21,4269
"17031805111",4047,595,245,0,2281,289,2109,385,9951
"17031805112",1831,48,60,12,975,49,147,8,3130
"17031805201",2417,70,1,2,786,0,490,14,3780
"17031805202",3083,150,71,17,960,64,347,0,4692
"17031805301",1642,195,79,29,1174,135,209,0,3463
"17031805302",2187,209,49,0,1009,112,145,0,3711
"17031805401",3138,245,168,0,363,62,292,97,4365
"17031805402",3492,397,44,0,981,15,413,15,5357
"17031805501",3274,182,9,0,355,0,180,30,4030
"17031805502",3733,159,1,1,34,0,210,46,4184
"17031805600",4290,124,0,0,167,0,146,0,4727
"17031805701",4664,164,0,0,295,18,286,0,5427
"17031805702",1816,65,0,2,84,1,73,14,2055
"17031805801",2030,101,21,4,139,64,26,0,2385
"17031805802",4341,136,21,0,221,8,439,16,5182
"17031805901",3364,193,10,2,489,46,364,0,4468
"17031805902",4718,129,154,2,645,567,313,163,6691
"17031806001",2815,531,187,40,2176,251,544,60,6604
"17031806002",3070,1049,232,40,2762,334,876,351,8714
"17031806003",3801,212,123,30,2945,239,868,58,8276
"17031806004",4999,311,101,106,1543,249,904,413,8626
"17031806102",2758,186,258,0,761,26,446,38,4473
"17031806103",3363,239,128,0,1110,101,384,58,5383
"17031806104",1979,463,641,85,997,657,233,431,5486
"17031806201",3185,345,49,0,1071,91,1104,359,6204
"17031806202",3459,308,63,26,626,19,475,20,4996
"17031806300",3726,127,0,0,947,79,714,69,5662
"17031806400",1830,418,13,0,194,17,157,275,2904
"17031806501",1108,82,6,1,1000,223,848,57,3325
"17031806502",3220,341,75,0,751,6,1437,255,6085
"17031806600",2202,151,101,0,905,111,860,96,4426
"17031806700",2930,118,220,32,913,0,366,2,4581
"17031806801",1957,359,407,65,601,31,269,10,3699
"17031806802",2027,139,89,3,544,27,260,0,3089
"17031806900",1909,297,0,11,2265,162,252,13,4909
"17031807000",3135,351,530,273,1501,412,534,16,6752
"17031807100",2550,88,314,94,415,0,204,0,3665
"17031807200",2878,294,362,124,1808,31,438,32,5967
"17031807300",3664,557,536,94,1934,485,330,129,7729
"17031807400",3564,1032,444,10,1976,140,603,211,7980
"17031807500",2061,40,150,22,1128,137,355,37,3930
"17031807600",3024,353,76,4,2797,274,479,1,7008
"17031807700",2825,923,222,36,1732,146,734,330,6948
"17031807800",1998,86,4,13,695,5,384,14,3199
"17031807900",2445,105,0,0,1416,151,270,61,4448
"17031808001",2307,63,163,0,1075,126,307,4,4045
"17031808002",2757,186,136,0,1545,131,237,0,4992
"17031808100",2263,271,22,22,363,0,215,22,3178
"17031808200",3460,682,0,2,1342,109,364,35,5994
"17031808301",3196,347,51,206,2051,277,206,189,6523
"17031808302",2159,127,110,49,1382,47,386,0,4260
"17031808400",2497,119,97,11,1522,33,17,11,4307
"17031808500",2571,137,12,57,1130,229,142,202,4480
"17031808600",1794,57,0,2,222,0,85,0,2160
"17031808702",524,161,0,0,101,94,60,17,957
"17031808800",2598,225,52,1,305,21,170,8,3380
"17031808900",3652,215,0,0,221,72,244,0,4404
"17031809000",3666,53,46,0,251,9,59,0,4084
"17031809100",2721,62,221,23,224,47,71,0,3369
"17031809200",1194,274,2553,277,527,317,1034,244,6420
"17031809300",1835,1389,130,82,257,779,246,240,4958
"17031809400",2787,632,132,52,909,375,129,99,5115
"17031809500",2423,430,73,65,592,185,204,80,4052
"17031809600",1448,15,1013,379,265,9,464,0,3593
"17031809700",2634,189,822,28,318,60,1286,39,5376
"17031809800",2072,123,123,111,225,9,269,22,2954
"17031809900",2402,97,86,16,304,94,131,0,3130
"17031810000",3240,420,191,70,487,171,111,115,4805
"17031810100",3144,394,506,177,573,43,262,274,5373
"17031810200",2087,249,2506,261,614,31,264,171,6183
"17031810301",1940,38,955,168,516,24,705,24,4370
"17031810302",1831,63,638,114,485,17,238,0,3386
"17031810400",4743,378,0,1,264,0,474,19,5879
"17031810501",4296,470,15,5,213,0,608,33,5640
"17031810502",3654,646,10,0,368,9,307,137,5131
"17031810600",3654,506,52,9,375,78,841,43,5558
"17031810701",3539,764,33,0,827,60,1624,393,7240
"17031810702",2965,192,75,0,464,87,943,125,4851
"17031810800",4033,267,91,19,938,0,1260,19,6627
"17031810900",4419,349,133,0,1085,224,1592,209,8011
"17031811000",3432,298,153,13,267,0,441,4,4608
"17031811100",4627,886,34,9,509,14,1160,86,7325
"17031811200",3944,452,171,0,987,115,1652,196,7517
"17031811301",2943,233,206,21,1353,271,2580,383,7990
"17031811302",1421,208,283,142,982,465,1717,653,5871
"17031811401",3952,404,35,58,706,11,1679,255,7100
"17031811402",3077,185,8,0,842,436,1567,476,6591
"17031811500",4672,273,37,0,890,121,2234,244,8471
"17031811600",3879,770,82,17,1059,320,1444,550,8121
"17031811701",2311,275,74,0,1018,276,2147,517,6618
"17031811702",2576,420,60,25,1060,254,1644,302,6341
"17031811800",3694,302,30,6,807,404,2580,549,8372
"17031811900",4138,200,368,0,321,66,158,22,5273
"17031812000",4062,159,153,30,832,0,392,0,5628
"17031812100",2787,67,819,361,575,37,290,0,4936
"17031812200",2974,45,414,144,449,5,91,11,4133
"17031812301",2107,380,560,26,468,150,555,107,4353
"17031812302",1830,137,359,0,199,41,233,29,2828
"17031812400",2680,26,364,59,357,0,70,0,3556
"17031812500",1735,216,1017,199,157,43,192,35,3594
"17031812600",1957,161,625,191,334,135,131,63,3597
"17031812700",2068,136,466,63,298,113,186,65,3395
"17031812801",1596,330,574,107,285,24,128,17,3061
"17031812802",1785,183,249,99,265,56,310,72,3019
"17031812900",3465,163,511,90,547,16,299,20,5111
"17031813000",2409,104,707,120,206,30,249,0,3825
"17031813100",2521,164,1538,140,512,63,289,69,5296
"17031813200",3188,133,573,44,487,0,258,0,4683
"17031813301",1155,279,123,102,1360,540,2391,799,6749
"17031813302",1167,305,60,163,1349,534,2431,835,6844
"17031813400",2480,585,240,233,3073,890,5091,1393,13985
"17031813500",2890,512,45,90,3514,369,5581,746,13747
"17031813600",1228,575,53,0,2601,746,3583,1297,10083
"17031813701",985,697,89,94,1468,655,2353,1298,7639
"17031813702",1079,230,214,188,1553,494,2500,724,6982
"17031813801",1048,152,49,0,1430,346,2392,483,5900
"17031813802",2003,442,198,97,2152,420,3896,786,9994
"17031813900",2033,670,47,184,2956,635,4489,1405,12419
"17031814000",2711,434,95,19,1741,110,3844,474,9428
"17031814100",1451,503,67,0,1811,460,3207,942,8441
"17031814200",2253,658,23,17,2614,1104,4390,1578,12637
"17031814300",1468,375,52,131,2329,735,3629,1155,9874
"17031814400",3451,862,62,12,2280,856,4616,1494,13633
"17031814500",2266,276,97,3,2256,129,4095,345,9467
"17031814600",2871,634,373,85,1062,312,2913,762,9012
"17031814700",3146,512,85,97,1615,340,3119,670,9584
"17031814800",4254,177,420,24,912,156,3160,219,9322
"17031814900",3982,843,831,233,710,180,2954,864,10597
"17031815000",2133,385,349,173,921,321,2245,542,7069
"17031815100",2687,161,245,0,1215,205,2820,357,7690
"17031815200",3487,387,235,307,1557,235,3470,336,10014
"17031815300",2447,193,91,0,1060,124,2155,140,6210
"17031815400",3827,459,123,11,625,316,1769,609,7739
"17031815500",4553,375,18,0,2739,670,4796,941,14092
"17031815600",3711,571,75,29,665,51,1579,262,6943
"17031815701",3544,54,33,2,172,0,435,26,4266
"17031815702",4306,351,70,80,334,0,754,126,6021
"17031815800",1212,54,26,0,95,0,145,5,1537
"17031815900",2117,130,1327,290,499,221,166,0,4750
"17031816000",2021,174,898,49,237,7,209,9,3604
"17031816100",3104,240,1560,130,854,141,843,174,7046
"17031816200",2291,109,327,75,617,250,1120,313,5102
"17031816300",2762,420,92,27,1683,174,3259,387,8804
"17031816401",2710,259,16,191,1812,383,3872,590,9833
"17031816402",1595,441,149,84,1722,301,2965,590,7847
"17031816500",1822,531,82,102,1607,492,2923,885,8444
"17031816600",1769,412,20,23,1772,630,3334,957,8917
"17031816700",1374,151,173,92,812,169,1672,305,4748
"17031816800",2693,156,1275,70,1022,188,1680,174,7258
"17031816900",942,103,3143,268,569,454,1182,417,7078
"17031817000",760,309,3305,423,446,52,1016,359,6670
"17031817101",207,53,3443,622,234,0,178,30,4767
"17031817102",315,0,2854,244,260,35,398,24,4130
"17031817200",67,100,2713,900,254,108,263,185,4590
"17031817300",306,37,1193,689,135,190,374,198,3122
"17031817400",1290,110,879,647,1130,0,1952,102,6110
"17031817500",437,127,2072,853,170,227,465,306,4657
"17031817600",548,40,2842,504,193,1,604,20,4752
"17031817700",202,273,3928,668,156,0,296,280,5803
"17031817900",1000,123,3504,665,191,0,288,174,5945
"17031818000",1765,107,1650,136,565,106,489,117,4935
"17031818100",1698,76,345,1,359,6,377,33,2895
"17031818200",2647,221,1132,102,331,35,917,111,5496
"17031818300",1762,272,2115,394,1129,264,1748,373,8057
"17031818401",1846,111,749,177,444,0,660,0,3987
"17031818402",2163,159,406,26,457,6,680,8,3905
"17031818500",3857,337,572,1,607,36,622,53,6085
"17031818600",4043,276,240,86,133,26,581,35,5420
"17031818700",3078,229,124,10,115,77,449,145,4227
"17031818800",4687,649,82,11,101,23,748,107,6408
"17031818900",4122,316,76,5,124,10,584,93,5330
"17031819000",4227,196,7,18,87,0,153,2,4690
"17031819100",3399,262,125,75,508,74,1861,162,6466
"17031819200",4400,1148,247,9,343,8,2232,719,9106
"17031819300",2217,161,188,1,283,106,542,76,3574
"17031819400",4233,489,158,14,367,15,1176,113,6565
"17031819500",1963,162,380,205,131,0,232,44,3117
"17031819600",3462,79,150,42,84,0,214,14,4045
"17031819700",5522,170,0,34,221,18,109,0,6074
"17031819801",5287,54,0,0,88,0,268,0,5697
"17031819802",2437,54,5,0,140,0,154,0,2790
"17031819900",3353,55,0,0,47,0,170,0,3625
"17031820000",1685,132,22,0,364,8,120,81,2412
"17031820101",6342,202,49,0,260,11,16,26,6906
"17031820103",3437,329,0,0,199,29,1229,99,5322
"17031820104",3117,533,108,156,280,0,637,191,5022
"17031820201",6667,546,124,8,704,0,373,164,8586
"17031820202",2783,191,52,0,260,120,1045,206,4657
"17031820300",3301,732,135,4,784,178,2303,647,8084
"17031820400",3040,696,647,403,1142,316,3577,930,10751
"17031820501",4974,851,21,4,378,23,1054,70,7375
"17031820502",3553,523,25,0,539,33,680,63,5416
"17031820603",3731,453,203,415,377,80,972,308,6539
"17031820604",2791,589,59,0,509,129,668,101,4846
"17031820605",1513,331,1454,712,153,27,411,151,4752
"17031820606",3265,292,25,9,238,92,443,72,4436
"17031820700",4493,233,0,0,1730,281,3260,201,10198
"17031820800",2998,101,39,170,717,113,1942,184,6264
"17031820901",4151,800,131,15,448,0,1520,118,7183
"17031820902",3345,178,11,121,1126,194,1956,56,6987
"17031821001",3876,522,38,34,599,55,919,10,6053
"17031821002",4245,652,32,21,438,55,1244,81,6768
"17031821101",3357,442,2,17,633,142,1211,278,6082
"17031821102",3029,553,30,15,399,108,1001,202,5337
"17031821200",1334,326,2165,588,1275,439,1857,591,8575
"17031821300",2083,537,923,713,1390,1,2389,349,8385
"17031821401",240,149,2721,530,68,39,81,149,3977
"17031821402",153,45,2858,449,12,0,0,19,3536
"17031821500",64,0,1223,543,19,7,49,4,1909
"17031821600",2074,190,1613,133,315,90,484,172,5071
"17031821700",4224,243,466,15,42,0,362,42,5394
"17031821800",3793,137,924,153,302,60,643,126,6138
"17031821900",3801,306,443,304,143,0,306,119,5422
"17031822000",3780,248,28,0,218,41,966,53,5334
"17031822101",3506,344,73,63,405,21,673,155,5240
"17031822102",3028,303,368,60,642,96,1404,151,6052
"17031822200",3217,376,72,0,475,40,843,162,5185
"17031822301",3013,344,143,11,355,8,562,9,4445
"17031822302",2880,402,298,34,539,155,546,94,4948
"17031822400",3953,1941,159,12,158,114,766,122,7225
"17031822500",3792,208,37,66,206,2,619,116,5046
"17031822601",4136,356,65,8,176,19,670,78,5508
"17031822602",5372,582,646,49,767,24,805,14,8259
"17031822701",3194,440,294,0,309,23,1041,95,5396
"17031822702",2176,258,201,244,340,7,373,0,3599
"17031822801",2436,104,142,0,170,265,529,0,3646
"17031822802",3032,145,173,1,45,1,508,10,3915
"17031822900",1580,170,91,6,115,25,352,0,2339
"17031823001",3064,759,778,315,786,123,730,112,6667
"17031823002",4547,536,179,8,489,23,720,31,6533
"17031823101",3715,473,132,31,225,126,394,151,5247
"17031823102",2999,382,0,0,0,0,220,147,3748
"17031823200",3918,437,198,0,96,24,774,110,5557
"17031823302",2870,522,1655,176,1144,0,1913,275,8555
"17031823303",2937,351,419,90,729,92,1040,92,5750
"17031823304",3844,717,760,6,844,19,1353,407,7950
"17031823400",1678,717,885,166,1408,247,1976,620,7697
"17031823500",2265,340,478,94,1059,357,1682,492,6767
"17031823602",5292,318,23,0,169,116,185,103,6206
"17031823603",289,146,661,346,480,552,720,660,3854
"17031823604",3160,186,64,0,90,0,16,15,3531
"17031823605",3413,122,52,53,94,0,277,10,4021
"17031823702",4749,880,692,181,314,18,496,111,7441
"17031823703",4860,1675,29,24,890,179,443,554,8654
"17031823704",3537,248,35,10,370,15,604,15,4834
"17031823705",3051,963,228,138,260,80,425,342,5487
"17031823801",4537,225,2,13,578,0,408,17,5780
"17031823803",5418,567,31,20,477,139,400,156,7208
"17031823805",2480,297,43,0,132,0,230,0,3182
"17031823806",2783,358,174,49,181,35,240,99,3919
"17031823901",3200,56,76,1,406,0,168,1,3908
"17031823903",4213,88,88,0,148,0,348,0,4885
"17031823904",4005,65,12,0,90,0,230,0,4402
"17031824003",5882,100,0,0,191,0,367,0,6540
"17031824004",4628,312,91,17,216,0,277,20,5561
"17031824005",4833,270,91,0,431,0,462,0,6087
"17031824006",3839,259,0,0,70,18,365,18,4569
"17031824105",5605,425,82,0,363,6,168,129,6778
"17031824106",5919,274,324,0,787,0,418,130,7852
"17031824107",5654,277,357,3,224,0,672,42,7229
"17031824108",5884,499,352,239,1026,138,711,13,8862
"17031824113",6414,84,51,0,414,0,610,0,7573
"17031824114",4234,165,129,0,490,0,270,0,5288
"17031824115",2931,191,51,16,129,125,252,92,3787
"17031824116",3984,323,31,13,569,127,575,106,5728
"17031824117",8487,238,232,0,981,0,531,31,10500
"17031824119",4943,261,58,0,489,0,264,0,6015
"17031824120",7246,527,154,0,588,0,337,0,8852
"17031824121",2736,142,101,0,73,49,82,12,3195
"17031824122",5095,540,90,0,357,0,342,48,6472
"17031824123",6836,357,246,23,762,143,966,195,9528
"17031824300",94,41,3082,1264,9,121,77,117,4805
"17031824400",1074,203,636,218,56,23,344,50,2604
"17031824503",6005,231,204,0,251,0,345,0,7036
"17031824505",5831,372,250,39,591,30,678,115,7906
"17031824506",6794,127,137,3,628,0,376,0,8065
"17031824507",3273,310,145,45,278,238,250,241,4780
"17031824601",4187,148,232,0,288,25,643,48,5571
"17031824602",5252,322,208,8,401,175,671,175,7212
"17031824701",3199,92,178,62,655,13,1095,32,5326
"17031824702",3367,511,229,271,661,396,1275,246,6956
"17031824800",3237,1195,1387,499,1480,306,3538,1124,12766
"17031824900",763,72,1417,585,189,116,229,116,3487
"17031825000",3788,448,247,141,426,2,420,201,5673
"17031825200",1245,5,209,22,479,19,370,9,2358
"17031825302",4420,502,471,90,272,1,1000,1,6757
"17031825303",3113,621,195,0,72,171,268,222,4662
"17031825304",3419,242,9,0,312,112,406,93,4593
"17031825400",4043,426,168,28,494,10,595,26,5790
"17031825501",947,23,3358,1018,113,97,390,97,6043
"17031825503",730,71,5049,998,159,55,261,1,7324
"17031825504",198,30,3083,420,26,10,23,21,3811
"17031825505",621,5,3477,1113,47,0,133,0,5396
"17031825600",733,55,3470,1085,80,166,450,124,6163
"17031825700",1034,254,1825,479,220,78,779,237,4906
"17031825801",184,75,1748,1276,8,63,50,0,3404
"17031825802",549,124,4324,353,303,64,442,185,6344
"17031825803",505,110,3170,908,384,92,525,166,5860
"17031825900",1001,117,1345,1102,107,0,748,31,4451
"17031826000",712,314,1281,686,170,0,458,304,3925
"17031826100",1643,547,4015,812,239,108,838,614,8816
"17031826201",413,111,2532,482,26,0,35,30,3629
"17031826202",1382,124,3014,890,366,0,651,0,6427
"17031826301",391,73,3184,419,100,12,406,57,4642
"17031826303",223,1,3121,745,131,17,9,6,4253
"17031826304",108,0,1829,1063,59,0,106,12,3177
"17031826401",105,186,2758,581,73,0,95,184,3982
"17031826402",393,17,3872,754,155,24,345,0,5560
"17031826500",347,86,4009,2023,134,67,105,160,6931
"17031826600",188,23,4038,1553,140,49,113,12,6116
"17031826700",258,19,3283,1482,147,22,31,0,5242
"17031826800",1049,721,1291,695,1016,384,1651,894,7701
"17031826901",0,11,873,675,26,32,21,43,1681
"17031826902",8,4,666,395,9,11,17,1,1111
"17031827000",40,110,2341,1421,51,170,49,280,4462
"17031827100",64,27,1672,862,129,92,31,66,2943
"17031827200",553,509,2065,725,152,137,462,548,5151
"17031827300",229,0,1442,969,378,146,153,103,3420
"17031827400",49,0,2505,1126,0,339,49,339,4407
"17031827500",663,229,2239,698,693,859,1086,839,7306
"17031827600",51,12,2113,1081,48,0,12,12,3329
"17031827700",457,70,1496,683,194,8,244,5,3157
"17031827801",1315,47,2559,482,111,0,363,0,4877
"17031827802",453,3,2629,366,132,0,51,0,3634
"17031827804",387,42,2429,157,59,0,20,1,3095
"17031827805",551,20,2276,136,0,0,64,10,3057
"17031827901",284,14,1874,179,37,0,62,0,2450
"17031827902",1902,325,1618,458,171,10,616,181,5281
"17031828000",2673,146,988,666,679,195,1139,208,6694
"17031828100",3231,173,618,23,150,356,313,356,5220
"17031828201",1852,185,1481,217,425,22,442,78,4702
"17031828202",2350,184,1374,233,296,54,382,111,4984
"17031828300",2153,228,679,148,122,39,273,6,3648
"17031828401",2209,154,730,172,322,54,446,0,4087
"17031828402",1751,67,1251,309,361,73,572,93,4477
"17031828503",1322,180,2264,721,98,31,481,38,5135
"17031828504",1552,226,2018,1616,426,212,421,187,6658
"17031828505",3158,240,2216,573,307,237,624,150,7505
"17031828506",2207,793,4555,773,83,182,491,470,9554
"17031828601",2865,206,562,21,284,130,236,184,4488
"17031828602",1699,95,1931,158,528,91,119,71,4692
"17031828701",1277,121,1756,281,167,0,293,0,3895
"17031828702",930,134,3218,678,128,115,265,173,5641
"17031828801",2521,159,2235,94,527,42,622,115,6315
"17031828802",2091,287,644,105,176,93,500,247,4143
"17031828900",760,286,662,623,743,288,1036,396,4794
"17031829000",0,10,479,812,0,10,0,12,1323
"17031829100",815,520,295,265,1056,708,1574,1049,6282
"17031829200",2447,583,915,485,1154,320,2463,451,8818
"17031829301",1701,186,973,229,429,135,455,150,4258
"17031829302",382,148,1802,829,478,570,724,566,5499
"17031829401",36,0,609,625,52,17,68,0,1407
"17031829402",908,20,1835,457,97,8,134,3,3462
"17031829500",1861,209,443,242,961,318,1106,388,5528
"17031829600",2117,321,93,1,300,23,447,9,3311
"17031829700",835,21,1931,1314,282,34,200,0,4617
"17031829800",3076,149,2735,168,500,0,271,7,6906
"17031829901",2956,191,4419,805,692,0,701,158,9922
"17031829902",789,30,4984,426,186,0,135,0,6550
"17031830001",1763,228,105,0,8,0,39,113,2256
"17031830003",418,69,5905,987,90,95,22,92,7678
"17031830004",717,23,6132,591,0,136,137,137,7873
"17031830005",978,33,2971,85,120,51,22,13,4273
"17031830006",873,78,1017,114,177,17,145,24,2445
"17031830007",723,77,2669,980,101,73,76,73,4772
"17031830008",517,0,3502,257,185,8,122,8,4599
"17031830100",532,5,1783,321,358,100,388,5,3492
"17031830201",802,66,3505,1179,267,0,72,0,5891
"17031830202",1118,156,1598,441,91,206,90,212,3912
"17031830300",903,248,2341,1077,116,0,115,26,4826
"17031830400",1350,120,2226,643,179,31,157,55,4761
"17031830500",2587,1009,0,0,787,6,3329,999,8717
"17031830600",2220,665,427,241,841,212,1290,545,6441
"17031830700",1399,515,682,542,146,203,264,145,3896
"17031830800",1881,86,91,82,391,0,247,0,2778
"17031830900",2386,119,37,34,414,32,1153,68,4243
"17031831000",1842,8,73,0,361,0,211,0,2495
"17031831100",5424,1282,144,0,1476,153,4084,1080,13643
"17031831200",1750,485,92,130,1886,589,3519,943,9394
"17031831300",159,75,508,52,197,54,319,129,1493
"17031831400",302,12,1344,462,349,96,420,91,3076
"17031831500",2389,208,162,74,674,31,1776,109,5423
"17031831600",3145,951,457,80,2354,143,3776,1002,11908
"17031831700",1161,86,52,62,585,333,1003,359,3641
"17031831800",2786,542,267,13,1789,533,1535,259,7724
"17031831900",2158,114,18,2,349,40,53,28,2762
"17031832000",1409,352,7,33,122,89,68,145,2225
"17031832100",1896,323,409,268,173,67,139,47,3322
"17031832200",2838,137,80,2,377,34,571,0,4039
"17031832300",1420,130,65,1,312,35,215,69,2247
"17031832400",2297,251,79,0,438,22,971,197,4255
"17031832500",2429,475,114,97,110,37,183,156,3601
"17031832600",3369,260,21,27,283,9,243,22,4234
"17031832900",1060,713,46,34,412,293,105,213,2876
"17031833000",2140,180,134,84,331,26,85,32,3012
"17031833100",4787,308,386,454,1067,178,551,39,7770
"17031833300",1077,390,66,132,443,526,212,39,2885
"17031833900",696,197,474,800,145,114,828,335,3589
"17031834000",48,0,2173,763,39,8,48,0,3079
"17031834200",108,0,2644,1604,19,0,104,0,4479
"17031834300",75,12,4459,1323,119,0,61,1,6050
"17031834400",105,15,2743,1233,180,0,17,23,4316
"17031834500",0,0,692,726,102,0,19,0,1539
"17031834600",0,85,1652,1111,28,9,38,0,2923
"17031834700",0,91,869,926,16,132,6,112,2152
"17031834800",0,3,785,651,5,11,0,0,1455
"17031834900",0,38,1223,1009,0,56,0,21,2347
"17031835000",445,173,2074,1673,967,436,1315,609,7692
"17031835100",1752,547,496,213,1937,640,3568,1128,10281
"17031835200",869,200,0,6,624,115,959,193,2966
"17031835500",8,77,844,424,74,10,79,67,1583
"17031835600",20,0,677,303,0,0,6,0,1006
"17031835700",0,0,118,232,0,27,0,0,377
"17031835800",50,14,962,587,32,0,44,0,1689
"17031835900",38,9,1621,1283,71,230,59,0,3311
"17031836000",52,0,1517,801,61,28,10,0,2469
"17031836100",10,0,1007,791,0,5,47,0,1860
"17031836200",151,47,8,4,62,18,0,0,290
"17031836300",450,92,814,48,95,71,19,29,1618
"17031836400",151,17,2143,847,134,0,118,48,3458
"17031836500",18,43,1012,500,0,0,0,43,1616
"17031836600",696,57,619,301,744,191,1143,232,3983
"17031836700",66,69,1095,592,261,83,334,124,2624
"17031836800",51,0,951,1400,21,39,21,39,2522
"17031836900",89,19,733,596,63,0,104,10,1614
"17031837000",171,9,952,1090,16,5,70,18,2331
"17031837100",310,32,1048,485,108,0,158,5,2146
"17031837300",26,6,1066,645,107,0,82,20,1952
"17031837400",51,90,948,959,0,14,13,16,2091
"17031837800",456,31,1353,1061,314,7,249,9,3480
"17031838000",445,67,952,1174,198,92,177,82,3187
"17031838100",486,51,557,434,222,118,79,72,2019
"17031838200",427,225,82,82,105,70,245,14,1250
"17031838300",497,102,268,318,121,38,76,32,1452
"17031838600",0,3,447,733,0,0,0,0,1183
"17031838700",111,78,1895,2501,151,0,111,152,4999
"17031838800",1010,381,685,1275,121,53,1010,407,4942
"17031839000",4486,799,849,536,1359,471,98,174,8772
"17031839100",2398,256,511,131,756,364,210,0,4626
"17031839200",202,60,1450,449,200,148,61,0,2570
"17031839500",125,17,653,226,46,75,34,0,1176
"17031839600",55,50,1088,388,40,7,15,5,1648
"17031839700",1961,689,119,0,1617,667,1788,842,7683
"17031839800",1428,205,31,3,943,200,568,97,3475
"17031839900",2493,397,23,103,758,211,934,91,5010
"17031840000",1235,65,14,0,1007,406,328,139,3194
"17031840100",783,121,20,0,1237,468,260,19,2908
"17031840200",621,173,24,11,1396,325,436,43,3029
"17031840300",1575,413,25,127,1352,533,1632,675,6332
"17031840400",1139,404,0,162,1033,589,1016,539,4882
"17031840700",1313,1536,157,78,790,346,1868,1818,7906
"17031840800",1483,956,0,26,510,236,1956,1192,6359
"17031841000",133,4,258,75,226,40,5,0,741
"17031841100",216,36,184,161,4436,2639,41,29,7742
"17031841200",2460,468,43,179,1260,1241,3346,1576,10573
"17031841300",1510,642,73,80,1222,490,2298,1051,7366
"17031841400",59,38,585,516,0,15,43,86,1342
"17031841500",35,33,1222,1584,28,127,31,124,3184
"17031841600",15,0,291,439,0,0,0,0,745
"17031841700",123,376,579,215,230,84,284,460,2351
"17031841800",0,5,1730,797,48,13,53,5,2651
"17031841900",2149,167,281,250,734,59,403,40,4083
"17031842000",132,74,402,33,100,61,40,1,843
"17031842100",554,282,3082,1284,1205,632,1890,871,9800
"17031842200",1523,125,262,199,465,31,317,88,3010
"17031842300",2565,400,251,120,410,8,195,193,4142
"17031842400",0,0,2467,635,0,0,0,0,3102
"17031842500",1,1,716,1561,6,0,6,0,2291
"17031842600",2811,613,161,1,1001,265,1577,378,6807
"17031842800",2364,1449,15,0,2188,1379,4034,2677,14106
"17031842900",153,25,955,887,287,105,305,122,2839
"17031843000",0,6,1319,1451,58,0,66,6,2906
"17031843100",70,0,933,698,33,38,28,0,1800
"17031843200",824,253,36,12,831,582,1344,819,4701
"17031843300",297,296,346,498,298,6,546,245,2532
"17031843400",51,45,747,297,24,117,7,46,1334
"17031843500",414,183,0,0,227,73,625,256,1778
"17031843600",109,27,1664,742,64,33,57,80,2776
"17031843700",1997,169,36,3,225,10,603,32,3075
"17031843800",452,234,678,192,271,12,307,75,2221
"17031843900",48,0,2405,989,143,45,119,22,3771
"17031980000",0,0,0,0,0,0,0,0,0
"17031980100",0,0,0,0,0,0,0,0,0
"17031990000",0,0,0,0,0,0,0,0,0
"17033880100",2514,221,0,0,79,0,2,0,2816
"17033880200",3017,284,0,9,68,1,18,9,3406
"17033880300",2782,451,4,0,169,4,37,3,3450
"17033880400",2281,552,6,0,170,0,28,80,3117
"17033880500",2034,398,29,0,7,11,0,0,2479
"17033880600",2595,375,12,0,52,4,8,0,3046
"17035972400",2533,525,0,0,16,0,0,0,3074
"17035972500",2730,584,2,0,13,22,26,0,3377
"17035972600",3726,501,0,0,64,68,12,76,4447
"17037000100",5927,569,0,0,228,0,497,17,7238
"17037000200",4221,257,21,1,192,7,308,51,5058
"17037000300",2429,226,5,11,37,2,74,19,2803
"17037000400",7187,485,115,1,471,448,517,345,9569
"17037000500",3317,552,55,0,224,127,376,106,4757
"17037000600",4264,414,25,11,328,141,279,193,5655
"17037000700",3436,233,150,8,274,17,211,21,4350
"17037000800",4056,1245,550,97,659,94,843,389,7933
"17037000900",3807,661,301,104,253,597,442,142,6307
"17037001001",2038,863,674,1447,327,402,303,296,6350
"17037001002",1253,2144,480,754,138,637,142,457,6005
"17037001300",3553,736,36,22,495,766,217,668,6493
"17037001400",5064,606,404,182,298,76,188,111,6929
"17037001500",2778,415,149,0,189,236,398,391,4556
"17037001600",3790,184,59,24,254,100,363,119,4893
"17037001700",2963,352,32,0,122,0,194,0,3663
"17037001800",3309,386,8,81,72,16,96,29,3997
"17037001900",2151,179,17,0,67,0,167,8,2589
"17037002000",4251,305,0,0,109,0,469,0,5134
"17037002100",1781,305,0,10,327,159,420,259,3261
"17037002200",169,497,9,1,71,143,79,124,1093
"17039971400",2283,242,0,0,43,30,0,0,2598
"17039971500",2677,143,0,0,39,10,3,1,2873
"17039971600",3338,365,0,0,47,10,7,65,3832
"17039971700",2671,390,8,1,194,29,216,25,3534
"17039971800",2664,769,0,12,69,72,26,20,3632
"17041952000",1721,419,17,3,29,43,15,12,2259
"17041952100",3482,364,0,0,125,0,71,0,4042
"17041952200",3827,405,47,0,167,8,231,0,4685
"17041952300",5212,297,6,0,32,8,59,8,5622
"17041952400",2768,457,4,5,180,10,851,114,4389
"17043840000",1897,268,86,0,493,0,1460,165,4369
"17043840101",4426,519,0,5,674,152,1872,336,7984
"17043840102",3802,273,0,26,572,88,1018,111,5890
"17043840103",5017,440,19,0,653,0,675,232,7036
"17043840104",4750,956,52,117,331,118,2667,847,9838
"17043840201",4726,136,3,5,487,121,516,121,6115
"17043840202",4519,320,0,0,574,38,645,0,6096
"17043840303",3013,710,285,0,244,106,1150,653,6161
"17043840304",3227,253,84,1,506,0,437,75,4583
"17043840600",4043,136,26,0,460,0,377,26,5068
"17043840703",2981,259,271,64,416,83,1348,40,5462
"17043840704",2060,650,31,0,351,27,864,412,4395
"17043840705",2694,79,102,0,779,0,653,13,4320
"17043840706",2444,83,94,0,756,55,437,0,3869
"17043840801",1502,353,29,0,395,5,1143,151,3578
"17043840802",3610,358,133,15,1340,456,2346,632,8890
"17043840901",2862,234,107,19,349,23,364,7,3965
"17043840904",2140,176,112,459,1177,41,1279,50,5434
"17043840906",2180,414,136,137,158,0,501,336,3862
"17043840907",2277,384,139,652,1077,101,574,314,5518
"17043840908",2773,556,166,20,679,219,936,385,5734
"17043840910",3322,457,429,33,1005,90,1837,348,7521
"17043840911",1679,117,89,0,1101,220,694,175,4075
"17043841002",2371,75,33,0,236,0,58,0,2773
"17043841003",2336,183,516,0,299,0,202,18,3554
"17043841004",2877,123,283,21,126,7,594,0,4031
"17043841102",4497,231,96,0,1062,7,755,169,6817
"17043841103",3119,49,120,231,378,11,614,11,4533
"17043841104",3985,201,64,0,364,0,296,69,4979
"17043841108",2391,107,442,334,959,131,1349,161,5874
"17043841109",3090,123,418,12,612,11,768,0,5034
"17043841110",3147,167,27,0,104,13,465,33,3956
"17043841111",2865,146,11,11,409,101,269,8,3820
"17043841112",1984,111,127,0,792,1,355,9,3379
"17043841113",2814,220,13,82,1069,25,660,7,4890
"17043841114",2976,138,160,13,1088,7,198,11,4591
"17043841204",2900,297,318,181,2297,137,1273,271,7674
"17043841205",3230,426,36,0,916,148,550,325,5631
"17043841206",4274,465,95,0,678,223,548,469,6752
"17043841207",2280,91,54,15,680,0,1156,50,4326
"17043841208",2831,336,111,176,1426,243,1009,265,6397
"17043841209",2648,72,55,112,1015,0,289,0,4191
"17043841210",2443,284,139,56,732,314,446,190,4604
"17043841307",5225,70,103,0,676,0,537,10,6621
"17043841308",3681,78,21,0,747,10,417,9,4963
"17043841310",3029,53,113,0,537,0,86,0,3818
"17043841312",2164,649,32,0,1069,68,1343,642,5967
"17043841313",2312,122,6,0,341,13,460,0,3254
"17043841314",4976,199,100,70,742,29,475,88,6679
"17043841315",2367,52,196,0,562,144,741,0,4062
"17043841316",2973,42,0,0,212,191,195,3,3616
"17043841318",2231,125,34,0,583,27,521,27,3548
"17043841320",1459,270,25,140,812,19,469,151,3345
"17043841321",1925,52,112,0,514,78,95,0,2776
"17043841322",2569,66,83,44,1867,77,718,0,5424
"17043841323",2129,119,34,0,584,204,389,23,3482
"17043841324",2018,50,17,0,740,23,266,20,3134
"17043841325",4554,65,186,0,1242,28,638,18,6731
"17043841326",2979,21,18,0,329,0,250,11,3608
"17043841327",3875,64,22,0,623,0,223,0,4807
"17043841401",5178,259,28,34,297,40,2431,205,8472
"17043841403",3636,122,90,14,124,0,365,0,4351
"17043841404",2886,200,0,0,116,14,116,0,3332
"17043841501",4525,538,0,279,575,87,3099,548,9651
"17043841503",2624,472,0,0,608,12,2510,426,6652
"17043841504",2413,513,38,112,235,22,1651,349,5333
"17043841603",3304,329,38,11,531,75,1365,223,5876
"17043841604",2823,111,144,40,685,259,1004,142,5208
"17043841605",2266,1029,75,7,398,25,795,953,5548
"17043841606",1918,46,29,0,290,10,27,0,2320
"17043841607",4514,287,168,9,463,10,1428,142,7021
"17043841703",3537,633,984,135,1927,149,922,436,8723
"17043841704",3648,192,176,146,456,0,179,86,4883
"17043841705",3393,246,105,44,1773,139,899,170,6769
"17043841706",2151,271,417,269,1156,48,1038,208,5558
"17043841801",4101,227,246,0,326,249,164,16,5329
"17043841802",5067,21,127,0,198,0,200,0,5613
"17043841901",2409,36,0,0,118,0,107,0,2670
"17043841902",1701,326,57,43,105,24,72,26,2354
"17043842000",3951,223,11,0,134,18,62,0,4399
"17043842100",5261,189,11,173,275,121,329,0,6359
"17043842200",4250,202,1,19,113,87,305,0,4977
"17043842300",3132,39,31,33,103,22,122,0,3482
"17043842400",3999,431,361,76,624,0,362,66,5919
"17043842500",2540,352,68,10,97,5,47,13,3132
"17043842601",3824,47,92,0,282,0,76,0,4321
"17043842602",4191,24,22,0,142,1,179,0,4559
"17043842603",2420,148,74,0,355,41,142,12,3192
"17043842604",3440,268,44,184,159,86,154,0,4335
"17043842605",3756,51,49,0,301,0,145,0,4302
"17043842702",3722,114,290,134,516,56,290,0,5122
"17043842703",3651,141,112,0,196,0,401,0,4501
"17043842704",3745,323,327,25,576,148,149,34,5327
"17043842706",4115,44,146,0,314,0,365,0,4984
"17043842708",1879,73,280,0,261,3,102,0,2598
"17043842709",2472,131,571,48,284,15,308,17,3846
"17043842710",2599,270,253,10,436,99,160,0,3827
"17043842711",2489,66,10,0,298,20,90,9,2982
"17043842800",4306,95,0,0,312,13,190,40,4956
"17043842900",3915,381,8,21,456,0,148,38,4967
"17043843000",3908,276,71,0,206,0,379,0,4840
"17043843100",2753,290,119,24,450,115,787,188,4726
"17043843200",3758,471,244,249,325,40,937,238,6262
"17043843301",3217,332,240,14,489,183,966,406,5847
"17043843302",2647,181,10,0,279,21,296,23,3457
"17043843400",3014,134,29,128,119,0,328,83,3835
"17043843500",4712,289,80,12,468,20,315,27,5923
"17043843601",3223,354,135,4,138,0,279,237,4370
"17043843602",2782,144,28,114,47,8,143,0,3266
"17043843700",4022,178,0,41,184,0,400,4,4829
"17043843800",2657,100,97,10,259,24,263,0,3410
"17043843900",3818,42,0,0,234,11,303,11,4419
"17043844001",3603,52,0,1,201,0,310,0,4167
"17043844002",4454,54,18,0,115,0,66,0,4707
"17043844100",3653,51,31,0,164,0,248,0,4147
"17043844201",4058,382,54,0,739,234,525,15,6007
"17043844202",2461,93,0,0,305,12,257,40,3168
"17043844301",3948,362,463,0,1080,150,184,32,6219
"17043844304",1978,233,362,0,1288,86,120,11,4078
"17043844305",2569,177,199,0,637,44,227,7,3860
"17043844306",1979,172,517,32,1515,196,978,126,5515
"17043844307",1955,172,46,9,1013,272,661,97,4225
"17043844401",2754,75,67,0,269,0,89,0,3254
"17043844402",2788,164,307,9,974,184,488,91,5005
"17043844501",2747,157,303,0,435,193,471,25,4331
"17043844502",2183,117,74,0,826,27,108,15,3350
"17043844601",2942,145,190,0,585,50,79,23,4014
"17043844602",3227,126,190,0,686,39,185,0,4453
"17043844701",3357,218,10,0,481,63,217,46,4392
"17043844702",4588,150,37,0,551,68,209,9,5612
"17043844801",3545,298,0,20,269,16,107,13,4268
"17043844802",2904,101,0,0,54,48,79,14,3200
"17043844901",3069,137,46,0,210,32,221,5,3720
"17043844902",3800,287,0,24,136,57,173,7,4484
"17043845000",4080,408,83,129,453,66,275,53,5547
"17043845100",5759,408,67,1,519,0,301,189,7244
"17043845200",4637,86,0,0,384,16,215,16,5354
"17043845300",3023,96,9,6,150,56,80,0,3420
"17043845401",2534,230,177,0,436,53,208,8,3646
"17043845402",1979,172,120,0,429,179,161,113,3153
"17043845502",3410,123,493,42,1120,0,549,0,5737
"17043845505",2649,293,358,0,956,180,525,176,5137
"17043845506",2562,371,317,59,425,200,209,274,4417
"17043845507",3046,87,37,0,327,11,45,0,3553
"17043845508",2938,156,0,0,389,55,116,0,3654
"17043845509",1773,51,314,13,1029,27,146,27,3380
"17043845510",1868,162,320,0,786,92,137,10,3375
"17043845601",3406,208,363,0,509,40,510,45,5081
"17043845602",4419,242,123,74,195,0,197,0,5250
"17043845701",3131,143,81,0,334,19,141,0,3849
"17043845702",4334,54,29,0,321,0,190,0,4928
"17043845703",3048,157,227,115,926,59,340,95,4967
"17043845704",3804,118,190,20,451,0,328,0,4911
"17043845802",3009,321,58,0,366,0,107,0,3861
"17043845803",2123,258,1000,442,1675,493,927,214,7132
"17043845805",2722,124,173,10,421,0,267,0,3717
"17043845807",4946,455,122,30,782,0,310,0,6645
"17043845808",2714,37,15,0,1099,0,442,0,4307
"17043845809",3145,46,65,0,694,0,151,0,4101
"17043845810",2966,204,328,44,640,16,244,51,4493
"17043845811",2836,176,363,66,405,22,392,53,4313
"17043845901",2398,211,28,0,725,0,386,0,3748
"17043845902",2803,89,91,0,494,0,68,10,3555
"17043846002",3414,320,192,0,367,90,253,0,4636
"17043846003",3852,248,0,0,305,30,175,103,4713
"17043846004",2624,146,235,118,413,2,218,116,3872
"17043846102",2753,150,330,147,520,315,379,159,4753
"17043846103",4133,133,145,1,496,62,362,31,5363
"17043846104",3050,328,43,4,1067,178,467,296,5433
"17043846105",2997,97,66,0,368,0,262,66,3856
"17043846106",2517,232,160,0,829,35,22,212,4007
"17043846201",4421,78,404,224,760,205,203,40,6335
"17043846202",3579,84,311,1,1098,228,231,0,5532
"17043846203",3237,57,19,76,892,25,115,0,4421
"17043846205",2989,153,46,1,660,38,352,0,4239
"17043846206",3892,166,0,0,246,49,145,21,4519
"17043846207",5004,111,137,0,605,12,145,65,6079
"17043846208",2813,34,26,0,315,11,212,0,3411
"17043846209",2804,97,20,0,365,53,102,8,3449
"17043846304",3631,140,375,0,2144,157,394,0,6841
"17043846305",4196,136,138,143,902,0,402,0,5917
"17043846307",2534,267,649,212,843,47,428,42,5022
"17043846308",1791,105,372,0,987,86,659,102,4102
"17043846310",2968,269,687,236,407,74,394,183,5218
"17043846311",4369,159,484,0,395,101,678,79,6265
"17043846312",3393,284,147,33,313,116,160,0,4446
"17043846313",3404,148,43,28,990,0,283,0,4896
"17043846314",2573,169,83,9,635,0,138,32,3639
"17043846315",3761,74,109,0,417,0,206,0,4567
"17043846404",4227,478,295,234,647,0,375,281,6537
"17043846405",2732,77,61,16,818,17,70,0,3791
"17043846408",2491,62,104,0,1480,27,118,0,4282
"17043846409",3154,121,318,0,948,0,210,27,4778
"17043846410",2588,122,346,4,1987,175,863,91,6176
"17043846411",2366,132,311,120,864,45,781,11,4630
"17043846412",2955,96,332,72,739,10,173,0,4377
"17043846413",2984,89,133,0,376,0,115,5,3702
"17043846504",4741,249,96,389,654,20,1008,15,7172
"17043846507",1610,40,254,8,677,70,218,0,2877
"17043846509",2240,324,842,202,1149,24,645,35,5461
"17043846510",1819,104,191,5,450,34,474,65,3142
"17043846511",4956,612,617,34,660,0,1118,374,8371
"17043846513",1761,26,48,0,902,9,198,0,2944
"17043846514",2297,182,183,0,1572,156,256,0,4646
"17043846515",3151,346,614,229,1149,71,886,50,6496
"17043846517",3694,15,1099,0,1519,147,775,49,7298
"17043846518",2976,22,53,11,647,37,79,22,3847
"17043846519",1666,267,250,0,875,34,233,182,3507
"17043846521",3725,257,104,1,1059,101,226,1,5474
"17043846522",1968,75,20,22,1271,39,252,19,3666
"17043846523",2524,51,100,0,87,0,77,1,2840
"17043846524",2847,108,324,27,1306,57,111,15,4795
"17043846603",2699,821,2,106,494,106,2262,835,7325
"17043846604",2873,145,42,0,506,45,1234,81,4926
"17043846701",3555,420,124,0,248,136,1430,378,6291
"17043846702",3448,380,24,28,592,0,1412,283,6167
"17045070100",2187,302,0,17,11,0,7,5,2529
"17045070200",1681,306,1,0,19,12,11,58,2088
"17045070300",2849,1060,0,14,53,0,57,0,4033
"17045070400",4339,851,0,34,59,0,49,0,5332
"17045070500",3377,403,19,0,74,0,7,0,3880
"17047956900",2120,213,9,5,13,5,3,18,2386
"17047957000",1803,217,0,0,41,7,13,0,2081
"17047957100",1710,393,21,0,45,11,0,32,2212
"17049950100",3746,139,0,0,43,25,19,8,3980
"17049950200",4298,318,6,3,73,0,135,0,4833
"17049950300",3519,444,0,1,27,0,30,0,4021
"17049950400",3520,294,5,0,72,6,2,0,3899
"17049950500",4015,255,1,0,60,7,29,0,4367
"17049950600",4702,588,2,3,50,10,166,10,5531
"17049950700",2671,625,0,0,135,77,92,3,3603
"17049950800",3110,721,17,27,43,14,118,8,4058
"17051950500",2175,506,0,0,16,10,0,0,2707
"17051950600",1880,442,0,0,92,12,0,0,2426
"17051950700",3879,520,16,16,81,114,0,0,4626
"17051950800",2719,394,26,5,19,70,29,10,3272
"17051950900",1375,397,7,6,38,14,65,0,1902
"17051951000",1900,196,10,0,18,0,35,0,2159
"17051951100",2375,942,0,0,18,0,12,53,3400
"17053961600",1624,289,0,0,32,1,66,28,2040
"17053961700",1836,238,0,0,18,0,52,7,2151
"17053961800",3608,346,13,19,53,0,133,0,4172
"17053961900",1507,257,12,0,21,5,24,20,1846
"17053962000",2833,572,0,0,50,63,0,0,3518
"17055040100",2401,361,15,0,107,28,67,0,2979
"17055040200",2752,450,4,0,17,6,14,18,3261
"17055040300",2652,563,26,0,0,14,16,0,3271
"17055040400",3074,811,0,6,27,13,42,8,3981
"17055040500",2025,490,0,0,55,20,0,0,2590
"17055040600",2232,615,0,0,20,18,51,111,3047
"17055040700",3310,926,5,0,4,78,144,0,4467
"17055040800",3186,452,5,4,28,11,10,0,3696
"17055040900",1798,522,0,13,0,114,7,16,2470
"17055041000",1801,732,0,0,38,56,5,18,2650
"17055041100",2879,310,37,25,88,6,10,0,3355
"17055041200",3143,543,0,2,50,2,22,0,3762
"17057952800",2244,350,0,0,32,0,74,7,2707
"17057952900",2473,275,0,7,65,0,50,2,2872
"17057953000",1970,230,22,3,64,1,34,11,2335
"17057953100",2026,239,35,0,45,5,9,6,2365
"17057953200",2321,412,73,0,38,8,25,2,2879
"17057953300",2969,460,0,0,23,0,0,0,3452
"17057953400",1393,436,34,0,33,19,15,0,1930
"17057953500",2285,990,14,0,37,19,112,124,3581
"17057953600",3528,565,114,6,71,0,100,23,4407
"17057953700",2417,183,0,0,42,1,11,0,2654
"17057953800",2341,271,0,0,7,2,30,3,2654
"17057953900",2338,318,56,12,45,26,16,2,2813
"17059972700",1925,383,0,0,114,4,0,0,2426
"17059972800",2448,435,18,3,18,12,50,0,2984
"17061973600",3039,407,0,2,54,10,44,0,3556
"17061973700",1354,388,0,0,36,3,16,29,1826
"17061973800",1697,319,0,0,24,8,8,8,2064
"17061973900",1694,745,0,0,16,0,22,0,2477
"17061974000",2895,349,0,0,20,0,0,0,3264
"17063000102",6872,304,66,0,329,42,872,0,8485
"17063000103",5090,402,290,15,530,0,766,0,7093
"17063000200",5903,321,7,145,373,5,784,47,7585
"17063000300",2882,429,25,0,76,0,516,209,4137
"17063000400",4339,669,31,15,82,0,90,77,5303
"17063000500",2558,178,3,5,128,0,33,42,2947
"17063000600",2422,442,0,0,51,59,196,98,3268
"17063000700",4896,655,8,32,131,47,72,108,5949
"17063000800",4707,326,50,0,163,0,322,7,5575
"17063000900",3310,426,3,4,86,10,213,33,4085
"17065973100",2550,458,6,1,0,0,5,0,3020
"17065973200",1806,466,0,31,7,0,0,0,2310
"17065973300",2612,255,0,0,8,0,9,0,2884
"17067953700",1942,328,0,0,36,10,3,0,2319
"17067953800",2414,184,1,0,42,5,42,33,2721
"17067953900",1651,243,16,1,3,32,16,12,1974
"17067954000",2321,221,23,0,45,7,36,26,2679
"17067954100",2768,378,17,0,13,0,0,14,3190
"17067954200",2148,180,0,0,45,17,43,13,2446
"17067954300",2818,534,2,2,31,17,4,3,3411
"17069970900",1599,441,0,2,24,7,0,0,2073
"17069971000",1664,357,0,8,32,49,19,51,2180
"17071973300",2168,230,4,0,38,37,21,7,2505
"17071973400",1699,109,0,0,19,0,18,0,1845
"17071973500",2310,301,0,0,52,15,33,14,2725
"17073030100",4796,443,4,0,257,0,291,0,5791
"17073030201",4505,283,23,0,51,21,37,0,4920
"17073030202",3295,329,20,0,63,0,59,0,3766
"17073030203",4139,100,18,0,41,7,113,7,4425
"17073030300",6418,371,37,0,105,140,155,45,7271
"17073030400",2089,344,0,0,13,1,14,4,2465
"17073030500",1994,143,5,10,58,32,25,9,2276
"17073030600",1886,307,84,30,300,79,580,120,3386
"17073030800",2151,708,58,134,225,100,199,236,3811
"17073030900",2562,592,32,38,368,13,414,14,4033
"17073031000",2900,326,103,67,118,39,68,51,3672
"17073031100",2272,318,0,5,24,16,50,7,2692
"17073031200",2633,257,33,0,55,3,83,0,3064
"17075950100",2261,424,9,126,63,8,20,13,2924
"17075950200",3379,376,21,7,74,3,37,32,3929
"17075950300",2987,313,12,10,24,0,57,27,3430
"17075950400",2540,754,61,0,15,301,97,263,4031
"17075950500",3058,729,2,77,96,0,45,55,4062
"17075950600",2504,464,13,0,234,138,612,285,4250
"17075950700",2346,237,7,17,35,2,57,34,2735
"17075950800",2072,237,0,5,29,0,79,3,2425
"17075950900",1894,454,0,0,58,53,19,67,2545
"17077010100",2840,383,0,0,6,18,125,18,3390
"17077010200",3309,739,60,18,118,102,61,106,4513
"17077010300",2272,365,3,0,5,39,4,0,2688
"17077010400",3783,496,66,84,32,30,0,0,4491
"17077010600",5030,857,150,164,47,13,28,0,6289
"17077010700",1474,672,296,234,91,126,0,0,2893
"17077010800",1667,725,503,195,313,20,178,23,3624
"17077010900",1004,257,736,403,48,102,55,133,2738
"17077011000",4065,289,634,232,655,178,105,0,6158
"17077011100",678,1099,43,665,167,225,70,193,3140
"17077011200",1197,1324,368,1581,151,346,39,211,5217
"17077011400",940,1967,167,179,294,227,261,51,4086
"17077011600",2996,334,88,138,354,0,32,25,3967
"17077011700",1014,1363,324,137,495,527,11,457,4328
"17079977300",2652,135,4,0,128,10,73,10,3012
"17079977400",2234,509,15,9,0,0,0,7,2774
"17079977500",3589,206,0,0,29,12,19,5,3860
"17081050100",3322,517,0,0,141,7,83,0,4070
"17081050200",2612,415,2,11,14,92,12,0,3158
"17081050300",3837,492,17,0,121,27,97,7,4598
"17081050400",3006,662,0,28,70,0,54,0,3820
"17081050500",2337,534,445,22,176,43,14,2,3573
"17081050600",2616,159,146,0,184,34,17,0,3156
"17081050700",3000,595,17,30,118,29,54,0,3843
"17081050800",3375,571,7,8,88,11,9,9,4078
"17081050900",1445,344,456,146,69,0,53,18,2531
"17081051000",572,242,241,287,38,220,47,59,1706
"17081051100",1449,567,251,62,62,24,11,98,2524
"17083010100",3895,607,3,0,78,0,24,2,4609
"17083010200",3270,151,0,0,0,0,57,0,3478
"17083010300",3079,197,6,0,114,0,3,0,3399
"17083010401",6406,186,0,0,100,0,137,1,6830
"17083010402",1792,198,2,0,84,13,1,0,2090
"17083010500",1169,214,0,15,83,9,14,21,1525
"17085020100",4035,526,5,0,40,15,100,1,4722
"17085020200",4315,299,11,9,146,28,38,0,4846
"17085020300",3952,405,0,0,81,21,286,104,4849
"17085020401",2061,34,0,0,0,0,35,0,2130
"17085020402",2427,294,9,0,35,28,50,9,2852
"17085020500",2942,370,8,0,49,3,19,0,3391
"17087977600",3575,640,25,0,145,0,7,0,4392
"17087977700",2725,240,0,0,56,0,72,0,3093
"17087977800",2642,656,49,32,41,8,54,7,3489
"17087980000",29,13,0,0,0,0,0,0,42
"17089850101",4335,494,50,52,1661,319,2293,658,9862
"17089850103",5130,61,166,29,872,0,712,0,6970
"17089850105",6095,356,45,0,891,0,737,29,8153
"17089850106",6507,226,0,0,1227,353,1038,353,9704
"17089850201",2072,282,5,264,1446,249,2501,453,7272
"17089850202",3129,495,96,134,2291,467,4515,915,12042
"17089850301",3175,625,255,1026,1670,508,3680,1045,11984
"17089850302",2929,155,239,258,768,402,1883,360,6994
"17089850400",1841,286,0,0,73,27,160,235,2622
"17089850500",2981,187,336,0,161,161,156,191,4173
"17089850600",5754,200,144,12,1113,147,577,14,7961
"17089850701",15022,189,742,166,3157,714,2912,758,23660
"17089850702",13362,343,39,0,565,36,971,0,15316
"17089850703",1972,281,1,1,11,0,68,51,2385
"17089850800",4975,620,73,0,923,63,3525,230,10409
"17089851000",3839,388,321,132,1639,209,2050,329,8907
"17089851101",2746,210,444,2,718,40,1516,56,5732
"17089851102",1931,519,118,142,486,260,976,658,5090
"17089851301",2273,298,138,41,1107,246,2492,472,7067
"17089851302",1461,462,243,172,930,232,1917,621,6038
"17089851400",2795,410,306,65,2751,405,4118,450,11300
"17089851500",545,176,35,0,130,164,294,278,1622
"17089851600",4365,868,99,251,653,283,2459,835,9813
"17089851801",5903,635,86,0,724,0,778,360,8486
"17089851904",4637,858,115,111,1287,344,1828,1080,10260
"17089851905",9378,268,817,0,2411,39,1510,0,14423
"17089851907",5010,175,504,0,1603,0,1788,17,9097
"17089851908",2807,167,312,132,1313,116,1611,140,6598
"17089851909",3154,340,44,12,816,48,1213,208,5835
"17089851910",2748,128,237,103,1344,330,1694,333,6917
"17089852001",3571,162,90,45,296,15,613,15,4807
"17089852002",5985,286,0,0,820,182,577,182,8032
"17089852003",7319,129,0,0,322,13,186,0,7969
"17089852101",6303,332,0,1,536,0,145,0,7317
"17089852102",7979,162,67,0,947,0,529,0,9684
"17089852201",4320,109,53,0,157,0,286,0,4925
"17089852202",6080,373,200,97,1343,141,1333,129,9696
"17089852300",1747,195,0,4,120,0,115,14,2195
"17089852401",8102,356,68,0,148,38,292,62,9066
"17089852402",7873,340,106,0,153,52,242,88,8854
"17089852403",4801,216,25,18,163,10,115,13,5361
"17089852500",5807,307,186,0,299,28,323,27,6977
"17089852601",6773,481,0,10,212,181,362,158,8177
"17089852606",3989,41,0,1,122,0,92,24,4269
"17089852700",6335,410,199,0,680,26,986,140,8776
"17089852803",3486,435,131,181,263,43,128,219,4886
"17089852805",4753,63,113,20,345,189,557,155,6195
"17089852806",6507,84,23,0,384,0,362,0,7360
"17089852807",2681,152,0,0,277,84,140,0,3334
"17089852808",6701,314,74,85,549,0,440,94,8257
"17089852903",3543,218,599,188,1535,55,1680,197,8015
"17089852904",786,69,132,331,881,437,1450,444,4530
"17089852905",1867,356,470,522,946,360,1698,475,6694
"17089852906",3108,234,378,126,1240,216,1475,336,7113
"17089852907",2011,544,325,24,2482,293,3065,697,9441
"17089853001",1686,67,274,27,683,9,803,68,3617
"17089853004",2141,159,99,22,305,173,298,63,3260
"17089853005",3087,536,702,45,895,585,1613,606,8069
"17089853006",1810,160,333,111,754,342,1222,285,5017
"17089853007",2121,272,710,275,1439,567,2053,584,8021
"17089853008",2321,630,567,16,1211,140,1991,485,7361
"17089853100",1530,164,183,23,777,341,1306,428,4752
"17089853200",2406,583,574,404,1716,404,2553,599,9239
"17089853300",3029,462,24,1,1147,489,3352,928,9432
"17089853400",2638,370,598,0,4258,1793,6687,2105,18449
"17089853500",1941,653,534,21,3034,715,4600,1246,12744
"17089853600",1894,503,552,354,3187,2338,4275,2687,15790
"17089853900",3944,935,353,0,916,187,1142,18,7495
"17089854001",3670,134,145,5,435,47,554,72,5062
"17089854002",2976,563,140,380,670,191,1150,453,6523
"17089854100",1702,210,37,287,2606,340,3550,451,9183
"17089854200",1793,379,382,143,2538,920,3473,1151,10779
"17089854301",2524,368,213,71,3310,922,4904,1218,13530
"17089854302",2029,341,114,9,2162,641,3207,901,9404
"17089854400",6342,904,1186,1105,2794,1957,4162,2509,20959
"17089854501",13662,316,357,23,1084,43,865,0,16350
"17089854503",8984,269,801,0,1820,186,2162,395,14617
"17089854504",6770,237,439,0,337,0,433,0,8216
"17089854600",1676,452,258,202,817,340,1698,496,5939
"17089854700",887,378,199,180,425,305,748,393,3515
"17089854800",7640,86,26,0,360,52,140,0,8304
"17089854900",3273,422,440,332,613,64,1016,227,6387
"17091010100",2167,196,3,4,64,16,71,41,2562
"17091010201",1723,52,44,0,37,3,41,0,1900
"17091010202",8514,740,47,12,257,0,454,15,10039
"17091010300",3269,278,3,23,54,6,73,0,3706
"17091010400",4568,232,32,0,74,16,52,8,4982
"17091010500",5193,384,231,73,322,0,334,0,6537
"17091010601",4494,146,615,0,358,0,203,0,5816
"17091010602",3885,835,181,173,187,256,443,131,6091
"17091010701",3909,109,741,0,96,0,797,0,5652
"17091010702",5660,546,228,4,351,0,346,0,7135
"17091010800",2552,314,451,197,139,12,293,122,4080
"17091010900",3655,451,48,55,126,0,593,6,4934
"17091011000",249,118,1163,614,57,25,108,48,2382
"17091011100",1735,303,24,2,64,0,366,86,2580
"17091011200",1909,35,123,0,114,4,31,6,2222
"17091011300",1725,219,147,8,63,7,93,73,2335
"17091011400",721,106,345,361,226,48,214,28,2049
"17091011500",218,79,872,838,51,42,129,71,2300
"17091011600",12,189,626,671,6,0,0,182,1686
"17091011700",1455,686,182,744,78,175,289,336,3945
"17091011800",2387,217,17,0,33,75,139,25,2893
"17091011900",1209,162,12,1,3,5,126,8,1526
"17091012000",2300,513,138,687,116,18,84,184,4040
"17091012100",2300,150,205,141,126,197,321,206,3646
"17091012200",2400,560,599,109,41,0,261,304,4274
"17091012300",1210,758,938,1257,412,88,902,410,5975
"17091012400",2439,236,1077,402,198,121,749,243,5465
"17091012500",1342,645,253,214,126,42,150,232,3004
"17091012600",3817,330,50,15,46,15,23,14,4310
"17093890101",14536,206,1983,0,3554,46,3176,212,23713
"17093890102",11880,229,172,220,571,0,1046,0,14118
"17093890201",3816,517,19,67,382,43,1078,43,5965
"17093890202",2411,248,192,0,238,59,798,83,4029
"17093890301",5019,152,277,188,366,0,1443,0,7445
"17093890302",5198,422,8,0,62,113,282,27,6112
"17093890400",22058,710,1777,0,2498,390,4129,615,32177
"17093890500",9613,1407,637,122,1274,247,3528,523,17351
"17093890600",8126,356,537,6,398,2,422,16,9863
"17093890700",12398,640,1346,195,1286,31,1756,328,17980
"17095000100",2867,143,0,0,89,3,70,0,3172
"17095000200",2424,174,14,8,88,9,51,7,2775
"17095000300",3223,485,223,185,99,33,100,107,4455
"17095000400",3423,516,18,141,153,34,131,0,4416
"17095000500",2882,229,89,228,79,51,96,55,3709
"17095000600",2760,344,48,116,64,19,104,45,3500
"17095000700",1328,243,156,142,127,100,86,80,2262
"17095000800",888,618,60,48,31,23,24,20,1712
"17095000900",762,872,358,196,105,32,127,271,2723
"17095001000",2590,695,206,40,262,337,399,330,4859
"17095001100",1114,587,143,539,0,0,69,17,2469
"17095001200",1469,104,38,0,39,14,28,0,1692
"17095001300",3144,393,14,0,33,0,31,0,3615
"17095001400",1480,205,0,0,5,0,27,0,1717
"17095001500",2862,671,65,0,60,74,56,0,3788
"17095001600",2980,329,3,2,13,31,23,3,3384
"17097860101",5282,264,1980,207,1208,42,1928,35,10946
"17097860103",3110,113,0,19,131,0,208,0,3581
"17097860104",2697,367,246,11,177,0,184,10,3692
"17097860200",1674,143,455,335,287,10,362,154,3420
"17097860301",1617,231,617,495,439,53,1330,278,5060
"17097860302",1254,175,768,485,449,61,932,111,4235
"17097860400",2688,288,1266,300,685,115,1281,173,6796
"17097860500",1663,677,982,662,741,157,1123,397,6402
"17097860600",5216,634,386,212,553,128,1655,508,9292
"17097860805",1229,217,13,11,169,14,7,87,1747
"17097860806",4438,584,14,0,42,52,490,94,5714
"17097860807",2852,373,0,0,67,0,213,0,3505
"17097860808",2111,277,0,0,49,9,146,8,2600
"17097860809",3074,198,32,0,107,0,92,0,3503
"17097860810",6151,633,121,63,372,0,539,93,7972
"17097860811",3233,199,303,1,428,4,303,10,4481
"17097860903",4307,861,28,0,713,24,576,0,6509
"17097860904",4980,269,55,0,128,14,635,41,6122
"17097860905",5028,614,0,0,562,32,654,284,7174
"17097860906",7542,385,293,11,864,32,2044,28,11199
"17097861007",3635,50,101,0,397,0,185,35,4403
"17097861008",4567,162,29,16,465,39,506,61,5845
"17097861009",4218,217,85,0,486,64,344,17,5431
"17097861010",4707,408,146,0,566,15,832,125,6799
"17097861011",6299,153,332,26,716,149,1522,0,9197
"17097861012",5111,357,79,0,31,20,266,8,5872
"17097861013",2568,125,32,54,213,0,129,0,3121
"17097861014",2714,305,241,6,482,12,272,209,4241
"17097861105",3452,96,95,107,381,28,315,0,4474
"17097861106",6270,284,211,0,1387,178,948,263,9541
"17097861107",3401,45,120,0,257,0,335,0,4158
"17097861108",5561,206,0,3,422,77,610,3,6882
"17097861201",5370,827,15,0,660,73,3483,578,11006
"17097861202",3466,472,47,44,279,0,1492,343,6143
"17097861301",3247,613,127,227,606,125,1574,274,6793
"17097861303",3419,966,146,8,402,19,2556,677,8193
"17097861304",2431,661,0,0,217,0,1809,422,5540
"17097861402",6231,781,345,0,1390,53,2270,245,11315
"17097861403",2118,128,27,100,237,115,1518,96,4339
"17097861404",3744,1103,116,206,749,50,2230,916,9114
"17097861504",4009,651,622,0,2401,104,3075,539,11401
"17097861505",2953,0,65,24,664,0,421,0,4127
"17097861506",2658,424,994,303,1032,106,937,405,6859
"17097861507",1946,236,449,14,356,0,643,52,3696
"17097861508",2255,186,394,0,801,18,475,33,4162
"17097861509",2740,166,446,56,281,112,555,48,4404
"17097861510",3340,372,402,49,644,69,964,227,6067
"17097861603",5048,103,28,0,482,1,290,0,5952
"17097861604",4297,189,293,0,991,198,577,67,6612
"17097861607",3577,438,284,74,397,22,422,244,5458
"17097861608",2804,219,12,10,272,0,423,36,3776
"17097861609",2927,199,291,100,1126,0,459,124,5226
"17097861610",2733,31,192,49,436,30,242,0,3713
"17097861611",3191,54,293,0,770,84,477,0,4869
"17097861701",1539,62,24,31,218,0,574,7,2455
"17097861702",2471,154,388,134,868,102,1513,167,5797
"17097861803",3379,712,863,178,1196,160,2659,640,9787
"17097861804",1911,505,337,229,271,114,1707,512,5586
"17097861901",2461,270,497,1,853,25,1483,250,5840
"17097861902",3173,507,618,502,1142,86,2764,642,9434
"17097862000",3348,239,427,379,881,7,3280,189,8750
"17097862100",2844,622,658,482,246,93,2231,558,7734
"17097862200",1316,563,332,216,605,234,995,641,4902
"17097862300",647,929,663,533,330,131,706,957,4896
"17097862401",2319,665,151,145,380,97,2180,696,6633
"17097862402",1772,869,297,88,264,73,1935,901,6199
"17097862501",2420,308,155,136,464,49,2653,334,6519
"17097862502",1033,737,433,53,149,41,1075,629,4150
"17097862603",4748,1420,613,216,1244,141,4139,1128,13649
"17097862604",2557,701,350,129,767,341,2430,863,8138
"17097862605",1538,306,500,1524,228,83,841,203,5223
"17097862700",1525,961,656,185,351,134,1760,1073,6645
"17097862800",374,125,692,480,172,128,472,241,2684
"17097862901",1455,811,636,301,513,171,1737,967,6591
"17097862902",700,155,902,343,192,145,721,203,3361
"17097863003",85,19,0,73,5,0,5,14,201
"17097863004",2322,284,403,72,499,114,554,0,4248
"17097863005",0,0,0,0,0,0,0,0,0
"17097863006",0,0,0,0,0,0,0,0,0
"17097863100",642,465,1068,384,131,0,632,337,3659
"17097863201",1059,405,1173,552,676,26,1448,395,5734
"17097863202",4127,243,69,0,644,51,291,75,5500
"17097863300",2384,101,20,0,93,0,0,0,2598
"17097863400",3346,258,0,0,12,0,53,0,3669
"17097863500",3521,196,7,0,192,0,69,0,3985
"17097863601",2887,39,83,6,405,0,80,4,3504
"17097863603",2782,30,20,1,519,8,104,1,3465
"17097863604",2769,65,29,34,153,0,212,0,3262
"17097863701",3753,397,11,0,218,20,210,6,4615
"17097863702",2804,73,37,0,703,16,194,0,3827
"17097863801",4329,118,10,4,199,18,205,24,4907
"17097863902",3714,191,118,51,1771,16,268,14,6143
"17097863903",3999,248,18,1,117,8,211,0,4602
"17097863904",4403,39,25,0,1455,12,81,36,6051
"17097864001",5091,507,0,0,740,84,1554,493,8469
"17097864002",4796,808,69,4,632,95,3325,737,10466
"17097864101",8572,266,798,7,1420,25,1350,0,12438
"17097864105",4641,148,459,79,949,0,448,139,6863
"17097864106",3725,285,22,0,271,0,895,207,5405
"17097864107",4184,291,82,0,270,6,757,25,5615
"17097864108",4686,290,0,3,664,134,1854,118,7749
"17097864203",3647,199,30,0,275,236,398,223,5008
"17097864204",3572,407,27,6,253,0,768,1,5034
"17097864205",7991,619,190,0,824,14,1013,208,10859
"17097864206",3142,385,0,6,70,27,1095,63,4788
"17097864303",4050,154,48,17,212,5,222,0,4708
"17097864305",3578,162,0,39,301,0,82,50,4212
"17097864306",2147,64,0,0,134,0,78,0,2423
"17097864307",1501,151,0,0,118,0,60,0,1830
"17097864308",3435,383,0,0,193,20,105,212,4348
"17097864402",6095,217,6,0,1043,54,287,0,7702
"17097864403",3984,156,264,10,492,25,264,18,5213
"17097864407",5095,107,62,12,587,0,30,0,5893
"17097864408",4624,153,12,0,705,61,973,40,6568
"17097864409",3806,157,48,102,702,0,627,0,5442
"17097864410",4419,125,0,0,628,44,29,81,5326
"17097864411",4646,58,0,0,263,7,61,11,5046
"17097864412",3558,106,28,0,370,71,145,6,4284
"17097864505",4760,244,510,38,1237,344,280,0,7413
"17097864510",2695,234,168,4,1266,70,1231,184,5852
"17097864511",3666,184,422,0,2088,63,537,53,7013
"17097864512",3544,133,5,0,694,190,555,188,5309
"17097864513",3898,100,103,0,1029,0,176,19,5325
"17097864514",1844,7,12,0,933,35,52,0,2883
"17097864515",2156,47,4,0,420,22,21,0,2670
"17097864516",3499,58,13,0,831,15,184,1,4601
"17097864517",2555,105,90,0,596,6,66,0,3418
"17097864518",3896,40,9,0,994,42,127,0,5108
"17097864519",3588,123,29,11,832,231,126,0,4940
"17097864520",3926,29,122,3,1313,52,154,0,5599
"17097864521",1700,83,29,0,636,0,30,7,2485
"17097864522",3825,143,0,0,451,43,69,0,4531
"17097864601",3325,209,48,0,234,2,27,0,3845
"17097864602",3253,73,58,0,427,0,98,0,3909
"17097864700",2591,11,150,1,79,1,156,0,2989
"17097864801",4536,118,8,0,240,41,213,18,5174
"17097864802",2411,96,1,14,270,1,55,0,2848
"17097864901",3852,177,125,1,76,8,68,6,4313
"17097864903",4415,151,0,0,242,47,23,0,4878
"17097864904",2036,67,0,0,200,0,76,0,2379
"17097865000",1215,34,0,0,55,0,40,0,1344
"17097865200",4156,765,214,0,384,70,2007,536,8132
"17097865300",2770,90,82,0,238,9,230,0,3419
"17097865400",3355,525,144,9,193,18,327,372,4943
"17097865501",1897,138,22,70,168,6,287,87,2675
"17097865502",2063,137,51,0,181,19,211,20,2682
"17097865600",3382,132,8,0,114,0,69,0,3705
"17097865700",5240,519,0,0,167,0,113,63,6102
"17097865801",2770,109,2,2,152,41,148,0,3224
"17097865802",2824,24,0,0,72,0,9,10,2939
"17097866000",5107,124,959,63,535,0,739,14,7541
"17097866100",1766,364,438,201,257,287,1675,671,5659
"17097866200",4394,386,62,44,407,10,215,17,5535
"17097990000",0,0,0,0,0,0,0,0,0
"17099961701",6027,295,0,0,79,34,165,0,6600
"17099961702",2761,188,1,2,36,10,112,30,3140
"17099961800",3416,544,0,0,51,3,345,20,4379
"17099961900",3404,681,86,76,144,12,639,411,5453
"17099962000",2635,383,0,0,376,116,869,129,4508
"17099962100",3858,635,0,0,178,49,459,90,5269
"17099962200",4132,489,18,0,58,0,100,145,4942
"17099962300",5209,491,112,0,139,17,141,4,6113
"17099962400",3246,576,0,0,27,52,107,69,4077
"17099962500",1805,324,0,0,61,15,59,18,2282
"17099962600",4259,678,165,96,23,141,241,295,5898
"17099962700",1534,489,109,63,88,0,208,66,2557
"17099962800",2823,515,107,0,120,57,237,67,3926
"17099962900",2630,326,0,3,40,9,400,5,3413
"17099963000",3400,550,36,67,37,16,62,114,4282
"17099963100",3128,118,0,0,7,0,118,0,3371
"17099963200",2875,237,6,21,159,13,412,23,3746
"17099963300",1914,534,1,6,132,0,357,38,2982
"17099963400",3654,328,14,0,0,0,209,11,4216
"17099963500",3728,382,37,2,126,82,300,0,4657
"17099963600",2963,250,149,10,75,43,124,26,3640
"17099963700",4427,778,38,0,23,3,128,41,5438
"17099963800",3100,706,35,71,187,99,305,126,4629
"17099963900",4351,528,2,154,356,90,701,172,6354
"17099964000",2259,114,0,0,15,11,47,3,2449
"17099964100",3556,415,7,0,40,25,168,147,4358
"17099964200",1823,507,62,13,162,0,227,25,2819
"17099964300",2099,779,33,65,128,0,188,58,3350
"17101880700",1888,237,12,0,0,0,61,0,2198
"17101880800",1862,404,10,1,9,1,2,9,2298
"17101880900",1561,158,0,0,2,0,24,0,1745
"17101881000",1632,268,23,0,88,55,83,33,2182
"17101881100",2481,309,16,14,59,62,26,4,2971
"17103000100",2353,271,21,4,80,33,78,41,2881
"17103000200",3200,110,7,3,78,0,33,1,3432
"17103000300",3440,392,22,30,202,18,129,14,4247
"17103000400",4057,597,105,13,40,62,195,107,5176
"17103000500",4124,234,117,0,116,20,258,26,4895
"17103000600",2363,557,116,35,251,22,137,20,3501
"17103000700",1783,290,0,5,26,2,80,32,2218
"17103000800",3006,383,1,9,65,0,114,18,3596
"17103000900",2687,441,14,5,161,19,205,25,3557
"17105960100",3446,476,15,20,52,3,123,53,4188
"17105960200",3069,319,14,0,63,23,56,8,3552
"17105960300",2357,158,16,0,8,0,135,0,2674
"17105960400",2666,298,0,5,39,4,65,20,3097
"17105960500",2177,506,4,11,44,6,61,75,2884
"17105960600",3461,626,12,5,46,1,137,1,4289
"17105960700",3069,367,32,0,66,11,66,10,3621
"17105960800",4820,420,0,0,36,0,141,28,5445
"17105960900",2128,295,0,0,41,0,53,28,2545
"17105961000",1946,314,0,0,21,29,63,19,2392
"17107952900",2348,363,54,12,135,16,54,1,2983
"17107953000",1787,124,7,2,101,9,39,1,2070
"17107953100",2260,440,48,181,121,266,0,0,3316
"17107953200",3027,405,10,0,283,70,130,0,3925
"17107953300",2388,335,36,0,335,270,18,0,3382
"17107953400",2776,416,18,37,153,22,132,22,3576
"17107953500",1749,122,1,0,133,5,21,8,2039
"17107953600",2120,180,0,0,97,28,6,2,2433
"17109010100",2999,523,79,33,47,44,14,0,3739
"17109010200",1667,179,0,0,33,2,24,0,1905
"17109010300",1956,56,35,0,107,18,77,0,2249
"17109010400",2425,2083,101,167,64,184,44,157,5225
"17109010500",32,71,0,23,0,15,5,0,146
"17109010600",1456,799,14,132,78,34,22,33,2568
"17109010700",3539,672,0,9,361,0,13,0,4594
"17109010900",1843,630,21,27,77,90,17,38,2743
"17109011000",2006,175,8,0,19,2,10,2,2222
"17109011100",2332,426,6,0,49,0,0,0,2813
"17111870101",6053,512,5,30,292,75,415,6,7388
"17111870102",6360,303,0,0,97,0,352,13,7125
"17111870200",5120,587,0,5,393,109,1043,294,7551
"17111870301",3293,503,0,0,661,396,1483,594,6930
"17111870302",2591,670,0,8,140,722,998,1111,6240
"17111870401",6879,771,60,9,488,0,892,5,9104
"17111870402",4001,399,58,184,459,325,1247,458,7131
"17111870500",7636,891,0,0,309,0,326,251,9413
"17111870603",3777,345,54,19,170,19,622,28,5034
"17111870604",5087,269,69,0,293,0,456,19,6193
"17111870605",5419,444,0,0,426,318,745,318,7670
"17111870606",3336,706,25,17,286,55,718,401,5544
"17111870702",6167,554,66,27,487,331,596,326,8554
"17111870703",5023,175,23,0,259,0,329,15,5824
"17111870704",3255,338,0,0,43,0,128,38,3802
"17111870803",7089,282,22,27,305,0,421,0,8146
"17111870807",4676,478,31,0,432,0,696,220,6533
"17111870808",3361,89,44,26,83,0,248,36,3887
"17111870809",5932,249,56,59,535,0,323,11,7165
"17111870810",4172,260,19,0,142,8,284,0,4885
"17111870811",4117,270,0,0,200,23,620,37,5267
"17111870812",4121,289,14,0,269,0,559,23,5275
"17111870902",6700,792,18,143,116,11,475,313,8568
"17111870903",2684,342,38,65,47,46,776,116,4114
"17111870904",3903,606,90,0,60,21,432,160,5272
"17111870905",3922,323,46,7,621,178,1254,123,6474
"17111871003",3800,417,48,0,178,16,492,9,4960
"17111871004",5038,438,18,0,327,57,800,64,6742
"17111871104",14247,776,287,22,2128,0,2136,176,19772
"17111871105",4886,72,103,0,337,0,326,0,5724
"17111871106",7864,362,247,0,469,0,599,113,9654
"17111871107",4402,255,75,19,385,21,120,0,5277
"17111871108",4646,120,150,0,533,0,411,0,5860
"17111871109",4677,36,0,0,399,0,550,8,5670
"17111871201",6066,287,15,0,258,19,367,34,7046
"17111871202",4567,557,275,7,200,168,1082,413,7269
"17111871205",3857,435,102,25,338,0,462,0,5219
"17111871206",5617,20,0,0,686,0,497,20,6840
"17111871207",4300,269,23,0,436,0,621,133,5782
"17111871208",3463,224,0,0,210,17,243,0,4157
"17111871209",2627,278,148,0,199,0,109,98,3459
"17111871301",4241,138,24,0,258,95,448,0,5204
"17111871304",2656,35,11,0,239,44,125,0,3110
"17111871305",5586,336,60,10,293,0,431,151,6867
"17111871306",6674,476,137,9,588,1,759,54,8698
"17111871307",4228,391,0,0,64,507,297,466,5953
"17111871310",4121,264,0,0,27,0,225,0,4637
"17111871311",3421,192,292,0,588,82,730,115,5420
"17111871402",5285,266,29,0,242,186,96,169,6273
"17111871404",4070,128,125,0,311,24,317,70,5045
"17111871500",10901,686,78,8,592,0,547,42,12854
"17111871600",4229,531,262,0,126,1,427,53,5629
"17113000102",3734,2110,442,343,383,55,289,0,7356
"17113000104",7053,1567,896,543,690,28,665,127,11569
"17113000105",4100,155,44,0,67,33,179,0,4578
"17113000200",107,715,0,37,0,15,7,22,903
"17113000301",1929,1317,121,142,277,139,110,53,4088
"17113000302",4086,244,632,951,175,0,136,200,6424
"17113000400",1371,1862,22,32,32,45,106,67,3537
"17113000501",1483,1003,83,106,93,30,62,0,2860
"17113000502",2561,76,1,9,94,0,62,0,2803
"17113000504",3645,475,630,135,507,42,192,65,5691
"17113000505",4718,40,67,0,1222,32,100,0,6179
"17113001103",2048,115,271,0,611,0,103,0,3148
"17113001104",6343,29,461,0,1305,39,91,0,8268
"17113001105",3833,160,318,37,929,0,295,0,5572
"17113001106",2149,84,568,208,567,41,163,1,3781
"17113001200",2085,394,15,67,92,9,365,100,3127
"17113001301",1317,152,57,19,42,1,33,40,1661
"17113001302",452,395,54,0,29,49,19,27,1025
"17113001303",977,457,33,59,115,0,25,58,1724
"17113001402",3104,142,251,81,230,6,162,15,3991
"17113001403",2404,502,176,631,50,11,106,209,4089
"17113001404",2918,487,247,49,286,0,493,0,4480
"17113001500",823,437,375,301,77,99,118,77,2307
"17113001600",983,517,285,505,67,23,80,52,2512
"17113001700",1289,436,104,211,106,23,90,106,2365
"17113001800",2831,187,60,7,155,54,48,11,3353
"17113002101",3745,486,251,106,247,11,1005,0,5851
"17113002102",1646,134,0,8,50,11,105,80,2034
"17113005101",6513,40,347,0,2026,14,250,0,9190
"17113005102",6556,354,20,0,298,0,40,2,7270
"17113005201",1216,22,9,0,39,0,41,0,1327
"17113005202",2854,94,51,5,42,0,31,0,3077
"17113005400",8623,316,110,13,240,10,151,5,9468
"17113005501",2112,180,6,0,28,0,36,0,2362
"17113005502",2339,105,0,0,21,0,8,0,2473
"17113005601",1569,200,5,0,38,19,14,6,1851
"17113005602",2023,210,6,2,38,0,31,1,2311
"17113005700",4619,387,14,31,74,0,108,6,5239
"17113005800",2780,234,133,44,945,0,50,0,4186
"17113005900",3069,538,440,590,83,34,163,0,4917
"17113006000",3202,270,84,0,123,22,35,15,3751
"17115000200",826,467,573,658,136,125,38,42,2865
"17115000300",834,808,1021,598,114,133,56,22,3586
"17115000400",420,89,265,299,151,127,11,0,1362
"17115000500",763,1057,163,549,122,185,50,30,2919
"17115000600",291,184,711,334,140,56,9,0,1725
"17115000900",506,324,602,335,93,73,53,87,2073
"17115001000",803,199,121,160,31,6,8,0,1328
"17115001100",2304,270,96,175,351,15,61,0,3272
"17115001200",1631,565,556,67,42,14,0,0,2875
"17115001300",2007,72,180,11,64,28,48,0,2410
"17115001400",1998,46,131,122,9,0,0,0,2306
"17115001500",3534,281,226,50,219,0,45,0,4355
"17115001600",994,107,135,110,48,31,10,0,1435
"17115001700",1566,379,302,93,91,178,0,8,2617
"17115001801",1713,93,473,24,145,0,27,0,2475
"17115001802",1662,657,196,44,132,96,98,9,2894
"17115001900",975,324,389,643,209,34,74,9,2657
"17115002000",1359,534,537,242,151,235,60,88,3206
"17115002100",797,630,21,47,68,40,0,162,1765
"17115002200",4053,551,358,12,325,85,101,0,5485
"17115002300",2667,135,0,0,75,39,75,11,3002
"17115002401",2027,75,117,1,104,0,32,9,2365
"17115002402",4621,403,206,23,178,0,143,0,5574
"17115002500",6290,174,179,0,356,62,62,62,7185
"17115002601",3868,88,22,0,78,0,23,6,4085
"17115002602",1894,150,14,0,100,6,7,0,2171
"17115002700",2040,209,0,0,0,4,0,8,2261
"17115002800",3725,296,23,14,194,30,23,54,4359
"17115002901",3427,168,141,4,388,0,85,0,4213
"17115002902",3471,275,351,9,198,0,0,0,4304
"17115002903",1900,736,654,275,334,31,10,67,4007
"17115002904",3649,790,136,196,208,217,105,0,5301
"17115003000",3048,175,6,3,198,55,46,3,3534
"17115003100",181,259,321,763,58,75,37,5,1699
"17117956000",3072,248,8,0,12,0,8,0,3348
"17117956100",2609,434,6,0,114,5,5,0,3173
"17117956200",1960,211,0,0,37,3,13,0,2224
"17117956300",2590,287,5,0,27,17,32,10,2968
"17117956400",4160,843,103,0,55,0,0,0,5161
"17117956500",2513,137,21,0,48,5,0,0,2724
"17117956600",4300,339,37,0,21,11,11,41,4760
"17117956700",3650,285,62,9,61,48,35,43,4193
"17117956800",2073,370,0,3,101,71,3,0,2621
"17117956900",2920,647,0,0,127,20,36,0,3750
"17117957000",2910,762,14,0,60,15,65,8,3834
"17117957100",2423,209,0,0,0,3,0,0,2635
"17117957200",3869,686,0,0,42,61,105,0,4763
"17119400101",2220,301,8,61,0,6,120,28,2744
"17119400102",3338,672,242,61,283,175,212,126,5109
"17119400200",2445,948,328,152,134,121,149,90,4367
"17119400600",803,208,910,949,107,44,62,38,3121
"17119400700",18,20,1118,735,43,29,0,8,1971
"17119400801",1810,71,17,0,34,0,44,0,1976
"17119400802",4976,1139,81,144,15,0,145,50,6550
"17119400903",3374,900,420,242,224,0,470,69,5699
"17119400904",3257,394,36,0,52,27,77,0,3843
"17119400951",4572,247,18,0,221,0,82,0,5140
"17119400952",2047,566,122,251,67,33,71,248,3405
"17119401000",1912,623,0,0,15,25,6,99,2680
"17119401100",4986,985,0,1,42,18,52,18,6102
"17119401200",1463,267,0,0,51,0,19,15,1815
"17119401300",3861,1032,0,14,149,67,0,0,5123
"17119401400",2423,220,56,112,110,58,63,11,3053
"17119401500",1684,498,185,386,36,25,58,7,2879
"17119401701",1519,657,72,124,55,59,35,0,2521
"17119401721",4908,648,14,0,30,0,76,0,5676
"17119401722",2326,293,27,34,28,76,8,0,2792
"17119401800",5376,532,47,67,14,0,190,0,6226
"17119401901",1473,157,0,0,92,8,105,8,1843
"17119401903",3603,781,9,89,108,62,116,15,4783
"17119401904",573,38,0,0,9,0,0,0,620
"17119402000",2102,599,619,540,228,211,31,60,4390
"17119402100",1408,195,926,497,218,71,0,0,3315
"17119402200",2231,475,180,200,175,65,50,72,3448
"17119402300",1242,176,204,63,70,14,74,5,1848
"17119402400",800,211,280,363,90,11,3,0,1758
"17119402500",910,242,668,257,98,10,87,34,2306
"17119402600",1582,454,305,184,55,25,48,11,2664
"17119402701",5836,515,639,27,49,19,114,0,7199
"17119402721",6580,366,574,0,275,0,125,0,7920
"17119402722",2824,42,28,2,19,0,64,1,2980
"17119402801",2997,251,100,0,77,0,18,20,3463
"17119402802",7412,437,15,0,177,0,12,0,8053
"17119402803",2763,345,65,0,107,5,6,0,3291
"17119402900",3344,482,386,0,129,38,98,21,4498
"17119403001",3705,784,516,7,196,91,43,0,5342
"17119403002",5642,505,649,0,386,13,195,71,7461
"17119403101",2759,838,45,111,121,66,50,144,4134
"17119403121",7278,481,658,0,335,0,86,0,8838
"17119403122",4087,159,280,160,638,71,251,0,5646
"17119403200",3559,598,84,61,96,10,46,0,4454
"17119403300",2165,379,125,104,112,6,95,0,2986
"17119403401",2800,381,605,71,97,0,185,0,4139
"17119403402",4081,545,412,374,199,119,105,22,5857
"17119403502",5318,134,479,159,146,0,392,0,6628
"17119403531",6966,396,150,35,282,73,414,50,8366
"17119403532",4332,94,49,0,96,0,75,21,4667
"17119403533",8774,496,219,16,425,0,165,0,10095
"17119403534",3743,226,108,32,19,29,107,0,4264
"17119403601",2947,351,20,0,32,0,124,44,3518
"17119403603",1804,42,0,0,114,0,0,0,1960
"17119403604",5276,703,8,7,112,16,94,249,6465
"17119403701",5566,272,81,0,244,0,94,0,6257
"17119403702",5712,106,0,0,80,0,39,0,5937
"17119403801",4299,361,17,0,44,32,0,0,4753
"17119403802",4056,269,13,3,23,0,66,1,4431
"17119404000",1510,510,148,315,186,3,436,34,3142
"17119404100",2407,322,42,38,12,0,87,12,2920
"17121951600",2996,541,0,0,90,5,25,0,3657
"17121951700",2303,216,0,7,31,2,37,0,2596
"17121951800",1610,578,0,10,35,7,32,0,2272
"17121951900",2449,359,43,0,23,5,0,4,2883
"17121952000",3258,649,9,8,26,138,65,44,4197
"17121952100",2161,559,0,0,79,26,20,0,2845
"17121952200",3680,288,0,0,50,6,44,8,4076
"17121952300",3386,252,37,0,28,0,48,0,3751
"17121952400",2778,237,170,30,134,36,6,24,3415
"17121952500",1389,862,117,2,0,137,16,81,2604
"17121952600",1142,639,175,181,45,45,31,0,2258
"17121952700",1836,782,305,244,153,114,108,30,3572
"17123961100",2285,193,0,0,75,1,54,15,2623
"17123961200",2002,312,0,0,40,6,5,0,2365
"17123961300",1957,235,19,0,9,0,24,0,2244
"17123961400",2517,280,0,0,12,9,0,0,2818
"17123961500",1583,145,31,0,155,20,238,25,2197
"17125956300",2636,280,0,0,8,0,47,0,2971
"17125956400",1467,253,0,0,27,10,10,0,1767
"17125956500",2591,614,0,34,60,0,2,0,3301
"17125956600",1451,310,0,0,0,4,0,0,1765
"17125956700",1562,185,25,0,53,0,0,2,1827
"17125956800",1809,369,18,8,42,28,10,0,2284
"17127970100",4125,536,47,16,91,32,178,0,5025
"17127970200",2909,767,149,69,53,11,65,13,4036
"17127970300",2525,550,321,50,119,77,86,0,3728
"17127970400",1546,457,126,118,65,22,37,0,2371
"17129010100",5389,524,79,0,71,0,66,0,6129
"17129010200",3136,550,0,0,94,46,14,0,3840
"17129010300",2190,262,19,0,0,22,20,41,2554
"17131040100",4150,264,42,0,142,6,167,0,4771
"17131040200",3083,432,0,0,61,13,45,11,3645
"17131040300",3193,360,0,0,26,14,12,25,3630
"17131040400",3624,383,2,0,41,26,59,16,4151
"17133600101",6916,406,92,0,0,205,136,148,7903
"17133600102",4514,63,0,0,109,39,51,0,4776
"17133600401",5847,95,0,0,25,0,12,0,5979
"17133600402",4197,238,5,0,172,0,132,7,4751
"17133600501",6564,198,0,1,57,0,14,11,6845
"17133600502",3024,390,0,0,13,32,0,0,3459
"17135957300",2735,425,30,2,14,3,27,0,3236
"17135957400",1724,275,40,0,0,0,1,0,2040
"17135957500",2056,321,0,0,47,0,13,0,2437
"17135957600",2877,101,0,0,15,35,54,0,3082
"17135957700",2437,461,23,2,52,8,55,0,3038
"17135957800",2426,919,16,4,24,0,5,0,3394
"17135957900",3231,557,21,18,96,31,43,1,3998
"17135958000",2312,341,0,0,56,0,19,2,2730
"17137951400",2274,273,0,0,29,8,4,8,2596
"17137951500",2880,317,6,0,15,40,9,0,3267
"17137951600",1713,498,268,217,183,19,12,7,2917
"17137951700",1761,475,230,22,54,64,0,41,2647
"17137951800",2255,263,143,98,65,0,108,0,2932
"17137951900",4507,438,0,3,64,46,73,0,5131
"17137952000",1588,637,216,192,40,98,90,9,2870
"17137952100",3461,207,0,0,85,55,25,0,3833
"17137952200",2586,215,8,0,63,0,18,1,2891
"17137952300",2862,386,13,0,0,9,15,2,3287
"17139976900",4379,398,0,0,125,0,42,0,4944
"17139977000",1902,398,2,4,35,6,12,0,2359
"17139977100",2732,341,0,0,0,0,29,14,3116
"17139977200",3404,782,12,0,23,0,66,0,4287
"17141960700",4224,263,17,0,86,43,17,2,4652
"17141960800",3314,308,0,0,154,0,97,0,3873
"17141960900",3768,744,9,0,0,12,100,86,4719
"17141961000",5586,480,93,18,237,38,471,53,6976
"17141961100",4224,540,10,6,439,84,992,222,6517
"17141961200",4668,444,99,0,336,59,1132,168,6906
"17141961300",4172,450,0,0,37,0,145,13,4817
"17141961400",3058,798,8,0,77,9,31,23,4004
"17141961500",3810,411,9,0,38,0,123,10,4401
"17141961600",2468,389,242,47,228,30,813,239,4456
"17141961700",4749,304,9,0,69,0,146,23,5300
"17143000100",172,61,243,499,30,140,116,82,1343
"17143000200",506,116,472,430,41,57,101,49,1772
"17143000300",722,429,306,427,176,32,256,114,2462
"17143000500",410,105,445,747,79,55,239,15,2095
"17143000600",689,334,1267,715,82,89,115,184,3475
"17143000900",332,223,662,1024,26,26,14,73,2380
"17143001200",415,227,185,631,120,33,52,44,1707
"17143001300",430,344,449,414,176,128,349,130,2420
"17143001500",685,520,442,209,64,78,42,213,2253
"17143001600",1206,324,1026,781,256,153,188,15,3949
"17143001800",1009,669,668,346,150,85,110,37,3074
"17143001900",636,493,131,20,63,35,0,19,1397
"17143002000",852,395,65,94,78,60,53,43,1640
"17143002100",1060,520,1666,1234,103,121,117,106,4927
"17143002200",2061,283,850,344,197,103,69,257,4164
"17143002300",3781,250,369,43,147,73,111,137,4911
"17143002400",2836,208,572,181,492,0,89,16,4394
"17143002500",651,473,1510,534,450,31,297,167,4113
"17143002600",1380,201,160,3,22,38,16,30,1850
"17143002701",1581,388,843,504,238,209,149,169,4081
"17143002702",1922,356,854,446,276,72,147,0,4073
"17143002800",2324,204,451,111,226,85,21,0,3422
"17143002900",2689,236,264,195,281,41,20,0,3726
"17143003000",3118,405,265,195,442,21,235,4,4685
"17143003101",3251,132,372,342,1037,100,176,5,5415
"17143003102",3661,373,390,37,1224,42,59,0,5786
"17143003200",3202,474,627,30,553,40,114,0,5040
"17143003300",2790,105,36,0,111,0,8,0,3050
"17143003401",8113,953,90,0,2399,99,280,0,11934
"17143003402",3286,277,23,0,203,11,49,0,3849
"17143003601",2558,220,0,2,69,0,87,0,2936
"17143003602",4500,695,0,5,79,95,207,0,5581
"17143003700",3496,143,63,32,38,0,96,32,3900
"17143003800",3285,238,27,0,45,0,147,0,3742
"17143003900",5923,124,188,0,408,44,79,1,6767
"17143004000",4053,160,12,0,93,0,29,0,4347
"17143004101",5000,224,297,69,903,0,458,22,6973
"17143004102",1685,463,543,174,292,0,88,6,3251
"17143004200",2745,238,88,73,286,18,31,13,3492
"17143004300",1805,251,97,49,83,16,22,0,2323
"17143004400",2821,667,670,441,160,26,123,0,4908
"17143004500",4037,501,173,76,139,26,92,0,5044
"17143004600",4679,720,19,0,19,8,122,0,5567
"17143004801",4139,362,32,2,117,29,27,15,4723
"17143004802",3445,377,218,276,162,18,290,19,4805
"17143004901",3529,294,24,0,72,0,14,2,3935
"17143004902",4806,90,9,11,96,0,180,0,5192
"17143005000",166,194,988,863,182,209,75,66,2743
"17145030100",2512,375,38,0,121,0,53,30,3129
"17145030200",4575,681,5,120,142,0,6,0,5529
"17145030300",1731,357,0,0,2,3,0,21,2114
"17145030400",1645,482,110,202,50,178,43,56,2766
"17145030500",2241,173,18,0,50,8,39,0,2529
"17145030600",2852,797,114,4,68,0,0,0,3835
"17147954500",3991,240,0,0,74,18,26,8,4357
"17147954600",5687,346,21,9,69,0,107,0,6239
"17147954700",2977,179,5,0,94,19,31,0,3305
"17147954800",2360,208,14,0,81,0,6,0,2669
"17149952400",2680,373,13,0,55,5,46,5,3177
"17149952500",2162,232,2,14,45,0,19,34,2508
"17149952600",2774,406,0,0,108,2,31,0,3321
"17149952700",3557,582,0,0,47,25,0,17,4228
"17149952800",1969,488,0,0,31,6,2,0,2496
"17151971200",1852,238,11,21,21,0,5,0,2148
"17151971300",1528,332,32,13,50,11,44,15,2025
"17153971000",2053,361,373,165,71,0,79,12,3114
"17153971100",1115,289,958,361,91,2,7,4,2827
"17155954500",2428,290,0,0,37,70,84,8,2917
"17155954600",2597,320,3,7,25,4,129,58,3143
"17157950500",1777,216,15,0,50,0,35,0,2093
"17157950600",2569,475,627,529,57,11,25,0,4293
"17157950700",1940,331,28,0,16,8,0,0,2323
"17157950800",4535,166,0,0,143,0,217,0,5061
"17157950900",2959,495,1,0,75,6,14,13,3563
"17157951000",2475,139,0,0,28,0,58,0,2700
"17157951100",3292,287,0,0,68,29,128,56,3860
"17157951200",2112,345,150,83,39,15,0,15,2759
"17157951300",2822,674,44,7,22,0,26,45,3640
"17159977900",3025,374,0,6,34,1,67,0,3507
"17159978000",1593,642,11,23,0,0,19,0,2288
"17159978100",3299,503,0,9,118,11,130,0,4070
"17159978200",2111,394,11,0,87,0,0,0,2603
"17159978300",3038,419,0,0,88,0,20,0,3565
"17161020100",6264,433,25,0,173,32,210,64,7201
"17161020200",2423,332,282,195,315,88,266,39,3940
"17161020300",4530,714,448,52,529,80,557,428,7338
"17161020400",3544,316,247,95,460,137,581,26,5406
"17161020600",1266,548,197,113,386,42,872,124,3548
"17161020700",920,380,91,143,239,20,462,93,2348
"17161020800",4179,176,229,0,200,167,966,27,5944
"17161020900",3850,616,315,165,437,61,240,299,5983
"17161021000",1894,505,516,275,434,222,386,185,4417
"17161021100",2749,302,451,0,436,6,377,25,4346
"17161021200",3641,157,134,15,375,91,211,69,4693
"17161021300",3461,542,384,139,112,131,484,111,5364
"17161021400",902,171,175,0,28,0,287,46,1609
"17161021500",3269,304,164,87,278,18,284,74,4478
"17161021600",1788,327,24,20,322,22,365,136,3004
"17161021700",3044,721,131,35,149,73,850,86,5089
"17161021800",3756,454,110,0,289,0,345,89,5043
"17161021900",1325,230,48,106,58,16,63,16,1862
"17161022000",3307,285,44,0,349,19,552,12,4568
"17161022100",2190,175,24,23,255,9,273,0,2949
"17161022200",2595,363,0,0,449,176,977,189,4749
"17161022300",1476,178,29,29,319,37,1168,49,3285
"17161022600",563,330,731,317,97,71,180,108,2397
"17161022800",2436,597,200,137,387,76,486,56,4375
"17161022900",2139,191,61,88,295,19,220,12,3025
"17161023000",3212,128,91,0,141,53,111,32,3768
"17161023100",2106,56,231,18,106,0,169,0,2686
"17161023200",3491,445,379,146,112,93,328,88,5082
"17161023300",2058,498,205,134,106,61,351,157,3570
"17161023500",866,211,645,505,93,146,264,17,2747
"17161023600",164,194,814,668,145,173,188,85,2431
"17161023700",1095,269,544,312,288,49,285,85,2927
"17161024000",3737,205,62,0,119,0,76,9,4208
"17161024101",3469,316,0,0,41,21,212,23,4082
"17161024102",4326,603,46,42,124,88,103,188,5520
"17161024103",3620,266,3,0,72,123,57,59,4200
"17161024200",3197,632,270,0,126,99,119,109,4552
"17161024300",2429,257,2,2,103,7,69,0,2869
"17161024400",867,362,225,222,148,146,49,13,2032
"17161024500",684,447,198,162,241,70,305,97,2204
"17163500400",63,0,652,876,0,11,0,0,1602
"17163500500",4,4,1006,1932,15,76,0,3,3040
"17163500900",43,60,1728,2173,30,142,0,0,4176
"17163501100",0,0,923,471,16,0,12,0,1422
"17163501200",0,9,2013,1077,22,0,0,15,3136
"17163501300",9,0,2342,1217,0,23,93,0,3684
"17163501400",34,1,1678,812,62,1,0,1,2589
"17163501501",670,106,850,138,34,0,43,6,1847
"17163501502",1546,211,579,330,66,13,35,11,2791
"17163501602",3207,455,878,324,213,58,133,0,5268
"17163501603",2769,829,743,905,46,125,50,0,5467
"17163501604",1813,343,1086,883,241,0,141,33,4540
"17163501605",1859,23,339,28,45,0,93,0,2387
"17163501700",1674,320,562,182,26,57,7,16,2844
"17163501800",4009,598,420,573,365,135,94,0,6194
"17163501900",2394,398,142,140,218,38,79,0,3409
"17163502100",1431,642,0,0,199,113,1189,741,4315
"17163502200",68,8,1095,819,0,42,0,11,2043
"17163502300",1896,333,1669,2358,206,25,210,0,6697
"17163502401",0,6,1058,731,16,0,0,0,1811
"17163502404",1223,1150,586,281,199,17,467,588,4511
"17163502500",0,9,782,388,7,0,0,0,1186
"17163502602",1727,314,1652,1467,137,179,17,40,5533
"17163502603",843,198,1186,1168,0,56,0,100,3551
"17163502700",8,0,531,941,0,7,0,0,1487
"17163502800",0,90,1088,1378,0,16,25,16,2613
"17163502900",0,10,1207,496,0,10,0,0,1723
"17163503100",6105,1074,64,28,195,34,229,45,7774
"17163503202",4426,513,442,252,70,0,52,0,5755
"17163503203",6074,358,26,0,69,0,83,0,6610
"17163503211",3229,137,431,167,184,37,55,12,4252
"17163503301",2646,401,308,165,226,35,65,15,3861
"17163503304",4733,519,1034,198,403,134,136,25,7182
"17163503322",5971,438,642,193,566,35,224,0,8069
"17163503323",4941,344,946,54,279,12,395,12,6983
"17163503324",3338,26,1867,332,508,0,384,0,6455
"17163503332",2913,436,1057,210,155,0,57,39,4867
"17163503334",3755,263,1107,199,364,16,89,2,5795
"17163503402",4078,320,1706,365,611,21,339,64,7504
"17163503404",4465,130,445,156,272,12,206,43,5729
"17163503411",2217,287,296,107,123,107,34,107,3278
"17163503412",4382,368,375,107,280,10,82,0,5604
"17163503413",3602,309,1497,79,254,41,55,17,5854
"17163503414",2661,572,936,127,323,8,473,81,5181
"17163503800",965,0,55,0,35,13,39,0,1107
"17163503903",3332,130,263,18,321,0,190,0,4254
"17163503904",7132,241,1418,83,769,151,421,37,10252
"17163503905",2636,110,0,0,35,7,53,0,2841
"17163503906",5012,208,73,0,97,0,305,9,5704
"17163504001",4336,299,12,11,16,0,110,0,4784
"17163504002",4973,564,18,1,89,37,42,21,5745
"17163504302",5930,227,389,534,184,86,58,0,7408
"17163504303",6635,668,322,23,350,51,98,9,8156
"17163504351",2353,120,343,208,375,0,75,0,3474
"17163504352",3245,350,467,42,202,63,78,36,4483
"17163504353",3330,193,439,58,403,25,129,9,4586
"17163504354",4573,248,1041,0,212,0,97,0,6171
"17163504355",3982,97,524,262,391,60,141,25,5482
"17163504500",47,56,2646,2307,56,178,0,0,5290
"17163504600",24,25,1133,1107,0,0,0,1,2290
"17165955100",1722,604,54,0,33,0,6,23,2442
"17165955500",1401,638,13,28,9,69,0,0,2158
"17165955600",1857,434,0,0,1,0,26,2,2320
"17165955700",2096,334,0,0,10,26,2,0,2468
"17165955800",2018,711,12,20,173,0,0,34,2968
"17165955900",1698,803,27,102,99,13,21,118,2881
"17165956000",1949,684,23,141,135,8,51,9,3000
"17165956100",2078,461,201,88,137,8,10,26,3009
"17165956200",2692,300,54,30,31,32,7,3,3149
"17167000100",2517,485,136,166,97,129,21,0,3551
"17167000201",1805,216,206,31,63,29,75,10,2435
"17167000202",1936,785,257,187,118,41,66,15,3405
"17167000300",1699,240,205,106,75,23,60,55,2463
"17167000400",2035,235,194,162,38,31,17,0,2712
"17167000501",2057,128,73,17,29,0,15,0,2319
"17167000503",2581,733,187,80,63,18,43,33,3738
"17167000504",2036,463,184,0,52,32,70,23,2860
"17167000600",3228,1317,66,345,131,121,58,14,5280
"17167000700",1315,387,176,69,60,14,14,0,2035
"17167000800",499,428,634,618,40,71,18,0,2308
"17167000900",727,406,326,644,91,11,33,0,2238
"17167001001",1342,57,339,67,93,0,50,0,1948
"17167001003",1236,124,6,0,19,0,14,0,1399
"17167001004",3140,129,995,0,413,13,181,13,4884
"17167001100",1733,213,107,23,96,91,0,84,2347
"17167001200",2640,502,246,90,259,64,148,12,3961
"17167001300",784,306,297,182,400,22,7,22,2020
"17167001400",347,235,76,20,11,0,9,12,710
"17167001500",91,189,299,315,9,3,0,5,911
"17167001600",598,473,1367,1568,74,11,65,111,4267
"17167001700",91,124,445,451,38,86,8,0,1243
"17167001800",1210,238,399,508,101,13,27,45,2541
"17167001900",1907,449,307,449,48,18,161,35,3374
"17167002000",5084,137,157,23,290,39,74,65,5869
"17167002100",2836,88,302,77,87,5,92,5,3492
"17167002200",2640,289,227,282,121,4,39,20,3622
"17167002300",674,398,448,548,130,88,52,0,2338
"17167002400",851,511,1344,780,308,6,28,18,3846
"17167002500",2729,572,1270,436,125,142,38,8,5320
"17167002600",1275,453,210,136,69,423,5,0,2571
"17167002700",2596,644,97,0,51,64,17,27,3496
"17167002801",1837,273,330,127,133,85,48,0,2833
"17167002802",1483,610,368,526,113,330,202,124,3756
"17167002900",3600,193,446,169,305,82,99,21,4915
"17167003000",3530,569,583,134,72,118,0,10,5016
"17167003100",6456,137,224,2,171,19,209,0,7218
"17167003201",4048,226,90,0,433,45,199,12,5053
"17167003202",3826,175,23,17,39,0,58,23,4161
"17167003203",5247,226,44,29,213,0,110,18,5887
"17167003300",4351,461,10,0,42,20,11,0,4895
"17167003400",5599,348,83,14,75,0,83,0,6202
"17167003500",4685,454,5,22,80,7,92,69,5414
"17167003601",2521,130,34,0,49,0,20,0,2754
"17167003602",3949,102,92,0,312,0,0,0,4455
"17167003603",4645,176,96,0,266,6,88,0,5277
"17167003604",3813,88,326,0,446,0,93,0,4766
"17167003700",8113,166,0,0,218,7,51,0,8555
"17167003801",1911,610,11,9,146,6,23,0,2716
"17167003802",4763,893,25,0,103,34,12,73,5903
"17167003901",5009,27,0,0,91,14,0,0,5141
"17167003902",3631,179,0,11,12,49,82,0,3964
"17167004000",3754,365,28,10,92,51,21,51,4372
"17169970100",1620,477,0,244,0,0,4,8,2353
"17169970200",2417,532,70,5,47,10,0,0,3081
"17169970300",1604,114,0,0,16,0,17,0,1751
"17171970600",1590,270,0,0,8,0,29,0,1897
"17171970700",2671,431,0,0,48,11,0,0,3161
"17173959100",3019,422,43,8,44,0,20,0,3556
"17173959200",2599,277,0,0,6,0,7,0,2889
"17173959300",4818,524,0,0,26,34,50,0,5452
"17173959400",2927,470,50,0,18,5,22,42,3534
"17173959500",2984,335,0,0,59,0,4,12,3394
"17173959600",2798,364,4,0,13,10,4,31,3224
"17175951400",2611,436,20,3,20,20,27,3,3140
"17175951500",2355,213,0,0,44,12,18,12,2654
"17177000100",4113,251,36,5,85,11,49,7,4557
"17177000200",3085,198,0,0,31,3,24,11,3352
"17177000300",3375,346,0,0,48,20,10,14,3813
"17177000400",2488,357,0,0,16,0,54,10,2925
"17177000500",2730,111,74,0,103,0,27,6,3051
"17177000600",2902,321,29,0,17,33,29,4,3335
"17177000700",597,210,381,305,57,96,0,0,1646
"17177000800",1552,698,459,417,53,58,95,0,3332
"17177000900",3507,651,360,123,109,49,33,112,4944
"17177001000",3304,243,83,87,213,74,120,80,4204
"17177001100",2655,332,221,138,115,19,35,33,3548
"17177001200",2146,390,508,108,216,27,103,18,3516
"17177001300",2322,578,498,373,382,217,471,133,4974
"17179020100",2049,434,20,0,36,13,47,11,2610
"17179020301",3681,534,35,0,290,0,106,0,4646
"17179020302",4413,560,137,0,66,0,0,0,5176
"17179020400",4740,654,43,0,60,52,7,0,5556
"17179020500",4129,338,7,14,58,1,137,0,4684
"17179020600",1757,270,0,0,51,40,6,7,2131
"17179020700",4188,339,7,0,54,0,10,9,4607
"17179020800",2698,621,0,0,70,15,77,58,3539
"17179020900",1677,321,19,14,17,5,0,0,2053
"17179021000",5023,567,35,1,0,92,65,0,5783
"17179021101",5087,1073,2,1,141,47,38,63,6452
"17179021102",5130,585,21,0,107,40,89,0,5972
"17179021201",4147,99,0,75,211,0,90,0,4622
"17179021202",3080,89,56,1,131,19,100,38,3514
"17179021203",4057,514,29,118,245,50,72,107,5192
"17179021500",6388,408,13,3,104,17,386,16,7335
"17179021603",4821,93,35,0,70,0,40,0,5059
"17179021604",1552,139,0,0,141,16,46,0,1894
"17179021605",2408,173,60,0,30,0,116,0,2787
"17179021606",5085,163,123,0,165,0,153,0,5689
"17179021701",5415,297,0,23,110,0,214,0,6059
"17179021702",5250,321,0,8,67,0,35,0,5681
"17179021801",3426,531,2,0,97,0,9,0,4065
"17179021802",1931,89,0,0,42,0,25,0,2087
"17179021900",4209,363,43,7,64,4,68,4,4762
"17179022000",3944,337,2,0,40,9,23,0,4355
"17179022100",3449,255,0,2,82,124,54,0,3966
"17179022200",4836,198,31,16,183,0,43,0,5307
"17179022300",4615,68,0,0,71,76,215,76,5121
"17179022400",4339,215,42,0,147,8,30,0,4781
"17181950100",3572,472,79,71,126,140,358,101,4919
"17181950200",1984,197,4,0,177,3,58,24,2447
"17181950300",1696,354,24,11,26,12,14,0,2137
"17181950400",3368,1076,37,6,17,130,10,262,4906
"17181950500",3217,495,4,0,13,4,16,4,3753
"17183000100",899,250,213,184,105,34,59,32,1776
"17183000200",602,147,513,554,32,0,138,0,1986
"17183000300",993,318,491,315,218,18,394,47,2794
"17183000400",856,273,840,1320,111,30,166,31,3627
"17183000500",1970,285,782,293,252,73,195,0,3850
"17183000600",1061,276,617,477,49,74,134,0,2688
"17183000700",2670,281,301,36,203,0,46,0,3537
"17183000800",1735,178,206,57,18,0,61,0,2255
"17183000900",1608,410,59,345,59,53,0,97,2631
"17183001200",2066,311,248,50,181,75,47,0,2978
"17183001300",2892,318,58,32,124,0,22,0,3446
"17183010100",3001,450,14,0,26,7,24,0,3522
"17183010200",4256,750,68,50,187,20,589,47,5967
"17183010300",4315,497,2,4,79,26,47,0,4970
"17183010400",2051,131,1,0,91,1,89,1,2365
"17183010500",3107,769,10,0,45,10,0,10,3951
"17183010600",3149,562,11,16,129,52,17,40,3976
"17183010701",2137,718,0,0,8,38,220,274,3395
"17183010702",2775,149,4,0,0,10,52,0,2990
"17183010800",3068,311,22,0,36,24,135,10,3606
"17183010900",2621,223,8,0,12,0,0,0,2864
"17183011000",3290,752,95,0,6,16,32,50,4241
"17183011100",2237,190,0,2,33,18,19,14,2513
"17183011200",1933,809,902,851,36,48,12,156,4747
"17185957200",3470,335,0,0,73,8,45,2,3933
"17185957300",2581,422,0,0,33,0,18,0,3054
"17185957400",1599,118,93,0,48,53,24,34,1969
"17185957500",2126,493,14,2,47,16,0,61,2759
"17187870100",1876,249,7,1,0,0,60,3,2196
"17187870200",2144,328,2,0,21,0,31,0,2526
"17187870300",2683,138,13,0,18,0,15,0,2867
"17187870400",3249,568,25,10,182,30,469,99,4632
"17187870500",3110,717,146,171,534,252,669,136,5735
"17189950100",2878,381,7,48,54,18,48,3,3437
"17189950200",3398,176,17,0,24,8,98,0,3721
"17189950300",2386,702,0,0,36,0,7,0,3131
"17189950400",3447,468,7,0,111,33,15,33,4114
"17191954900",2756,354,0,0,48,0,14,5,3177
"17191955000",3821,602,3,10,19,0,25,0,4480
"17191955100",2236,461,0,12,4,1,4,0,2718
"17191955200",2273,348,3,73,244,11,18,17,2987
"17191955300",2613,510,5,0,26,3,6,0,3163
"17193958000",1543,565,0,0,54,4,51,0,2217
"17193958100",2808,343,7,0,17,0,0,0,3175
"17193958200",2400,386,0,1,81,6,23,8,2905
"17193958300",2382,231,6,0,21,0,13,7,2660
"17193958400",2830,372,3,0,10,8,58,5,3286
"17195000100",3623,143,44,0,44,8,242,0,4104
"17195000200",2565,132,0,11,110,0,96,0,2914
"17195000300",3011,225,0,14,40,9,161,15,3475
"17195000400",2702,288,40,0,59,5,42,18,3154
"17195000500",3006,286,0,25,89,0,37,0,3443
"17195000600",3500,300,53,49,86,127,69,12,4196
"17195000700",2273,286,15,4,36,10,93,28,2745
"17195000800",1737,209,0,0,37,2,41,0,2026
"17195000900",2747,357,15,0,261,0,343,88,3811
"17195001000",1813,405,48,18,491,84,904,131,3894
"17195001100",3670,554,0,68,416,9,1131,87,5935
"17195001200",3281,424,25,36,227,11,912,28,4944
"17195001300",1729,432,113,0,153,148,275,148,2998
"17195001400",2132,150,0,0,42,21,72,2,2419
"17195001500",2223,550,43,95,148,6,183,184,3432
"17195001600",1871,263,88,28,287,79,414,96,3126
"17195001700",2494,615,60,0,129,104,494,175,4071
"17195001800",1982,150,6,0,45,0,104,45,2332
"17197880105",4259,100,1277,135,2050,14,1822,0,9657
"17197880106",2469,175,853,114,971,110,1461,138,6291
"17197880107",2164,157,869,88,1357,259,1161,287,6342
"17197880109",3009,91,1465,178,702,337,506,223,6511
"17197880111",2096,158,503,36,834,17,1656,133,5433
"17197880112",1100,84,245,7,563,38,287,114,2438
"17197880113",1365,376,412,194,1011,329,1128,653,5468
"17197880114",712,97,666,11,571,416,700,395,3568
"17197880115",1058,55,775,298,984,137,975,161,4443
"17197880116",1484,34,594,112,520,267,605,281,3897
"17197880117",1050,235,866,429,542,404,625,496,4647
"17197880118",3865,21,173,0,682,49,40,0,4830
"17197880119",3151,140,100,53,1077,0,216,0,4737
"17197880120",4987,50,1636,0,2935,0,1594,16,11218
"17197880121",5835,418,1321,0,2312,16,1709,16,11627
"17197880202",2972,185,301,11,744,168,778,153,5312
"17197880203",2722,127,29,0,1049,119,1437,136,5619
"17197880204",3847,140,699,0,1135,0,1017,58,6896
"17197880303",3752,95,0,0,424,51,168,17,4507
"17197880304",4096,150,75,0,781,32,210,9,5353
"17197880305",4160,66,86,8,705,7,200,0,5232
"17197880306",3674,355,712,0,2131,205,571,10,7658
"17197880307",3347,220,475,145,1302,215,352,28,6084
"17197880308",5743,14,1019,89,1806,170,332,170,9343
"17197880309",4010,7,132,0,1091,0,101,0,5341
"17197880310",8906,80,813,0,2874,45,1235,0,13953
"17197880312",5456,41,311,0,4000,42,174,0,10024
"17197880313",7696,88,1008,14,2672,132,1713,62,13385
"17197880314",6450,44,261,0,532,30,436,0,7753
"17197880404",9034,362,621,6,922,62,1286,160,12453
"17197880408",3660,241,549,55,424,438,1373,299,7039
"17197880410",4183,773,1222,98,2241,29,2258,721,11525
"17197880411",2585,130,203,0,396,0,470,0,3784
"17197880412",3582,83,303,0,381,13,812,13,5187
"17197880414",3779,330,55,0,390,34,1258,247,6093
"17197880415",5323,485,609,61,839,207,1871,260,9655
"17197880416",2166,6,45,10,665,101,749,101,3843
"17197880417",2194,52,204,0,99,0,318,0,2867
"17197880418",4603,35,265,0,356,0,960,0,6219
"17197880419",6718,164,612,0,1564,0,1818,28,10904
"17197880420",6907,692,1064,0,1680,27,2429,317,13116
"17197880421",4607,360,300,0,779,12,502,79,6639
"17197880502",4584,355,0,0,124,0,490,16,5569
"17197880503",3111,354,426,0,236,19,453,159,4758
"17197880505",5019,175,296,80,1080,471,2271,367,9759
"17197880507",3118,117,1705,474,2061,517,2315,21,10328
"17197880601",3040,60,0,0,79,0,237,0,3416
"17197880602",2967,452,6,0,136,12,208,12,3793
"17197880701",3626,277,57,20,321,8,393,44,4746
"17197880702",979,192,902,166,467,80,565,108,3459
"17197880901",5048,308,213,14,519,1,966,105,7174
"17197880903",1444,320,263,109,116,335,210,379,3176
"17197880905",2029,135,91,33,296,21,523,35,3163
"17197881001",4738,201,77,0,136,11,358,24,5545
"17197881002",4672,272,46,0,171,0,276,28,5465
"17197881005",3160,26,0,16,128,12,76,0,3418
"17197881006",2496,48,0,0,92,0,302,0,2938
"17197881007",5686,152,49,18,275,43,830,39,7092
"17197881009",6593,94,169,0,73,137,612,0,7678
"17197881010",3181,35,0,2,291,1,368,0,3878
"17197881011",2779,177,0,0,83,0,101,8,3148
"17197881012",3050,21,0,0,41,0,79,0,3191
"17197881105",5393,184,71,0,459,0,517,0,6624
"17197881107",2695,194,49,2,218,0,351,0,3509
"17197881108",5686,190,37,14,474,12,610,12,7035
"17197881109",4341,153,52,0,88,4,119,3,4760
"17197881111",2893,105,0,0,273,0,133,0,3404
"17197881112",4878,137,0,0,12,0,108,0,5135
"17197881113",3542,308,0,1,0,0,168,0,4019
"17197881115",3850,96,44,0,256,0,453,0,4699
"17197881116",3564,129,41,0,405,0,376,0,4515
"17197881200",1021,581,1817,927,308,341,814,711,6520
"17197881301",680,274,172,19,1235,417,1843,539,5179
"17197881302",607,408,146,0,518,68,1084,448,3279
"17197881401",1647,248,83,77,1000,72,1360,78,4565
"17197881402",1982,88,301,67,401,119,596,6,3560
"17197881500",2427,305,74,39,193,40,460,171,3709
"17197881601",1404,75,73,33,81,37,159,47,1909
"17197881603",1688,51,1004,369,229,0,551,0,3892
"17197881604",1156,101,1072,56,283,124,360,25,3177
"17197881700",2478,160,45,54,343,11,473,11,3575
"17197881800",1875,196,494,188,1327,260,2051,266,6657
"17197881900",764,371,716,1035,654,115,965,229,4849
"17197882000",551,403,589,524,621,309,820,671,4488
"17197882100",951,292,260,114,800,310,1646,463,4836
"17197882200",2293,496,384,46,984,277,1870,328,6678
"17197882300",2243,371,331,33,831,229,1387,281,5706
"17197882400",549,333,1284,210,895,271,1255,503,5300
"17197882500",499,45,1133,472,147,132,540,79,3047
"17197882601",2280,475,167,12,508,26,1067,325,4860
"17197882602",1211,518,487,180,437,188,972,499,4492
"17197882701",1902,115,144,6,209,96,617,115,3204
"17197882702",1392,415,770,23,356,60,568,338,3922
"17197882801",1959,120,217,121,74,58,874,68,3491
"17197882802",1013,361,755,199,396,62,373,42,3201
"17197882900",1755,263,25,15,333,58,853,80,3382
"17197883000",947,263,1243,71,475,66,604,99,3768
"17197883100",1514,429,1907,299,264,48,772,216,5449
"17197883206",2874,343,491,67,508,14,531,91,4919
"17197883208",2007,160,37,34,254,304,389,214,3399
"17197883209",2471,79,72,118,591,0,525,51,3907
"17197883210",2246,80,115,0,92,0,154,0,2687
"17197883211",5100,213,296,25,497,0,1392,0,7523
"17197883212",4549,283,471,0,365,81,417,30,6196
"17197883213",4683,458,101,0,499,0,272,71,6084
"17197883214",1975,143,88,9,507,0,479,33,3234
"17197883215",7447,184,1122,14,1340,347,1968,400,12822
"17197883216",2513,26,129,0,101,10,191,28,2998
"17197883303",3429,7,7,0,95,19,129,19,3705
"17197883304",1667,166,0,0,0,0,43,39,1915
"17197883305",2831,31,0,0,108,0,151,0,3121
"17197883306",3397,309,0,0,174,7,109,116,4112
"17197883307",3395,337,155,50,47,47,248,0,4279
"17197883401",3061,565,72,0,112,0,211,9,4030
"17197883402",1728,255,12,0,110,38,171,71,2385
"17197883504",4433,71,233,48,34,0,34,0,4853
"17197883505",7123,324,662,114,662,12,767,0,9664
"17197883507",3669,264,28,0,38,0,178,0,4177
"17197883509",3957,193,0,19,88,0,185,0,4442
"17197883510",4824,154,11,0,114,24,350,24,5501
"17197883511",3934,110,100,0,322,0,296,9,4771
"17197883513",4724,488,6,0,467,21,290,0,5996
"17197883514",6418,170,218,0,439,0,400,26,7671
"17197883515",3747,98,43,6,109,11,132,12,4158
"17197883516",6195,504,73,0,205,0,215,0,7192
"17197883517",2907,79,1,1,164,30,326,7,3515
"17197883519",5093,121,0,0,158,0,455,0,5827
"17197883521",3407,65,71,0,149,0,116,13,3821
"17197883522",3307,41,0,0,89,0,63,0,3500
"17197883602",4254,196,830,0,153,42,211,59,5745
"17197883603",970,50,1507,425,56,120,17,119,3264
"17197883605",48,0,2149,776,103,47,0,11,3134
"17197883606",806,13,2442,164,380,20,237,20,4082
"17197883700",1970,372,202,33,277,13,495,12,3374
"17197883803",540,5,1384,413,92,0,183,0,2617
"17197883804",1672,203,441,0,176,343,197,340,3372
"17197883806",2055,441,899,18,169,24,215,0,3821
"17197883808",1719,78,248,12,45,22,72,0,2196
"17197883809",2179,245,318,0,224,18,162,33,3179
"17197883810",2258,85,1225,26,103,0,100,0,3797
"17197883811",2464,105,271,0,112,83,254,21,3310
"17197883902",5307,433,125,0,353,7,531,133,6889
"17197883903",1818,44,8,0,45,4,121,4,2044
"17197883904",4260,160,0,0,0,0,207,0,4627
"17197884003",3552,498,0,16,63,31,37,0,4197
"17197884004",2453,309,11,0,28,24,122,33,2980
"17197884005",1094,138,0,0,31,19,37,14,1333
"17197884006",1803,294,37,0,58,11,73,0,2276
"17197884101",2229,110,243,2,385,13,654,13,3649
"17197884103",1929,128,354,207,578,0,758,33,3987
"17197980000",0,0,0,0,0,0,0,0,0
"17197980100",53,0,0,5,52,6,36,0,152
"17199020100",2940,416,200,60,17,79,106,0,3818
"17199020201",4365,931,52,22,98,107,90,102,5767
"17199020202",2056,377,13,152,197,26,57,44,2922
"17199020300",4107,256,157,0,64,4,89,0,4677
"17199020400",2620,931,66,57,27,20,0,75,3796
"17199020500",2761,661,0,0,0,6,60,40,3528
"17199020600",3437,380,40,0,162,52,79,0,4150
"17199020700",3718,820,34,0,211,0,75,0,4858
"17199020800",5515,747,0,0,74,14,1,0,6351
"17199020900",4067,221,439,28,175,14,39,8,4991
"17199021000",3369,804,397,120,168,73,119,4,5054
"17199021100",2063,846,16,59,63,78,52,78,3255
"17199021200",3464,660,168,161,139,60,108,21,4781
"17199021300",4504,325,81,21,27,0,89,0,5047
"17199021400",3243,166,49,0,21,29,112,0,3620
"17201000101",4197,431,59,82,122,62,103,76,5132
"17201000103",2064,354,34,12,196,62,55,164,2941
"17201000104",2281,400,60,0,77,36,156,96,3106
"17201000105",3362,227,121,30,251,32,206,8,4237
"17201000200",2848,646,8,11,36,66,51,20,3686
"17201000300",2930,614,197,0,170,82,123,17,4133
"17201000401",1507,102,79,6,200,28,118,11,2051
"17201000402",2195,37,322,10,180,0,67,0,2811
"17201000403",2849,311,436,81,209,43,103,24,4056
"17201000501",3151,264,431,250,213,0,449,189,4947
"17201000502",2018,408,226,118,240,69,375,147,3601
"17201000504",5432,292,475,135,432,109,418,0,7293
"17201000506",3593,131,352,22,294,6,179,16,4593
"17201000507",2147,592,283,28,415,175,426,574,4640
"17201000510",2607,75,97,6,321,27,60,0,3193
"17201000511",1747,123,331,10,366,78,461,0,3116
"17201000512",4013,253,596,30,338,17,373,17,5637
"17201000513",2879,129,181,0,242,143,34,0,3608
"17201000514",3038,225,120,0,168,0,234,67,3852
"17201000600",3323,430,260,104,122,28,311,25,4603
"17201000700",2537,212,127,28,126,179,126,120,3455
"17201000800",1307,810,177,237,76,111,217,403,3338
"17201001000",384,192,135,810,330,245,360,62,2518
"17201001100",422,324,183,84,63,25,39,52,1192
"17201001200",869,392,172,198,325,186,644,159,2945
"17201001300",1065,457,385,425,268,318,407,485,3810
"17201001400",2345,629,135,204,425,152,590,336,4816
"17201001500",3401,658,209,87,293,267,614,708,6237
"17201001600",3429,603,732,501,189,117,491,0,6062
"17201001700",2346,187,273,143,297,118,798,147,4309
"17201001800",2355,1235,359,698,584,430,1041,599,7301
"17201001900",2283,452,118,127,247,40,793,94,4154
"17201002000",1353,734,84,32,456,75,402,441,3577
"17201002100",382,551,209,610,76,220,69,252,2369
"17201002200",1336,218,650,560,834,116,1169,177,5060
"17201002301",1183,317,724,226,130,108,435,80,3203
"17201002302",890,150,55,14,83,64,184,80,1520
"17201002400",203,431,766,708,78,74,134,244,2638
"17201002500",287,415,1142,1419,94,144,179,342,4022
"17201002600",342,362,452,969,49,235,131,203,2743
"17201002700",575,841,472,318,481,249,803,966,4705
"17201002800",528,295,190,312,327,205,773,461,3091
"17201002900",514,271,164,152,42,59,1,69,1272
"17201003000",1312,185,22,51,104,0,64,67,1805
"17201003100",1089,577,865,660,414,207,458,286,4556
"17201003200",951,395,1177,862,143,149,422,411,4510
"17201003300",1495,358,525,556,79,367,325,257,3962
"17201003400",3339,507,393,149,479,16,896,25,5804
"17201003500",2050,85,309,0,96,0,157,0,2697
"17201003601",1189,278,106,19,22,0,70,14,1698
"17201003602",2141,309,603,583,57,39,361,26,4119
"17201003604",1678,440,524,59,102,0,288,0,3091
"17201003605",841,268,176,89,52,14,102,5,1547
"17201003606",1533,242,334,463,106,13,152,133,2976
"17201003705",4331,158,110,28,303,2,277,26,5235
"17201003706",4238,404,514,0,1109,86,826,86,7263
"17201003707",2250,406,568,74,347,157,344,71,4217
"17201003708",1277,309,384,249,387,197,453,151,3407
"17201003709",800,425,180,31,220,43,346,69,2114
"17201003710",2195,25,63,0,170,0,376,5,2834
"17201003711",3687,350,436,0,101,189,140,0,4903
"17201003801",5095,518,171,19,245,36,188,0,6272
"17201003805",6359,310,61,0,370,0,325,54,7479
"17201003806",4323,209,114,0,167,0,190,0,5003
"17201003807",6113,410,516,0,605,8,446,0,8098
"17201003808",3328,187,70,0,83,27,239,10,3944
"17201003809",3994,539,186,3,82,0,291,0,5095
"17201003901",4067,292,115,28,147,3,59,0,4711
"17201003903",5564,104,24,0,213,51,62,0,6018
"17201003904",4125,192,69,0,278,0,92,0,4756
"17201004001",7628,677,126,42,255,41,286,132,9187
"17201004002",6171,390,52,0,156,0,285,0,7054
"17201004003",1332,384,93,0,235,52,289,128,2513
"17201004100",4660,248,7,6,50,6,48,3,5028
"17201004200",5442,330,127,12,433,0,99,5,6448
"17201004300",4629,261,0,0,155,16,110,0,5171
"17201980000",0,0,0,0,0,0,0,0,0
"17203030100",2379,127,10,0,47,0,35,0,2598
"17203030200",2688,163,0,0,52,1,35,3,2942
"17203030300",2840,53,0,0,24,8,63,0,2988
"17203030400",4935,434,0,2,130,52,23,35,5611
"17203030501",7091,284,54,7,235,63,185,3,7922
"17203030502",1994,477,0,0,141,4,17,0,2633
"17203030601",5217,554,0,3,88,26,67,33,5988
"17203030602",3242,84,0,0,31,0,22,1,3380
"17203030700",3635,668,21,57,56,38,57,23,4555
"18001030100",4011,514,9,0,164,0,97,27,4822
"18001030200",3975,555,9,3,65,47,419,127,5200
"18001030300",4470,557,0,164,117,20,363,10,5701
"18001030400",2864,369,0,0,15,0,146,0,3394
"18001030500",4697,1166,0,0,19,0,19,0,5901
"18001030600",2771,446,0,25,55,23,146,38,3504
"18001030700",5087,1618,0,15,54,7,77,7,6865
"18003000100",2036,177,131,0,72,69,246,41,2772
"18003000300",2495,314,179,0,200,23,164,0,3375
"18003000400",1925,261,76,57,28,6,46,12,2411
"18003000500",1225,379,111,70,156,563,186,33,2723
"18003000600",998,475,60,85,108,96,168,27,2017
"18003000701",2047,888,57,43,130,89,87,45,3386
"18003000704",1736,332,82,21,274,5,158,0,2608
"18003000800",3047,347,98,129,179,85,123,14,4022
"18003000900",2011,617,144,12,151,68,327,58,3388
"18003001000",756,202,8,7,30,39,48,15,1105
"18003001100",1197,320,90,41,87,27,64,0,1826
"18003001200",509,254,40,71,44,37,19,55,1029
"18003001300",401,154,139,250,169,21,5,60,1199
"18003001600",613,519,383,302,106,389,200,219,2731
"18003001700",416,277,459,567,32,109,264,284,2408
"18003002000",1052,570,428,477,95,196,134,178,3130
"18003002100",1081,754,58,183,148,154,290,233,2901
"18003002200",2083,876,168,412,462,122,570,111,4804
"18003002300",1004,270,1466,787,459,643,661,365,5655
"18003002500",2244,267,197,63,153,245,283,236,3688
"18003002600",1651,624,285,607,377,203,433,57,4237
"18003002800",371,200,706,791,101,153,335,252,2909
"18003002900",296,356,766,441,178,237,204,296,2774
"18003003000",587,414,922,1091,522,257,959,306,5058
"18003003100",1073,625,390,489,114,388,406,399,3884
"18003003200",4273,313,303,259,482,52,774,48,6504
"18003003301",1937,437,110,28,291,65,122,0,2990
"18003003304",2211,405,296,173,362,279,269,54,4049
"18003003400",3277,525,206,196,131,71,70,90,4566
"18003003500",1858,394,293,277,508,299,85,8,3722
"18003003600",1914,486,1781,916,485,486,430,166,6664
"18003003700",1787,188,179,228,60,27,115,26,2610
"18003003800",1817,273,308,313,102,49,56,42,2960
"18003003901",2837,289,69,45,73,90,295,30,3728
"18003003902",1420,394,340,181,261,123,75,242,3036
"18003004000",521,224,1538,634,305,57,442,201,3922
"18003004101",1406,118,196,237,123,20,54,10,2164
"18003004103",3336,553,329,85,589,378,227,0,5497
"18003004300",208,360,834,291,329,325,276,270,2893
"18003004400",401,706,838,846,308,381,376,531,4387
"18003010100",4470,600,26,0,27,0,83,0,5206
"18003010201",6482,155,94,0,143,26,100,14,7014
"18003010202",5484,428,66,0,200,0,217,0,6395
"18003010304",5883,387,83,0,191,32,11,17,6604
"18003010305",5181,121,321,0,697,0,162,0,6482
"18003010306",5548,289,18,0,111,25,130,24,6145
"18003010307",4298,205,97,0,654,0,148,4,5406
"18003010308",5100,111,137,0,345,71,350,71,6185
"18003010400",3573,108,26,0,85,0,87,0,3879
"18003010500",2381,114,9,0,116,18,43,0,2681
"18003010601",2965,78,126,9,285,0,157,23,3643
"18003010602",3340,363,108,0,125,15,333,23,4307
"18003010603",1449,101,0,0,79,5,6,0,1640
"18003010604",1510,1114,0,0,67,157,117,492,3457
"18003010705",3920,370,234,21,292,0,384,0,5221
"18003010706",3317,340,236,93,545,53,208,16,4808
"18003010707",4131,339,211,15,352,42,101,14,5205
"18003010803",4268,246,239,28,286,49,180,0,5296
"18003010804",3361,190,88,95,440,84,72,20,4350
"18003010807",3523,354,348,8,158,16,176,18,4601
"18003010808",4354,135,226,0,394,93,167,0,5369
"18003010809",4228,301,499,89,316,10,57,0,5500
"18003010811",4446,218,268,70,97,1,250,1,5351
"18003010812",3998,64,313,0,37,0,52,26,4490
"18003010813",3288,428,138,90,151,82,102,117,4396
"18003010815",3915,306,70,10,292,82,44,23,4742
"18003010816",4077,93,427,0,261,0,9,0,4867
"18003010817",3576,113,310,39,160,0,77,0,4275
"18003010819",3749,436,233,39,175,12,100,67,4811
"18003010821",2687,305,564,335,478,4,53,0,4426
"18003010900",5563,851,0,2,70,116,61,116,6779
"18003011000",2484,214,0,0,0,0,50,16,2764
"18003011100",2515,525,0,1,20,1,0,0,3062
"18003011201",1136,837,32,0,80,14,85,209,2393
"18003011202",2601,415,34,0,69,179,146,179,3623
"18003011204",2736,195,194,0,89,78,264,49,3605
"18003011205",2876,267,13,0,40,0,79,0,3275
"18003011302",1252,144,1741,841,350,1006,356,21,5711
"18003011303",416,317,439,188,532,329,78,146,2445
"18003011304",1906,192,1465,642,665,141,611,80,5702
"18003011501",2713,626,317,301,126,57,407,217,4764
"18003011502",2280,277,12,6,153,41,15,16,2800
"18003011603",5756,333,105,0,253,0,32,0,6479
"18003011604",3698,299,57,0,181,0,198,0,4433
"18003011605",2393,113,71,2,149,0,108,0,2836
"18003011606",3943,281,102,1,462,26,126,0,4941
"18003011607",4574,43,155,7,760,0,339,0,5878
"18003011608",4746,174,234,221,628,75,225,0,6303
"18003011609",5557,136,90,0,725,20,64,30,6622
"18003011701",3030,209,138,0,125,0,0,0,3502
"18003011702",2894,188,124,76,157,0,381,20,3840
"18003011801",3730,247,0,1,46,0,93,15,4132
"18003011802",1635,91,0,0,33,0,135,0,1894
"18003011900",1522,145,0,0,29,0,44,0,1740
"18003980001",41,32,4,0,0,0,0,0,77
"18003980002",24,21,0,0,0,0,0,0,45
"18005010100",2768,918,194,1,424,47,374,80,4806
"18005010200",3352,465,56,25,343,0,262,0,4503
"18005010300",3196,93,4,1,297,0,149,2,3742
"18005010400",4227,529,111,0,942,0,293,190,6292
"18005010500",4228,305,164,2,346,117,49,23,5234
"18005010600",4135,671,289,35,261,41,81,28,5541
"18005010700",2132,514,29,37,532,63,100,29,3436
"18005010800",2041,941,100,12,788,46,164,90,4182
"18005010900",4651,162,110,0,824,0,156,0,5903
"18005011000",4451,148,4,0,142,123,0,0,4868
"18005011100",5521,1008,10,0,523,1097,600,1137,9896
"18005011200",4851,449,36,0,138,16,14,0,5504
"18005011300",5146,516,92,0,24,61,71,38,5948
"18005011400",3312,361,6,5,260,91,228,91,4354
"18005011500",6336,821,28,97,834,209,420,202,8947
"18007100100",2919,418,0,2,35,0,71,7,3452
"18007100200",2439,406,38,23,16,15,74,35,3046
"18007100300",1962,293,7,2,23,22,238,31,2578
"18009975100",2746,436,0,0,12,24,38,19,3275
"18009975200",2174,217,0,0,144,0,0,0,2535
"18009975300",2130,702,0,0,48,0,52,0,2932
"18009975400",3139,321,30,0,11,0,55,0,3556
"18011810100",3338,122,0,0,198,0,126,1,3785
"18011810200",3474,316,0,0,44,8,119,0,3961
"18011810300",5493,204,0,91,0,29,0,0,5817
"18011810400",4898,604,0,106,0,27,277,27,5939
"18011810500",5439,448,30,2,314,27,266,0,6526
"18011810601",4846,678,124,89,341,0,38,43,6159
"18011810603",11462,131,129,0,983,0,154,28,12887
"18011810604",5165,85,31,0,309,0,125,0,5715
"18011810605",5007,115,130,0,274,0,200,2,5728
"18011810700",4244,416,0,0,46,0,99,26,4831
"18013974600",2297,259,0,0,73,12,6,0,2647
"18013974700",2851,443,0,0,56,52,10,0,3412
"18013974800",3642,319,38,8,28,132,22,21,4210
"18013974900",4009,640,0,0,0,0,127,35,4811
"18015959300",2879,377,0,0,3,0,6,2,3267
"18015959400",2427,118,0,0,25,40,12,0,2622
"18015959500",1995,265,0,2,28,20,11,1,2322
"18015959600",2548,480,16,0,60,5,402,105,3616
"18015959700",2696,280,0,0,101,0,0,88,3165
"18015959800",2414,279,23,10,11,0,34,13,2784
"18015959900",2377,273,0,0,60,0,36,73,2819
"18017950900",4057,373,11,2,277,157,0,2,4879
"18017951000",2363,306,0,0,43,44,49,78,2883
"18017951100",2600,427,0,8,33,56,72,41,3237
"18017951200",1203,500,18,71,292,99,338,175,2696
"18017951300",1648,210,185,5,568,42,429,42,3129
"18017951400",1372,427,43,7,322,5,363,50,2589
"18017951500",2094,1041,0,6,791,309,960,412,5613
"18017951600",4179,474,19,9,839,467,1001,630,7618
"18017951700",2232,250,0,2,247,1,191,0,2923
"18017951800",2759,322,0,17,287,0,307,4,3696
"18017951900",3246,234,0,0,38,13,12,1,3544
"18019050100",933,206,117,79,20,0,133,0,1488
"18019050200",1450,491,569,389,140,18,105,132,3294
"18019050303",1969,346,77,9,211,0,0,0,2612
"18019050304",2815,316,918,102,372,260,70,18,4871
"18019050305",2539,51,289,0,13,30,82,0,3004
"18019050306",1418,580,302,145,107,25,37,11,2625
"18019050401",2447,352,13,29,194,18,0,18,3071
"18019050403",2058,270,253,32,150,0,357,26,3146
"18019050404",3111,371,129,10,130,17,266,47,4081
"18019050501",1495,187,12,0,0,6,48,0,1748
"18019050503",4491,479,83,18,113,0,404,265,5853
"18019050504",1899,587,251,37,209,80,469,69,3601
"18019050603",5024,814,829,127,295,16,541,0,7646
"18019050604",4215,356,582,103,368,137,117,33,5911
"18019050605",4687,197,652,22,94,30,229,55,5966
"18019050606",3608,62,342,12,258,12,291,24,4609
"18019050701",4321,164,571,0,297,31,75,34,5493
"18019050703",5286,351,172,0,195,0,22,0,6026
"18019050704",5255,162,0,1,179,249,0,248,6094
"18019050801",6041,414,0,0,61,0,134,0,6650
"18019050803",4552,401,0,0,12,0,199,0,5164
"18019050804",3420,443,0,2,0,73,0,0,3938
"18019050902",3870,580,6,0,200,107,60,287,5110
"18019050903",2766,619,143,32,284,189,260,196,4489
"18019050904",4903,177,120,38,74,0,279,0,5591
"18019051000",4382,519,9,0,17,29,50,0,5006
"18021040100",3814,1228,14,8,56,220,29,91,5460
"18021040200",5127,1027,0,0,188,16,8,0,6366
"18021040300",3163,250,0,0,24,0,3,0,3440
"18021040400",3621,285,5,17,21,3,136,0,4088
"18021040500",3138,348,0,0,26,0,35,0,3547
"18021040600",3161,400,0,0,35,5,0,0,3601
"18023950100",2574,388,0,0,48,19,30,0,3059
"18023950200",4285,423,0,0,240,92,411,92,5543
"18023950300",4366,656,3,0,32,26,33,56,5172
"18023950400",3533,364,0,0,39,58,90,58,4142
"18023950500",3522,516,0,64,261,54,1078,209,5704
"18023950600",2429,745,79,0,372,0,543,361,4529
"18023950700",2951,279,9,0,311,0,528,10,4088
"18023950800",2083,597,130,78,261,145,829,395,4518
"18025951900",2763,817,0,0,45,23,63,27,3738
"18025952000",3380,744,0,0,62,42,43,11,4282
"18025952100",2032,485,4,0,36,55,2,0,2614
"18027954300",3226,481,0,0,36,7,18,0,3768
"18027954400",2617,237,67,0,0,23,8,13,2965
"18027954500",8144,1079,0,0,87,0,61,4,9375
"18027954600",3698,422,5,0,84,0,78,0,4287
"18027954700",2578,446,110,0,333,39,709,40,4255
"18027954800",2440,949,278,14,48,10,60,360,4159
"18027954900",3883,485,7,0,26,0,48,0,4449
"18029080101",2575,213,48,1,23,15,0,0,2875
"18029080103",5327,293,0,0,157,0,217,0,5994
"18029080104",3681,164,0,0,92,8,27,0,3972
"18029080201",2250,47,0,0,45,0,62,0,2404
"18029080202",6184,389,0,0,62,0,43,0,6678
"18029080300",3843,545,0,14,58,0,17,0,4477
"18029080400",5070,533,140,51,168,3,107,0,6072
"18029080500",3252,664,0,0,48,56,35,0,4055
"18029080600",5670,854,0,3,161,131,34,6,6859
"18029080700",5403,564,0,0,6,5,0,5,5983
"18031969000",4218,696,8,14,541,4,198,0,5679
"18031969100",2746,578,27,0,53,0,53,0,3457
"18031969200",3366,988,67,8,31,35,31,0,4526
"18031969300",2765,546,56,0,0,0,90,0,3457
"18031969400",5034,381,3,0,51,0,68,6,5543
"18031969500",3088,397,0,0,70,0,10,21,3586
"18033020100",3682,437,2,0,118,14,104,0,4357
"18033020200",3563,840,15,0,95,43,93,41,4690
"18033020300",3395,662,0,0,114,7,116,11,4305
"18033020400",6256,675,51,12,146,66,217,56,7479
"18033020500",4675,1141,4,0,139,9,175,0,6143
"18033020601",2496,472,0,13,45,5,40,0,3071
"18033020602",3769,693,0,5,48,75,32,32,4654
"18033020700",3113,312,0,0,68,0,103,0,3596
"18033020800",3939,526,0,0,89,100,71,0,4725
"18035000300",194,130,687,368,33,74,0,0,1486
"18035000400",722,742,67,211,59,118,61,0,1980
"18035000500",2700,1103,0,34,64,120,31,20,4072
"18035000600",462,521,29,76,77,60,30,30,1285
"18035000700",1020,2137,24,67,162,285,96,168,3959
"18035000800",3050,971,72,95,101,90,80,51,4510
"18035000902",14,106,0,0,31,108,0,0,259
"18035000903",1341,1109,184,31,82,31,29,86,2893
"18035000904",4721,725,51,12,224,265,144,0,6142
"18035001000",1820,2138,191,74,75,162,38,92,4590
"18035001100",2377,515,76,80,94,66,33,42,3283
"18035001200",281,332,588,435,217,190,48,31,2122
"18035001300",1951,1090,172,77,16,9,17,0,3332
"18035001400",1143,438,26,137,3,88,5,18,1858
"18035001500",2097,359,257,0,138,0,28,0,2879
"18035001600",1520,465,18,25,19,114,5,0,2166
"18035001700",767,424,0,123,21,31,0,15,1381
"18035002000",3178,814,157,175,494,82,292,75,5267
"18035002100",1728,489,341,186,190,16,0,5,2955
"18035002200",5143,644,32,0,89,29,187,0,6124
"18035002301",3428,216,0,0,28,0,0,0,3672
"18035002302",3596,255,1,11,61,14,15,0,3953
"18035002401",4395,307,21,19,180,123,0,0,5045
"18035002402",7916,591,149,0,190,10,43,28,8927
"18035002500",4618,589,13,3,255,4,135,4,5621
"18035002601",6428,416,146,0,127,9,83,0,7209
"18035002602",2430,291,0,0,53,23,0,0,2797
"18035002700",4299,346,0,0,97,26,20,16,4804
"18035002800",1300,735,159,200,11,115,41,55,2616
"18035002900",3792,282,415,26,108,202,9,12,4846
"18037953200",5957,298,41,1,70,0,36,0,6403
"18037953300",5862,805,20,0,64,66,97,137,7051
"18037953400",4325,442,0,0,361,0,434,130,5692
"18037953500",4560,195,0,0,21,0,128,0,4904
"18037953600",4830,522,56,0,0,0,0,0,5408
"18037953700",6872,395,0,0,0,0,17,7,7291
"18037953800",3936,479,0,24,370,844,932,753,7338
"18039000100",1765,678,38,188,135,205,422,91,3522
"18039000200",3997,1411,0,0,390,586,1244,1153,8781
"18039000301",3609,399,50,0,284,0,1095,90,5527
"18039000302",4402,956,0,78,156,0,951,405,6948
"18039000400",3730,615,23,3,403,69,369,421,5633
"18039000501",4453,1146,306,40,787,241,2077,780,9830
"18039000502",3028,531,131,25,542,285,800,220,5562
"18039000600",8818,918,0,4,153,0,403,386,10682
"18039000700",5914,721,61,11,242,99,299,67,7414
"18039000801",3086,253,0,0,127,21,292,36,3815
"18039000802",7721,928,38,0,188,126,362,215,9578
"18039000900",7147,369,0,3,115,44,88,1,7767
"18039001000",4095,169,8,0,83,3,194,11,4563
"18039001100",4750,450,13,0,47,0,71,155,5486
"18039001200",4284,347,41,0,195,0,196,0,5063
"18039001300",6828,271,99,9,259,0,84,3,7553
"18039001400",8067,812,309,0,272,72,428,185,10145
"18039001501",2849,1399,246,243,229,128,396,306,5796
"18039001502",5103,377,17,0,428,129,354,129,6537
"18039001601",3642,398,250,0,252,108,287,22,4959
"18039001602",3479,408,445,0,223,34,428,38,5055
"18039001701",2707,425,25,221,68,8,20,80,3554
"18039001702",3879,1266,75,0,568,47,659,523,7017
"18039001801",2587,243,82,0,226,142,178,126,3584
"18039001802",5302,330,515,0,406,126,134,60,6873
"18039001901",3806,1325,233,543,263,179,652,565,7566
"18039001902",3157,213,94,0,344,15,287,67,4177
"18039002000",5409,391,80,437,316,0,608,46,7287
"18039002101",3046,241,170,107,201,147,426,256,4594
"18039002102",2450,1012,124,780,687,142,1326,590,7111
"18039002200",3868,1008,1102,536,1364,423,2243,664,11208
"18039002300",1143,415,290,264,358,144,492,270,3376
"18039002400",3295,427,175,52,349,11,498,220,5027
"18039002600",1388,717,879,1068,622,437,1028,865,7004
"18039002700",873,549,185,188,90,88,200,310,2483
"18039002900",3721,465,91,105,197,54,161,124,4918
"18041954000",3127,537,0,0,0,0,0,0,3664
"18041954100",1567,616,78,11,0,0,0,33,2305
"18041954200",2803,617,22,0,9,0,9,0,3460
"18041954300",2260,470,77,0,73,16,12,11,2919
"18041954400",2721,1128,115,54,25,42,13,0,4098
"18041954500",2762,602,51,4,34,107,8,99,3667
"18041954600",2740,576,49,0,67,26,34,1,3493
"18043070200",882,591,64,60,80,42,63,15,1797
"18043070301",2600,335,0,0,62,41,53,6,3097
"18043070302",2869,204,46,117,292,0,88,0,3616
"18043070400",1480,605,109,71,146,44,81,14,2550
"18043070500",1668,676,108,192,284,178,256,85,3447
"18043070600",2039,212,18,4,45,10,0,0,2328
"18043070700",1405,347,281,361,31,81,7,31,2544
"18043070801",1400,865,146,320,230,257,144,155,3517
"18043070802",3028,607,127,95,126,79,149,72,4283
"18043070901",4690,673,352,0,14,0,16,82,5827
"18043070902",1037,430,10,18,75,0,87,0,1657
"18043071003",6193,120,82,0,179,0,84,0,6658
"18043071004",4011,144,0,0,73,9,29,0,4266
"18043071005",4585,152,111,0,479,0,71,23,5421
"18043071006",2964,639,231,128,165,35,40,290,4492
"18043071007",3677,190,395,68,75,0,65,0,4470
"18043071101",5388,126,14,0,155,7,69,0,5759
"18043071103",3953,64,17,0,71,0,0,0,4105
"18043071104",4350,139,5,6,70,0,51,0,4621
"18043071200",2063,188,1,0,67,0,0,1,2320
"18045957600",2493,313,0,0,11,9,177,3,3006
"18045957700",1900,328,27,6,20,15,32,7,2335
"18045957800",3249,248,0,14,120,18,10,0,3659
"18045957900",3758,614,0,0,63,0,103,20,4558
"18045958000",2886,388,5,4,11,35,35,0,3364
"18047960100",4380,452,6,0,30,0,35,5,4908
"18047969600",5597,466,0,0,67,53,79,0,6262
"18047969700",2146,423,0,0,11,0,5,41,2626
"18047969800",5016,328,25,0,176,0,0,0,5545
"18047969900",2960,655,0,0,20,36,47,27,3745
"18049953000",2707,373,0,0,12,50,27,0,3169
"18049953100",4518,964,0,0,75,37,105,98,5797
"18049953200",2788,540,136,0,95,48,67,0,3674
"18049953300",1773,285,24,0,36,5,14,5,2142
"18049953400",2421,314,0,1,24,0,8,0,2768
"18049953500",2174,341,0,0,463,53,568,81,3680
"18051050100",3333,434,13,0,173,0,82,0,4035
"18051050200",7643,556,50,7,110,0,4,0,8370
"18051050300",4511,727,27,0,84,24,30,42,5445
"18051050401",2903,282,9,16,46,46,27,0,3329
"18051050402",3642,463,43,0,101,0,33,0,4282
"18051050501",2352,454,28,0,101,49,53,0,3037
"18051050502",3399,448,211,107,348,62,205,0,4780
"18053000100",1930,665,380,185,214,39,18,148,3579
"18053000200",1443,808,935,301,247,112,379,135,4360
"18053000400",2362,850,185,181,216,165,145,50,4154
"18053000500",3878,323,133,57,204,162,0,22,4779
"18053000600",1804,393,97,74,51,56,215,47,2737
"18053000700",1930,955,307,227,35,25,93,190,3762
"18053000800",2115,983,593,212,83,0,191,0,4177
"18053000900",1514,511,94,202,62,73,78,89,2623
"18053010100",5112,367,16,3,243,63,169,58,6031
"18053010200",3856,449,17,15,90,2,38,0,4467
"18053010300",3441,569,0,0,91,65,31,0,4197
"18053010400",2325,501,0,0,49,12,37,12,2936
"18053010500",4133,719,37,0,198,180,196,89,5552
"18053010600",2745,394,103,7,14,21,79,12,3375
"18053010700",3583,388,0,0,19,146,19,9,4164
"18053010800",4344,368,0,0,129,1,73,0,4915
"18055954701",4061,661,17,0,190,0,0,0,4929
"18055954702",3141,483,8,0,0,0,0,0,3632
"18055954800",2713,459,0,0,32,8,50,8,3270
"18055954900",4820,344,2,5,40,0,24,1,5236
"18055955000",2163,699,0,0,0,0,31,0,2893
"18055955100",2525,578,0,0,32,7,0,0,3142
"18055955200",1661,430,11,0,62,0,30,57,2251
"18055955300",3593,290,8,0,65,5,33,10,4004
"18055955400",2766,429,8,0,112,0,136,0,3451
"18057110100",8623,781,505,346,857,191,607,0,11910
"18057110201",3660,291,9,5,30,13,35,9,4052
"18057110202",5957,264,0,0,112,47,316,0,6696
"18057110300",12069,675,355,3,354,297,99,351,14203
"18057110401",2912,127,0,0,136,0,267,9,3451
"18057110403",8501,443,414,0,883,122,291,0,10654
"18057110404",4936,89,41,14,148,0,93,23,5344
"18057110505",6464,163,87,0,236,0,35,62,7047
"18057110506",9114,647,265,7,433,44,507,97,11114
"18057110507",11423,184,432,0,378,111,127,66,12721
"18057110508",8036,255,146,111,505,61,270,80,9464
"18057110509",4543,432,108,0,467,0,468,87,6105
"18057110511",4951,92,147,6,75,0,159,0,5430
"18057110512",4544,171,86,0,70,34,41,15,4961
"18057110600",3312,552,13,17,46,7,39,6,3992
"18057110700",2579,566,8,8,128,30,176,51,3546
"18057110804",12737,417,478,0,1041,0,400,0,15073
"18057110805",7162,187,182,0,514,0,144,0,8189
"18057110806",10472,133,1210,26,1575,50,463,50,13979
"18057110807",4676,279,364,17,348,173,104,33,5994
"18057110808",15613,519,1144,12,2386,257,752,0,20683
"18057110809",8514,396,363,19,629,18,403,157,10499
"18057110810",5412,86,646,0,366,0,33,0,6543
"18057110811",3700,67,270,4,320,6,259,0,4626
"18057110812",5365,128,257,41,867,68,617,15,7358
"18057110903",8027,263,277,0,2941,0,595,0,12103
"18057110904",4303,6,71,0,241,0,13,6,4640
"18057110905",2793,248,44,0,733,17,250,0,4085
"18057110906",5618,351,168,0,269,0,122,96,6624
"18057110907",4939,43,59,0,277,0,80,0,5398
"18057110908",9105,317,290,0,1938,58,478,0,12186
"18057111001",9692,234,186,0,2075,0,304,32,12523
"18057111003",4429,71,36,0,243,32,0,0,4811
"18057111004",2914,78,92,20,169,9,73,0,3355
"18057111006",3795,122,66,27,204,46,256,0,4516
"18057111007",2271,710,106,0,186,192,144,361,3970
"18057111008",4270,284,439,69,608,98,36,19,5823
"18057111101",3491,40,12,0,262,0,117,0,3922
"18057111102",6234,384,268,61,1040,0,128,10,8125
"18059410100",3748,416,0,15,31,1,59,0,4270
"18059410200",9607,805,481,47,538,0,332,0,11810
"18059410300",10340,261,0,0,376,32,281,0,11290
"18059410400",6002,740,17,73,62,44,0,2,6940
"18059410500",2365,304,0,0,89,28,39,28,2853
"18059410600",4518,430,0,0,100,19,169,86,5322
"18059410700",5254,375,0,0,40,0,0,0,5669
"18059410800",8552,310,0,0,153,0,146,30,9191
"18059410900",7503,261,442,0,287,0,104,0,8597
"18059411000",5196,409,253,0,73,13,113,0,6057
"18061060100",5187,910,9,0,141,22,118,3,6390
"18061060200",6408,1090,237,0,73,24,8,0,7840
"18061060300",4173,642,0,3,146,38,59,59,5120
"18061060400",5849,1289,0,0,21,60,47,128,7394
"18061060500",5075,622,10,11,15,32,64,0,5829
"18061060600",5870,637,45,0,85,12,178,10,6837
"18063210102",15050,165,1549,0,1039,0,223,0,18026
"18063210103",3477,97,59,0,54,0,119,0,3806
"18063210104",6607,134,938,0,714,0,56,0,8449
"18063210201",3723,257,115,0,151,43,244,0,4533
"18063210202",7219,275,58,44,202,35,337,44,8214
"18063210300",6028,283,0,0,145,20,85,8,6569
"18063210400",4781,250,54,0,48,38,20,0,5191
"18063210501",6534,199,0,0,17,0,50,0,6800
"18063210502",4854,573,124,4,193,0,215,0,5963
"18063210603",7407,309,694,0,395,22,251,0,9078
"18063210604",11649,241,1237,84,551,95,787,56,14700
"18063210605",9838,232,85,0,417,9,65,0,10646
"18063210606",9349,539,1728,53,1313,104,1460,228,14774
"18063210607",2979,416,694,0,182,591,186,296,5344
"18063210608",2757,174,87,0,180,0,108,0,3306
"18063210700",7981,365,132,0,395,10,81,0,8964
"18063210801",3267,93,164,0,219,8,141,0,3892
"18063210802",3843,283,6,0,59,9,47,0,4247
"18063210900",2918,449,89,0,69,7,77,0,3609
"18063211000",5271,500,13,0,174,0,42,0,6000
"18063211100",2951,496,28,8,21,0,0,0,3504
"18065975500",2751,236,0,0,30,0,0,0,3017
"18065975600",3838,466,4,0,48,5,34,3,4398
"18065975700",3693,522,1,0,8,0,59,0,4283
"18065975800",3698,652,26,0,80,6,9,6,4477
"18065975900",3635,806,0,0,53,0,0,0,4494
"18065976000",2245,483,97,4,148,28,108,11,3124
"18065976100",1634,508,12,20,119,0,0,0,2293
"18065976300",959,521,53,58,0,33,0,0,1624
"18065976400",3584,807,0,18,114,24,0,39,4586
"18065976500",1809,752,11,0,43,20,97,100,2832
"18065976600",1714,321,2,0,73,18,73,8,2209
"18065976700",3957,600,0,0,40,0,3,12,4612
"18065976800",3748,539,2,5,26,13,24,0,4357
"18067000200",1196,568,824,735,274,56,308,38,3999
"18067000300",1859,628,102,61,72,0,75,0,2797
"18067000400",2093,808,49,89,77,362,39,51,3568
"18067000500",2314,762,53,174,62,116,88,88,3657
"18067000600",1973,255,344,41,42,34,63,0,2752
"18067000700",3942,614,93,128,208,24,44,0,5053
"18067000800",4689,326,322,32,51,27,246,22,5715
"18067000900",2683,918,97,137,42,36,152,25,4090
"18067001000",1372,198,3,86,29,54,36,13,1791
"18067001100",3102,568,354,443,128,145,123,15,4878
"18067001200",1859,1062,236,253,80,160,52,137,3839
"18067001300",1792,259,111,143,273,46,36,0,2660
"18067001400",3767,586,241,0,38,0,169,0,4801
"18067001500",2505,377,154,246,274,16,103,21,3696
"18067010100",5598,616,4,0,152,14,79,9,6472
"18067010200",4847,1081,13,0,87,0,155,28,6211
"18067010300",3289,301,60,0,156,28,92,0,3926
"18067010400",3384,105,0,0,169,14,59,0,3731
"18067010500",4777,280,9,0,116,7,54,0,5243
"18067010600",4063,421,129,5,247,0,47,0,4912
"18069961300",4092,160,6,4,108,27,24,4,4425
"18069961400",3079,530,11,0,26,31,23,31,3731
"18069961500",3664,652,3,34,17,3,41,12,4426
"18069961600",2589,672,0,0,133,0,96,11,3501
"18069961700",4258,240,6,14,7,1,16,2,4544
"18069961800",2351,612,17,0,221,65,34,134,3434
"18069961900",3667,384,44,11,79,0,73,0,4258
"18069962000",3532,525,6,0,47,10,41,6,4167
"18069962100",3063,254,0,0,21,12,27,32,3409
"18071967500",6393,768,54,0,353,0,211,117,7896
"18071967600",2795,595,0,0,286,16,117,4,3813
"18071967700",3598,255,0,0,67,61,71,131,4183
"18071967800",1411,550,71,82,334,116,177,64,2805
"18071967901",2745,859,5,28,732,342,858,509,6078
"18071967902",2386,237,66,15,167,22,203,22,3118
"18071968000",4881,604,0,0,96,42,33,0,5656
"18071968100",3366,626,0,0,100,0,30,0,4122
"18071968200",3317,516,0,0,36,0,23,0,3892
"18071968300",2762,563,0,0,97,0,66,0,3488
"18073100400",1050,109,0,0,109,0,196,0,1464
"18073100800",4430,492,7,0,193,27,502,3,5654
"18073100901",2771,395,0,0,38,0,90,12,3306
"18073100902",5771,363,117,0,185,0,38,0,6474
"18073101000",5945,177,0,0,19,0,773,3,6917
"18073101100",3112,446,8,0,61,107,66,147,3947
"18073101200",2974,376,44,0,52,4,21,0,3471
"18073101300",2792,214,2,0,23,0,39,0,3070
"18075962700",2996,251,40,3,72,9,20,9,3400
"18075962800",2550,730,0,2,13,4,62,3,3364
"18075962900",2362,397,34,0,51,6,1,29,2880
"18075963000",1905,260,0,0,15,9,149,12,2350
"18075963100",3308,674,7,0,39,0,165,108,4301
"18075963200",2289,400,0,0,13,2,5,4,2713
"18075963300",1776,653,9,0,14,0,7,0,2459
"18077966000",3606,268,45,0,79,0,0,0,3998
"18077966100",5003,745,0,0,125,266,1,332,6472
"18077966200",4339,504,21,0,33,0,14,0,4911
"18077966300",1938,666,85,10,39,0,29,23,2790
"18077966400",4143,1004,166,0,117,0,76,225,5731
"18077966500",4016,627,17,6,150,50,0,0,4866
"18077966600",1676,188,12,0,100,9,48,0,2033
"18079960200",3941,781,54,0,0,0,72,76,4924
"18079960301",3337,231,0,0,0,0,0,0,3568
"18079960302",3499,1112,35,23,40,12,88,12,4821
"18079960400",5458,1037,91,142,103,109,150,0,7090
"18079960500",2154,454,25,8,30,0,115,0,2786
"18079960600",4491,469,0,0,44,12,107,0,5123
"18081610100",10588,1544,221,235,2513,9,812,630,16552
"18081610201",4110,485,0,0,70,0,62,0,4727
"18081610202",7374,927,738,0,818,126,302,391,10676
"18081610300",2504,727,121,0,45,119,121,91,3728
"18081610401",4828,631,482,0,121,22,4,31,6119
"18081610403",3808,1135,165,136,278,85,214,110,5931
"18081610404",3949,417,120,0,35,0,103,15,4639
"18081610500",7692,440,29,0,32,0,96,0,8289
"18081610603",6256,93,1,0,107,0,0,22,6479
"18081610604",7580,482,0,0,500,0,180,0,8742
"18081610605",4704,433,156,0,161,19,50,19,5542
"18081610606",4622,427,0,0,136,0,13,0,5198
"18081610701",11766,396,37,0,330,12,232,0,12773
"18081610702",5219,451,0,0,45,19,0,0,5734
"18081610801",6213,480,0,0,65,0,0,0,6758
"18081610802",5989,758,0,0,207,57,216,16,7243
"18081610900",4011,456,104,22,51,296,0,296,5236
"18081611000",2627,358,0,187,151,0,114,0,3437
"18081611100",3028,247,20,0,13,76,19,0,3403
"18081611200",3952,430,1,35,305,8,157,30,4918
"18081611300",2798,844,83,60,209,0,218,175,4387
"18081611400",6509,520,15,0,160,1,44,1,7250
"18083955000",2383,858,0,0,0,0,0,0,3241
"18083955100",2462,179,0,0,4,0,4,0,2649
"18083955200",5229,341,24,8,171,24,79,43,5919
"18083955300",1273,504,129,0,5,29,0,0,1940
"18083955400",1209,457,32,9,105,46,118,0,1976
"18083955500",2587,524,22,0,53,117,21,62,3386
"18083955600",2336,556,29,56,11,38,48,0,3074
"18083955700",3650,854,132,0,74,0,94,0,4804
"18083955800",3285,243,0,0,58,0,33,27,3646
"18083955900",4362,520,0,220,150,47,23,92,5414
"18085960900",2553,330,4,14,97,0,60,8,3066
"18085961000",3559,458,4,0,152,42,220,4,4439
"18085961100",5075,550,9,92,125,58,498,295,6702
"18085961200",4461,614,3,0,712,199,637,194,6820
"18085961300",2727,147,0,36,110,9,172,9,3210
"18085961400",2352,577,0,0,209,5,169,69,3381
"18085961500",2374,320,0,0,25,10,25,0,2754
"18085961600",1347,82,0,0,14,10,0,0,1453
"18085961700",3531,194,0,0,438,153,735,153,5204
"18085961800",4615,428,243,19,338,0,444,91,6178
"18085961900",1921,392,35,18,300,152,423,97,3338
"18085962000",3765,781,0,0,315,62,214,59,5196
"18085962100",5961,373,79,11,409,140,446,200,7619
"18085962200",3852,581,21,0,176,0,260,87,4977
"18085962300",4625,214,0,1,284,0,194,0,5318
"18085962400",2933,188,5,0,87,12,121,0,3346
"18085962500",2147,375,0,0,30,25,3,10,2590
"18085962600",2521,282,0,0,6,18,35,18,2880
"18085962700",2925,639,0,3,11,31,25,25,3659
"18087970100",4996,1013,0,2,136,0,524,284,6955
"18087970200",4112,674,4,4,71,103,366,19,5353
"18087970300",6713,1105,0,0,53,5,70,0,7946
"18087970401",4045,380,0,0,53,0,14,0,4492
"18087970402",4242,463,0,0,191,26,139,0,5061
"18087970500",3487,403,0,0,23,0,22,0,3935
"18087970600",2143,195,0,0,7,9,14,3,2371
"18087970700",2351,527,0,0,106,0,0,0,2984
"18089010100",1295,231,2389,407,138,25,44,0,4529
"18089010201",378,476,3046,1424,209,186,270,35,6024
"18089010203",60,0,1529,1058,0,63,59,31,2800
"18089010205",58,15,424,583,31,9,89,19,1228
"18089010302",52,68,2296,875,19,0,66,138,3514
"18089010304",217,0,1709,908,79,295,295,295,3798
"18089010400",0,0,2044,744,0,15,58,10,2871
"18089010500",61,61,327,612,22,38,30,54,1205
"18089010600",50,16,502,826,100,18,100,7,1619
"18089010900",10,0,441,406,4,6,4,6,877
"18089011000",0,4,1178,530,67,0,24,31,1834
"18089011100",20,86,2945,1389,27,16,24,20,4527
"18089011200",28,17,3072,1183,12,15,12,0,4339
"18089011300",32,31,787,934,25,15,9,15,1848
"18089011400",14,126,633,781,3,6,5,77,1645
"18089011500",316,67,1721,609,37,123,227,36,3136
"18089011600",19,0,1369,655,0,0,0,0,2043
"18089011700",46,27,496,216,36,16,11,1,849
"18089011800",0,0,991,592,32,0,0,22,1637
"18089011900",37,18,497,859,5,1,20,16,1453
"18089012000",4,9,545,302,0,0,0,51,911
"18089012100",7,0,485,332,0,9,0,9,842
"18089012200",4,0,582,989,3,0,10,0,1588
"18089012300",244,253,1254,953,80,12,57,0,2853
"18089012400",169,202,1633,1959,432,182,277,184,5038
"18089012500",441,138,3005,845,129,110,264,75,5007
"18089012600",95,66,1265,876,222,21,187,32,2764
"18089012700",199,248,1780,855,318,0,324,31,3755
"18089012800",92,86,1111,981,71,7,88,115,2551
"18089020100",2977,373,64,97,1092,238,1292,340,6473
"18089020200",1360,213,51,41,371,196,408,194,2834
"18089020300",2399,593,75,46,1542,1619,2126,1689,10089
"18089020400",1301,360,415,287,1912,984,2388,1028,8675
"18089020500",720,424,663,248,1330,352,1711,475,5923
"18089020600",151,432,277,994,216,140,220,152,2582
"18089020700",1144,394,1371,934,1143,361,1377,619,7343
"18089020800",316,96,1839,786,682,285,742,160,4906
"18089020900",2195,176,486,130,509,181,658,106,4441
"18089021000",2770,534,456,248,772,665,1267,766,7478
"18089021100",1374,306,293,113,763,47,923,149,3968
"18089021300",1472,189,1163,178,894,76,916,76,4964
"18089021400",1834,206,555,878,567,490,1211,462,6203
"18089021500",1308,86,254,21,196,288,276,264,2693
"18089021600",2086,174,327,1,498,145,966,210,4407
"18089021700",2075,543,632,284,885,267,1205,325,6216
"18089021800",1857,386,435,501,307,94,650,269,4499
"18089021900",2984,368,579,207,867,158,1383,328,6874
"18089022000",2571,556,722,307,589,111,860,59,5775
"18089030100",0,0,216,791,15,100,23,113,1258
"18089030200",171,106,429,483,280,56,424,154,2103
"18089030300",90,152,781,1095,24,181,93,259,2675
"18089030400",573,380,345,371,1442,242,1761,383,5497
"18089030500",1089,564,460,541,886,729,1639,1231,7139
"18089030600",1748,492,723,309,898,1003,1819,1115,8107
"18089030700",457,74,723,125,534,48,834,36,2831
"18089030800",605,190,1057,686,1465,622,2047,778,7450
"18089030900",727,109,1469,287,762,183,1366,266,5169
"18089031000",100,33,458,412,100,58,173,91,1425
"18089040100",831,156,55,15,324,60,370,82,1893
"18089040200",1978,308,46,83,857,192,1145,327,4936
"18089040300",5478,501,258,22,611,729,568,572,8739
"18089040401",4002,315,20,25,272,20,453,21,5128
"18089040402",3205,111,308,7,738,5,408,24,4806
"18089040403",5160,216,0,0,886,12,1054,28,7356
"18089040501",2194,178,397,69,411,96,539,6,3890
"18089040502",2625,206,125,12,254,19,331,8,3580
"18089040600",2744,400,0,74,405,0,417,60,4100
"18089040700",4099,202,67,8,633,55,989,28,6081
"18089040801",3206,241,34,0,464,0,590,167,4702
"18089040802",3229,158,0,0,532,27,749,14,4709
"18089040900",6046,235,16,1,742,50,708,50,7848
"18089041001",2012,57,1687,658,459,67,928,27,5895
"18089041002",3418,653,52,22,262,58,476,71,5012
"18089041100",1281,547,66,7,257,200,359,93,2810
"18089041200",1114,589,47,221,39,112,78,130,2330
"18089041302",2119,254,175,129,84,11,217,36,3025
"18089041400",1713,602,142,158,104,32,134,36,2921
"18089041500",283,155,463,525,32,174,72,239,1943
"18089041600",2712,688,60,97,486,121,1028,326,5518
"18089041700",2634,936,45,180,321,420,910,620,6066
"18089041800",4617,788,31,35,402,396,1643,251,8163
"18089041900",4146,325,31,22,130,0,431,89,5174
"18089042000",4894,796,351,0,387,75,519,67,7089
"18089042100",4695,588,371,0,405,39,837,14,6949
"18089042200",4755,712,295,0,651,0,984,200,7597
"18089042300",4229,496,1254,20,526,13,807,92,7437
"18089042401",1537,118,2824,421,944,445,599,373,7261
"18089042402",2869,300,2640,241,688,65,1094,85,7982
"18089042403",770,239,2694,453,167,144,361,192,5020
"18089042501",3241,422,861,865,983,250,1318,283,8223
"18089042503",1462,219,988,149,199,0,375,30,3422
"18089042504",4950,453,384,211,691,13,618,19,7339
"18089042505",2612,87,2620,268,529,88,393,88,6685
"18089042602",5361,187,162,2,351,1,559,0,6623
"18089042605",6880,331,82,0,363,45,832,45,8578
"18089042606",2047,178,365,159,451,20,503,40,3763
"18089042607",5346,32,5,0,806,149,660,1,6999
"18089042608",3751,115,0,0,774,11,697,0,5348
"18089042609",8313,173,0,2,287,295,567,295,9932
"18089042702",4280,209,420,81,254,7,373,0,5624
"18089042703",3332,127,260,17,358,240,447,228,5009
"18089042704",4064,146,85,0,476,9,478,7,5265
"18089042801",7373,273,620,13,1120,13,950,1,10363
"18089042802",4731,90,112,1,196,1,420,32,5583
"18089042901",5819,142,15,0,102,110,176,119,6483
"18089042902",5546,435,70,0,505,37,543,101,7237
"18089043001",3978,291,74,10,145,27,177,15,4717
"18089043002",4942,470,0,0,255,20,283,0,5970
"18089043101",2194,333,8,0,169,0,145,10,2859
"18089043102",6440,312,60,0,284,30,307,9,7442
"18089043201",2910,420,3,0,277,63,182,51,3906
"18089043202",7030,243,145,18,528,20,459,0,8443
"18089043300",8088,501,587,0,1095,0,1725,35,12031
"18089043401",6227,429,0,0,123,1,331,16,7127
"18089043403",5983,605,0,16,160,159,207,159,7289
"18089043404",1293,199,8,16,64,8,92,6,1686
"18089043405",4757,179,24,0,117,0,201,0,5278
"18089990000",0,0,0,0,0,0,0,0,0
"18091040100",695,206,428,224,10,67,36,38,1704
"18091040300",1238,514,238,100,142,124,35,38,2429
"18091040400",2574,220,232,103,103,113,231,0,3576
"18091040500",2597,210,134,282,90,30,144,15,3502
"18091040600",2671,937,415,522,111,6,36,235,4933
"18091040700",1107,92,110,179,68,52,222,52,1882
"18091040800",1905,253,156,284,492,21,240,36,3387
"18091040900",362,174,1006,625,82,115,4,0,2368
"18091041100",1853,97,118,1,105,1,79,0,2254
"18091041200",877,36,6,0,32,0,10,0,961
"18091041300",1144,597,320,333,93,51,13,41,2592
"18091041400",1940,317,406,782,99,68,130,80,3822
"18091041500",4449,129,18,0,154,17,54,0,4821
"18091041600",5462,704,34,0,67,187,143,187,6784
"18091041700",2669,401,9,11,49,0,71,0,3210
"18091041800",5050,746,13,0,122,390,274,446,7041
"18091041900",5280,331,0,0,180,0,151,216,6158
"18091042000",2121,229,45,19,94,30,119,41,2698
"18091042100",4350,1368,72,0,449,178,533,344,7294
"18091042200",2582,450,11,0,127,23,221,12,3426
"18091042300",1101,909,6,0,53,6,220,59,2354
"18091042400",5477,827,53,74,360,63,403,44,7301
"18091042500",4451,286,18,0,142,0,117,0,5014
"18091042600",2870,723,56,30,63,0,119,33,3894
"18091042700",4355,426,70,49,166,118,139,5,5328
"18091042800",2838,92,0,0,27,10,105,55,3127
"18091042900",3186,348,3,0,64,45,114,32,3792
"18091043000",996,301,455,507,98,29,69,8,2463
"18091990000",0,0,0,0,0,0,0,0,0
"18093950400",3464,231,0,0,91,48,43,48,3925
"18093950500",4231,365,0,0,48,21,0,0,4665
"18093950600",6722,514,41,0,166,0,0,0,7443
"18093950700",6165,969,0,0,8,149,0,35,7326
"18093950800",2486,645,4,24,82,101,23,87,3452
"18093950900",2053,347,33,0,17,0,55,0,2505
"18093951000",2658,599,5,0,49,66,32,0,3409
"18093951100",2308,509,0,0,111,45,51,22,3046
"18093951200",5227,517,9,8,49,75,88,75,6048
"18093951300",2801,577,0,3,163,37,93,0,3674
"18095000300",1424,540,148,150,8,26,40,41,2377
"18095000400",560,312,744,514,32,171,25,81,2439
"18095000500",1329,760,704,439,236,116,214,247,4045
"18095000800",696,830,140,18,56,65,77,95,1977
"18095000900",1047,505,31,82,64,124,42,167,2062
"18095001000",1631,747,27,66,143,121,115,125,2975
"18095001100",1220,358,89,60,217,18,77,15,2054
"18095001200",2130,580,84,0,71,2,10,0,2877
"18095001300",3306,335,338,36,20,235,159,0,4429
"18095001400",2615,560,266,12,28,64,70,141,3756
"18095001500",2953,447,146,114,118,42,4,39,3863
"18095001600",2314,90,104,12,23,0,19,52,2614
"18095001700",1887,343,1437,576,19,10,24,21,4317
"18095001800",3472,453,174,98,370,174,247,119,5107
"18095001900",4081,1285,257,129,46,6,89,38,5931
"18095002000",2619,738,209,4,118,9,59,70,3826
"18095010100",2763,182,0,0,9,3,106,6,3069
"18095010200",3575,1046,1,0,196,75,195,0,5088
"18095010300",2508,538,0,0,3,0,105,0,3154
"18095010400",2458,247,0,0,73,8,86,0,2872
"18095010500",3185,267,0,21,83,12,49,12,3629
"18095010600",3629,1341,0,49,0,1,0,263,5283
"18095010700",2709,306,47,41,37,0,0,6,3146
"18095010800",2948,265,8,29,88,20,51,5,3414
"18095010900",1917,252,0,0,50,0,29,36,2284
"18095011000",1706,176,0,0,46,0,0,0,1928
"18095011100",3385,338,9,3,25,94,110,0,3964
"18095011200",5828,217,47,28,19,23,112,23,6297
"18095011300",2122,333,20,0,91,8,45,8,2627
"18095011400",3526,319,2,0,17,0,2,11,3877
"18095011501",4156,140,36,0,95,76,25,0,4528
"18095011502",3298,193,49,0,18,2,0,0,3560
"18095011600",9,0,0,0,0,0,0,0,9
"18095011700",2283,96,0,0,54,61,14,0,2508
"18095011800",6554,551,170,0,165,4,297,0,7741
"18095011900",594,411,135,23,17,12,71,18,1281
"18095012000",1222,612,414,254,61,36,110,44,2753
"18097310103",3950,560,1568,120,446,56,34,42,6776
"18097310104",1804,232,1017,42,187,27,64,27,3400
"18097310105",1762,149,1091,233,370,7,241,0,3853
"18097310106",1472,267,1501,49,312,66,284,151,4102
"18097310108",2176,107,644,54,151,0,69,0,3201
"18097310110",1206,68,1015,146,192,239,48,227,3141
"18097310111",1402,137,1317,71,291,95,273,81,3667
"18097310201",1377,237,1499,101,591,16,503,16,4340
"18097310203",2169,290,1129,959,704,392,724,197,6564
"18097310204",985,224,3037,447,1139,185,596,184,6797
"18097310305",1539,173,2985,879,763,593,900,489,8321
"18097310306",762,401,2636,1051,1221,1259,1219,1380,9929
"18097310308",834,58,1441,590,602,112,463,93,4193
"18097310309",660,100,2063,792,359,151,414,156,4695
"18097310310",1590,58,2171,267,586,0,577,0,5249
"18097310311",1410,219,3130,48,376,155,365,287,5990
"18097310312",1102,86,2557,251,693,810,603,822,6924
"18097320105",2624,410,611,249,308,0,100,132,4434
"18097320106",1525,89,418,46,266,22,270,10,2646
"18097320107",1485,125,112,6,61,0,6,0,1795
"18097320108",1600,365,1451,970,368,34,333,97,5218
"18097320109",1876,128,203,8,241,64,41,0,2561
"18097320202",3587,254,10,0,70,3,67,21,4012
"18097320203",2041,339,464,22,388,49,163,63,3529
"18097320204",2984,618,510,194,475,537,138,360,5816
"18097320301",2887,230,194,50,251,0,36,22,3670
"18097320303",1915,230,380,155,522,9,265,31,3507
"18097320304",5162,128,185,39,247,0,97,38,5896
"18097320400",1839,196,658,67,422,63,250,66,3561
"18097320500",1948,78,460,209,359,69,273,69,3465
"18097320600",1814,307,57,27,169,23,76,7,2480
"18097320700",1493,169,112,51,80,0,0,0,1905
"18097320800",2553,99,107,6,184,9,65,0,3023
"18097320901",3217,373,1576,183,343,250,87,367,6396
"18097320902",1470,302,1082,590,667,391,651,603,5756
"18097320903",634,138,2429,682,661,319,800,222,5885
"18097321001",995,327,1128,163,49,90,133,142,3027
"18097321002",1767,77,1554,70,176,412,89,39,4184
"18097321100",1828,127,1366,265,104,24,75,9,3798
"18097321200",4437,257,53,32,188,0,62,0,5029
"18097321300",2031,236,37,0,29,0,22,0,2355
"18097321400",3545,423,936,54,373,108,331,108,5878
"18097321600",2101,268,2175,375,518,2,259,2,5700
"18097321700",3095,97,218,4,516,0,107,0,4037
"18097321800",3081,169,123,0,108,15,83,0,3579
"18097321900",2242,612,612,36,119,46,60,11,3738
"18097322000",1113,382,1646,572,44,82,19,37,3895
"18097322100",1246,61,1012,391,106,99,28,0,2943
"18097322200",1161,60,461,173,118,0,0,0,1973
"18097322300",1919,205,331,48,75,15,46,0,2639
"18097322400",1239,299,1126,167,344,8,59,17,3259
"18097322500",284,167,588,298,78,120,30,101,1666
"18097322600",277,37,1936,1365,180,179,79,61,4114
"18097322700",302,54,1478,231,34,10,0,10,2119
"18097330103",3882,318,462,29,378,147,223,0,5439
"18097330105",3387,463,624,50,534,0,277,141,5476
"18097330106",2630,552,604,231,119,234,367,368,5105
"18097330107",5384,49,378,0,217,0,197,0,6225
"18097330108",3212,86,144,0,308,0,18,0,3768
"18097330109",3977,90,473,23,356,16,103,17,5055
"18097330202",3131,695,4513,1863,384,96,1011,254,11947
"18097330203",5207,199,219,21,396,0,311,0,6353
"18097330204",4037,84,1438,140,265,39,416,0,6419
"18097330206",3547,117,609,26,351,5,165,16,4836
"18097330208",2152,93,287,0,134,0,95,0,2761
"18097330209",6104,560,1685,220,142,291,317,133,9452
"18097330401",4470,106,1391,0,14,13,123,0,6117
"18097330500",1422,308,3685,712,178,346,111,0,6762
"18097330600",2447,820,533,1207,206,0,245,360,5818
"18097330700",4251,1365,170,0,329,79,1797,707,8698
"18097330803",622,550,1239,1432,96,163,237,457,4796
"18097330804",406,472,1254,859,154,91,199,487,3922
"18097330805",723,757,656,898,91,93,146,615,3979
"18097330806",847,494,1250,795,239,139,358,464,4586
"18097330900",575,301,2775,509,241,30,226,87,4744
"18097331000",200,23,3131,846,155,26,0,23,4404
"18097340101",2934,132,116,0,335,39,133,0,3689
"18097340102",1891,134,1202,543,190,10,587,9,4566
"18097340108",333,99,525,406,301,309,346,305,2624
"18097340109",486,10,430,95,266,125,253,120,1785
"18097340110",1886,199,1795,302,756,321,825,307,6391
"18097340111",1698,136,708,45,289,99,133,99,3207
"18097340112",2508,328,949,669,284,0,246,11,4995
"18097340113",3195,126,344,12,207,0,152,56,4092
"18097340114",3066,318,523,0,352,0,253,0,4512
"18097340201",1408,427,736,460,399,257,601,497,4785
"18097340202",1716,285,1240,229,400,230,234,260,4594
"18097340300",1693,692,1118,1277,1648,1094,2219,1278,11019
"18097340400",1270,209,714,395,735,153,928,202,4606
"18097340500",760,104,1947,717,238,37,98,37,3938
"18097340600",970,379,2427,314,748,518,724,649,6729
"18097340700",1176,529,545,1210,300,439,396,588,5183
"18097340800",1225,315,5,0,155,17,8,0,1725
"18097340901",2323,174,1140,79,159,29,156,11,4071
"18097340902",2304,636,1481,672,415,911,236,610,7265
"18097341000",1628,153,58,0,17,0,44,0,1900
"18097341100",704,455,285,227,202,160,173,299,2505
"18097341200",116,152,897,499,93,129,103,79,2068
"18097341600",197,134,893,556,53,74,59,34,2000
"18097341700",2270,926,306,248,382,510,646,689,5977
"18097341902",2505,256,334,110,133,11,98,1,3448
"18097341903",1950,366,978,939,596,648,788,638,6903
"18097341904",671,254,356,134,547,560,651,713,3886
"18097342000",3356,263,1690,425,1109,11,927,26,7807
"18097342101",2752,613,500,548,911,190,806,395,6715
"18097342200",3097,1131,340,386,399,195,639,542,6729
"18097342300",3048,2338,347,400,377,358,321,478,7667
"18097342400",1143,433,18,1,9,130,3,111,1848
"18097342500",2912,800,42,45,355,512,529,420,5615
"18097342600",989,946,218,301,535,564,533,732,4818
"18097350100",207,15,737,243,28,74,19,56,1379
"18097350300",258,201,640,869,32,20,12,9,2041
"18097350400",585,130,1276,449,72,31,42,18,2603
"18097350500",48,42,1388,704,4,25,48,30,2289
"18097350600",144,143,2900,825,63,183,48,0,4306
"18097350700",17,28,658,594,83,26,66,35,1507
"18097350800",65,18,941,1066,16,89,0,89,2284
"18097350900",196,49,771,320,17,13,2,0,1368
"18097351000",567,154,811,833,47,148,0,57,2617
"18097351200",37,112,782,1218,97,167,80,0,2493
"18097351500",327,132,819,318,130,87,37,47,1897
"18097351600",1136,230,474,227,175,5,58,24,2329
"18097351700",533,262,837,963,56,39,73,0,2763
"18097351900",65,0,1543,670,49,0,25,0,2352
"18097352100",99,54,995,594,66,36,104,34,1982
"18097352300",95,40,645,477,3,39,21,8,1328
"18097352400",1453,368,507,640,51,105,227,25,3376
"18097352500",1629,475,311,192,125,85,88,51,2956
"18097352600",1292,671,275,528,203,110,208,252,3539
"18097352700",844,631,355,403,115,181,125,54,2708
"18097352800",53,43,450,351,20,0,1,0,918
"18097353300",1459,393,130,279,137,153,149,8,2708
"18097353500",400,396,439,350,129,335,36,75,2160
"18097353600",85,365,894,689,78,43,58,18,2230
"18097354200",3131,797,358,487,342,103,241,36,5495
"18097354400",832,172,189,116,22,26,47,15,1419
"18097354500",1532,395,110,227,55,14,173,101,2607
"18097354700",633,190,328,130,61,51,184,87,1664
"18097354800",496,361,146,399,59,67,200,111,1839
"18097354900",876,506,559,428,323,34,445,199,3370
"18097355000",959,535,147,328,76,100,302,165,2612
"18097355100",807,405,188,316,54,117,59,123,2069
"18097355300",1400,635,190,163,5,131,148,62,2734
"18097355400",1275,553,458,391,77,342,47,506,3649
"18097355500",2202,690,148,201,120,64,145,379,3949
"18097355600",916,444,33,174,154,72,323,170,2286
"18097355700",1090,1003,221,91,101,28,265,208,3007
"18097355900",1250,721,156,60,35,51,131,81,2485
"18097356200",1036,130,81,59,175,14,82,5,1582
"18097356400",1569,1140,325,413,218,212,314,264,4455
"18097356900",1722,638,179,163,138,99,231,47,3217
"18097357000",1334,799,44,221,63,36,117,25,2639
"18097357100",1254,691,108,65,84,38,349,177,2766
"18097357200",1306,1582,102,180,12,83,72,472,3809
"18097357300",728,607,277,301,39,12,34,81,2079
"18097357400",2043,903,494,400,27,99,33,337,4336
"18097357500",2889,740,23,31,104,31,67,96,3981
"18097357600",3889,2034,1058,677,98,68,402,453,8679
"18097357800",923,484,52,86,54,86,85,57,1827
"18097357900",2654,490,107,73,223,466,193,451,4657
"18097358000",897,263,122,62,38,3,143,44,1572
"18097358100",1483,774,242,4,101,160,92,122,2978
"18097360101",466,390,423,715,71,67,79,145,2356
"18097360102",162,242,975,897,26,22,12,43,2379
"18097360201",1182,206,1386,820,263,15,10,22,3904
"18097360202",797,140,1650,518,200,0,229,107,3641
"18097360301",1748,270,836,156,96,201,245,172,3724
"18097360302",560,275,695,543,0,59,209,196,2537
"18097360401",1721,950,2278,665,133,18,136,553,6454
"18097360402",439,100,1053,413,34,10,141,53,2243
"18097360404",1876,888,2875,1375,397,177,543,789,8920
"18097360405",1999,80,2746,599,144,0,379,22,5969
"18097360501",3685,245,1651,452,402,105,584,105,7229
"18097360502",2977,500,1539,795,127,121,24,313,6396
"18097360601",3433,362,408,109,338,37,472,42,5201
"18097360602",3768,498,1181,401,19,0,329,0,6196
"18097360700",1316,126,166,22,64,4,16,31,1745
"18097360800",1398,540,292,140,14,48,162,300,2894
"18097360900",2471,735,835,879,77,37,276,310,5620
"18097361000",1688,123,35,0,39,1,27,0,1913
"18097361100",2362,237,136,320,145,8,149,7,3364
"18097361200",2560,623,183,53,85,0,130,0,3634
"18097361300",1730,444,0,138,59,0,64,17,2452
"18097361400",7244,965,1778,734,673,30,362,106,11892
"18097361600",5383,152,1666,49,618,198,49,0,8115
"18097370201",2852,645,92,38,138,0,131,0,3896
"18097370202",4111,1009,99,705,106,224,166,193,6613
"18097370301",7216,496,962,62,383,137,442,0,9698
"18097370302",6672,1501,80,0,334,242,172,535,9536
"18097380100",13929,1251,808,113,1312,248,461,0,18122
"18097380200",2020,481,148,67,61,227,101,186,3291
"18097380300",2833,1395,180,450,138,92,527,76,5691
"18097380402",2786,937,187,49,157,265,340,163,4884
"18097380403",3309,419,57,23,6,0,7,0,3821
"18097380404",3007,485,78,150,95,42,14,8,3879
"18097380501",1985,434,0,29,21,0,58,191,2718
"18097380502",2259,659,380,15,59,116,240,114,3842
"18097380600",2822,939,478,196,634,310,573,285,6237
"18097380700",3170,835,237,425,502,363,132,330,5994
"18097380800",1920,381,32,0,20,13,10,23,2399
"18097380901",4152,461,29,10,257,116,72,0,5097
"18097380902",5181,366,107,0,177,0,206,17,6054
"18097381001",3508,751,458,28,1525,867,178,65,7380
"18097381002",2524,137,6,6,222,117,25,120,3157
"18097381101",4689,475,92,0,123,35,0,73,5487
"18097381102",4276,565,0,0,694,187,85,44,5851
"18097381201",5893,255,204,28,394,0,274,0,7048
"18097381203",1668,683,147,82,347,319,249,212,3707
"18097381204",1438,592,34,66,447,63,82,139,2861
"18097381205",3982,1013,150,187,1443,258,490,316,7839
"18097390101",6913,866,467,0,266,0,633,0,9145
"18097390102",3539,352,145,650,246,19,81,0,5032
"18097390200",2904,112,169,0,269,0,66,0,3520
"18097390300",4988,219,90,0,357,0,15,0,5669
"18097390402",10913,312,462,0,1078,0,770,0,13535
"18097390403",9031,399,234,0,991,0,179,0,10834
"18097390404",4611,484,141,9,254,34,401,98,6032
"18097390405",2713,267,270,18,405,43,94,90,3900
"18097390500",146,48,1057,869,31,78,0,18,2247
"18097390600",2206,251,1497,762,253,0,406,46,5421
"18097390700",826,956,314,134,586,195,679,569,4259
"18097390800",3355,253,63,31,238,183,128,197,4448
"18097390900",935,270,686,282,83,26,95,11,2388
"18097391000",2342,879,219,112,397,314,136,129,4528
"18099020101",4415,497,30,6,202,49,320,49,5568
"18099020102",3341,207,0,0,132,0,140,0,3820
"18099020201",3735,314,0,0,172,0,145,16,4382
"18099020202",2493,142,38,0,136,0,0,0,2809
"18099020301",3434,341,11,0,123,0,91,33,4033
"18099020302",2563,319,49,5,57,33,85,8,3119
"18099020400",2316,364,10,1,103,4,204,35,3037
"18099020500",1903,936,0,10,484,324,1069,675,5401
"18099020600",4070,512,0,0,268,225,383,329,5787
"18099020701",2960,360,0,3,352,0,323,48,4046
"18099020702",2626,406,4,0,53,0,132,25,3246
"18099020800",4420,531,54,5,60,0,77,24,5171
"18101950100",2027,364,0,0,18,15,14,0,2438
"18101950200",3080,519,0,0,106,12,10,0,3727
"18101950300",3569,395,13,0,26,15,0,0,4018
"18103952000",3835,407,0,0,256,32,60,14,4604
"18103952100",3976,353,56,0,144,0,80,0,4609
"18103952200",1977,394,119,0,17,46,0,0,2553
"18103952300",1844,370,302,60,37,68,49,56,2786
"18103952400",1679,701,399,22,23,4,17,0,2845
"18103952500",1512,493,22,0,85,31,90,26,2259
"18103952600",2951,441,0,0,26,0,7,0,3425
"18103952700",6235,604,10,34,247,12,335,0,7477
"18103952800",1393,536,7,2,46,0,0,0,1984
"18103952900",1378,526,126,8,73,30,84,51,2276
"18105000100",1295,3514,17,12,131,317,49,125,5460
"18105000201",62,62,25,16,107,292,0,0,564
"18105000202",11,45,0,0,0,4,0,0,60
"18105000301",2350,1513,156,84,144,295,104,80,4726
"18105000302",1762,980,7,2,121,54,17,17,2960
"18105000401",2803,1017,82,127,118,211,86,262,4706
"18105000402",2777,994,154,88,535,57,171,53,4829
"18105000501",3024,722,58,130,259,45,59,37,4334
"18105000502",2589,414,66,0,360,9,166,0,3604
"18105000601",1642,1438,137,277,484,369,211,29,4587
"18105000602",962,1431,2,302,320,120,260,84,3481
"18105000700",2267,184,44,7,119,45,90,0,2756
"18105000800",4417,721,86,0,336,364,0,53,5977
"18105000901",1383,908,49,13,236,341,112,56,3098
"18105000903",2990,1225,187,82,290,289,221,54,5338
"18105000904",2644,742,6,243,469,1365,0,98,5567
"18105001001",3907,278,305,0,539,35,113,0,5177
"18105001002",4221,420,147,0,552,261,98,52,5751
"18105001101",3273,1118,127,96,422,205,75,11,5327
"18105001102",3204,558,229,105,289,105,163,0,4653
"18105001103",2507,310,53,0,260,0,94,0,3224
"18105001200",5618,284,0,0,141,0,85,0,6128
"18105001301",5121,561,0,0,97,46,0,39,5864
"18105001303",5548,165,12,0,132,37,91,37,6022
"18105001304",3209,340,104,0,332,0,221,0,4206
"18105001305",1971,98,13,0,47,3,0,0,2132
"18105001401",1972,203,7,0,48,0,14,0,2244
"18105001402",4454,613,16,0,166,0,111,0,5360
"18105001501",5085,242,0,0,96,29,0,0,5452
"18105001502",2464,303,0,0,75,0,22,0,2864
"18105001600",968,3544,57,36,124,242,73,116,5160
"18107956700",2814,171,8,2,144,0,38,0,3177
"18107956800",2708,277,0,0,40,5,57,10,3097
"18107956900",4526,661,1,0,118,0,381,0,5687
"18107957000",2818,796,106,114,34,0,13,0,3881
"18107957100",3324,940,0,0,113,118,247,137,4879
"18107957200",3038,1283,35,0,297,33,493,218,5397
"18107957300",3850,265,0,13,36,0,11,20,4195
"18107957400",4151,117,0,0,14,16,0,47,4345
"18107957500",3044,341,0,0,20,1,5,0,3411
"18109510100",9292,232,0,0,34,162,118,0,9838
"18109510201",3756,422,0,0,55,0,90,0,4323
"18109510202",3186,511,0,0,13,0,3,0,3713
"18109510300",4191,612,0,0,14,0,44,15,4876
"18109510401",3699,224,0,0,94,19,0,4,4040
"18109510402",4868,367,28,0,68,41,133,0,5505
"18109510500",3862,348,6,0,88,1,118,0,4423
"18109510600",6643,972,11,0,97,2,35,14,7774
"18109510701",2580,374,41,2,139,0,130,0,3266
"18109510702",5369,318,0,0,31,0,5,0,5723
"18109510800",2713,618,0,0,61,44,6,0,3442
"18109510900",2377,1641,0,88,6,95,27,45,4279
"18109511000",6447,970,0,0,201,174,21,113,7926
"18111100400",5273,612,21,0,0,45,326,28,6305
"18111100500",2537,321,0,1,110,47,26,48,3090
"18111100600",1902,490,0,3,55,49,157,64,2720
"18111100700",1951,324,0,0,73,0,86,49,2483
"18113971700",5220,431,0,0,219,16,192,0,6078
"18113971800",2619,776,0,3,29,52,220,38,3737
"18113971900",3866,879,1,0,80,0,180,97,5103
"18113972000",2459,319,0,4,106,19,39,0,2946
"18113972100",4073,429,35,0,208,0,583,0,5328
"18113972200",3694,658,0,15,291,0,2198,361,7217
"18113972300",3894,845,85,0,149,31,285,243,5532
"18113972400",4076,515,0,49,25,39,83,11,4798
"18113972500",5788,392,0,0,109,9,45,50,6393
"18113972600",3735,184,0,0,31,0,15,0,3965
"18115965700",2233,277,51,0,0,0,0,0,2561
"18115965800",3151,193,7,0,8,0,0,0,3359
"18117951300",2612,537,14,35,8,0,0,0,3206
"18117951400",2711,523,4,0,35,0,32,0,3305
"18117951500",2157,664,117,64,122,56,48,106,3334
"18117951600",2783,439,25,0,33,10,0,0,3290
"18117951700",2376,558,0,0,64,48,14,3,3063
"18117951800",2786,469,0,0,35,0,40,0,3330
"18119955500",3050,412,42,0,4,7,36,7,3558
"18119955600",3160,514,0,0,138,14,0,0,3826
"18119955700",4014,900,0,0,56,20,0,0,4990
"18119955800",3290,559,71,8,144,0,21,0,4093
"18119955900",3777,697,0,0,25,41,69,13,4622
"18121030100",3753,511,0,0,26,0,14,4,4308
"18121030200",2798,552,0,0,29,14,32,24,3449
"18121030300",2740,636,0,64,39,22,0,42,3543
"18121030400",3588,620,0,12,53,55,67,2,4397
"18123952200",3514,352,39,0,32,0,0,6,3943
"18123952300",3189,135,0,0,48,0,13,20,3405
"18123952400",3246,606,7,1,71,34,50,0,4015
"18123952500",3163,462,160,32,7,89,0,63,3976
"18123952600",1674,507,0,14,80,44,50,28,2397
"18125953900",3287,114,0,0,9,0,0,0,3410
"18125954000",2461,404,0,0,0,0,0,0,2865
"18125954100",2734,127,0,0,9,10,0,0,2880
"18125954200",2704,582,0,3,14,3,11,0,3317
"18127050101",7446,983,264,0,513,181,551,194,10132
"18127050103",7057,323,16,17,714,29,271,26,8453
"18127050202",5245,660,296,19,57,36,284,5,6602
"18127050203",5772,442,0,2,118,67,308,174,6883
"18127050300",5672,1027,10,4,181,120,316,307,7637
"18127050402",6325,973,437,61,364,98,1415,318,9991
"18127050405",1092,46,4,0,61,0,22,7,1232
"18127050407",2856,814,199,31,202,13,606,135,4856
"18127050501",3993,883,132,119,259,100,579,177,6242
"18127050503",4076,612,139,99,70,23,535,0,5554
"18127050505",2289,216,43,2,126,11,386,26,3099
"18127050506",4739,423,510,54,322,46,1123,152,7369
"18127050507",2790,479,482,95,235,7,549,46,4683
"18127050508",3422,749,485,167,151,153,318,303,5748
"18127050509",3624,480,256,54,115,165,389,180,5263
"18127050602",3820,759,0,10,185,0,209,435,5418
"18127050603",3369,69,0,0,53,28,180,0,3699
"18127050604",7121,877,60,0,241,0,391,14,8704
"18127050702",5692,1195,113,300,104,312,755,203,8674
"18127050703",2941,210,83,12,68,0,170,0,3484
"18127050704",4145,441,168,29,160,25,201,0,5169
"18127050800",5273,622,86,15,94,148,386,28,6652
"18127050900",1639,597,58,19,114,39,104,101,2671
"18127051002",7226,413,19,1,376,112,426,150,8723
"18127051005",4261,194,54,0,86,14,244,14,4867
"18127051006",3920,206,8,0,295,17,323,34,4803
"18127051007",6559,247,49,0,204,0,537,26,7622
"18127051008",2153,206,0,0,23,51,121,51,2605
"18127051101",5521,342,6,280,48,0,56,26,6279
"18127051102",4240,177,24,0,74,0,146,25,4686
"18127980001",0,0,0,0,0,0,0,0,0
"18127980002",0,0,0,0,0,0,0,0,0
"18127990000",0,0,0,0,0,0,0,0,0
"18129040100",5269,473,0,0,27,3,44,0,5816
"18129040200",1922,99,7,0,87,0,8,20,2143
"18129040300",2555,107,0,0,10,0,46,0,2718
"18129040400",4721,632,120,0,0,0,35,0,5508
"18129040500",2529,337,0,0,14,0,0,24,2904
"18129040600",2659,670,68,0,119,17,45,0,3578
"18129040700",2293,303,21,102,27,58,4,0,2808
"18131958900",2210,343,28,0,29,0,77,0,2687
"18131959000",2725,623,32,0,106,65,108,23,3682
"18131959100",3098,443,0,0,150,0,78,32,3801
"18131959200",2558,309,0,0,24,25,35,5,2956
"18133956000",2602,456,0,0,12,0,2,0,3072
"18133956100",2205,189,0,0,0,0,0,0,2394
"18133956200",3397,307,2,4,35,19,26,4,3794
"18133956300",4906,585,7,14,140,113,68,18,5851
"18133956400",6739,552,39,82,77,44,36,51,7620
"18133956500",5297,727,6,0,74,3,22,9,6138
"18133956600",2992,147,14,0,48,3,64,32,3300
"18135951400",2240,487,13,4,24,0,22,4,2794
"18135951500",2387,382,0,0,12,8,97,2,2888
"18135951600",2554,1017,0,0,109,80,175,351,4286
"18135951700",2150,694,0,0,12,2,0,2,2860
"18135951800",2079,331,0,0,47,38,0,4,2499
"18135951900",3503,682,3,0,64,31,33,0,4316
"18135952000",2705,373,13,0,61,0,12,5,3169
"18135952100",2429,381,21,4,143,8,23,41,3050
"18137968400",6561,423,14,0,96,8,58,58,7218
"18137968500",3989,285,13,0,267,0,68,0,4622
"18137968600",4218,517,0,0,121,71,126,62,5115
"18137968700",3021,510,0,0,9,0,13,0,3553
"18137968800",2795,272,54,0,41,10,66,0,3238
"18137968900",4375,307,0,0,75,0,27,0,4784
"18139974100",2401,281,0,0,28,0,0,0,2710
"18139974200",3040,724,0,0,81,0,41,0,3886
"18139974300",2665,735,33,0,123,0,17,0,3573
"18139974400",2086,540,108,13,0,42,64,89,2942
"18139974500",3180,611,0,0,26,0,0,0,3817
"18141000100",924,87,386,397,190,11,301,20,2316
"18141000200",727,673,1115,957,151,178,99,276,4176
"18141000301",1523,496,226,162,187,39,23,215,2871
"18141000302",961,140,451,713,153,30,44,76,2568
"18141000400",416,286,687,795,65,133,69,189,2640
"18141000500",325,122,735,201,71,19,94,83,1650
"18141000600",561,370,510,455,160,66,267,112,2501
"18141000700",841,110,80,182,132,25,96,0,1466
"18141000800",1483,113,52,11,60,9,109,0,1837
"18141000900",516,235,109,41,61,13,6,26,1007
"18141001000",1159,486,447,594,137,122,123,185,3253
"18141001100",2999,379,786,314,235,142,185,166,5206
"18141001200",1987,80,98,11,156,4,126,0,2462
"18141001300",1460,135,405,222,59,27,69,7,2384
"18141001400",1975,401,307,196,157,27,131,205,3399
"18141001500",1308,361,71,386,4,348,11,17,2506
"18141001600",1959,46,96,20,55,0,98,0,2274
"18141001700",478,337,359,343,21,24,20,23,1605
"18141001900",266,137,366,485,47,21,29,89,1440
"18141002000",197,315,390,812,28,222,40,101,2105
"18141002100",169,87,258,469,24,68,57,62,1194
"18141002200",1510,390,277,155,449,284,1300,535,4900
"18141002300",148,214,592,194,120,157,217,115,1757
"18141002400",827,566,659,408,359,228,706,645,4398
"18141002500",814,290,506,193,168,160,426,305,2862
"18141002600",1662,296,491,166,173,21,737,144,3690
"18141002700",285,417,102,97,140,131,322,283,1777
"18141002800",1136,403,365,161,230,71,592,266,3224
"18141002900",134,137,467,161,84,81,98,90,1252
"18141003000",575,132,395,187,151,216,165,194,2015
"18141003100",1530,1057,277,260,295,204,266,52,3941
"18141003200",3815,333,315,5,411,38,240,62,5219
"18141003300",1628,355,401,357,35,59,112,0,2947
"18141003400",1533,584,699,722,329,164,767,220,5018
"18141003500",1649,375,250,228,204,174,107,110,3097
"18141010100",1907,598,80,19,56,168,84,11,2923
"18141010200",3549,1190,143,229,96,27,147,0,5381
"18141010300",4226,491,272,106,274,114,88,0,5571
"18141010400",2635,450,36,11,106,34,139,34,3445
"18141010500",2460,134,58,0,258,0,118,0,3028
"18141010600",2262,410,108,120,168,187,50,35,3340
"18141010700",2445,493,13,80,197,26,132,0,3386
"18141010800",4119,325,3,0,43,0,127,4,4621
"18141010900",6528,702,394,0,116,18,532,18,8308
"18141011000",5198,390,540,29,304,16,343,52,6872
"18141011100",3062,513,129,277,463,188,620,227,5479
"18141011201",409,157,50,8,40,101,20,7,792
"18141011202",447,324,19,16,42,72,6,23,949
"18141011301",3293,1067,269,216,389,20,163,58,5475
"18141011302",5401,349,832,33,281,0,55,33,6984
"18141011303",4466,329,360,213,280,33,490,0,6171
"18141011304",2206,42,89,0,83,0,78,0,2498
"18141011305",3742,114,90,64,341,0,199,0,4550
"18141011306",2496,111,106,0,255,0,77,6,3051
"18141011403",4640,494,85,69,456,190,28,21,5983
"18141011404",5574,160,200,0,1035,0,141,0,7110
"18141011405",3511,87,9,0,91,0,120,0,3818
"18141011406",4653,203,53,0,189,35,13,0,5146
"18141011501",1399,682,660,180,77,362,53,756,4169
"18141011503",1550,130,0,0,43,13,55,0,1791
"18141011504",1212,140,81,0,99,0,55,0,1587
"18141011505",2081,125,59,36,375,40,230,0,2946
"18141011506",3650,475,458,70,109,124,126,198,5210
"18141011601",7759,422,29,0,97,30,172,73,8582
"18141011602",7090,424,25,7,246,23,277,6,8098
"18141011701",2804,694,187,41,86,32,135,9,3988
"18141011702",6214,577,719,266,401,270,7,7,8461
"18141011801",1361,41,39,0,73,8,46,8,1576
"18141011802",5309,552,282,54,248,88,243,37,6813
"18141011900",3646,204,36,5,173,25,372,52,4513
"18141012000",3362,280,102,0,44,30,107,27,3952
"18141012100",3213,576,3,12,31,0,64,0,3899
"18141012200",2520,350,0,0,29,23,45,55,3022
"18141012300",2964,627,9,0,14,5,17,64,3700
"18141012400",1948,109,15,0,0,7,7,7,2093
"18143966700",3711,571,0,0,90,16,116,0,4504
"18143966800",3086,824,12,0,42,0,15,79,4058
"18143966900",3566,695,0,0,21,47,35,8,4372
"18143967000",3842,1175,0,3,75,35,96,36,5262
"18143967100",4454,751,10,18,212,13,0,13,5471
"18145710100",3297,341,0,0,57,9,24,0,3728
"18145710200",5328,414,0,2,66,0,107,2,5919
"18145710300",4227,426,0,0,65,0,119,2,4839
"18145710400",2084,495,0,3,310,216,303,198,3609
"18145710500",3494,554,123,0,427,139,306,139,5182
"18145710601",2272,680,1,4,140,34,201,9,3341
"18145710602",1977,515,103,28,188,45,170,45,3071
"18145710700",5260,621,189,73,41,0,40,31,6255
"18145710800",4087,226,0,2,107,0,0,0,4422
"18145710900",4399,463,0,0,4,12,0,0,4878
"18147952700",6867,377,7,0,298,140,226,227,8142
"18147952800",2378,601,10,1,101,2,76,0,3169
"18147952900",2288,163,3,0,18,7,24,0,2503
"18147953000",3674,274,32,0,0,0,0,0,3980
"18147953100",2538,577,49,0,25,71,0,0,3260
"18149953600",2229,214,0,0,93,0,51,0,2587
"18149953700",2922,577,0,0,286,15,302,0,4102
"18149953800",3246,406,48,0,48,0,6,0,3754
"18149953900",1792,259,0,0,42,0,0,0,2093
"18149954000",2756,680,0,12,45,89,74,89,3745
"18149954100",2490,723,0,28,40,46,71,39,3437
"18149954200",3188,533,30,35,67,65,106,65,4089
"18151970800",3554,368,0,0,88,18,96,0,4124
"18151970900",2108,70,0,0,42,0,8,0,2228
"18151971000",3227,328,0,0,74,2,114,0,3745
"18151971100",2377,311,0,0,57,0,0,0,2745
"18151971200",2969,150,3,0,54,0,188,0,3364
"18151971300",3775,891,13,0,59,82,34,0,4854
"18151971400",3270,566,0,6,78,32,313,14,4279
"18151971500",3126,331,14,0,47,2,69,33,3622
"18151971600",4131,365,3,9,45,11,107,29,4700
"18153050100",4690,1197,61,29,40,6,32,34,6089
"18153050200",2777,355,0,0,65,0,0,0,3197
"18153050300",3846,1326,0,0,123,47,101,9,5452
"18153050400",1938,173,0,0,22,0,13,3,2149
"18153050500",1745,401,8,0,40,0,0,0,2194
"18155965700",3447,1219,45,1,53,67,47,0,4879
"18155965800",2577,272,47,0,19,0,0,0,2915
"18155965900",2066,427,7,0,51,36,6,15,2608
"18157000100",1569,482,82,241,11,33,211,37,2666
"18157000200",1271,329,8,171,24,9,69,120,2001
"18157000300",2678,119,239,0,73,0,288,0,3397
"18157000400",1876,1300,684,353,236,99,121,162,4831
"18157000700",1937,567,107,360,179,8,417,96,3671
"18157000800",1487,250,65,0,71,7,221,3,2104
"18157001000",1145,168,0,7,110,0,46,14,1490
"18157001100",2672,135,0,25,66,0,165,0,3063
"18157001200",2238,409,228,0,114,59,468,64,3580
"18157001300",3428,602,132,0,223,40,322,85,4832
"18157001400",2895,387,104,205,289,38,827,251,4996
"18157001501",2986,698,201,532,107,10,327,148,5009
"18157001502",4590,1202,106,211,172,82,112,177,6652
"18157001600",9798,1009,44,75,706,2,1011,180,12825
"18157001700",4245,1569,148,492,519,124,935,594,8626
"18157001800",2765,486,274,150,138,82,640,257,4792
"18157001900",3422,319,98,52,170,15,376,99,4551
"18157005101",1721,363,26,0,828,464,36,133,3571
"18157005102",4037,172,8,0,798,141,186,0,5342
"18157005200",3426,480,23,110,896,99,101,0,5135
"18157005300",1131,1244,80,0,397,239,29,32,3152
"18157005400",627,2700,0,155,243,1037,32,126,4920
"18157005500",488,2403,17,41,144,618,19,177,3907
"18157010100",5479,294,0,0,285,84,234,0,6376
"18157010201",4845,382,49,0,138,0,218,0,5632
"18157010203",5163,2159,301,3,785,710,397,196,9714
"18157010204",6784,4072,152,254,727,939,326,488,13742
"18157010300",133,246,0,28,6,332,0,31,776
"18157010400",0,0,0,0,0,0,0,0,0
"18157010500",104,174,59,0,691,473,40,31,1572
"18157010600",5091,263,0,0,127,4,53,0,5538
"18157010700",3984,619,240,0,226,112,574,286,6041
"18157010800",4393,224,175,0,58,0,78,0,4928
"18157010901",6781,282,21,53,314,176,478,16,8121
"18157010902",3779,278,13,26,24,0,59,89,4268
"18157011000",3874,199,0,0,112,0,65,0,4250
"18157011100",2866,593,142,95,103,49,110,202,4160
"18159020100",2421,438,0,1,116,0,149,136,3261
"18159020200",2912,126,9,2,19,0,27,2,3097
"18159020300",2404,171,0,0,9,56,0,0,2640
"18159020400",5736,735,7,0,203,0,74,11,6766
"18161960700",3501,453,2,0,110,8,46,1,4121
"18161960800",2727,293,0,0,134,0,0,0,3154
"18163000100",1544,277,3,11,50,0,13,0,1898
"18163000201",6657,401,296,131,254,0,0,0,7739
"18163000202",1503,164,104,45,123,0,50,0,1989
"18163000300",1650,605,142,60,54,77,30,54,2672
"18163000400",1864,284,25,11,7,0,15,0,2206
"18163000500",1806,147,71,10,120,7,58,19,2238
"18163000600",1461,131,124,6,174,110,43,29,2078
"18163000800",1678,239,405,168,185,23,10,0,2708
"18163000900",3969,968,350,187,321,286,119,499,6699
"18163001000",1984,645,480,584,416,25,224,0,4358
"18163001100",741,460,654,509,8,160,0,163,2695
"18163001200",620,201,288,234,76,48,0,0,1467
"18163001300",439,278,532,370,38,81,0,18,1756
"18163001400",682,330,445,475,82,0,86,7,2107
"18163001500",446,147,737,540,71,31,33,0,2005
"18163001700",803,483,361,310,86,25,70,0,2138
"18163001800",256,118,7,39,5,4,0,4,433
"18163001900",496,288,55,78,55,66,41,16,1095
"18163002000",472,264,50,36,13,0,0,0,835
"18163002100",1291,633,154,21,98,20,100,17,2334
"18163002300",1947,645,26,35,10,35,10,0,2708
"18163002400",2959,505,19,32,65,0,0,0,3580
"18163002500",1242,437,171,172,4,67,116,11,2220
"18163002600",1545,1196,422,284,58,84,0,138,3727
"18163002800",1957,292,102,38,59,0,66,0,2514
"18163002900",841,164,0,0,0,31,0,0,1036
"18163003000",3904,646,0,0,0,0,16,0,4566
"18163003100",2156,512,21,0,12,38,0,0,2739
"18163003200",3247,894,62,51,55,9,27,16,4361
"18163003300",2529,642,67,186,129,38,32,30,3653
"18163003400",2629,269,1,0,0,37,0,2,2938
"18163003500",2046,314,53,0,134,3,61,7,2618
"18163003600",3010,548,342,406,15,76,259,40,4696
"18163003701",1304,130,55,31,101,70,86,65,1842
"18163003702",2457,1067,500,400,173,233,105,462,5397
"18163003801",4174,379,314,56,192,22,123,29,5289
"18163003803",4475,244,142,2,165,34,23,18,5103
"18163003804",4539,470,455,296,383,17,245,0,6405
"18163003900",2602,170,290,11,18,0,38,0,3129
"18163010100",4288,611,439,146,447,171,13,38,6153
"18163010201",9639,179,336,2,715,18,195,1,11085
"18163010202",2705,108,166,0,121,9,29,16,3154
"18163010203",7371,1205,217,0,175,40,48,40,9096
"18163010403",3141,474,30,24,98,45,0,2,3814
"18163010404",6126,494,0,0,299,0,23,0,6942
"18163010500",6967,552,0,0,42,0,35,0,7596
"18163010600",1742,125,0,0,53,0,6,0,1926
"18163010700",7615,380,206,26,426,92,81,0,8826
"18163980100",0,0,0,0,0,0,0,0,0
"18165020100",2720,368,0,6,34,0,24,3,3155
"18165020200",2772,265,0,0,40,5,1,10,3093
"18165020300",2434,381,2,3,30,15,26,4,2895
"18165020400",1766,129,0,0,0,0,1,0,1896
"18165020500",3570,819,36,5,131,0,98,0,4659
"18167000300",767,609,7,97,105,148,8,9,1750
"18167000400",2264,1033,114,184,68,98,141,82,3984
"18167000500",704,533,101,186,175,170,73,12,1954
"18167000600",1107,839,330,84,14,119,0,180,2673
"18167000700",891,544,75,186,120,112,20,26,1974
"18167000900",1687,658,13,155,9,0,36,14,2572
"18167001000",2719,594,112,9,193,46,12,0,3685
"18167001100",1561,965,40,0,65,59,3,59,2752
"18167001200",1766,402,141,47,170,14,33,0,2573
"18167001300",1369,424,13,19,121,7,0,12,1965
"18167001400",2307,272,95,0,83,228,88,54,3127
"18167001500",2417,524,39,23,76,40,77,0,3196
"18167001600",4463,132,178,1,51,1,147,1,4974
"18167001700",3119,646,100,174,110,79,64,90,4382
"18167001800",1643,577,161,239,152,21,19,4,2816
"18167001900",988,569,28,96,48,246,69,13,2057
"18167010100",3983,451,114,0,104,22,5,0,4679
"18167010201",4111,236,88,0,51,54,16,0,4556
"18167010202",2584,587,10,0,82,0,0,0,3263
"18167010300",2818,284,39,0,73,0,20,0,3234
"18167010400",3440,222,0,0,113,0,0,0,3775
"18167010500",1837,677,20,0,6,6,48,0,2594
"18167010600",4384,1236,56,60,203,53,14,5,6011
"18167010701",5218,526,205,16,474,106,78,24,6647
"18167010702",4598,873,219,0,421,0,19,86,6216
"18167011000",3491,320,0,2,156,0,75,31,4075
"18167011100",1381,1109,168,205,94,346,42,99,3444
"18167011200",4482,504,87,38,543,103,135,0,5892
"18169102200",4223,655,70,0,114,129,196,42,5429
"18169102300",3000,613,54,27,73,14,29,48,3858
"18169102400",2713,401,0,0,41,0,24,2,3181
"18169102500",3705,377,0,0,104,17,106,24,4333
"18169102600",2365,719,40,0,103,15,93,0,3335
"18169102700",3168,715,0,0,58,40,0,0,3981
"18169102800",2776,448,0,0,120,0,34,30,3408
"18169102900",3212,193,0,0,133,10,66,9,3623
"18171951000",4036,292,0,35,80,8,47,0,4498
"18171951100",3267,405,0,0,24,0,48,0,3744
"18173030100",3110,413,0,0,7,8,8,10,3556
"18173030200",3081,218,0,0,17,4,0,0,3320
"18173030300",4582,164,48,0,131,23,45,0,4993
"18173030400",1982,519,0,0,23,138,5,40,2707
"18173030500",6627,270,0,0,96,87,108,25,7213
"18173030600",4979,1106,0,44,54,31,105,166,6485
"18173030702",6023,290,139,3,589,0,121,0,7165
"18173030703",4303,927,142,0,151,95,33,57,5708
"18173030704",3889,304,117,157,158,26,116,0,4767
"18173030705",6810,405,0,0,430,0,28,0,7673
"18173030800",5903,642,186,52,256,0,176,0,7215
"18175967200",3804,499,0,0,156,0,0,8,4467
"18175967300",3756,875,5,0,50,14,33,3,4736
"18175967400",3707,639,0,0,64,48,31,10,4499
"18175967500",2252,625,0,0,51,27,0,40,2995
"18175967600",3642,607,0,0,37,50,34,50,4420
"18175967700",5763,806,0,0,15,0,137,36,6757
"18177000200",1678,1142,54,130,15,135,0,228,3382
"18177000400",2095,464,164,189,132,0,0,11,3055
"18177000500",2376,1329,182,211,307,53,289,176,4923
"18177000600",1501,404,58,7,3,7,56,11,2047
"18177000700",4920,823,129,82,180,122,33,1,6290
"18177000800",2635,538,54,16,223,203,21,135,3825
"18177000900",2841,1403,588,160,23,271,0,134,5420
"18177001000",2359,905,217,33,305,275,102,112,4308
"18177001100",4878,802,527,42,367,86,139,19,6860
"18177010100",2356,448,0,0,15,0,0,0,2819
"18177010200",2775,401,0,0,35,10,0,0,3221
"18177010300",2708,468,0,0,3,7,9,31,3226
"18177010400",3015,272,0,14,73,21,16,0,3411
"18177010500",2213,183,0,1,25,0,21,0,2443
"18177010600",3484,962,3,0,45,17,42,0,4553
"18177010700",3560,289,6,16,30,49,3,0,3953
"18177010800",2155,590,26,32,113,120,10,101,3147
"18179040100",4845,595,9,0,133,118,8,138,5846
"18179040200",3555,206,0,0,33,0,64,0,3858
"18179040300",3479,391,77,0,102,0,94,2,4145
"18179040400",3041,375,15,0,29,0,51,0,3511
"18179040500",2396,288,0,7,14,0,30,0,2735
"18179040600",2746,770,7,41,111,104,101,140,4020
"18179040700",3280,401,0,0,23,10,28,13,3755
"18181958100",2046,253,0,0,136,0,156,0,2591
"18181958200",2012,536,0,0,107,122,243,367,3387
"18181958300",2065,109,23,0,77,5,20,5,2304
"18181958400",1860,85,0,0,146,0,121,0,2212
"18181958500",3299,281,0,0,107,18,168,18,3891
"18181958600",3942,473,0,0,275,105,519,120,5434
"18181958700",2491,154,20,0,49,0,10,0,2724
"18181958800",2908,162,28,0,68,6,28,0,3200
"18183050100",4793,319,0,0,174,0,95,0,5381
"18183050200",4967,78,0,0,8,0,0,0,5053
"18183050300",4705,550,18,3,88,8,63,0,5435
"18183050400",5997,731,34,0,176,20,121,0,7079
"18183050500",4140,344,0,14,154,233,149,134,5168
"18183050600",1892,247,0,0,58,0,17,0,2214
"18183050700",2968,86,0,0,14,0,10,0,3078
"19001960100",2382,298,18,9,4,8,39,3,2761
"19001960200",1425,114,0,0,16,12,4,5,1576
"19001960300",2546,323,0,0,46,0,49,13,2977
"19003950100",1598,73,0,1,29,4,9,2,1716
"19003950200",1782,263,6,18,13,29,12,8,2131
"19005960100",1718,151,4,0,41,0,36,3,1953
"19005960200",2452,154,0,0,5,31,0,0,2642
"19005960300",3262,440,0,0,97,13,43,0,3855
"19005960400",2060,188,0,0,13,1,2,1,2265
"19005960500",2369,459,43,22,132,32,465,215,3737
"19007950100",2515,349,4,0,54,1,27,3,2953
"19007950200",1544,182,0,2,3,2,4,4,1741
"19007950300",1962,305,21,5,145,2,101,5,2546
"19007950400",2693,653,11,0,21,8,30,13,3429
"19007950500",1793,198,0,0,27,12,3,3,2036
"19009070100",1732,137,10,0,28,0,20,0,1927
"19009070200",1851,187,0,0,36,39,0,28,2141
"19009070300",1452,183,8,0,9,6,0,0,1658
"19011960100",2710,223,40,0,8,0,0,0,2981
"19011960200",2812,235,0,0,85,5,82,0,3219
"19011960300",4511,614,0,10,73,21,0,0,5229
"19011960400",2704,377,12,0,0,0,0,0,3093
"19011960500",5362,231,117,0,62,0,39,0,5811
"19011960600",2417,210,0,0,49,20,5,98,2799
"19011960700",2043,488,0,0,65,6,14,98,2714
"19013000100",403,391,193,337,53,26,17,65,1485
"19013000200",1683,294,275,411,169,218,275,64,3389
"19013000300",1047,853,487,69,466,71,197,88,3278
"19013000400",1205,221,31,18,56,9,16,0,1556
"19013000500",635,464,408,169,232,20,146,8,2082
"19013000700",319,199,318,446,247,34,299,213,2075
"19013000800",2617,420,329,9,287,79,581,34,4356
"19013000900",1122,354,170,76,109,25,123,65,2044
"19013001000",3084,142,160,0,146,120,75,29,3756
"19013001100",2189,199,174,108,208,111,473,111,3573
"19013001200",2182,61,38,0,72,0,60,0,2413
"19013001301",2849,280,81,158,108,265,141,106,3988
"19013001302",3001,250,127,218,296,1,77,0,3970
"19013001400",3803,294,203,166,185,0,101,29,4781
"19013001501",2352,112,211,109,215,103,137,0,3239
"19013001502",3511,293,60,120,175,11,86,0,4256
"19013001503",3190,441,17,12,154,46,0,29,3889
"19013001600",1824,157,328,142,188,69,99,0,2807
"19013001701",514,127,834,667,78,20,91,28,2359
"19013001702",1515,75,564,155,78,23,134,24,2568
"19013001800",187,33,982,453,10,1,18,27,1711
"19013001900",997,210,751,165,178,0,211,0,2512
"19013002000",4420,399,209,0,216,54,109,21,5428
"19013002200",3485,631,95,49,80,7,45,0,4392
"19013002301",1715,353,73,5,139,10,70,13,2378
"19013002303",466,871,28,0,0,66,0,37,1468
"19013002304",1362,747,0,44,160,35,0,0,2348
"19013002400",3595,114,102,84,133,0,77,0,4105
"19013002500",5021,536,27,35,341,0,20,38,6018
"19013002601",3045,720,0,22,71,89,58,0,4005
"19013002603",8233,2103,23,2,394,21,100,113,10989
"19013002604",3968,167,35,17,35,10,13,0,4245
"19013002700",3463,280,44,0,63,7,26,5,3888
"19013002800",2933,108,106,0,22,0,60,0,3229
"19013002901",1233,55,0,0,7,0,14,0,1309
"19013002902",3583,306,0,0,38,0,89,10,4026
"19013003001",3483,643,13,39,158,15,44,15,4410
"19013003002",3528,113,0,0,30,0,7,0,3678
"19015020100",2484,182,14,0,70,0,63,0,2813
"19015020200",3694,257,0,0,38,21,49,0,4059
"19015020300",5198,571,117,64,34,52,257,1,6294
"19015020400",1955,334,0,0,57,12,6,12,2376
"19015020500",4122,336,0,0,17,20,48,3,4546
"19015020600",1649,365,0,6,26,0,21,77,2144
"19015020700",3553,355,0,0,91,13,24,0,4036
"19017004000",1125,259,1,0,24,0,10,0,1419
"19017004100",3203,85,77,2,50,7,29,0,3453
"19017004200",3497,359,0,3,125,0,114,0,4098
"19017004300",1654,119,0,0,19,0,13,9,1814
"19017004400",2616,184,0,0,29,45,46,6,2926
"19017004500",2277,189,24,2,14,54,2,51,2613
"19017004600",4365,353,2,3,66,0,0,0,4789
"19017004700",1820,218,0,0,27,12,7,0,2084
"19019950100",2021,301,2,0,112,48,26,34,2544
"19019950200",3184,488,0,2,43,0,26,6,3749
"19019950300",3295,224,0,0,37,0,5,0,3561
"19019950400",2292,153,0,0,52,25,29,0,2551
"19019950500",3336,465,32,0,43,11,135,10,4032
"19019950600",4250,227,16,14,4,12,0,10,4533
"19021960100",1203,195,20,0,24,15,34,27,1518
"19021960200",1534,114,7,0,49,0,45,0,1749
"19021960300",1681,235,0,0,121,13,79,81,2210
"19021960400",3382,668,136,182,1391,312,2138,307,8516
"19021960500",2890,290,131,41,1067,37,1644,170,6270
"19021960600",3111,344,16,0,190,6,264,97,4028
"19023070100",2932,290,18,0,22,0,0,0,3262
"19023070200",1742,264,0,3,0,35,19,12,2075
"19023070300",2522,200,0,0,98,0,17,12,2849
"19023070400",3275,370,28,0,23,0,47,4,3747
"19023070500",2674,160,0,0,27,0,39,0,2900
"19025950100",1960,236,12,0,74,14,34,16,2346
"19025950200",2587,488,0,24,33,15,16,30,3193
"19025950300",1523,230,0,0,14,6,16,3,1792
"19025950400",1758,330,0,10,10,31,12,3,2154
"19027960100",3559,255,6,8,16,15,32,15,3906
"19027960200",2148,94,2,0,22,0,9,0,2275
"19027960300",4986,565,99,147,60,0,47,12,5916
"19027960400",3491,324,13,0,13,115,106,115,4177
"19027960500",1672,205,0,22,7,10,35,0,1951
"19027960600",2105,272,2,0,16,15,24,39,2473
"19029190100",2225,189,0,0,6,0,25,3,2448
"19029190200",1921,334,0,0,40,24,9,4,2332
"19029190300",1315,251,18,0,17,2,0,0,1603
"19029190400",3422,424,0,0,65,26,130,65,4132
"19029190500",2361,553,0,31,66,21,69,0,3101
"19031450100",2510,256,42,2,48,17,55,0,2930
"19031450200",3215,184,0,0,40,27,18,5,3489
"19031450300",3193,274,0,0,82,0,9,0,3558
"19031450400",2643,209,0,0,34,10,57,6,2959
"19031450500",4753,397,17,0,152,17,121,39,5496
"19033950102",3004,924,39,0,261,26,205,26,4485
"19033950200",5174,939,11,0,510,54,309,194,7191
"19033950300",3328,1003,62,7,70,26,127,45,4668
"19033950402",3068,415,43,7,124,0,61,49,3767
"19033950600",2055,116,48,0,41,0,33,0,2293
"19033950700",3615,407,88,0,19,11,70,33,4243
"19033950800",3645,742,0,18,98,31,75,159,4768
"19033950900",1592,107,0,0,39,0,30,0,1768
"19033951000",2373,257,25,4,40,39,48,44,2830
"19033951400",3219,133,0,2,65,0,36,0,3455
"19033951600",3914,325,98,62,47,10,262,10,4728
"19035080100",4219,644,21,5,106,38,160,53,5246
"19035080200",2334,148,9,0,58,7,16,12,2584
"19035080300",1485,124,0,0,21,6,27,7,1670
"19035080400",1873,309,0,0,15,0,47,27,2271
"19037070100",2845,361,13,7,33,17,47,0,3323
"19037070200",2290,136,5,0,6,0,5,0,2442
"19037070300",2538,185,7,0,36,0,38,66,2870
"19037070400",3229,283,0,28,19,50,95,27,3731
"19039960100",3453,1056,0,2,245,0,554,408,5718
"19039960200",1867,208,4,0,87,1,77,0,2244
"19039960300",1933,226,2,0,8,0,0,0,2169
"19041080100",1708,286,0,0,25,24,1,0,2044
"19041080200",4030,645,65,0,172,17,134,28,5091
"19041080300",5276,636,27,0,239,0,290,26,6494
"19041080400",2658,214,0,7,41,19,9,2,2950
"19043070100",2461,312,4,0,96,3,81,20,2977
"19043070200",2920,491,68,40,53,5,23,55,3655
"19043070300",2906,273,11,23,13,0,65,0,3291
"19043070400",2122,221,0,0,32,0,0,17,2392
"19043070500",1896,205,2,0,18,16,19,16,2172
"19043070600",2965,350,5,2,20,0,6,0,3348
"19045000100",1731,545,109,132,71,86,54,15,2743
"19045000200",1442,324,11,35,36,72,175,46,2141
"19045000300",3519,1007,365,130,114,187,84,17,5423
"19045000400",3048,378,38,28,10,6,0,0,3508
"19045000500",3461,503,156,14,249,30,29,7,4449
"19045000600",3069,337,83,0,92,84,51,0,3716
"19045000700",3242,435,120,35,192,36,242,0,4302
"19045000800",4091,859,0,0,49,20,16,203,5238
"19045000900",5840,547,1,28,124,62,98,110,6810
"19045001000",3734,196,4,0,26,9,49,1,4019
"19045001100",2023,290,0,0,29,4,20,4,2370
"19045001200",3699,180,21,0,58,9,115,7,4089
"19047070100",1687,178,53,0,44,49,205,81,2297
"19047070200",1800,278,0,1,75,0,86,43,2283
"19047070300",1980,265,0,0,7,28,100,29,2409
"19047070400",5551,1910,0,154,622,309,2703,1275,12524
"19047070500",1783,132,0,0,50,63,66,63,2157
"19049050100",4734,225,15,13,105,4,15,8,5119
"19049050200",3772,133,0,11,13,5,40,5,3979
"19049050300",3312,700,93,0,450,63,895,232,5745
"19049050400",2743,296,0,29,327,94,1606,135,5230
"19049050500",1826,75,0,0,24,51,27,51,2054
"19049050600",2577,252,18,0,87,28,13,0,2975
"19049050700",4034,376,10,6,73,11,143,0,4653
"19049050803",6548,129,66,0,727,0,170,0,7640
"19049050805",5495,73,21,0,489,0,325,21,6424
"19049050807",7027,212,96,0,601,22,207,0,8165
"19049050809",5972,716,60,0,432,13,226,0,7419
"19049050811",6929,715,219,2,1240,0,244,27,9376
"19049050812",1896,61,167,0,83,13,25,0,2245
"19049050901",3217,177,0,0,31,0,144,0,3569
"19049050902",3965,222,0,0,48,69,30,2,4336
"19051080100",3167,610,0,0,80,8,56,19,3940
"19051080200",3673,1034,7,0,17,5,28,0,4764
"19053960100",1955,391,0,7,24,15,16,17,2425
"19053960200",2212,647,36,5,94,35,104,26,3159
"19053960300",1598,441,0,0,29,0,15,0,2083
"19055950100",3558,253,8,2,112,39,30,43,4045
"19055950200",2592,153,0,0,53,4,0,0,2802
"19055950300",4284,778,0,29,8,31,49,31,5210
"19055950400",4825,426,0,0,9,2,3,32,5297
"19057000200",2013,457,21,32,53,0,91,172,2839
"19057000300",2471,515,156,368,144,42,74,0,3770
"19057000400",2396,596,321,203,297,128,159,57,4157
"19057000500",3491,1063,325,373,32,0,29,68,5381
"19057000600",3352,472,35,0,16,0,89,99,4063
"19057000700",2295,264,50,0,113,0,23,0,2745
"19057000800",2488,456,14,78,147,0,46,0,3229
"19057000900",2878,453,11,0,225,0,0,0,3567
"19057001000",3978,180,30,9,10,14,177,0,4398
"19057001100",3378,135,115,0,83,45,10,0,3766
"19057001200",2443,125,2,2,96,0,43,0,2711
"19059450200",2007,39,0,0,10,6,6,0,2068
"19059450500",4429,272,0,0,145,10,117,0,4973
"19059450800",2968,336,1,0,7,23,26,11,3372
"19059451000",2415,110,0,0,39,0,10,0,2574
"19059451100",3452,287,37,0,62,17,85,14,3954
"19061000100",1454,464,159,273,189,104,103,45,2791
"19061000300",1496,222,58,56,51,0,71,0,1954
"19061000400",2795,764,21,3,106,181,29,7,3906
"19061000500",1985,726,141,104,356,334,158,146,3950
"19061000600",2128,409,44,172,155,88,13,9,3018
"19061000701",1587,832,0,234,24,189,45,149,3060
"19061000702",1935,404,15,73,231,0,77,0,2735
"19061000801",3654,471,0,0,68,49,0,13,4255
"19061000802",2878,312,0,0,140,0,0,0,3330
"19061000900",2619,179,0,0,68,64,70,0,3000
"19061001101",3215,186,0,0,87,21,42,27,3578
"19061001102",6345,664,8,0,37,0,83,0,7137
"19061001201",3093,354,6,0,74,36,62,5,3630
"19061001202",1462,246,28,11,51,7,50,22,1877
"19061001204",2267,71,7,0,95,6,0,0,2446
"19061001205",3659,176,37,40,350,27,22,0,4311
"19061010101",1606,283,0,0,23,0,25,0,1937
"19061010103",2569,321,30,0,10,0,0,0,2930
"19061010104",4468,82,31,0,272,15,113,0,4981
"19061010105",3461,233,5,0,54,0,42,0,3795
"19061010201",5276,205,14,49,135,16,27,37,5759
"19061010202",4197,224,0,0,53,11,11,0,4496
"19061010300",2868,245,0,0,18,5,22,38,3196
"19061010400",3333,377,0,0,79,0,5,87,3881
"19061010500",4215,355,0,0,0,0,0,61,4631
"19061010600",2924,215,0,1,18,0,167,8,3333
"19063070100",1655,200,0,0,25,0,22,0,1902
"19063070200",1510,116,1,0,10,22,11,3,1673
"19063070300",2265,424,45,0,48,7,347,137,3273
"19063070400",2358,481,0,0,42,0,175,168,3224
"19065080100",2194,345,0,91,81,0,0,0,2711
"19065080200",2270,482,0,50,30,30,25,18,2905
"19065080300",2222,195,0,0,21,0,7,2,2447
"19065080400",2501,311,0,3,85,39,178,0,3117
"19065080500",2775,435,13,0,44,32,43,104,3446
"19065080600",2218,179,0,0,30,3,11,4,2445
"19065080700",2718,324,0,3,43,28,0,15,3131
"19067480100",2784,258,0,0,17,0,0,2,3061
"19067480200",2476,188,2,13,20,24,68,30,2821
"19067480300",2172,243,7,0,11,14,25,0,2472
"19067480400",2344,312,0,28,251,34,117,0,3086
"19067480500",3518,659,119,156,123,28,117,0,4720
"19069360100",2852,299,4,0,140,39,118,39,3491
"19069360200",3551,429,0,95,242,221,463,437,5438
"19069360300",2102,274,11,2,62,13,121,29,2614
"19071970100",1937,157,0,0,29,1,13,0,2137
"19071970200",2134,336,8,7,84,24,74,7,2674
"19071970300",1897,232,0,0,64,0,62,24,2279
"19073080100",1664,367,1,0,9,0,20,9,2070
"19073080200",2141,219,0,0,22,31,72,0,2485
"19073080300",2496,257,0,0,25,37,23,34,2872
"19073080500",1496,200,0,0,33,24,66,8,1827
"19075960100",4059,194,13,14,42,0,98,0,4420
"19075960200",2625,122,0,0,74,19,4,0,2844
"19075960300",2622,275,14,0,0,0,0,0,2911
"19075960400",1943,133,0,0,25,0,23,11,2135
"19077950100",3620,353,3,0,60,3,59,18,4116
"19077950200",1915,247,0,1,19,9,28,19,2238
"19077950300",3645,550,29,23,57,13,75,29,4421
"19079960100",1764,121,15,0,63,2,10,8,1983
"19079960200",2943,285,27,6,114,38,178,38,3629
"19079960300",2405,317,0,0,85,227,115,91,3240
"19079960400",4103,527,31,0,226,49,248,118,5302
"19079960500",1470,135,0,0,52,5,2,5,1669
"19081270100",3345,267,0,0,62,16,57,98,3845
"19081270200",2330,194,0,39,3,3,39,6,2614
"19081270300",2269,136,0,11,106,0,69,17,2608
"19081270400",1818,222,11,5,25,31,87,33,2232
"19083480100",2195,236,0,0,51,0,70,0,2552
"19083480200",1763,309,34,0,31,0,297,0,2434
"19083480300",3192,221,0,0,54,0,26,15,3508
"19083480400",2634,183,0,0,81,5,81,5,2989
"19083480500",2364,262,15,0,95,7,103,24,2870
"19083480600",2376,221,0,0,169,10,8,18,2802
"19085290100",2005,344,0,0,116,0,14,1,2480
"19085290200",2836,359,0,0,85,0,63,6,3349
"19085290300",2588,245,0,3,72,8,51,0,2967
"19085290400",2802,307,0,0,10,0,60,3,3182
"19085290500",2187,119,0,0,30,13,0,0,2349
"19087970100",3261,250,0,69,218,21,230,22,4071
"19087970200",2878,313,0,5,36,11,3,0,3246
"19087970300",2931,545,81,43,335,2,136,84,4157
"19087970400",2766,723,80,13,152,153,120,161,4168
"19087970500",3038,526,0,0,55,21,43,12,3695
"19089960100",3178,486,0,12,51,48,78,34,3887
"19089960200",2371,252,19,0,21,0,0,0,2663
"19089960300",2532,282,0,0,11,1,7,14,2847
"19091970100",1925,189,9,0,32,0,64,0,2219
"19091970200",1571,178,0,0,5,6,33,7,1800
"19091970300",2367,433,0,0,56,48,59,46,3009
"19091970400",2339,301,0,0,37,0,153,0,2830
"19093090100",2325,160,0,0,58,13,63,2,2621
"19093090200",1761,247,0,0,33,2,2,0,2045
"19093090300",1935,347,0,39,10,1,14,54,2400
"19095960100",3239,139,61,0,48,17,39,0,3543
"19095960200",3214,405,33,0,28,20,238,8,3946
"19095960300",3064,318,8,1,2,31,20,2,3446
"19095960400",4916,423,18,16,7,21,49,0,5450
"19097950100",2240,153,5,0,25,9,0,0,2432
"19097950200",3110,291,21,0,11,7,37,34,3511
"19097950300",3153,357,1,0,29,25,24,3,3592
"19097950400",3366,266,1,0,11,3,33,18,3698
"19097950500",3079,703,0,0,93,135,83,0,4093
"19097950600",1766,366,2,3,107,25,18,12,2299
"19099040100",3572,202,0,0,16,12,78,12,3892
"19099040200",3269,126,0,0,19,22,89,38,3563
"19099040300",1882,448,63,0,27,54,20,0,2494
"19099040400",3977,684,75,8,70,0,44,0,4858
"19099040500",4397,594,39,41,40,50,20,46,5227
"19099040600",2451,158,0,9,187,29,0,0,2834
"19099040700",4596,430,3,0,94,16,101,46,5286
"19099040800",3768,314,3,0,27,11,14,4,4141
"19099040900",2814,122,0,6,10,6,8,0,2966
"19101090100",2612,425,0,0,31,4,128,0,3200
"19101090200",2993,431,1,0,7,6,29,6,3473
"19101090300",3280,602,48,18,427,95,106,157,4733
"19101090400",3342,428,20,65,368,237,0,0,4460
"19103000100",4384,828,75,85,597,83,412,21,6485
"19103000200",1643,291,232,87,285,114,116,0,2768
"19103000301",7202,460,367,74,887,31,246,151,9418
"19103000302",2977,595,715,294,653,350,440,310,6334
"19103000400",3742,760,176,542,1140,739,55,33,7187
"19103000500",4966,1251,184,168,1379,138,250,90,8426
"19103000600",1704,843,31,173,433,133,79,26,3422
"19103001100",1303,2088,58,16,28,180,10,8,3691
"19103001200",1686,106,0,28,52,24,88,0,1984
"19103001300",2604,220,56,62,227,0,88,0,3257
"19103001400",3673,315,162,98,364,67,130,0,4809
"19103001500",2046,124,50,17,117,13,22,0,2389
"19103001600",1422,4577,145,152,524,588,288,121,7817
"19103001700",2132,684,113,77,62,8,12,21,3109
"19103001801",3275,425,638,220,677,145,675,252,6307
"19103001802",2092,203,675,290,414,266,244,265,4449
"19103002100",458,854,0,39,36,134,16,55,1592
"19103002300",1386,519,0,10,141,192,9,10,2267
"19103010100",6283,129,74,0,138,72,40,64,6800
"19103010200",4664,10,6,0,247,2,12,2,4943
"19103010301",9565,660,68,324,643,151,451,164,12026
"19103010302",11304,455,523,5,438,20,579,173,13497
"19103010400",6339,353,67,42,13,96,315,0,7225
"19103010500",6420,402,0,5,629,31,481,30,7998
"19105070100",3718,315,20,0,58,34,81,0,4226
"19105070300",2910,458,0,22,69,8,46,0,3513
"19105070400",4061,570,18,0,22,19,70,3,4763
"19105070500",2143,278,2,0,124,4,20,7,2578
"19105070600",3988,242,0,0,42,0,0,19,4291
"19107080100",1791,254,0,0,21,28,9,0,2103
"19107080200",2177,314,0,0,45,11,24,24,2595
"19107080300",2142,376,0,0,94,2,72,0,2686
"19107080400",2483,389,0,0,16,0,7,0,2895
"19109950100",2153,192,0,0,36,24,37,25,2467
"19109950200",2195,211,6,6,37,13,32,35,2535
"19109950300",1790,349,33,0,61,8,27,0,2268
"19109950400",2195,218,0,0,107,0,2,66,2588
"19109950500",3098,204,0,2,0,0,12,7,3323
"19109950600",1913,130,3,0,12,0,37,0,2095
"19111490100",3157,637,68,145,130,97,144,0,4378
"19111490200",3350,768,49,12,147,28,263,24,4641
"19111490300",1873,257,0,0,27,10,56,10,2233
"19111490400",2498,209,0,0,15,0,41,6,2769
"19111490500",2958,269,0,0,6,0,41,0,3274
"19111490600",3002,369,10,0,47,0,4,0,3432
"19111490700",3610,251,142,35,224,67,155,0,4484
"19111490800",1042,1148,23,0,16,29,23,10,2291
"19111490900",1596,459,37,39,53,78,93,34,2389
"19111491000",1524,390,103,58,81,18,74,0,2248
"19111491100",2618,418,219,0,154,0,172,0,3581
"19113000100",10848,762,116,5,562,189,101,42,12625
"19113000201",4356,568,225,52,231,133,130,88,5783
"19113000203",6999,209,132,2,615,0,55,0,8012
"19113000205",4045,106,66,0,86,26,0,0,4329
"19113000206",6971,100,64,2,666,0,84,70,7957
"19113000207",4000,406,273,117,652,195,108,361,6112
"19113000300",5117,471,131,30,144,0,123,0,6016
"19113000400",4799,123,35,0,270,0,95,0,5322
"19113000500",5074,535,209,19,251,0,183,0,6271
"19113000600",2919,141,9,0,88,24,67,15,3263
"19113000700",1766,289,107,0,53,21,78,53,2367
"19113000800",3280,583,151,37,535,100,384,31,5101
"19113000901",4841,262,121,0,229,16,27,16,5512
"19113000902",5154,204,132,31,534,0,362,0,6417
"19113001001",3928,136,207,1,125,27,31,7,4462
"19113001002",2899,102,87,0,134,65,45,71,3403
"19113001003",3853,609,352,616,635,207,500,151,6923
"19113001101",3925,196,24,0,29,7,61,6,4248
"19113001102",2803,406,131,64,78,16,44,0,3542
"19113001200",1225,200,94,28,72,0,52,0,1671
"19113001300",2416,304,41,90,175,59,0,20,3105
"19113001400",3114,242,6,68,103,20,91,0,3644
"19113001500",2436,208,8,59,94,10,53,126,2994
"19113001600",4776,215,37,0,409,0,95,0,5532
"19113001700",3990,194,758,112,926,131,140,13,6264
"19113001800",2840,382,0,222,155,6,6,12,3623
"19113001900",826,397,59,227,127,107,115,89,1947
"19113002200",922,251,210,142,108,147,66,77,1923
"19113002300",2855,650,134,102,100,52,28,0,3921
"19113002400",3132,155,210,308,318,0,153,1,4277
"19113002500",2098,416,137,65,165,36,33,36,2986
"19113002600",2159,482,96,43,44,53,55,65,2997
"19113002700",711,419,140,169,184,12,15,0,1650
"19113002800",3566,240,58,83,87,11,58,16,4119
"19113002900",3958,619,247,0,226,14,114,14,5192
"19113003001",7401,630,491,165,254,32,232,82,9287
"19113003002",4968,1500,0,237,147,283,17,102,7254
"19113010100",2809,274,0,0,0,0,2,18,3103
"19113010200",4051,200,34,0,69,0,33,0,4387
"19113010300",3389,245,21,0,28,0,9,0,3692
"19113010400",2417,141,0,0,27,0,8,0,2593
"19113010500",3418,337,0,0,112,0,72,0,3939
"19113010600",5918,162,35,0,91,0,35,1,6242
"19113010700",5805,108,36,52,147,0,50,19,6217
"19113010800",5549,397,25,9,533,15,335,44,6907
"19115450100",2669,324,23,5,35,2,235,99,3392
"19115450200",3021,313,42,4,442,162,945,272,5201
"19115450300",3423,511,16,0,90,36,117,144,4337
"19117950100",1694,320,0,0,7,15,0,0,2036
"19117950200",2075,127,4,8,48,0,30,0,2292
"19117950300",1694,241,0,0,0,52,0,0,1987
"19117950400",1889,363,0,0,54,0,0,0,2306
"19119950100",2341,309,0,0,112,2,72,0,2836
"19119950200",3043,186,0,0,18,24,16,6,3293
"19119950300",5071,293,3,0,121,29,147,41,5705
"19121060100",6095,266,32,28,36,23,51,36,6567
"19121060200",4210,600,0,0,161,0,101,0,5072
"19121060300",3621,227,20,7,67,13,29,8,3992
"19123950100",2619,367,37,0,54,2,38,8,3125
"19123950200",3044,203,0,0,65,3,49,0,3364
"19123950300",3286,329,0,9,27,0,68,0,3719
"19123950400",2403,341,0,0,30,26,0,0,2800
"19123950500",2738,562,1,31,136,36,35,9,3548
"19123950600",2057,577,0,33,20,21,33,44,2785
"19123950700",1826,528,113,0,95,138,57,62,2819
"19125030100",6941,349,0,0,216,41,54,14,7615
"19125030200",5617,408,63,0,200,188,0,99,6575
"19125030300",1620,206,23,29,71,0,48,0,1997
"19125030401",3911,652,21,0,34,51,177,23,4869
"19125030402",3297,249,0,0,0,0,16,0,3562
"19125030500",1442,340,13,0,62,47,60,31,1995
"19125030600",2257,306,3,0,37,0,0,0,2603
"19125030700",2580,253,9,5,48,0,7,5,2907
"19127950100",2659,193,4,0,27,1,21,0,2905
"19127950200",2758,198,7,1,66,12,156,15,3213
"19127950300",3245,190,9,0,55,5,58,6,3568
"19127950400",2861,195,8,0,28,4,28,0,3124
"19127950500",1853,669,262,60,1273,652,1993,799,7561
"19127950600",2875,348,9,0,684,232,1053,39,5240
"19127950700",2953,394,32,23,436,77,432,232,4579
"19127950800",5893,94,0,0,652,0,936,16,7591
"19127950900",2537,396,19,1,466,103,1123,216,4861
"19127951000",2927,247,122,89,619,245,432,250,4931
"19129040100",2514,246,22,0,12,0,37,8,2839
"19129040201",1957,130,14,0,15,0,61,4,2181
"19129040202",3320,100,0,0,40,44,236,0,3740
"19129040301",2476,208,20,12,51,0,0,0,2767
"19129040302",2808,486,27,9,31,65,46,0,3472
"19131560100",3068,236,0,0,65,4,108,2,3483
"19131560200",3061,380,0,0,8,0,5,2,3456
"19131560300",3290,371,2,12,23,2,7,0,3707
"19133960100",1998,237,0,0,38,3,30,9,2315
"19133960200",1802,167,0,0,10,0,38,16,2033
"19133960300",2058,610,44,0,63,68,0,0,2843
"19133960400",1580,147,0,0,29,1,35,0,1792
"19135070100",2674,279,0,0,86,0,0,0,3039
"19135070200",2084,442,0,0,239,0,14,0,2779
"19135070300",1717,223,5,0,76,0,54,0,2075
"19137960100",1846,101,0,0,31,1,0,1,1980
"19137960200",2030,303,0,0,128,82,62,58,2663
"19137960300",1960,894,0,0,117,22,137,45,3175
"19137960400",2377,308,0,0,36,6,43,2,2772
"19139050100",2991,247,0,0,95,0,203,0,3536
"19139050200",4693,334,14,0,59,0,174,0,5274
"19139050300",3993,532,21,0,533,29,1530,393,7031
"19139050400",3511,432,0,0,98,15,371,132,4559
"19139050500",3768,437,144,147,71,0,302,38,4907
"19139050600",4163,468,32,14,119,0,178,83,5057
"19139050700",3903,808,35,0,640,32,893,151,6462
"19139050800",2626,559,92,30,620,83,1438,27,5475
"19139050900",2123,299,36,0,78,40,189,52,2817
"19139051000",2235,623,11,53,210,37,789,196,4154
"19141490100",2385,150,0,8,88,16,114,0,2761
"19141490200",3362,198,12,0,46,75,88,74,3855
"19141490300",4269,310,22,0,358,28,275,0,5262
"19141490400",2247,210,9,15,44,3,10,4,2542
"19143460100",2634,311,0,2,170,0,152,76,3345
"19143460200",2684,196,17,3,73,9,174,3,3159
"19145490100",2388,151,0,0,68,0,4,0,2611
"19145490200",1392,737,0,0,137,57,47,183,2553
"19145490300",2386,338,0,0,37,93,55,28,2937
"19145490400",1939,285,134,28,50,7,19,7,2469
"19145490500",1980,381,0,0,9,0,0,50,2420
"19145490600",1945,181,0,0,25,4,0,13,2168
"19147960100",1685,172,0,0,34,1,44,0,1936
"19147960200",1595,183,15,0,2,3,19,3,1820
"19147960300",3076,376,81,0,59,4,0,102,3698
"19147960400",1334,199,0,0,13,10,16,0,1572
"19149970100",5386,430,41,0,217,66,162,0,6302
"19149970200",3043,401,44,16,117,0,216,151,3988
"19149970300",2897,196,0,0,4,0,52,15,3164
"19149970400",2916,129,0,0,27,0,63,2,3137
"19149970500",2751,202,9,0,18,143,27,134,3284
"19149970600",5027,319,14,0,69,5,60,37,5531
"19151780100",1567,253,45,16,41,33,17,23,1995
"19151780200",2406,418,18,4,24,18,52,17,2957
"19151780300",1865,214,5,0,3,31,89,34,2241
"19153000101",1732,1126,256,162,78,105,197,52,3708
"19153000102",3376,397,128,17,140,8,192,29,4287
"19153000103",1783,175,60,0,37,0,161,0,2216
"19153000201",2394,90,50,0,279,98,485,0,3396
"19153000202",2573,309,201,107,383,58,276,168,4075
"19153000300",2196,309,333,52,534,13,446,0,3883
"19153000400",3054,826,336,69,489,135,726,636,6271
"19153000500",3492,711,258,72,238,326,919,281,6297
"19153000600",2706,434,210,124,308,61,153,0,3996
"19153000701",1398,194,385,615,730,97,127,91,3637
"19153000702",2191,243,419,0,533,6,47,78,3517
"19153000703",2512,285,24,13,117,0,107,54,3112
"19153000704",2458,143,103,11,291,61,92,0,3159
"19153000801",4437,466,356,81,434,257,189,140,6360
"19153000802",2931,139,37,0,46,25,27,0,3205
"19153000803",2872,215,121,163,626,205,100,8,4310
"19153000901",2589,333,111,25,214,28,24,20,3344
"19153000902",2689,202,58,64,107,12,20,3,3155
"19153001000",2574,421,462,46,328,228,189,39,4287
"19153001100",1408,893,641,408,375,383,751,498,5357
"19153001200",927,500,664,636,650,367,820,315,4879
"19153001500",2128,268,151,54,252,42,424,29,3348
"19153001700",901,280,623,286,417,97,668,83,3355
"19153001800",1295,241,93,95,180,15,85,19,2023
"19153001900",2955,735,113,56,98,194,350,174,4675
"19153002100",3142,758,96,390,282,230,672,170,5740
"19153002600",937,395,365,294,221,121,287,130,2750
"19153002700",1569,420,214,389,131,48,116,0,2887
"19153002800",2211,650,184,76,270,302,174,139,4006
"19153002900",2708,527,136,102,125,211,220,0,4029
"19153003001",1740,167,46,38,34,40,30,27,2122
"19153003002",3111,71,0,15,151,0,73,1,3422
"19153003100",1574,89,0,0,88,5,15,23,1794
"19153003200",2248,171,27,0,71,46,59,0,2622
"19153003901",1640,594,533,264,667,232,734,654,5318
"19153003902",2880,717,564,227,618,340,688,346,6380
"19153004001",2291,521,570,584,168,14,90,7,4245
"19153004004",2836,43,134,0,230,32,122,32,3429
"19153004100",2256,365,126,133,215,23,129,16,3263
"19153004200",1279,330,228,5,32,0,196,146,2216
"19153004300",4322,530,94,298,60,33,63,222,5622
"19153004400",2406,764,209,299,202,205,456,280,4821
"19153004501",2717,597,67,76,507,275,285,247,4771
"19153004502",2087,159,1,14,185,54,137,0,2637
"19153004602",4239,750,491,244,367,157,893,193,7334
"19153004603",2342,309,324,9,176,31,125,8,3324
"19153004701",3188,657,76,0,291,152,430,401,5195
"19153004702",1531,382,121,263,346,126,324,72,3165
"19153004800",1347,343,411,355,386,210,723,276,4051
"19153004900",663,484,200,188,364,64,360,220,2543
"19153005000",594,448,787,822,836,100,552,160,4299
"19153005100",2415,756,248,279,659,412,412,89,5270
"19153005200",2065,400,231,177,210,190,1027,181,4481
"19153005300",1543,346,130,49,346,50,231,0,2695
"19153010101",4012,251,4,0,32,5,18,4,4326
"19153010102",6669,308,0,0,210,0,290,0,7477
"19153010203",20875,1187,152,0,1199,0,307,24,23744
"19153010205",5235,1134,65,48,250,135,103,302,7272
"19153010207",4134,253,0,0,58,0,64,19,4528
"19153010208",4036,157,41,105,153,25,56,0,4573
"19153010209",5146,674,69,56,196,34,18,0,6193
"19153010211",3164,295,62,0,122,12,35,99,3789
"19153010212",3889,269,41,0,158,0,83,0,4440
"19153010404",4089,110,95,57,288,0,249,0,4888
"19153010405",5472,757,151,101,351,3,235,6,7076
"19153010406",3639,130,154,34,69,40,298,0,4364
"19153010407",4361,154,0,0,22,0,104,0,4641
"19153010408",3130,382,275,156,221,107,106,59,4436
"19153010409",3871,278,9,0,122,0,121,0,4401
"19153010500",4603,553,38,18,124,20,212,282,5850
"19153010600",6748,948,87,0,383,107,377,30,8680
"19153010702",4618,415,7,0,53,5,51,0,5149
"19153010703",4252,350,37,0,92,11,229,24,4995
"19153010705",4008,91,31,0,34,0,88,0,4252
"19153010706",6231,499,33,0,277,0,304,0,7344
"19153010802",6570,1480,356,398,946,11,583,558,10902
"19153010803",4419,135,201,67,186,84,174,97,5363
"19153010804",3917,377,18,0,246,0,379,265,5202
"19153011001",2344,439,404,36,239,40,419,87,4008
"19153011021",4369,159,197,0,241,12,100,0,5078
"19153011025",3276,197,65,22,313,11,76,67,4027
"19153011026",5354,176,0,0,231,80,107,0,5948
"19153011027",6612,338,94,86,889,63,451,47,8580
"19153011028",3910,204,96,11,782,0,372,0,5375
"19153011111",4004,382,133,48,467,422,336,244,6036
"19153011112",4229,227,10,0,63,118,419,17,5083
"19153011113",1752,129,150,77,315,12,34,11,2480
"19153011114",2746,167,375,193,636,0,463,45,4625
"19153011201",3942,474,101,5,281,283,24,177,5287
"19153011203",3539,28,0,0,226,0,13,0,3806
"19153011205",2521,284,160,1,569,105,939,83,4662
"19153011206",3236,18,113,0,172,0,66,0,3605
"19153011300",15024,454,125,5,757,17,240,15,16637
"19153011404",5925,217,218,70,248,0,119,0,6797
"19153011500",5890,140,0,0,77,0,27,0,6134
"19153011600",0,0,0,0,0,0,0,0,0
"19153011701",8251,288,0,0,383,0,0,82,9004
"19153011702",2942,318,10,0,128,13,24,0,3435
"19155021200",3021,497,102,0,71,6,290,0,3987
"19155021400",2912,203,0,0,90,0,30,0,3235
"19155021501",2216,150,0,0,13,0,30,0,2409
"19155021502",2337,207,0,0,54,0,47,0,2645
"19155021602",2601,70,0,0,47,0,15,0,2733
"19155021603",2331,99,0,0,22,0,48,0,2500
"19155021701",2093,108,0,0,156,0,195,7,2559
"19155021702",1900,146,0,0,44,0,5,0,2095
"19155030100",5230,443,24,0,45,0,122,0,5864
"19155030200",2599,386,112,32,116,69,13,57,3384
"19155030300",2633,238,18,47,142,0,139,0,3217
"19155030401",2880,937,7,64,249,25,596,343,5101
"19155030402",2110,518,0,9,53,53,83,38,2864
"19155030501",1675,271,66,12,99,0,81,18,2222
"19155030502",2210,297,58,0,79,32,346,63,3085
"19155030601",1592,295,0,15,50,6,132,0,2090
"19155030602",1855,632,0,0,199,62,549,95,3392
"19155030700",1741,755,0,0,151,169,285,151,3252
"19155030800",2625,562,0,0,0,7,281,109,3584
"19155030900",1089,544,0,30,79,11,106,154,2013
"19155031000",1851,383,47,14,47,0,124,8,2474
"19155031100",2122,627,0,0,53,0,235,158,3195
"19155031200",2956,231,0,16,35,0,142,8,3388
"19155031300",1915,377,18,0,124,247,374,226,3281
"19155031400",2789,516,0,94,342,10,151,38,3940
"19155031601",4113,266,0,0,110,13,67,13,4582
"19155031602",2402,161,0,0,72,70,77,0,2782
"19155031700",3343,267,9,0,219,0,103,0,3941
"19155031800",2782,348,10,0,92,41,28,0,3301
"19155031900",3554,91,60,0,52,0,203,0,3960
"19157370100",2666,276,3,0,24,5,65,8,3047
"19157370200",2882,230,0,0,19,2,12,65,3210
"19157370300",3465,356,27,17,136,0,85,49,4135
"19157370400",3008,410,18,22,216,47,82,41,3844
"19157370500",2684,378,11,10,36,14,18,9,3160
"19159950100",1861,182,0,0,20,0,21,9,2093
"19159950200",2390,312,9,2,61,18,27,6,2825
"19161080100",2322,235,17,11,52,26,154,17,2834
"19161080200",2310,154,12,0,0,0,16,0,2492
"19161080300",2039,129,15,0,0,4,58,0,2245
"19161080400",2247,240,0,6,57,0,15,0,2565
"19163010101",3559,133,0,10,79,25,9,0,3815
"19163010102",6477,220,77,0,291,56,151,0,7272
"19163010201",5465,402,186,0,111,0,127,0,6291
"19163010202",5688,386,68,0,75,0,172,1,6390
"19163010300",2063,176,22,0,42,18,0,0,2321
"19163010401",5208,270,16,0,34,4,182,0,5714
"19163010402",3538,159,0,5,81,0,35,16,3834
"19163010600",1082,528,317,234,147,123,254,84,2769
"19163010700",847,233,330,211,23,120,91,38,1893
"19163010800",1535,382,201,174,297,140,412,33,3174
"19163010900",754,392,156,37,95,113,216,142,1905
"19163011000",1132,489,234,147,28,112,239,59,2440
"19163011100",2944,156,103,44,85,15,266,57,3670
"19163011200",1191,325,270,182,119,5,237,74,2403
"19163011300",1273,419,587,375,566,131,39,24,3414
"19163011400",1524,509,288,128,202,100,272,119,3142
"19163011500",1255,239,379,39,73,115,145,128,2373
"19163011600",2651,501,61,54,175,249,96,138,3925
"19163011700",2619,129,46,162,82,32,216,28,3314
"19163011800",1701,388,9,0,70,0,168,0,2336
"19163011900",2172,148,219,63,108,32,57,0,2799
"19163012000",2998,223,89,12,367,40,406,28,4163
"19163012100",2855,163,234,63,337,40,183,10,3885
"19163012200",1827,385,82,0,29,0,246,39,2608
"19163012300",1168,244,27,58,51,29,169,52,1798
"19163012400",971,133,13,0,30,0,37,14,1198
"19163012501",2895,301,268,316,135,28,77,28,4048
"19163012502",3131,392,165,45,239,6,470,253,4701
"19163012601",3726,824,303,313,261,34,27,133,5621
"19163012602",2529,695,318,452,229,98,123,128,4572
"19163012701",2212,459,266,50,383,30,171,0,3571
"19163012702",2791,134,42,86,62,91,185,0,3391
"19163012801",3144,330,561,483,181,62,374,25,5160
"19163012802",3579,325,407,24,218,0,586,0,5139
"19163012901",3711,444,619,0,103,0,119,0,4996
"19163012902",4297,284,327,136,400,61,351,0,5856
"19163013000",4006,449,232,45,184,0,253,75,5244
"19163013100",1615,128,25,0,36,0,77,0,1881
"19163013200",1536,43,3,0,47,0,54,0,1683
"19163013300",3129,169,158,0,22,0,59,0,3537
"19163013400",2617,165,64,0,33,11,174,49,3113
"19163013500",2451,332,215,232,73,33,55,0,3391
"19163013600",2388,103,64,0,100,0,129,0,2784
"19163013702",4771,187,176,0,577,69,25,0,5805
"19163013703",2688,60,6,0,94,9,209,0,3066
"19163013705",4019,357,233,2,675,10,284,9,5589
"19163013706",3922,93,220,0,586,0,168,33,5022
"19165960100",2585,220,0,0,27,6,9,14,2861
"19165960200",2615,230,0,2,35,0,4,2,2888
"19165960300",2906,310,0,0,280,45,209,45,3795
"19165960400",1886,494,19,0,52,0,0,0,2451
"19167070100",3646,172,0,0,73,10,142,93,4136
"19167070200",3602,309,9,1,226,143,260,109,4659
"19167070300",5011,600,23,6,137,0,80,50,5907
"19167070400",3353,451,13,0,282,142,409,415,5065
"19167070500",2689,91,22,0,138,55,193,56,3244
"19167070600",4473,260,7,0,209,158,175,241,5523
"19167070700",4905,237,7,0,623,28,826,141,6767
"19169000100",8817,468,379,0,1182,95,495,0,11436
"19169000200",2702,168,196,22,532,43,47,0,3710
"19169000300",2560,505,77,0,250,92,24,30,3538
"19169000400",2212,276,0,0,46,0,32,0,2566
"19169000500",317,1416,31,211,274,792,65,130,3236
"19169000600",3606,643,153,25,368,38,122,6,4961
"19169000700",1285,1420,23,48,103,351,6,56,3292
"19169000800",0,7,0,0,0,0,0,0,7
"19169000900",2581,399,173,0,154,48,41,20,3416
"19169001000",2161,805,116,137,539,1001,111,147,5017
"19169001100",1641,1962,14,0,149,386,52,38,4242
"19169001200",37,14,0,0,0,0,0,0,51
"19169001301",4737,4202,84,151,676,302,74,93,10319
"19169001302",3792,669,21,21,356,33,133,101,5126
"19169010100",6549,536,29,0,79,0,130,69,7392
"19169010200",3534,264,0,0,58,13,56,10,3935
"19169010300",3560,609,48,0,105,70,23,91,4506
"19169010400",2424,318,29,9,6,0,149,37,2972
"19169010500",1599,147,3,0,30,12,0,0,1791
"19169010600",4584,336,0,24,198,21,74,0,5237
"19171290100",2731,230,0,0,63,0,14,0,3038
"19171290200",2502,227,0,0,33,2,22,8,2794
"19171290300",2379,133,22,0,51,2,5,0,2592
"19171290400",1764,381,13,3,353,66,257,170,3007
"19171290500",2031,461,18,3,791,209,503,261,4277
"19171290600",2123,158,5,0,236,44,121,36,2723
"19173180100",1876,291,0,0,91,41,261,127,2687
"19173180200",1606,337,8,4,37,56,20,55,2123
"19173180300",1600,127,0,0,10,4,0,0,1741
"19175190100",1910,332,2,0,42,8,32,11,2337
"19175190200",3275,730,20,16,78,37,177,0,4333
"19175190300",2010,119,0,0,12,0,27,0,2168
"19175190400",3166,432,72,2,24,0,51,0,3747
"19177950100",3394,730,2,8,13,9,52,13,4221
"19177950200",2801,290,10,0,29,58,5,0,3193
"19179960100",2594,206,16,11,0,58,73,0,2958
"19179960200",1396,808,46,0,232,95,357,64,2998
"19179960300",3538,189,0,0,160,57,150,57,4151
"19179960400",2641,604,44,143,304,76,436,52,4300
"19179960500",1293,724,193,112,216,53,299,286,3176
"19179960600",2170,257,19,6,174,19,451,0,3096
"19179960700",3045,714,18,0,23,0,12,205,4017
"19179960800",2630,335,0,0,105,45,263,20,3398
"19179960900",1675,725,16,29,149,153,237,203,3187
"19179961000",2571,650,13,0,57,4,207,20,3522
"19179961100",2584,313,0,0,32,13,35,16,2993
"19181020100",1863,137,88,11,17,0,87,46,2249
"19181020200",7193,115,0,0,166,14,248,14,7750
"19181020300",4691,129,0,0,56,0,65,0,4941
"19181020400",3844,270,0,0,171,17,14,0,4316
"19181020500",2180,102,20,0,98,0,26,0,2426
"19181020600",2767,161,0,0,46,0,0,24,2998
"19181020700",3255,347,0,0,80,126,61,92,3961
"19181020800",2564,145,0,0,33,0,19,4,2765
"19181020900",2707,571,74,27,162,0,77,10,3628
"19181021000",2118,504,0,0,6,24,7,0,2659
"19181021100",4626,227,0,0,86,2,141,5,5087
"19181021200",3570,190,12,0,63,5,70,12,3922
"19183960100",5712,644,6,0,79,17,55,93,6606
"19183960200",4348,258,14,4,28,23,65,0,4740
"19183960300",2940,412,23,31,231,24,370,77,4108
"19183960400",3034,306,65,23,94,47,149,38,3756
"19183960500",2885,216,0,6,93,2,214,79,3495
"19185070100",2028,217,6,0,22,17,50,0,2340
"19185070200",1457,111,0,0,18,2,13,0,1601
"19185070300",1901,438,4,15,10,34,0,0,2402
"19187000100",5590,348,56,0,114,0,123,0,6231
"19187000200",2934,271,0,0,242,0,38,0,3485
"19187000300",1047,282,0,0,3,22,85,65,1504
"19187000400",1396,557,132,150,100,189,123,206,2853
"19187000500",935,305,0,278,74,0,42,54,1688
"19187000600",3989,621,50,0,102,18,156,0,4936
"19187000700",868,328,69,82,84,19,92,50,1592
"19187000900",1650,695,51,88,20,36,0,205,2745
"19187010100",2167,107,0,0,19,0,58,0,2351
"19187010200",1687,95,40,0,6,0,72,15,1915
"19187010300",2874,333,25,5,102,0,36,9,3384
"19187010400",2716,371,0,0,21,10,9,2,3129
"19189680100",3443,390,8,0,102,0,101,0,4044
"19189680200",2412,233,0,8,45,37,74,37,2846
"19189680300",2859,300,50,3,119,24,141,23,3519
"19191950100",3229,168,0,0,27,21,0,17,3462
"19191950200",3059,420,42,0,103,0,70,0,3694
"19191950300",2904,325,25,0,213,0,58,39,3564
"19191950400",4312,217,0,0,54,8,174,6,4771
"19191950500",2978,347,18,0,27,1,43,1,3415
"19193000100",2835,698,15,0,451,153,737,198,5087
"19193000200",5225,459,0,21,596,23,498,107,6929
"19193000300",5952,181,0,22,324,155,1032,111,7777
"19193000400",4187,223,16,0,122,61,109,0,4718
"19193000500",2237,203,28,1,465,53,179,64,3230
"19193000600",2333,204,17,0,123,10,252,10,2949
"19193000700",1849,431,70,20,501,99,668,3,3641
"19193000800",2435,585,263,22,425,143,703,362,4938
"19193000900",1625,119,29,23,307,18,217,9,2347
"19193001000",1062,320,261,153,251,18,347,56,2468
"19193001100",2582,721,220,66,563,339,924,507,5922
"19193001200",1208,505,136,0,776,426,1101,653,4805
"19193001300",537,271,40,107,360,157,530,94,2096
"19193001400",2236,1031,96,80,987,299,1270,621,6620
"19193001500",760,447,168,78,146,405,220,212,2436
"19193001800",4313,796,33,0,428,223,664,44,6501
"19193001900",2434,225,0,1,163,31,266,47,3167
"19193002000",3923,496,213,0,291,16,385,33,5357
"19193002101",2720,78,0,0,93,0,76,0,2967
"19193002102",5278,333,23,0,296,25,369,211,6535
"19193003100",3432,433,0,0,71,23,59,6,4024
"19193003200",4343,265,29,0,100,0,88,3,4828
"19193003300",6005,1041,0,0,431,0,125,0,7602
"19193003500",3524,251,38,0,87,55,108,9,4072
"19193003600",943,585,471,22,443,308,369,365,3506
"19193940200",0,0,0,0,0,0,0,0,0
"19195690100",1812,318,0,58,22,18,34,0,2262
"19195690200",2065,94,0,0,19,0,31,0,2209
"19195690300",2539,386,2,5,72,8,57,60,3129
"19197680100",3211,260,11,0,129,7,303,108,4029
"19197680200",1400,103,1,0,9,10,0,31,1554
"19197680300",2238,390,12,4,165,121,180,161,3271
"19197680400",998,86,4,0,23,10,38,2,1161
"19197680500",3007,350,10,0,62,71,296,163,3959
"20001952600",1848,213,0,4,18,3,63,0,2149
"20001952700",1687,391,0,0,108,5,21,0,2212
"20001952800",2512,568,76,37,26,81,0,0,3300
"20001952900",1712,637,51,0,55,79,167,0,2701
"20001953000",2015,218,25,3,181,18,114,29,2603
"20003953600",3502,857,0,2,197,124,20,2,4704
"20003953700",2681,362,4,1,34,16,3,6,3107
"20005081600",3620,440,0,20,58,71,77,9,4295
"20005081700",3419,642,276,49,178,71,124,70,4829
"20005081800",2084,760,139,29,64,4,32,0,3112
"20005081900",2288,839,109,20,226,25,10,7,3524
"20007968100",2509,376,0,1,84,30,41,90,3131
"20007968200",1531,92,9,6,57,6,27,2,1730
"20009971100",3392,469,0,21,96,30,192,0,4200
"20009971200",1496,197,1,0,26,0,6,0,1726
"20009971300",2347,437,0,26,64,37,29,59,2999
"20009971400",2472,250,104,14,128,10,93,47,3118
"20009971500",2873,379,116,61,135,0,287,61,3912
"20009971600",3383,306,19,33,83,0,480,0,4304
"20009971700",1789,801,17,23,593,44,940,535,4742
"20009971800",3384,798,0,0,104,325,467,580,5658
"20011955600",2029,494,7,0,57,29,31,1,2648
"20011955700",1741,203,0,1,78,75,1,4,2103
"20011955800",2873,413,42,0,18,0,99,1,3446
"20011955900",2473,705,53,241,39,68,35,143,3757
"20011956000",1985,521,109,0,100,7,7,8,2737
"20013480600",1981,305,69,4,513,165,37,65,3139
"20013480700",2665,557,57,11,175,29,76,38,3608
"20013480800",2452,435,23,3,230,89,112,26,3370
"20015020100",4516,466,32,0,271,6,85,3,5379
"20015020201",5385,696,60,0,63,24,289,0,6517
"20015020202",7231,260,214,0,242,0,360,76,8383
"20015020203",5920,193,11,0,455,0,279,25,6883
"20015020300",3095,223,28,0,117,33,100,43,3639
"20015020400",1891,539,8,0,74,26,18,71,2627
"20015020500",3628,1582,34,0,132,0,387,0,5763
"20015020600",6241,476,191,60,280,78,92,5,7423
"20015020700",3330,579,0,0,137,26,110,26,4208
"20015020800",2101,491,0,25,132,154,206,100,3209
"20015020901",3762,332,21,0,209,9,164,0,4497
"20015020902",3599,24,34,38,133,0,136,31,3995
"20015020903",3319,258,4,0,84,22,23,19,3729
"20017960600",2158,355,6,0,78,5,84,5,2691
"20019964600",2576,457,8,12,279,110,27,27,3496
"20021958100",1924,463,0,0,121,134,9,37,2688
"20021958200",1586,306,0,0,79,102,2,16,2091
"20021958300",3346,402,0,0,203,94,74,60,4179
"20021958400",2738,526,74,38,196,194,8,0,3774
"20021958500",3135,514,7,0,99,0,109,0,3864
"20021958600",3087,570,0,0,528,168,149,0,4502
"20023950200",2334,165,0,0,93,49,138,36,2815
"20025967100",1672,235,12,10,86,66,201,54,2336
"20027458100",3517,291,18,9,37,5,138,2,4017
"20027458200",3559,636,17,0,181,1,66,8,4468
"20029977100",2160,150,0,0,2,2,32,0,2346
"20029977200",1684,432,3,0,37,148,23,33,2360
"20029977300",2490,263,9,0,161,31,161,0,3115
"20029977400",1166,172,0,0,20,4,16,23,1401
"20031966100",2337,237,21,7,47,12,19,28,2708
"20031966200",2540,234,7,9,62,25,37,13,2927
"20031966300",2413,249,0,19,71,41,103,0,2896
"20033967600",1766,129,0,0,30,11,86,0,2022
"20035493100",2246,346,0,0,115,7,60,5,2779
"20035493200",2721,293,50,0,84,33,48,16,3245
"20035493300",2129,221,64,0,75,0,25,0,2514
"20035493400",1898,291,59,12,107,24,137,12,2540
"20035493500",2850,745,21,35,324,99,315,125,4514
"20035493600",2799,630,140,9,521,53,191,29,4372
"20035493700",2647,539,79,19,211,57,536,128,4216
"20035493800",2690,1050,152,141,282,186,307,621,5429
"20035493900",2649,374,14,0,261,11,13,50,3372
"20035494000",1245,218,0,0,237,83,235,77,2095
"20035494100",1130,417,9,0,143,78,330,94,2201
"20037956600",3322,718,0,0,98,50,28,13,4229
"20037956700",3383,556,2,0,60,3,159,0,4163
"20037956800",2758,285,4,9,60,57,126,39,3338
"20037956900",3432,318,0,0,20,132,297,0,4199
"20037957000",2851,517,19,11,67,25,132,130,3752
"20037957100",1599,493,27,16,250,80,251,0,2716
"20037957200",1916,324,23,0,28,7,40,19,2357
"20037957300",2000,731,45,88,189,160,87,46,3346
"20037957400",1686,319,34,32,101,15,217,16,2420
"20037957500",1089,728,57,56,145,139,81,34,2329
"20037957600",3550,2017,297,39,103,294,76,63,6439
"20039951100",785,139,2,0,35,2,0,0,963
"20039951200",1625,175,8,0,46,0,67,9,1930
"20041084100",3267,483,8,14,321,32,186,21,4332
"20041084200",2090,164,0,0,101,6,110,39,2510
"20041084300",2186,109,44,2,8,4,80,2,2435
"20041084400",4221,525,0,0,115,36,184,22,5103
"20041084500",2692,297,2,0,124,37,41,17,3210
"20041084600",1775,248,14,0,122,48,136,9,2352
"20043020100",1498,186,5,4,146,21,26,0,1886
"20043020200",1861,167,1,0,18,4,27,0,2078
"20043020300",2681,371,35,64,61,75,59,68,3414
"20045000100",2388,216,105,0,131,2,101,2,2945
"20045000200",4206,1565,214,148,434,270,317,132,7286
"20045000300",2011,3349,89,18,104,39,175,143,5928
"20045000400",112,88,0,3,198,120,15,12,548
"20045000501",2077,443,140,57,316,27,88,62,3210
"20045000502",2371,1271,61,23,328,77,196,32,4359
"20045000603",5231,302,193,11,589,58,413,59,6856
"20045000604",4166,449,64,0,269,0,143,0,5091
"20045000702",3906,1346,287,119,682,306,528,41,7215
"20045000797",4110,496,121,0,271,115,281,0,5394
"20045000801",3769,832,238,69,754,318,173,184,6337
"20045000802",3979,1762,116,108,405,426,434,537,7767
"20045000901",2553,1421,344,57,982,310,292,259,6218
"20045000902",1202,348,243,133,314,56,141,25,2462
"20045001001",1301,174,80,5,311,0,56,15,1942
"20045001002",3825,567,327,36,855,140,440,52,6242
"20045001201",1622,84,9,6,38,0,9,0,1768
"20045001202",6190,519,151,107,355,84,96,0,7502
"20045001203",5409,400,20,0,136,45,128,56,6194
"20045001400",3912,329,32,17,247,75,48,0,4660
"20045001500",1922,185,41,0,182,18,69,18,2435
"20045001600",7220,503,417,5,1142,80,140,0,9507
"20047969600",1285,142,0,0,72,33,251,72,1855
"20047969700",1132,159,1,1,48,0,211,36,1588
"20049965100",2032,461,21,0,99,22,66,36,2737
"20051072600",2414,217,0,0,26,1,26,27,2711
"20051072701",4610,746,70,0,50,15,59,187,5737
"20051072702",2343,310,12,24,45,4,102,0,2840
"20051072800",6284,875,186,0,228,334,180,355,8442
"20051072900",3882,1408,0,0,165,250,267,156,6128
"20051073000",3126,126,11,7,28,36,166,0,3500
"20053086600",1762,141,3,0,46,0,114,10,2076
"20053086700",2895,325,15,1,156,17,72,6,3487
"20055960100",3441,459,27,12,327,110,775,207,5358
"20055960200",4374,636,185,97,1413,154,3517,371,10747
"20055960300",2216,320,5,1,269,64,740,217,3832
"20055960401",1318,110,9,0,224,120,224,99,2104
"20055960403",1837,279,0,0,324,17,866,60,3383
"20055960404",2329,199,203,8,483,317,819,138,4496
"20055960501",1223,368,0,0,475,192,1085,407,3750
"20055960503",974,54,0,0,155,114,306,164,1767
"20055960505",957,253,0,0,218,252,702,414,2796
"20055960507",784,345,73,20,374,5,426,249,2276
"20055960508",1112,163,4,0,643,342,1294,453,4011
"20055960600",3119,843,15,77,1244,291,3283,883,9755
"20057961600",1732,181,0,0,93,8,51,53,2118
"20057961700",1819,208,5,9,42,17,177,33,2310
"20057961800",5669,1410,174,18,928,313,2743,1336,12591
"20057961900",6117,1239,62,144,682,46,3128,1036,12454
"20057962000",4308,811,0,0,142,195,2966,752,9174
"20057962101",2942,769,94,93,571,24,2992,667,8152
"20057962102",2158,466,0,138,203,94,1816,419,5294
"20059954100",5886,631,20,33,234,6,85,4,6899
"20059954200",1902,606,45,18,119,21,145,21,2877
"20059954300",4187,606,0,42,412,125,285,107,5764
"20059954400",3486,547,8,41,41,28,63,24,4238
"20059954500",5040,453,18,0,269,107,84,98,6069
"20061000100",775,369,408,125,350,72,149,93,2341
"20061000200",1345,704,597,54,441,171,400,347,4059
"20061000300",2956,318,936,79,472,197,680,25,5663
"20061000400",4205,260,946,247,686,0,624,0,6968
"20061000500",1333,392,484,21,372,124,98,168,2992
"20061000600",4605,581,495,26,555,86,1150,35,7533
"20061000700",2072,209,387,55,429,29,408,36,3625
"20061000800",4776,235,1075,27,809,82,855,100,7959
"20063955100",1444,135,9,1,38,3,32,2,1664
"20063955200",943,77,13,0,11,3,19,1,1067
"20065952100",851,128,17,1,25,0,0,0,1022
"20065952200",1256,110,29,31,88,17,51,14,1596
"20067963600",1319,37,0,0,32,25,157,45,1615
"20067963700",3977,485,0,0,1611,248,2954,406,9681
"20069962600",2513,401,0,0,53,0,417,242,3626
"20069962700",2784,179,0,0,30,17,197,31,3238
"20071958100",991,50,9,0,99,47,208,70,1474
"20073965600",1695,386,0,0,17,9,26,84,2217
"20073965700",2069,297,0,0,31,84,71,55,2607
"20073965800",1386,152,0,0,122,17,0,0,1677
"20075958600",1951,324,54,0,210,47,634,237,3457
"20077961600",1491,253,0,8,56,18,86,41,1953
"20077961700",1129,264,0,0,55,9,43,52,1552
"20077961800",1993,357,0,0,42,24,32,120,2568
"20079030100",2997,768,83,44,297,151,456,166,4962
"20079030200",4765,535,56,0,139,53,444,68,6060
"20079030300",4291,678,31,17,304,140,794,381,6636
"20079030400",3817,847,151,36,141,38,872,184,6086
"20079030500",5384,361,0,13,164,39,125,64,6150
"20079030600",6170,632,47,0,224,63,288,12,7436
"20081463100",3051,450,0,0,473,112,891,283,5260
"20083461100",1759,73,0,0,58,15,142,0,2047
"20085082600",4897,231,30,0,159,46,204,11,5578
"20085082700",3088,463,3,0,223,84,116,90,4067
"20085082800",2706,158,37,0,812,215,71,35,4034
"20087020101",5425,204,28,0,266,11,82,56,6072
"20087020102",2524,290,4,3,96,5,33,0,2955
"20087020200",3425,346,0,0,114,15,84,5,3989
"20087020300",5018,489,20,0,171,31,131,15,5875
"20089576100",901,183,0,0,11,3,11,23,1132
"20089576200",1611,230,2,0,20,50,22,12,1947
"20091050000",4545,124,24,3,367,1,493,31,5588
"20091050100",3306,364,136,0,290,46,502,54,4698
"20091050200",3317,122,177,6,170,0,487,8,4287
"20091050301",2768,336,502,74,408,26,178,54,4346
"20091050302",1230,73,9,17,35,45,55,0,1464
"20091050400",3277,487,284,88,339,271,490,119,5355
"20091050500",2242,77,66,6,80,0,267,29,2767
"20091050600",4129,189,20,0,259,2,294,2,4895
"20091050700",4314,128,27,0,117,49,78,38,4751
"20091050800",2670,50,0,0,91,0,80,0,2891
"20091050900",4302,104,25,47,25,12,85,13,4613
"20091051000",3451,162,12,6,92,0,145,0,3868
"20091051100",3223,298,86,35,235,34,568,160,4639
"20091051200",3265,366,135,0,170,104,206,16,4262
"20091051300",3182,267,167,0,360,141,126,44,4287
"20091051400",3142,27,0,0,50,0,22,0,3241
"20091051500",3605,238,86,0,72,4,81,6,4092
"20091051600",5162,231,30,0,105,14,42,23,5607
"20091051700",4225,73,9,0,155,0,36,1,4499
"20091051801",3170,94,0,0,121,0,60,0,3445
"20091051802",5038,227,16,0,654,88,796,0,6819
"20091051803",3147,214,425,0,362,38,139,106,4431
"20091051804",3856,824,181,36,196,0,443,472,6008
"20091051805",4857,82,164,0,290,46,361,46,5846
"20091051806",4358,91,87,42,150,22,158,0,4908
"20091051902",3678,112,210,22,213,6,334,0,4575
"20091051903",2239,211,580,0,290,0,439,8,3767
"20091051904",4655,355,155,0,178,18,133,15,5509
"20091051906",4112,243,401,432,410,63,1113,0,6774
"20091051907",2484,611,444,103,436,34,213,402,4727
"20091051908",1319,39,182,102,0,0,88,0,1730
"20091051909",5024,152,224,4,366,53,209,0,6032
"20091052001",1806,228,99,9,89,40,98,9,2378
"20091052003",4515,643,410,215,349,114,518,242,7006
"20091052004",1369,55,165,4,45,0,128,19,1785
"20091052101",1650,206,75,0,68,15,49,35,2098
"20091052102",2156,332,87,11,52,2,342,29,3011
"20091052201",2518,335,327,33,346,64,398,40,4061
"20091052202",3053,74,100,0,147,0,145,6,3525
"20091052303",5404,227,799,329,694,418,778,207,8856
"20091052304",4004,248,80,0,370,24,188,47,4961
"20091052305",3933,188,73,9,117,19,385,0,4724
"20091052306",2975,82,134,0,191,53,53,0,3488
"20091052405",5663,766,237,21,698,18,1123,493,9019
"20091052410",4256,250,233,0,237,24,131,14,5145
"20091052411",2674,32,41,0,387,27,161,0,3322
"20091052414",3837,24,50,0,152,28,141,0,4232
"20091052415",2451,52,290,0,249,22,210,0,3274
"20091052416",4499,431,16,40,66,0,695,21,5768
"20091052417",2522,197,202,45,351,36,395,42,3790
"20091052418",1744,533,287,110,217,391,458,105,3845
"20091052419",3634,528,454,128,444,20,431,217,5856
"20091052421",3344,142,43,0,232,0,180,0,3941
"20091052502",1484,18,0,0,169,0,57,0,1728
"20091052504",4376,270,546,0,457,64,144,141,5998
"20091052601",7313,205,84,0,688,0,130,23,8443
"20091052603",15301,245,321,0,1165,44,479,0,17555
"20091052604",1423,60,22,0,103,0,51,0,1659
"20091052606",1584,112,46,0,123,0,91,7,1963
"20091052607",1827,44,36,0,0,0,27,0,1934
"20091052700",5647,816,151,190,504,197,591,191,8287
"20091052801",9287,75,507,0,408,29,550,0,10856
"20091052802",8511,30,11,0,638,39,592,0,9821
"20091052803",2340,238,512,7,540,40,541,33,4251
"20091052904",2879,123,316,0,202,8,98,18,3644
"20091052905",2313,601,404,47,683,8,875,376,5307
"20091052906",3518,350,267,148,469,240,600,128,5720
"20091052907",3302,336,536,84,397,136,380,426,5597
"20091052908",4717,387,122,19,219,165,642,147,6418
"20091052910",3328,128,74,0,431,53,248,0,4262
"20091053002",3896,110,312,156,301,21,35,21,4852
"20091053004",3150,178,344,18,75,10,168,0,3943
"20091053005",1262,80,242,7,239,5,39,0,1874
"20091053006",2830,216,188,21,238,0,83,82,3658
"20091053007",4118,157,172,30,527,25,217,36,5282
"20091053008",3707,239,286,0,444,36,109,0,4821
"20091053009",4056,138,108,31,306,27,204,0,4870
"20091053010",4147,47,37,0,395,17,36,0,4679
"20091053011",1725,59,62,0,313,0,50,21,2230
"20091053101",3449,100,209,35,451,29,337,0,4610
"20091053102",3490,149,167,39,607,82,292,49,4875
"20091053105",1934,299,458,81,785,58,318,0,3933
"20091053108",3171,282,123,0,877,0,117,0,4570
"20091053109",1764,43,153,0,509,0,150,0,2619
"20091053110",3220,36,54,0,584,0,185,0,4079
"20091053201",1727,37,28,0,114,0,25,0,1931
"20091053202",2882,132,64,26,171,45,42,0,3362
"20091053203",4010,143,282,0,792,1,247,2,5477
"20091053301",5064,61,24,0,313,0,59,0,5521
"20091053302",6326,161,23,0,417,0,240,0,7167
"20091053403",2974,121,137,21,578,0,344,52,4227
"20091053406",7820,164,196,2,874,4,102,51,9213
"20091053409",2931,67,31,129,342,0,24,0,3524
"20091053410",9194,137,221,68,1153,36,386,0,11195
"20091053411",4390,157,21,8,336,38,99,14,5063
"20091053413",3318,79,154,0,741,0,0,0,4292
"20091053414",2467,134,140,0,858,114,39,0,3752
"20091053415",2476,61,280,8,464,306,38,0,3633
"20091053417",3085,65,83,0,807,0,182,0,4222
"20091053418",2826,95,79,0,819,0,332,0,4151
"20091053419",1429,44,20,0,23,11,37,0,1564
"20091053421",3266,73,286,0,598,0,106,0,4329
"20091053422",2132,18,72,0,89,0,111,0,2422
"20091053423",4623,104,71,0,628,17,86,6,5535
"20091053424",4844,114,30,0,468,0,96,16,5568
"20091053502",2063,327,203,0,181,0,692,189,3655
"20091053505",7222,59,281,56,473,46,612,0,8749
"20091053506",3215,87,18,0,336,11,209,0,3876
"20091053507",5163,70,175,0,238,10,174,4,5834
"20091053508",4924,277,294,13,543,223,258,88,6620
"20091053509",5738,493,322,41,574,26,287,199,7680
"20091053510",5158,72,92,0,440,0,618,0,6380
"20091053555",1195,315,103,28,31,17,207,18,1914
"20091053556",2065,547,160,19,242,83,1074,426,4616
"20091053557",1339,542,111,32,115,130,297,291,2857
"20091053601",1328,487,102,0,180,32,337,394,2860
"20091053602",4523,542,320,0,991,218,850,280,7724
"20091053701",2338,191,0,0,56,10,83,10,2688
"20091053703",2647,113,348,0,174,0,272,0,3554
"20091053705",2570,165,118,0,228,90,216,0,3387
"20091053707",3890,150,244,0,321,25,284,0,4914
"20091053709",4853,186,158,0,256,0,257,35,5745
"20091053711",3183,125,82,0,144,0,60,0,3594
"20091053712",3589,13,7,0,108,7,246,0,3970
"20091053801",4949,248,22,38,169,9,122,0,5557
"20091053803",3293,173,0,0,165,0,144,0,3775
"20091053804",2308,39,21,0,39,0,64,0,2471
"20091980001",0,0,0,0,0,0,0,0,0
"20091980002",0,0,0,0,0,0,0,0,0
"20091980003",0,0,0,0,0,0,0,0,0
"20093959100",2918,319,27,0,498,93,1021,141,5017
"20095961100",2222,175,9,0,37,0,6,1,2450
"20095961200",2799,478,0,0,87,45,195,4,3608
"20095961300",1613,112,0,0,37,1,19,7,1789
"20097969100",1913,345,5,0,68,19,110,31,2491
"20099950100",2116,433,91,13,208,136,68,194,3259
"20099950200",1264,458,101,58,89,0,111,16,2097
"20099950300",2001,310,106,42,70,70,0,45,2644
"20099950400",2634,555,128,93,163,97,101,180,3951
"20099950500",2841,414,0,0,295,32,38,2,3622
"20099950600",1865,244,0,0,85,104,38,20,2356
"20099950700",1647,255,27,15,205,0,60,2,2211
"20099950800",891,253,9,0,75,69,15,6,1318
"20101956600",1483,149,5,0,20,0,101,0,1758
"20103070100",792,616,176,33,168,39,107,29,1960
"20103070200",1753,715,244,16,100,187,156,80,3251
"20103070300",4403,448,421,55,248,113,287,0,5975
"20103070400",2395,311,243,60,334,72,216,60,3691
"20103070500",2398,674,563,421,288,316,239,27,4926
"20103070700",3375,252,458,155,309,199,113,119,4980
"20103070900",2622,228,15,0,199,15,133,0,3212
"20103071000",3446,161,104,0,218,11,48,0,3988
"20103071101",7190,723,989,95,559,3,732,0,10291
"20103071102",2530,312,48,49,159,89,91,6,3284
"20103071202",3322,69,209,0,115,0,230,18,3963
"20103071203",6379,499,0,0,303,48,107,124,7460
"20103071400",3631,192,0,0,147,0,103,39,4112
"20103071600",2544,111,19,0,11,11,16,0,2712
"20103071800",5182,532,30,0,360,0,375,0,6479
"20103981900",4250,286,450,54,443,53,525,67,6128
"20105086100",2666,308,16,9,22,16,63,14,3114
"20107955100",4270,727,57,0,205,0,180,5,5444
"20107955200",3589,508,2,0,70,11,24,2,4206
"20109954600",2417,207,0,0,103,25,122,4,2878
"20111000100",2179,741,110,129,434,253,570,152,4568
"20111000200",5082,1052,166,22,235,126,883,179,7745
"20111000300",3278,1390,92,0,606,48,1588,743,7745
"20111000400",1669,957,47,1,57,215,369,24,3339
"20111000500",2948,1030,179,18,462,116,1470,479,6702
"20111000600",2125,145,2,0,77,90,84,0,2523
"20111000700",2039,239,9,0,58,35,50,81,2511
"20111000800",3273,296,17,2,104,14,59,16,3781
"20113788100",2770,204,11,5,99,0,48,27,3164
"20113788200",2806,156,0,24,115,16,155,16,3288
"20113788300",2688,254,5,0,96,5,238,0,3286
"20113788400",5321,404,68,4,148,39,67,0,6051
"20113788500",1506,127,10,0,159,1,271,36,2110
"20113788600",4679,212,92,1,281,0,127,0,5392
"20113788700",4861,487,5,0,157,54,67,28,5659
"20115489500",1581,232,3,1,35,29,40,5,1926
"20115489600",2925,166,27,8,86,24,125,2,3363
"20115489700",2077,400,0,0,15,29,11,53,2585
"20115489800",3235,397,24,0,145,20,78,8,3907
"20117040701",1488,183,0,0,18,65,9,4,1767
"20117060510",3184,230,21,3,39,29,131,0,3637
"20117070182",1845,318,0,0,49,17,53,0,2282
"20117090186",2064,235,2,0,27,7,22,2,2359
"20119966600",1944,270,0,0,331,41,449,122,3157
"20119966700",1382,156,29,0,89,14,41,14,1725
"20121100100",2969,149,122,8,93,0,40,0,3381
"20121100200",4335,118,40,0,221,0,151,0,4865
"20121100300",3053,98,0,0,35,0,43,0,3229
"20121100400",3131,318,0,0,106,6,91,6,3658
"20121100500",3850,203,33,0,128,45,24,22,4305
"20121100601",4847,809,78,38,69,104,171,52,6168
"20121100602",1785,57,0,0,7,0,65,13,1927
"20121100700",4052,936,31,0,113,60,125,152,5469
"20123176600",3527,462,0,0,22,44,16,65,4136
"20123176700",1833,110,0,5,22,5,6,10,1991
"20125950100",1801,140,0,0,72,47,17,14,2091
"20125950200",1788,526,0,15,59,28,21,8,2445
"20125950300",2858,416,126,11,456,67,230,0,4164
"20125950400",1268,439,150,32,72,26,106,240,2333
"20125950500",624,255,132,65,122,73,157,35,1463
"20125950600",2924,654,46,25,48,27,282,109,4115
"20125950700",3182,136,2,0,484,99,70,11,3984
"20125950800",3915,454,0,49,225,82,57,75,4857
"20125950900",707,78,27,257,31,27,196,0,1323
"20125951000",825,355,166,124,222,85,42,74,1893
"20125951100",1669,624,16,86,202,62,18,27,2704
"20125951200",589,230,124,41,177,89,94,29,1373
"20125951300",1509,559,0,0,228,20,85,0,2401
"20127963600",2624,227,0,0,73,10,73,0,3007
"20127963700",2371,238,0,0,78,30,139,16,2872
"20129964600",2301,285,17,0,371,40,605,33,3652
"20131480100",2880,435,30,2,25,3,82,0,3457
"20131480200",3528,391,12,24,34,8,48,13,4058
"20131480300",2172,226,7,2,55,38,7,8,2515
"20133951600",2817,449,0,0,131,56,46,24,3523
"20133951700",1923,491,37,20,82,32,109,22,2716
"20133951800",2807,717,0,9,88,11,99,128,3859
"20133951900",2794,642,32,31,130,6,172,97,3904
"20133952000",2019,487,0,0,100,10,78,9,2703
"20135956100",1107,219,2,0,33,1,41,119,1522
"20135956200",1476,122,0,12,45,0,118,3,1776
"20137951700",4168,371,1,0,106,27,123,1,4797
"20139010100",3594,419,0,0,101,49,87,60,4310
"20139010200",2394,289,0,0,39,15,24,4,2765
"20139010300",1818,176,3,0,78,26,10,18,2129
"20139010400",2254,550,5,9,67,59,42,4,2990
"20139010500",3408,401,0,0,102,4,128,16,4059
"20141474100",3012,564,9,0,70,0,43,11,3709
"20143085600",1960,163,12,0,21,0,77,0,2233
"20143085700",3347,268,0,0,109,35,82,0,3841
"20145970200",3645,202,60,16,222,9,361,38,4553
"20145970300",1530,236,1,0,13,1,24,1,1806
"20147475100",1019,82,6,0,28,37,10,1,1183
"20147475200",1377,187,1,0,36,13,18,4,1636
"20147475300",2396,164,0,0,12,11,104,6,2693
"20149000100",6517,684,150,25,346,31,439,81,8273
"20149000200",5162,358,0,0,187,41,136,41,5925
"20149000300",3550,472,70,0,245,79,325,6,4747
"20149000400",3988,286,37,5,92,11,100,18,4537
"20151968600",1916,165,16,0,40,44,76,2,2259
"20151968700",2774,473,0,0,92,0,164,24,3527
"20151968800",3288,318,0,0,64,144,279,77,4170
"20153950600",2208,230,3,6,43,14,73,44,2621
"20155000100",2718,430,50,2,129,72,60,107,3568
"20155000200",3343,127,12,0,125,0,285,0,3892
"20155000300",5987,607,0,0,223,17,434,63,7331
"20155000400",2944,296,111,78,147,107,380,94,4157
"20155000500",4823,553,126,0,212,60,598,17,6389
"20155000600",1348,627,20,12,193,43,380,144,2767
"20155000700",3953,1128,354,63,577,92,864,326,7357
"20155000800",1262,414,74,0,279,78,364,82,2553
"20155001000",1693,445,91,0,65,96,323,12,2725
"20155001100",4507,54,6,0,9,0,170,0,4746
"20155001200",2942,327,162,0,93,61,62,0,3647
"20155001300",2148,327,21,4,71,16,149,40,2776
"20155001400",4222,260,60,0,141,0,71,6,4760
"20155001500",2936,181,8,0,65,8,42,6,3246
"20155001600",1593,261,0,0,69,0,6,13,1942
"20155001700",1862,325,4,13,42,42,56,35,2379
"20155001800",1779,191,0,0,44,40,32,0,2086
"20157978100",995,159,0,0,4,0,5,4,1167
"20157978200",1470,142,0,0,7,9,19,4,1651
"20157978300",1549,271,7,0,67,18,18,18,1948
"20159967100",1931,364,16,3,116,32,65,42,2569
"20159967200",2726,494,48,11,363,112,668,122,4544
"20159967300",2615,327,24,0,81,22,60,65,3194
"20161000200",6343,1066,682,31,923,55,558,33,9691
"20161000303",365,501,0,9,188,198,70,86,1417
"20161000304",3240,1127,113,55,381,191,418,67,5592
"20161000500",1760,2643,44,72,154,524,169,231,5597
"20161000600",7136,456,294,32,1163,43,261,31,9416
"20161000700",2746,639,173,77,223,44,62,59,4023
"20161000801",2091,1604,127,231,130,144,110,84,4521
"20161000802",1551,551,106,6,48,22,379,47,2710
"20161000900",4153,630,665,0,343,105,378,23,6297
"20161001002",3958,416,759,125,384,49,877,38,6606
"20161001100",2896,1638,230,150,422,635,235,350,6556
"20161001301",2394,439,124,0,368,25,339,128,3817
"20161001302",4395,357,30,2,181,30,107,0,5102
"20161980000",0,0,0,0,0,0,0,0,0
"20163974600",1583,343,0,0,24,20,19,68,2057
"20163974700",2618,352,0,0,78,8,37,0,3093
"20165972100",1073,61,0,0,18,9,12,2,1175
"20165972200",1714,212,0,0,21,10,56,22,2035
"20167973800",3711,571,26,46,55,69,99,30,4607
"20167973900",2081,198,11,0,102,1,27,7,2427
"20169000100",3633,1126,71,45,139,192,189,320,5715
"20169000200",1326,311,193,51,148,42,396,86,2553
"20169000300",3462,1137,91,0,53,689,405,815,6652
"20169000400",2690,216,85,0,223,54,285,56,3609
"20169000500",3180,1210,288,0,788,590,804,862,7722
"20169000600",1633,503,88,21,416,68,231,80,3040
"20169000700",4852,324,108,97,447,32,327,73,6260
"20169000800",3752,137,85,0,289,7,179,21,4470
"20169000900",5243,802,168,97,86,40,73,14,6523
"20169001000",4221,403,100,0,254,33,45,19,5075
"20169001100",3463,159,75,0,259,13,381,0,4350
"20169001200",3373,298,5,0,125,3,82,10,3896
"20171957100",4302,314,0,0,226,5,807,0,5654
"20173000100",1211,1206,137,37,558,296,1393,1432,6270
"20173000200",2323,570,156,0,214,54,870,359,4546
"20173000300",2211,653,89,127,923,200,1799,582,6584
"20173000400",999,602,732,158,365,80,903,436,4275
"20173000600",265,228,632,641,175,17,147,117,2222
"20173000700",235,494,1295,901,74,140,224,302,3665
"20173000800",296,247,944,673,32,93,36,225,2546
"20173000900",408,236,893,329,265,275,177,96,2679
"20173001000",2178,272,1151,361,342,57,555,213,5129
"20173001100",777,222,540,388,112,98,289,140,2566
"20173001400",3414,224,12,0,241,0,367,0,4258
"20173001500",1401,741,86,14,615,55,750,291,3953
"20173001800",568,420,408,215,268,127,409,285,2700
"20173001900",1249,322,175,44,101,54,200,132,2277
"20173002000",1710,204,0,13,60,29,55,22,2093
"20173002100",2753,169,81,0,82,0,161,0,3246
"20173002200",1627,164,24,15,67,8,136,114,2155
"20173002300",1483,245,73,28,158,64,224,84,2359
"20173002400",854,254,140,277,54,40,136,72,1827
"20173002600",722,515,86,34,114,151,308,200,2130
"20173002700",922,288,33,3,107,39,246,85,1723
"20173002800",1823,438,97,35,303,197,319,200,3412
"20173002900",2230,373,147,142,180,125,792,192,4181
"20173003000",1396,482,132,36,98,20,355,173,2692
"20173003100",1273,442,142,180,132,91,524,121,2905
"20173003200",1137,997,66,197,35,393,351,435,3611
"20173003400",1346,809,11,134,524,22,623,269,3738
"20173003500",1092,374,76,143,148,11,230,74,2148
"20173003600",1530,420,455,153,487,77,424,118,3664
"20173003700",856,338,41,174,230,121,288,242,2290
"20173003800",1445,575,294,28,395,61,192,311,3301
"20173003900",2862,777,211,77,307,39,1284,299,5856
"20173004000",2545,1331,66,102,332,258,970,610,6214
"20173004300",1446,608,166,94,211,27,216,98,2866
"20173005100",2725,687,236,213,389,275,511,166,5202
"20173005200",2616,643,226,448,412,94,359,252,5050
"20173005300",4789,482,241,0,505,41,830,128,7016
"20173005400",4204,1309,29,34,727,134,405,287,7129
"20173005501",3804,572,0,0,451,11,283,32,5153
"20173005502",4743,482,27,0,198,17,125,169,5761
"20173005600",4166,319,96,9,409,66,636,37,5738
"20173005700",4138,980,9,0,788,91,546,31,6583
"20173005800",2644,1366,30,31,270,73,451,272,5137
"20173005900",2627,707,162,29,408,242,724,82,4981
"20173006000",2291,1062,420,340,672,132,548,534,5999
"20173006100",1993,1037,46,0,273,91,609,766,4815
"20173006200",1697,634,459,187,390,161,803,358,4689
"20173006300",1420,467,248,56,264,21,311,85,2872
"20173006400",1218,157,142,0,170,33,88,55,1863
"20173006500",1136,1280,187,71,1017,197,988,1000,5876
"20173006600",1085,178,568,185,200,134,406,82,2838
"20173006700",1413,398,187,107,226,55,456,208,3050
"20173006800",1888,1026,527,1019,97,119,609,747,6032
"20173006900",1401,252,445,137,377,110,620,114,3456
"20173007000",1802,407,1000,390,184,163,435,246,4627
"20173007101",1156,430,185,216,507,138,127,323,3082
"20173007102",2405,419,1294,277,561,92,469,65,5582
"20173007201",2531,547,154,18,684,46,330,217,4527
"20173007203",3121,355,839,128,2038,177,595,52,7305
"20173007204",4090,214,746,91,3045,323,846,0,9355
"20173007301",3155,250,49,36,307,49,106,12,3964
"20173007302",2741,72,212,153,238,8,84,0,3508
"20173007400",677,35,0,9,13,2,0,0,736
"20173007500",339,208,1297,527,176,177,205,93,3022
"20173007600",2580,206,599,209,160,46,56,11,3867
"20173007700",2722,693,3259,367,939,562,243,301,9086
"20173007800",53,75,1515,932,63,146,63,163,3010
"20173008000",4757,463,225,9,500,78,276,155,6463
"20173008100",4009,689,30,0,204,8,406,244,5590
"20173008200",2621,876,149,158,1004,602,2025,988,8423
"20173008300",3086,478,189,0,505,23,655,68,5004
"20173008400",2408,322,29,18,519,148,596,120,4160
"20173008500",2063,162,0,0,90,56,203,56,2630
"20173008600",2645,292,49,8,525,9,685,41,4254
"20173008700",2633,473,169,85,274,189,418,305,4546
"20173008800",3640,435,51,13,468,108,772,89,5576
"20173008900",2108,1026,74,0,290,130,270,133,4031
"20173009000",1661,421,130,9,307,84,271,20,2903
"20173009100",4484,1384,545,297,719,271,1295,251,9246
"20173009200",2153,397,34,0,189,0,133,0,2906
"20173009301",5177,201,211,0,332,0,631,0,6552
"20173009302",4098,391,121,377,586,59,291,17,5940
"20173009401",3701,213,25,10,86,0,250,12,4297
"20173009402",1958,206,36,43,115,0,182,0,2540
"20173009503",8207,119,27,0,963,297,640,167,10420
"20173009504",3695,538,30,0,166,0,250,97,4776
"20173009505",2886,34,40,0,125,7,146,0,3238
"20173009506",4131,124,62,0,333,0,378,0,5028
"20173009507",5236,53,102,0,513,11,405,0,6320
"20173009508",2780,253,9,0,90,50,183,34,3399
"20173009509",5714,149,0,11,390,43,341,18,6666
"20173009510",4043,22,38,0,341,35,109,0,4588
"20173009511",6371,217,281,0,291,0,660,12,7832
"20173009512",3474,166,171,0,299,25,262,0,4397
"20173009513",4055,277,0,0,369,127,492,129,5449
"20173009603",2262,140,12,14,385,51,298,7,3169
"20173009604",2453,252,0,0,21,0,0,26,2752
"20173009605",4610,335,30,0,327,23,491,215,6031
"20173009700",5915,187,0,0,291,15,618,0,7026
"20173009801",4055,427,16,0,342,8,300,9,5157
"20173009802",6426,641,85,0,438,0,292,0,7882
"20173009900",9811,349,125,0,728,0,283,0,11296
"20173010001",4131,15,140,0,234,0,60,0,4580
"20173010002",2666,242,210,0,662,29,48,0,3857
"20173010003",1487,27,270,13,764,16,228,12,2817
"20173010004",5590,199,241,0,403,45,468,9,6955
"20173010005",3295,133,247,9,331,0,310,20,4345
"20173010106",2173,100,248,0,229,0,47,0,2797
"20173010107",2844,346,408,9,146,56,148,0,3957
"20173010108",1712,50,267,0,231,24,71,0,2355
"20173010109",1450,439,91,53,151,61,80,170,2495
"20173010110",1352,32,0,5,52,0,64,13,1518
"20173010111",5768,207,529,117,586,0,253,14,7474
"20173010113",2968,237,281,124,300,5,127,178,4220
"20173010115",6046,103,177,1,716,0,190,0,7233
"20173010116",2111,186,121,4,88,9,158,38,2715
"20173010200",8781,336,32,0,202,101,386,0,9838
"20173010300",11455,438,163,0,628,377,673,275,14009
"20173010400",1842,334,8,0,52,10,83,7,2336
"20173010500",3881,221,0,0,70,3,114,0,4289
"20173010600",3458,88,3,0,51,19,61,4,3684
"20173010700",3015,141,2,0,54,3,112,0,3327
"20173010801",1863,94,412,10,348,144,190,10,3071
"20173010802",1491,197,329,182,318,79,286,29,2911
"20175965600",1648,137,0,0,662,8,1149,127,3731
"20175965700",3314,483,42,16,753,63,1376,406,6453
"20175965800",2142,406,48,102,971,713,1292,1019,6693
"20175965900",2384,1118,440,54,2292,236,3205,1133,10862
"20175966000",1588,229,94,21,2013,764,2832,928,8469
"20177000400",1385,1351,585,477,241,143,367,315,4864
"20177000500",725,557,151,16,334,207,266,160,2416
"20177000600",961,519,310,148,163,271,126,358,2856
"20177000700",1760,612,51,1,98,118,57,54,2751
"20177000800",1848,915,74,88,422,96,510,165,4118
"20177000900",2100,644,43,0,291,130,345,295,3848
"20177001000",2293,454,67,0,813,125,1378,208,5338
"20177001100",1049,623,197,353,103,313,812,465,3915
"20177001200",652,251,513,145,467,227,460,182,2897
"20177001300",2259,602,377,53,455,305,1142,419,5612
"20177001500",1156,256,353,209,151,54,124,58,2361
"20177001601",1758,412,96,0,142,30,163,26,2627
"20177001603",1736,345,333,282,223,93,238,46,3296
"20177001604",2731,225,72,62,371,6,149,36,3652
"20177001800",2630,606,69,27,143,0,117,38,3630
"20177001900",2846,74,67,0,88,35,87,7,3204
"20177002100",2197,519,170,60,310,271,188,148,3863
"20177002200",1926,326,79,9,167,9,227,59,2802
"20177002400",4162,614,101,94,448,0,327,0,5746
"20177002500",2228,225,172,39,116,1,140,46,2967
"20177002601",2396,265,399,63,260,13,256,0,3652
"20177002602",4782,331,254,136,549,157,495,20,6724
"20177002701",3613,443,175,85,265,10,430,18,5039
"20177002702",3314,250,231,17,322,52,176,8,4370
"20177002800",2331,554,376,42,205,252,72,35,3867
"20177002900",1072,925,662,84,432,168,398,566,4307
"20177003001",1914,432,815,300,244,186,657,401,4949
"20177003002",4409,257,874,0,367,42,769,0,6718
"20177003100",2575,986,725,366,217,93,477,618,6057
"20177003301",2322,149,49,0,69,0,104,18,2711
"20177003302",3461,149,0,0,28,45,68,0,3751
"20177003400",8928,130,112,66,605,39,582,39,10501
"20177003500",5645,216,16,0,382,8,280,43,6590
"20177003601",4508,190,12,0,238,4,195,12,5159
"20177003604",3471,71,119,27,129,0,127,6,3950
"20177003605",3477,74,46,0,457,15,120,0,4189
"20177003606",3634,214,116,20,229,0,479,0,4692
"20177003607",5569,199,92,27,417,0,326,59,6689
"20177003700",6609,1276,351,14,434,29,353,239,9305
"20177003901",6295,223,26,11,280,28,399,28,7290
"20177003902",3897,180,144,0,65,7,89,55,4437
"20177004000",832,718,216,214,125,354,291,180,2930
"20177004100",2598,544,152,0,166,68,178,115,3821
"20179952600",1075,93,0,0,14,0,16,0,1198
"20179952700",1209,72,0,0,37,0,48,29,1395
"20181453600",950,31,0,0,16,0,45,5,1047
"20181453700",3550,971,71,10,217,113,442,232,5606
"20183475800",1394,241,0,14,15,5,5,5,1679
"20183475900",1687,264,2,0,38,19,60,0,2070
"20185470600",1370,348,18,0,34,28,22,147,1967
"20185470700",1989,287,24,0,73,12,314,75,2774
"20187964100",1508,81,12,0,480,32,676,86,2875
"20189965100",1246,83,26,0,167,37,305,37,1901
"20189965200",2966,543,0,0,255,374,945,688,5771
"20191962100",4220,396,0,0,129,30,160,8,4943
"20191962200",4330,698,55,8,145,56,13,35,5340
"20191962300",1937,347,0,9,53,49,38,5,2438
"20191962400",3714,237,0,6,92,71,332,22,4474
"20191962500",2979,643,23,76,278,70,306,231,4606
"20191962600",2222,148,0,0,98,25,70,2,2565
"20193953100",4847,536,114,0,178,30,280,12,5997
"20193953400",1658,163,0,1,42,3,59,32,1958
"20195955800",2660,107,1,1,92,11,53,9,2934
"20197483100",4071,315,14,0,183,11,179,26,4799
"20197483200",2176,67,0,0,18,11,11,2,2285
"20199954100",1437,122,0,0,1,7,42,6,1615
"20201978600",2677,301,12,0,60,7,18,4,3079
"20201978700",2098,318,18,0,24,23,98,66,2645
"20203957600",1813,214,0,0,125,0,541,77,2770
"20205097100",1719,324,0,0,38,7,32,12,2132
"20205097200",1210,155,0,0,46,19,54,0,1484
"20205097300",1927,574,5,0,130,43,57,13,2749
"20205097400",1962,496,7,0,142,21,48,18,2694
"20207096600",1156,450,0,6,37,65,25,51,1790
"20207096700",1188,169,0,3,31,21,8,0,1420
"20209040001",0,0,0,0,0,0,0,0,0
"20209040002",0,0,0,0,0,0,0,0,0
"20209040200",102,99,539,411,72,16,166,101,1506
"20209040300",4,0,360,320,2,0,0,0,686
"20209040400",159,196,911,329,179,11,212,143,2140
"20209040500",722,163,428,162,301,17,410,63,2266
"20209040600",362,394,1134,499,164,29,325,377,3284
"20209040700",268,194,790,429,46,231,280,396,2634
"20209040800",171,0,163,127,30,1,195,0,687
"20209040900",251,101,178,300,137,17,163,48,1195
"20209041000",72,18,341,744,126,107,72,90,1570
"20209041100",58,26,358,691,232,68,93,76,1602
"20209041200",322,75,501,452,35,38,286,77,1786
"20209041300",1586,1005,865,339,481,830,1371,1054,7531
"20209041500",1268,377,302,202,256,243,1013,448,4109
"20209041600",1986,662,434,188,356,297,1355,655,5933
"20209041700",1355,274,101,87,567,109,1115,278,3886
"20209041800",72,110,310,276,29,124,10,14,945
"20209041900",1254,442,87,11,259,119,707,323,3202
"20209042001",308,328,19,23,364,265,382,390,2079
"20209042002",397,449,12,107,491,275,636,570,2937
"20209042100",1064,727,115,92,482,248,1008,712,4448
"20209042200",1101,465,72,2,236,45,973,426,3320
"20209042300",1400,849,133,145,480,226,1419,773,5425
"20209042400",630,236,82,190,709,380,1081,410,3718
"20209042501",0,0,0,0,0,0,0,0,0
"20209042502",0,0,0,0,0,0,0,0,0
"20209042600",1039,410,4,9,583,355,1075,553,4028
"20209042700",1856,685,275,593,179,236,1245,556,5625
"20209042800",1870,757,258,369,311,52,1231,436,5284
"20209043000",72,27,0,4,8,0,57,0,168
"20209043301",1966,510,238,352,421,106,934,324,4851
"20209043400",1534,284,139,0,113,17,571,191,2849
"20209043500",1416,137,9,0,146,11,416,0,2135
"20209043600",4610,926,76,222,476,191,1174,809,8484
"20209043700",1544,102,214,28,262,36,485,15,2686
"20209043802",1086,187,0,0,16,25,76,71,1461
"20209043803",2264,246,128,57,352,0,514,35,3596
"20209043804",4,0,0,0,0,0,4,0,8
"20209043903",1216,538,708,31,523,174,647,278,4115
"20209043904",664,572,1193,524,325,119,192,290,3879
"20209043905",567,372,393,530,73,39,128,67,2169
"20209044001",1835,274,792,213,477,37,382,152,4162
"20209044003",1889,548,107,199,93,16,251,88,3191
"20209044004",234,216,0,0,29,66,5,122,672
"20209044101",223,56,473,286,34,6,8,6,1092
"20209044102",1735,173,528,45,257,0,564,89,3391
"20209044103",1286,108,975,188,270,16,124,4,2971
"20209044104",634,113,1582,444,350,213,314,112,3762
"20209044201",2494,73,954,12,199,8,172,13,3925
"20209044202",1666,153,1345,256,381,86,335,21,4243
"20209044301",1295,173,515,177,126,50,263,49,2648
"20209044302",838,118,719,85,123,42,342,47,2314
"20209044303",929,154,938,148,319,0,493,129,3110
"20209044400",1119,228,1052,132,215,321,327,138,3532
"20209044500",663,87,667,136,248,91,30,91,2013
"20209044601",1772,160,338,53,193,71,183,79,2849
"20209044602",0,0,0,0,0,0,0,0,0
"20209044603",0,0,0,0,0,0,0,0,0
"20209044702",3344,406,149,35,180,0,332,0,4446
"20209044703",1286,43,368,0,191,0,169,0,2057
"20209044704",1056,66,538,15,114,0,106,53,1948
"20209044803",3963,132,637,0,313,18,249,50,5362
"20209044804",3347,177,890,0,364,0,240,149,5167
"20209044805",1941,290,172,6,95,50,187,36,2777
"20209044806",528,15,0,0,63,0,0,0,606
"20209044900",3308,356,510,20,65,47,308,22,4636
"20209045000",1916,901,50,311,589,128,1232,482,5609
"20209045100",672,408,275,268,290,355,363,394,3025
"20209045200",2244,880,191,90,253,70,456,621,4805
"21001970100",1050,315,0,0,51,0,18,0,1434
"21001970200",1297,186,45,13,8,11,8,4,1572
"21001970300",2411,641,0,0,44,12,0,0,3108
"21001970401",3210,786,218,1,0,64,29,55,4363
"21001970402",2887,591,38,12,7,79,182,2,3798
"21001970500",1659,453,13,0,46,26,0,0,2197
"21001970600",737,599,13,0,0,0,0,21,1370
"21003920100",2671,436,80,0,86,6,9,0,3288
"21003920200",2286,549,0,0,16,0,26,78,2955
"21003920300",3735,615,44,0,0,0,6,0,4400
"21003920400",3397,1026,105,0,26,26,92,0,4672
"21003920500",1126,236,0,34,171,0,102,0,1669
"21003920600",2759,526,0,0,102,0,56,0,3443
"21005950100",6961,853,329,77,11,0,76,0,8307
"21005950201",4497,444,46,0,176,0,23,60,5246
"21005950202",3096,368,0,0,36,114,35,0,3649
"21005950300",1862,178,7,0,83,0,82,0,2212
"21005950400",2208,175,43,0,13,14,0,50,2503
"21007950100",3406,633,115,49,17,42,27,13,4302
"21007950200",1121,295,9,11,16,14,12,16,1494
"21007950300",1818,209,61,16,69,26,18,11,2228
"21009950100",2914,398,21,22,28,0,0,0,3383
"21009950200",2592,792,186,67,90,67,18,45,3857
"21009950300",2144,541,234,57,28,73,0,0,3077
"21009950400",3580,1367,395,143,212,48,136,65,5946
"21009950500",2544,630,123,19,65,18,35,10,3444
"21009950600",3893,1196,169,213,157,76,309,53,6066
"21009950700",5548,641,1,0,25,43,147,0,6405
"21009950800",2643,931,0,0,26,0,114,7,3721
"21009950900",2743,751,0,0,92,7,125,51,3769
"21009951000",2924,498,19,0,56,0,6,94,3597
"21011970100",1259,510,89,23,53,16,8,4,1962
"21011970200",4538,1334,64,16,131,30,104,0,6217
"21011970300",2534,1168,0,0,16,25,0,25,3768
"21013960100",1272,1019,0,0,54,0,0,0,2345
"21013960200",2737,1969,3,3,0,41,0,0,4753
"21013960300",1599,614,0,5,0,0,0,0,2218
"21013960400",1374,322,6,0,0,0,0,0,1702
"21013960500",1668,618,19,49,10,0,47,0,2411
"21013960600",1737,2268,163,156,138,31,0,65,4558
"21013960700",1745,844,129,133,18,63,0,0,2932
"21013960800",2403,1166,75,0,10,89,10,0,3753
"21013961100",1565,835,0,8,5,0,0,0,2413
"21015070100",5199,710,326,218,150,10,236,235,7084
"21015070200",4807,795,183,124,456,57,344,46,6812
"21015070301",2968,1617,65,264,322,213,535,551,6535
"21015070305",4829,549,85,0,378,14,292,51,6198
"21015070307",10716,197,451,0,721,0,122,0,12207
"21015070308",8639,766,295,73,1001,0,160,265,11199
"21015070309",5637,126,104,0,496,0,213,0,6576
"21015070311",1907,431,15,7,105,0,38,0,2503
"21015070312",2369,268,296,0,135,64,47,20,3199
"21015070313",2975,29,0,0,73,47,107,0,3231
"21015070314",3889,226,313,12,88,0,174,0,4702
"21015070401",8792,155,297,0,567,0,134,0,9945
"21015070402",7434,524,246,0,230,0,248,135,8817
"21015070502",4239,370,0,4,17,0,28,17,4675
"21015070503",5821,411,83,0,372,0,285,15,6987
"21015070504",6452,300,12,53,97,250,0,56,7220
"21015070601",2781,77,0,0,0,0,0,0,2858
"21015070604",2368,344,37,0,4,0,42,0,2795
"21015070605",5189,250,11,0,545,0,196,0,6191
"21015070606",3573,387,49,0,21,0,68,8,4106
"21015070607",3738,214,57,0,74,0,21,0,4104
"21015980100",0,0,0,0,0,0,0,0,0
"21017030100",2253,805,523,244,66,0,162,175,4228
"21017030200",4160,826,219,215,182,0,463,0,6065
"21017030300",2576,111,36,0,52,106,150,106,3137
"21017030400",2260,172,57,0,80,0,55,0,2624
"21017030500",1699,469,74,15,16,5,18,0,2296
"21017030600",2112,288,35,5,23,11,187,18,2679
"21019030200",530,532,85,47,38,11,69,7,1319
"21019030300",1267,596,90,22,33,46,102,28,2184
"21019030400",1565,554,0,20,61,73,4,8,2285
"21019030500",3525,545,16,27,257,0,23,6,4399
"21019030600",3535,335,77,12,7,0,22,12,4000
"21019030700",2501,558,37,67,45,44,37,0,3289
"21019030800",1997,1763,16,72,25,60,14,0,3947
"21019030900",4369,707,0,63,23,160,0,0,5322
"21019031001",954,270,0,17,15,0,0,0,1256
"21019031002",4263,1092,5,5,140,2,161,0,5668
"21019031100",6539,952,0,0,64,0,0,0,7555
"21019031200",3050,348,0,0,0,0,64,0,3462
"21019031300",1934,494,16,6,10,0,13,0,2473
"21021930100",3203,629,223,129,144,0,48,0,4376
"21021930200",3398,279,129,134,198,46,44,46,4274
"21021930300",1233,425,207,62,62,1,59,49,2098
"21021930400",2600,749,410,92,232,31,90,202,4406
"21021930500",2810,258,74,20,124,2,167,75,3530
"21021930600",3303,525,39,7,48,0,26,0,3948
"21021930700",3741,836,97,41,24,25,31,1,4796
"21023950100",1780,496,0,0,0,80,0,86,2442
"21023950200",1728,242,0,0,0,0,10,2,1982
"21023950300",3276,726,0,0,8,0,23,0,4033
"21025920100",796,305,0,1,42,0,0,0,1144
"21025920200",1562,546,0,33,0,2,22,0,2165
"21025920300",2020,1314,0,0,68,23,0,14,3439
"21025920400",895,472,0,0,12,11,0,0,1390
"21025920500",839,443,0,0,33,26,0,0,1341
"21025920600",1171,715,0,0,0,18,0,18,1922
"21025920700",1478,457,0,0,6,0,0,7,1948
"21027960100",3929,884,140,57,141,49,16,49,5265
"21027960200",4144,708,131,14,40,63,0,28,5128
"21027960300",2338,427,37,42,12,4,15,0,2875
"21027960400",1214,158,0,0,0,0,0,0,1372
"21027960501",1303,349,0,9,0,15,62,15,1753
"21027960502",2754,633,0,0,26,10,55,0,3478
"21029020101",3311,194,0,0,84,0,8,0,3597
"21029020102",2604,820,0,0,134,15,30,0,3603
"21029020103",2943,200,8,0,49,0,78,0,3278
"21029020201",5658,569,66,0,65,29,53,0,6440
"21029020202",3556,170,0,0,101,0,13,0,3840
"21029020300",4175,344,54,0,13,0,26,126,4738
"21029020400",6038,339,85,0,93,0,0,52,6607
"21029020500",5381,396,0,0,82,143,21,104,6127
"21029020601",4723,589,15,0,236,0,75,0,5638
"21029020602",1256,73,47,0,133,28,2,28,1567
"21029020701",4666,1185,0,0,227,118,68,0,6264
"21029020702",1870,145,8,0,45,0,102,0,2170
"21029020800",4039,704,46,0,121,0,146,0,5056
"21029020900",2572,236,0,0,86,0,18,0,2912
"21029021101",5765,746,0,0,317,0,99,0,6927
"21029021102",3838,203,0,0,5,0,34,0,4080
"21029021200",3805,646,0,0,154,19,153,19,4796
"21029980100",0,0,0,0,0,0,0,0,0
"21031930100",2594,908,2,0,0,0,0,11,3515
"21031930200",1229,521,13,0,0,0,0,21,1784
"21031930300",2608,1684,65,26,7,69,72,331,4862
"21031930400",1319,196,0,0,0,0,0,10,1525
"21031930500",1019,263,0,0,9,0,0,0,1291
"21033920100",1634,387,34,0,11,6,0,0,2072
"21033920200",3726,797,308,105,61,16,90,33,5136
"21033920300",4191,974,59,236,62,23,43,0,5588
"21035010100",3454,696,0,0,5,22,37,22,4236
"21035010200",3881,330,23,25,62,0,35,0,4356
"21035010301",211,82,0,0,0,195,0,0,488
"21035010302",3143,2740,311,15,200,238,42,61,6750
"21035010400",1235,570,153,115,71,0,87,111,2342
"21035010500",2201,645,93,188,24,111,14,37,3313
"21035010600",5391,1029,155,0,157,113,120,134,7099
"21035010700",2945,296,32,26,124,47,88,4,3562
"21035010800",2643,519,12,0,130,13,83,33,3433
"21037050100",515,492,85,220,57,37,35,89,1530
"21037050400",1553,292,32,37,62,25,75,17,2093
"21037050500",1099,527,186,100,29,5,0,0,1946
"21037050600",720,956,134,141,6,15,19,85,2076
"21037051101",1766,704,0,0,18,11,14,24,2537
"21037051102",1077,76,0,0,222,7,0,0,1382
"21037051200",827,544,0,0,22,55,0,21,1469
"21037051300",4050,168,0,0,69,0,66,0,4353
"21037051901",4643,168,0,0,54,26,0,0,4891
"21037051903",4253,409,0,0,271,0,24,88,5045
"21037051904",4069,630,50,8,76,0,51,0,4884
"21037052001",3827,561,44,0,192,7,92,0,4723
"21037052002",2415,209,6,0,0,0,0,0,2630
"21037052100",2825,403,17,0,92,0,115,0,3452
"21037052200",2018,125,26,81,39,0,0,0,2289
"21037052301",4168,221,0,4,56,17,0,16,4482
"21037052302",4486,393,8,0,130,0,34,0,5051
"21037052400",1974,446,19,40,127,64,15,130,2815
"21037052500",3776,908,223,260,122,56,0,58,5403
"21037052800",2672,250,20,280,52,0,7,0,3281
"21037052900",4730,421,13,2,14,17,56,1,5254
"21037053100",5504,700,0,0,106,85,101,20,6516
"21037053200",1592,83,73,35,107,90,117,75,2172
"21037053301",4309,476,21,225,116,106,34,0,5287
"21037053302",3472,520,55,77,36,68,42,0,4270
"21039960100",1282,152,0,0,6,0,24,0,1464
"21039960200",1389,432,34,0,4,51,0,27,1937
"21039960300",1159,315,44,0,12,20,56,3,1609
"21041950100",1999,453,77,40,98,36,46,20,2769
"21041950200",3535,1463,70,58,247,91,184,482,6130
"21041950300",1464,757,0,0,0,0,0,0,2221
"21043960100",2517,544,15,0,0,0,59,38,3173
"21043960200",3249,1167,2,8,0,0,0,0,4426
"21043960300",2605,433,0,0,12,7,141,13,3211
"21043960400",1423,396,0,0,0,0,0,0,1819
"21043960500",2836,620,0,52,56,44,0,0,3608
"21043960600",5380,763,0,36,130,14,84,0,6407
"21043960700",3591,584,0,0,38,14,0,0,4227
"21045950100",909,401,0,0,0,20,74,20,1424
"21045950200",1890,338,12,0,119,6,52,14,2431
"21045950300",4244,1757,14,37,55,0,90,0,6197
"21045950400",2554,677,0,3,12,67,11,32,3356
"21045950500",1777,629,15,15,0,19,120,15,2590
"21047200100",1146,276,1161,709,141,163,129,42,3767
"21047200200",1509,748,444,536,159,11,178,223,3808
"21047200300",964,662,572,921,32,202,89,18,3460
"21047200400",418,410,994,947,118,7,169,124,3187
"21047200500",3352,311,282,153,243,88,342,89,4860
"21047200600",3509,190,434,97,289,49,290,0,4858
"21047200700",4285,473,614,0,214,0,194,0,5780
"21047200800",1024,209,781,514,28,11,5,0,2572
"21047200900",4541,270,476,30,550,0,360,0,6227
"21047201000",1358,380,29,14,28,15,5,0,1829
"21047201100",3105,810,85,51,30,48,0,19,4148
"21047201200",2270,324,8,11,46,13,19,0,2691
"21047201301",2287,250,231,44,69,25,68,12,2986
"21047201302",3672,1156,1299,322,863,243,487,155,8197
"21047201400",2262,153,122,29,222,36,61,0,2885
"21047201501",3122,532,882,63,483,207,426,138,5853
"21047201502",2822,747,529,74,419,42,676,431,5740
"21047201503",0,0,0,0,0,0,0,0,0
"21047980100",0,0,0,0,0,0,0,0,0
"21049020101",4508,677,11,12,135,0,11,50,5404
"21049020103",3534,104,121,0,59,0,8,0,3826
"21049020105",2778,224,73,0,32,0,13,0,3120
"21049020106",2029,692,97,88,39,40,44,89,3118
"21049020201",1464,928,763,328,0,0,39,190,3712
"21049020202",2605,1106,102,0,51,25,33,45,3967
"21049020300",2022,210,0,0,54,0,16,8,2310
"21049020400",2712,281,50,0,0,25,29,0,3097
"21049020500",2372,301,37,0,30,0,96,46,2882
"21049020600",3637,360,138,0,136,0,250,23,4544
"21051950100",1182,653,14,0,12,9,0,0,1870
"21051950200",3863,2507,6,0,86,122,25,67,6676
"21051950300",2971,1472,79,47,16,6,7,0,4598
"21051950400",1595,1447,0,0,0,0,0,0,3042
"21051950500",1191,1006,0,0,19,0,0,0,2216
"21051950600",672,448,0,0,15,15,0,0,1150
"21053970100",2378,508,0,0,29,0,6,0,2921
"21053970201",2271,1064,15,1,31,48,12,54,3496
"21053970202",2743,805,0,2,115,7,179,12,3863
"21055930100",1648,257,0,0,10,43,5,0,1963
"21055930200",3031,907,19,70,19,0,11,0,4057
"21055930300",1187,346,0,0,15,0,19,21,1588
"21055930400",1088,321,0,0,9,30,0,8,1456
"21057950100",2635,909,116,74,0,8,11,0,3753
"21057950200",2187,629,1,0,79,62,0,0,2958
"21059000100",1697,721,403,62,165,34,129,34,3245
"21059000200",1707,1174,236,121,37,365,277,200,4117
"21059000300",621,264,69,55,65,251,21,121,1467
"21059000400",5045,1622,243,435,233,55,111,0,7744
"21059000500",1302,315,226,161,0,7,113,22,2146
"21059000600",4154,541,278,70,15,55,0,0,5113
"21059000700",3389,311,89,55,350,118,0,0,4312
"21059000800",3015,486,91,153,139,39,108,33,4064
"21059000900",3886,846,74,15,65,0,36,0,4922
"21059001000",2064,364,171,28,227,0,178,140,3172
"21059001100",1838,197,4,0,3,0,0,42,2084
"21059001200",2945,170,210,0,127,42,159,0,3653
"21059001300",4563,837,130,46,56,0,0,0,5632
"21059001401",3993,378,59,0,186,0,22,0,4638
"21059001402",4605,419,20,0,114,10,38,0,5206
"21059001501",3112,463,0,0,0,9,13,9,3606
"21059001502",3098,139,0,2,143,0,51,0,3433
"21059001601",3973,24,0,0,256,0,43,0,4296
"21059001602",3942,538,0,3,11,4,0,0,4498
"21059001701",4485,861,174,134,224,22,139,27,6066
"21059001702",2461,446,163,0,180,40,22,117,3429
"21059001703",3900,546,0,0,81,7,99,10,4643
"21059001800",5450,860,68,13,14,15,0,321,6741
"21061920200",3505,1066,0,0,21,0,0,0,4592
"21061920300",935,208,32,102,0,57,0,18,1352
"21061920400",5104,839,37,6,48,11,37,132,6214
"21061980100",0,4,1,0,0,3,0,3,11
"21063920100",3038,1373,0,0,0,9,6,0,4426
"21063920200",1522,697,0,0,0,0,20,0,2239
"21065920100",983,356,0,0,25,5,0,0,1369
"21065920200",4268,1659,0,0,93,35,8,0,6063
"21065920300",3562,1763,0,0,53,18,0,0,5396
"21065920400",1092,359,12,0,50,4,0,0,1517
"21067000101",1580,896,312,263,72,107,20,48,3298
"21067000102",1148,304,173,200,35,0,20,0,1880
"21067000200",1004,484,751,550,113,50,87,0,3039
"21067000300",560,279,1004,704,404,76,251,65,3343
"21067000400",524,313,407,489,27,28,164,55,2007
"21067000500",2920,292,27,0,65,19,11,0,3334
"21067000600",4113,321,2,0,0,0,22,1,4459
"21067000700",1108,969,24,82,129,79,42,66,2499
"21067000801",26,47,0,5,123,117,17,7,342
"21067000802",522,1050,14,79,132,112,31,20,1960
"21067000900",1023,3366,482,294,193,808,80,127,6373
"21067001000",670,379,151,268,73,9,68,36,1654
"21067001100",940,908,1557,725,228,500,599,1008,6465
"21067001300",749,614,411,165,218,148,368,351,3024
"21067001400",1360,442,334,186,99,30,212,213,2876
"21067001500",1403,405,215,79,32,7,334,20,2495
"21067001600",1567,372,157,175,258,32,381,36,2978
"21067001700",1628,250,90,9,78,0,9,0,2064
"21067001800",750,1539,121,122,221,149,0,52,2954
"21067001900",1554,1537,310,500,72,758,115,286,5132
"21067002001",1512,877,376,249,1314,766,1555,1031,7680
"21067002002",1279,196,284,105,381,214,520,346,3325
"21067002200",1144,116,223,21,207,0,30,0,1741
"21067002302",4021,666,77,0,317,204,85,0,5370
"21067002303",2955,392,343,126,173,355,45,0,4389
"21067002304",2103,13,19,0,31,0,49,0,2215
"21067002400",2975,397,142,33,361,171,73,20,4172
"21067002500",2469,1147,0,0,60,72,28,0,3776
"21067002600",3284,1062,240,0,286,90,74,198,5234
"21067002700",2845,490,196,62,282,55,128,7,4065
"21067002800",2923,403,66,0,193,114,153,145,3997
"21067002900",3396,465,70,0,278,6,185,0,4400
"21067003000",4412,436,98,111,813,347,734,293,7244
"21067003101",1847,360,223,285,63,32,99,45,2954
"21067003102",1008,162,892,155,83,57,22,0,2379
"21067003201",1369,132,196,18,77,0,99,0,1891
"21067003202",4049,600,833,491,73,61,98,46,6251
"21067003300",1804,119,525,158,34,11,35,0,2686
"21067003402",2255,999,508,597,614,96,76,33,5178
"21067003404",1984,656,367,892,89,225,85,199,4497
"21067003405",3716,350,767,848,148,0,117,44,5990
"21067003406",4938,555,780,129,221,101,270,14,7008
"21067003407",2604,90,438,7,417,0,158,0,3714
"21067003501",2284,899,460,144,149,45,195,84,4260
"21067003503",1602,373,65,0,291,74,38,83,2526
"21067003504",1726,407,1294,143,112,6,161,0,3849
"21067003600",3918,131,30,0,261,59,63,0,4462
"21067003701",1008,135,28,13,63,92,178,78,1595
"21067003702",2190,153,319,137,322,28,256,81,3486
"21067003703",3722,248,661,21,293,13,278,0,5236
"21067003704",3003,63,1150,26,116,0,190,0,4548
"21067003802",1424,163,115,57,271,0,289,69,2388
"21067003803",1539,115,1322,23,233,43,117,25,3417
"21067003804",742,460,2337,1125,538,646,805,1102,7755
"21067003906",3586,198,134,0,117,0,147,0,4182
"21067003908",2903,202,565,145,374,44,188,0,4421
"21067003909",1909,305,443,161,452,34,333,19,3656
"21067003910",785,198,557,81,300,47,549,135,2652
"21067003911",2050,331,675,199,185,3,283,133,3859
"21067003912",3095,238,430,368,313,36,64,0,4544
"21067003913",5143,152,485,36,624,0,186,0,6626
"21067003914",1245,75,322,351,82,0,29,6,2110
"21067003915",2763,83,128,22,296,0,9,0,3301
"21067003916",556,31,9,0,2,0,0,0,598
"21067003917",811,38,345,28,23,0,147,0,1392
"21067003918",2242,139,123,126,136,2,22,0,2790
"21067004001",3353,826,360,588,340,241,77,223,6008
"21067004003",3941,409,276,16,413,11,68,0,5134
"21067004005",1690,54,4,0,33,12,29,0,1822
"21067004006",1146,0,6,0,38,27,0,0,1217
"21067004007",1653,90,12,0,152,0,29,6,1942
"21067004103",1155,109,72,8,154,99,43,0,1640
"21067004104",2902,561,459,166,177,54,191,16,4526
"21067004105",3838,563,180,0,137,96,52,226,5092
"21067004106",3133,270,301,38,431,9,23,0,4205
"21067004107",4288,187,105,61,649,0,156,0,5446
"21067004204",4797,383,220,30,202,30,36,0,5698
"21067004205",5588,28,301,16,306,21,216,0,6476
"21067004207",3335,172,85,9,214,53,44,7,3919
"21067004208",5435,251,109,0,1441,48,141,0,7425
"21067004209",3781,76,136,0,159,0,90,0,4242
"21067004210",3832,69,187,15,734,51,143,0,5031
"21069920100",3036,734,106,66,160,40,86,25,4253
"21069920200",2802,637,19,0,59,0,27,0,3544
"21069920300",1905,559,1,1,8,0,31,0,2505
"21069920400",3424,846,0,8,31,16,0,8,4333
"21071920100",2218,664,0,6,134,3,19,32,3076
"21071920200",1610,600,0,0,7,0,0,0,2217
"21071920300",3527,1181,22,0,80,14,93,54,4971
"21071920400",2863,1520,0,0,0,0,0,0,4383
"21071920500",1606,1188,54,25,94,17,15,0,2999
"21071920600",1938,916,10,0,0,45,0,0,2909
"21071920700",2234,1066,0,0,0,16,0,0,3316
"21071920800",4128,1507,4,1,4,7,18,0,5669
"21071920900",1326,458,0,0,0,11,0,0,1795
"21071921000",4739,2089,10,98,28,9,0,27,7000
"21073070100",3885,542,743,126,434,105,304,0,6139
"21073070401",1916,210,180,1,75,0,20,0,2402
"21073070402",3733,676,640,17,298,373,204,349,6290
"21073070500",1188,324,328,178,88,3,62,25,2196
"21073070600",1875,574,594,335,196,192,25,152,3943
"21073070701",3045,169,375,132,102,95,37,18,3973
"21073070702",4118,378,285,48,203,116,27,0,5175
"21073070800",4049,694,40,18,111,42,9,6,4969
"21073071000",4235,417,141,21,394,0,59,0,5267
"21073071100",5473,386,9,15,233,12,73,30,6231
"21073071200",1667,708,77,34,139,49,42,9,2725
"21075960100",2238,381,456,302,93,13,0,0,3483
"21075960200",1277,386,222,547,56,12,93,0,2593
"21077960101",4736,884,52,34,257,119,204,169,6455
"21077960102",2061,257,10,0,20,0,55,0,2403
"21079970100",5181,940,0,0,137,0,49,143,6450
"21079970200",3067,1029,46,0,80,18,79,4,4323
"21079970300",2053,993,142,22,113,0,9,30,3362
"21079970400",2270,629,6,0,85,22,44,22,3078
"21081920100",5660,758,32,0,291,142,81,0,6964
"21081920200",5917,1249,6,0,198,227,200,125,7922
"21081920300",5154,1650,13,0,166,0,158,0,7141
"21081920400",2109,419,0,0,113,0,37,1,2679
"21083020100",2386,697,144,352,126,127,362,169,4363
"21083020200",3260,338,238,444,41,59,599,23,5002
"21083020300",4093,1763,287,86,57,80,190,178,6734
"21083020400",2617,178,16,0,174,10,117,6,3118
"21083020500",3269,671,43,2,68,7,81,2,4143
"21083020600",2190,188,19,0,37,4,23,0,2461
"21083020700",3878,489,0,41,81,12,67,0,4568
"21083020800",4848,397,0,0,100,0,0,47,5392
"21083020900",2278,397,34,0,134,0,212,125,3180
"21085950100",2125,713,0,0,41,67,15,0,2961
"21085950200",2475,625,21,0,24,0,56,0,3201
"21085950300",2380,1213,70,0,79,0,31,0,3773
"21085950400",5219,1103,48,118,173,108,12,0,6781
"21085950500",1946,363,0,0,0,0,7,0,2316
"21085950600",2910,1138,4,0,23,0,14,11,4100
"21085950700",1801,508,0,0,52,163,13,156,2693
"21087930100",2020,649,45,84,96,0,0,0,2894
"21087930200",2983,746,105,15,64,29,0,0,3942
"21087930300",1910,525,48,0,9,0,7,10,2509
"21087930400",1421,157,31,11,50,0,0,0,1670
"21089040100",3857,468,7,8,146,17,106,0,4609
"21089040201",2296,249,35,0,8,0,0,0,2588
"21089040202",3308,903,0,0,106,71,82,0,4470
"21089040300",3775,597,3,0,103,0,3,0,4481
"21089040400",4857,870,4,0,26,132,43,5,5937
"21089040501",2783,594,0,0,33,0,28,13,3451
"21089040502",3040,950,96,78,46,9,43,3,4265
"21089040600",2208,596,0,0,23,14,0,36,2877
"21089040700",2760,764,6,0,21,35,0,0,3586
"21091960100",2271,313,48,3,80,14,0,0,2729
"21091960200",2643,519,22,10,36,21,13,47,3311
"21091960300",2098,474,23,6,15,0,52,11,2679
"21093000100",640,273,0,0,33,25,37,9,1017
"21093000201",773,6,179,0,39,10,28,10,1045
"21093000202",2188,443,778,105,405,18,795,169,4901
"21093000300",2691,209,1137,156,461,28,166,0,4848
"21093000400",2501,497,585,201,398,142,463,103,4890
"21093000500",982,220,398,130,200,107,158,34,2229
"21093000600",1759,643,758,244,349,340,95,94,4282
"21093000700",2302,865,831,222,448,86,369,94,5217
"21093000800",3693,39,803,10,460,100,219,83,5407
"21093000901",8855,774,576,107,444,36,292,0,11084
"21093000902",2553,345,1134,40,698,60,244,42,5116
"21093001001",5438,839,146,97,542,101,634,33,7830
"21093001002",7333,768,182,152,378,0,105,0,8918
"21093001100",2329,282,306,280,321,238,157,61,3974
"21093001200",3990,291,511,50,667,125,208,0,5842
"21093001300",4412,282,299,39,315,20,102,0,5469
"21093001401",2668,579,253,35,246,70,30,0,3881
"21093001402",2337,948,145,88,296,170,206,115,4305
"21093001500",1045,497,458,163,113,28,43,32,2379
"21093001600",7009,1189,82,4,179,2,195,16,8676
"21093001700",6869,974,121,50,67,44,19,0,8144
"21093980100",3,0,0,0,0,0,0,0,3
"21095970100",1083,261,143,95,21,4,0,0,1607
"21095970200",1919,1278,46,9,22,3,2,3,3282
"21095970300",791,233,0,0,0,7,0,0,1031
"21095970400",864,218,7,0,19,0,5,0,1113
"21095970500",1114,268,3,8,29,0,17,3,1442
"21095970600",1896,593,0,0,47,12,0,20,2568
"21095970700",2352,1146,0,0,41,0,4,0,3543
"21095970800",851,236,24,6,38,64,0,5,1224
"21095970900",3122,1137,87,88,19,118,0,113,4684
"21095971000",2397,1746,73,61,10,112,18,45,4462
"21095971300",2061,958,0,0,0,0,0,0,3019
"21097950100",2267,549,0,0,29,154,8,140,3147
"21097950200",2209,295,0,0,25,0,0,0,2529
"21097950300",3812,1197,92,99,23,120,10,6,5359
"21097950400",1996,757,29,116,36,65,79,141,3219
"21097950500",3584,717,43,0,136,0,7,0,4487
"21099970100",1484,166,7,0,4,0,20,0,1681
"21099970200",2005,742,35,0,32,13,15,0,2842
"21099970300",3159,1113,80,106,11,31,93,34,4627
"21099970400",3032,1401,294,150,137,4,38,11,5067
"21099970500",3124,717,122,30,94,34,85,0,4206
"21101020100",891,375,121,129,59,71,8,8,1662
"21101020200",845,510,168,32,30,6,68,0,1659
"21101020300",838,439,319,135,115,79,61,32,2018
"21101020400",1132,620,374,240,46,28,116,20,2576
"21101020500",1604,411,182,72,76,107,45,0,2497
"21101020601",5189,730,103,41,330,58,259,0,6710
"21101020602",3130,792,270,228,91,276,5,62,4854
"21101020701",3999,757,29,10,180,0,17,0,4992
"21101020702",6062,498,92,75,146,40,49,0,6962
"21101020800",4035,594,1,72,21,38,173,24,4958
"21101020900",5917,997,322,48,70,94,45,2,7495
"21103090100",2039,318,30,0,10,0,7,79,2483
"21103090200",2516,762,17,28,36,49,5,52,3465
"21103090301",2443,420,107,7,83,0,24,0,3084
"21103090302",2514,654,234,73,177,125,135,136,4048
"21103090400",2268,362,31,0,11,0,18,37,2727
"21105970100",3452,545,277,99,94,31,35,10,4543
"21107970100",2790,275,36,0,29,0,14,0,3144
"21107970200",3354,213,0,5,45,0,7,7,3631
"21107970300",5174,493,418,131,73,280,166,11,6746
"21107970400",1077,256,451,261,51,117,12,57,2282
"21107970500",3822,518,55,28,28,62,157,45,4715
"21107970600",1575,805,416,212,373,34,88,100,3603
"21107970700",3689,465,80,45,186,18,22,0,4505
"21107970800",2235,407,99,11,111,25,37,6,2931
"21107970900",2553,721,294,70,62,31,15,30,3776
"21107971000",2384,320,0,0,0,0,0,0,2704
"21107971100",1974,1041,0,14,48,50,5,0,3132
"21107971300",3913,851,39,10,54,30,8,6,4911
"21109960100",3277,1982,0,0,29,4,0,0,5292
"21109960200",2108,691,0,0,0,0,16,0,2815
"21109960300",3666,1486,0,0,0,0,0,0,5152
"21111000200",1576,563,334,319,27,0,8,9,2836
"21111000300",957,387,627,361,122,14,0,0,2468
"21111000400",777,363,2842,1010,200,39,69,0,5300
"21111000600",2,26,1005,605,46,64,0,0,1748
"21111000700",264,84,1583,915,38,0,0,0,2884
"21111000800",26,9,1697,408,14,4,0,0,2158
"21111000900",33,9,1508,610,19,0,0,0,2179
"21111001000",45,62,1523,904,59,133,59,0,2785
"21111001100",39,41,2477,644,58,7,0,0,3266
"21111001200",26,26,2090,706,23,52,0,0,2923
"21111001400",32,0,1829,920,13,0,9,0,2803
"21111001500",160,0,1881,894,6,26,19,0,2986
"21111001600",100,115,1538,718,55,0,0,0,2526
"21111001700",56,31,1242,654,39,18,0,0,2040
"21111001800",17,60,953,610,0,56,34,0,1730
"21111002100",923,723,213,441,16,75,27,6,2424
"21111002300",806,699,614,382,29,60,53,3,2646
"21111002400",174,44,3167,1578,22,240,0,0,5225
"21111002700",115,214,999,1179,40,110,0,0,2657
"21111002800",144,211,822,522,36,34,0,0,1769
"21111003000",44,204,456,2457,15,154,0,23,3353
"21111003500",479,503,508,1889,31,57,0,0,3467
"21111003600",1919,942,1047,1421,81,51,171,112,5744
"21111003700",463,376,462,182,104,40,91,64,1782
"21111003800",1846,450,613,153,233,12,99,0,3406
"21111003900",1563,608,848,504,47,150,47,17,3784
"21111004000",1034,153,392,89,4,56,169,26,1923
"21111004100",1047,792,418,298,212,31,30,339,3167
"21111004301",564,438,1372,1500,447,105,46,161,4633
"21111004302",575,334,297,104,99,56,120,0,1585
"21111004400",2633,384,317,347,419,29,269,25,4423
"21111004500",2075,577,253,266,69,63,193,24,3520
"21111004600",2343,307,279,8,399,170,463,0,3969
"21111004900",651,443,335,549,67,66,56,34,2201
"21111005000",577,194,532,258,71,19,45,0,1696
"21111005100",1411,766,459,490,12,14,81,12,3245
"21111005200",2013,584,267,223,197,106,152,39,3581
"21111005300",518,285,80,100,88,13,89,0,1173
"21111005600",1457,465,566,400,875,613,526,163,5065
"21111005900",1163,603,1310,1108,82,176,31,0,4473
"21111006200",181,231,442,692,50,39,5,11,1651
"21111006300",1177,291,53,66,70,13,9,0,1679
"21111006400",1258,296,72,0,44,8,33,50,1761
"21111006500",890,438,617,1073,61,166,18,8,3271
"21111006600",970,370,161,120,50,77,23,0,1771
"21111006800",1642,235,51,74,12,6,31,0,2051
"21111006900",1624,222,134,41,25,0,36,0,2082
"21111007000",1805,309,9,5,33,0,12,0,2173
"21111007100",2229,1304,245,163,484,338,171,166,5100
"21111007400",1598,271,17,24,61,32,28,0,2031
"21111007501",4992,100,27,0,116,2,13,2,5252
"21111007502",4423,301,101,53,332,0,44,0,5254
"21111007601",1482,215,169,10,45,7,43,10,1981
"21111007602",1771,630,534,143,300,27,21,0,3426
"21111007603",1563,255,313,109,187,7,41,0,2475
"21111007700",2527,262,157,0,141,196,90,0,3373
"21111007800",2833,174,116,19,73,0,65,0,3280
"21111007900",1581,161,31,17,63,6,0,9,1868
"21111008100",2487,355,85,41,120,18,40,8,3154
"21111008200",3439,423,141,0,194,11,36,132,4376
"21111008300",2089,233,31,0,83,0,0,0,2436
"21111008400",2573,222,0,0,19,20,43,9,2886
"21111008500",1872,214,41,22,24,0,49,0,2222
"21111008700",3581,116,17,3,126,0,101,12,3956
"21111008800",2595,200,68,0,90,10,18,0,2981
"21111008900",3014,197,133,1,175,0,89,0,3609
"21111009000",3054,1072,573,194,1079,177,679,269,7097
"21111009103",841,150,189,188,192,101,11,13,1685
"21111009105",1452,769,573,177,222,352,413,122,4080
"21111009106",3596,356,615,0,423,0,166,0,5156
"21111009300",4205,394,8,51,168,23,3,0,4852
"21111009400",5352,921,17,325,147,41,94,171,7068
"21111009600",3611,554,0,0,148,88,32,0,4433
"21111009700",2304,218,57,8,72,0,48,0,2707
"21111009800",2460,88,2,0,11,8,11,8,2588
"21111009900",2357,175,96,47,99,0,37,4,2815
"21111010001",4017,191,66,0,128,0,119,0,4521
"21111010004",3042,385,239,105,108,11,138,0,4028
"21111010005",3243,402,278,4,392,31,166,60,4576
"21111010006",2628,237,402,90,162,27,171,14,3731
"21111010007",3478,124,191,0,186,5,131,5,4120
"21111010008",3098,189,292,20,164,3,108,8,3882
"21111010102",3607,62,152,0,107,4,18,0,3950
"21111010103",3288,363,390,12,304,48,217,220,4842
"21111010104",2198,132,267,58,99,100,248,102,3204
"21111010307",4825,343,376,0,374,15,243,15,6191
"21111010309",3578,103,524,14,660,17,31,0,4927
"21111010311",4414,372,1291,115,988,255,153,200,7788
"21111010312",2960,67,71,0,33,0,47,0,3178
"21111010313",3280,119,287,0,313,16,191,0,4206
"21111010314",5606,34,426,41,557,0,320,0,6984
"21111010315",2542,132,82,8,426,53,217,13,3473
"21111010316",4178,223,288,25,284,8,48,8,5062
"21111010317",4231,77,28,9,244,0,89,0,4678
"21111010318",4854,263,266,0,449,47,254,0,6133
"21111010319",3185,464,669,9,262,29,106,151,4875
"21111010320",1844,84,901,61,565,51,179,35,3720
"21111010402",5059,266,363,44,474,62,253,0,6521
"21111010403",3074,94,294,13,261,9,218,0,3963
"21111010405",3448,418,205,26,339,50,156,0,4642
"21111010406",4385,244,320,334,233,3,34,38,5591
"21111010500",3290,263,171,2,138,24,111,0,3999
"21111010601",2464,413,27,100,110,0,96,38,3248
"21111010602",3011,339,177,0,353,167,408,114,4569
"21111010701",3739,243,135,2,814,0,170,80,5183
"21111010702",3890,226,558,15,719,73,115,65,5661
"21111010705",4442,324,1068,0,355,0,180,52,6421
"21111010706",3079,105,101,0,121,38,26,38,3508
"21111010800",2485,487,410,67,154,41,93,18,3755
"21111010901",2772,404,664,438,164,183,261,197,5083
"21111010902",3379,289,228,139,387,0,179,24,4625
"21111011002",2417,575,1123,727,266,283,679,86,6156
"21111011003",4652,286,464,106,158,0,353,4,6023
"21111011004",3804,677,723,352,343,1,191,268,6359
"21111011005",1728,306,499,63,93,75,155,75,2994
"21111011102",4935,304,356,0,428,19,317,0,6359
"21111011106",5316,406,331,343,408,0,322,15,7141
"21111011109",1714,54,415,34,83,0,48,0,2348
"21111011110",4944,105,311,23,246,81,114,0,5824
"21111011111",3595,313,950,43,306,46,329,99,5681
"21111011112",2543,63,518,265,152,0,43,28,3612
"21111011113",1852,127,331,8,66,0,70,0,2454
"21111011114",3005,213,1414,117,338,34,11,0,5132
"21111011200",2391,373,937,809,361,59,450,87,5467
"21111011301",669,209,1028,253,238,16,311,101,2825
"21111011302",971,576,3301,1708,396,243,335,0,7530
"21111011403",1424,248,7,13,36,6,96,6,1836
"21111011404",1357,608,947,273,207,126,499,338,4355
"21111011405",1734,770,1709,626,825,330,1170,218,7382
"21111011406",2718,240,1196,275,191,33,656,69,5378
"21111011505",4337,534,1347,355,211,43,346,230,7403
"21111011506",4025,355,511,449,397,0,202,208,6147
"21111011508",3270,338,1119,98,196,0,187,0,5208
"21111011509",2652,316,597,83,448,140,189,17,4442
"21111011513",2999,448,341,170,244,39,143,37,4421
"21111011514",2452,128,368,39,169,103,136,0,3395
"21111011515",4211,241,525,14,313,0,133,0,5437
"21111011516",3846,379,330,0,35,0,346,0,4936
"21111011517",4351,411,689,0,238,11,301,0,6001
"21111011518",2375,19,81,0,125,0,69,0,2669
"21111011519",4000,194,543,0,345,0,71,0,5153
"21111011520",3405,122,42,0,108,0,68,0,3745
"21111011601",5364,99,451,21,298,15,63,0,6311
"21111011603",4236,135,37,0,153,9,72,0,4642
"21111011604",2444,89,8,0,27,0,85,0,2653
"21111011706",3289,104,216,9,156,36,198,0,4008
"21111011707",4016,446,600,104,76,140,81,0,5463
"21111011708",4053,257,663,11,191,0,342,73,5590
"21111011709",3658,196,200,15,23,35,57,8,4192
"21111011710",2176,328,161,156,134,0,10,9,2974
"21111011711",4633,226,464,47,132,14,234,0,5750
"21111011712",3013,426,175,73,402,0,37,13,4139
"21111011713",1868,503,171,6,233,0,29,45,2855
"21111011800",1359,240,653,142,168,43,167,55,2827
"21111011901",382,353,0,0,205,86,396,273,1695
"21111011904",1808,376,85,167,140,72,492,277,3417
"21111011905",4841,1165,424,576,737,278,330,255,8606
"21111011906",1229,696,492,817,216,90,364,496,4400
"21111011907",3598,395,263,42,128,58,101,4,4589
"21111012001",2485,606,38,0,92,6,72,6,3305
"21111012002",4478,1170,240,0,93,0,198,690,6869
"21111012003",2673,816,57,0,272,35,8,464,4325
"21111012103",2516,324,100,0,35,0,60,0,3035
"21111012104",2753,704,225,5,38,15,14,0,3754
"21111012105",3848,379,140,30,319,0,209,0,4925
"21111012106",7134,564,331,0,109,0,271,0,8409
"21111012107",4464,913,11,85,8,78,52,213,5824
"21111012202",4044,619,1309,189,363,83,360,0,6967
"21111012203",4880,460,384,20,434,32,113,16,6339
"21111012204",3124,348,164,126,50,0,82,0,3894
"21111012301",2878,199,407,69,57,88,179,67,3944
"21111012302",3319,552,576,183,362,99,171,13,5275
"21111012406",5196,405,71,23,70,0,55,37,5857
"21111012407",3715,387,621,230,105,0,83,0,5141
"21111012408",1749,119,364,12,114,0,51,0,2409
"21111012409",2488,554,308,51,120,17,205,0,3743
"21111012410",3334,266,542,46,54,0,23,0,4265
"21111012411",5475,240,967,307,106,17,65,0,7177
"21111012501",1241,390,526,237,146,5,17,144,2706
"21111012502",3533,822,306,299,0,335,14,311,5620
"21111012503",2670,364,411,358,149,21,13,0,3986
"21111012601",1590,179,3778,1190,218,9,278,0,7242
"21111012603",1055,144,892,483,180,0,12,0,2766
"21111012604",2385,201,1919,457,86,226,161,0,5435
"21111012701",1172,287,1449,349,88,6,75,0,3426
"21111012702",1194,377,250,10,57,6,10,73,1977
"21111012703",3601,1163,730,55,230,0,185,21,5985
"21111012801",128,390,1899,528,22,36,0,10,3013
"21111012802",510,354,1152,351,42,101,49,291,2850
"21111013100",1892,27,11,3,52,4,18,0,2007
"21111980100",0,0,0,0,0,0,0,0,0
"21113060101",6054,1282,197,96,85,18,112,108,7952
"21113060102",4714,1280,192,241,88,34,13,0,6562
"21113060200",3238,664,6,24,93,13,147,35,4220
"21113060300",1793,569,29,0,24,123,16,6,2560
"21113060400",5034,1269,13,25,353,144,106,0,6944
"21113060502",4710,846,432,17,93,327,69,180,6674
"21113060503",3195,953,218,48,41,169,29,209,4862
"21113060504",2261,694,81,30,49,19,103,40,3277
"21113060600",5677,275,44,0,284,30,206,40,6556
"21115960100",2306,1112,0,0,31,14,16,0,3479
"21115960200",1952,670,0,0,0,0,0,0,2622
"21115960300",2488,606,17,0,45,0,0,0,3156
"21115960400",4015,1809,0,37,37,161,0,49,6108
"21115960500",2363,476,0,0,0,0,0,0,2839
"21115960600",3397,1085,2,7,113,0,32,0,4636
"21117060300",1060,300,38,47,29,16,29,16,1535
"21117060700",1007,170,231,40,68,97,37,60,1710
"21117060900",981,747,142,172,78,265,65,233,2683
"21117061000",1006,287,229,261,31,100,4,15,1933
"21117061100",1346,173,5,21,25,0,87,0,1657
"21117061200",1825,503,6,6,72,0,51,0,2463
"21117061300",1663,319,102,38,117,16,80,8,2343
"21117061400",2862,789,108,59,48,73,43,0,3982
"21117061600",710,189,108,13,71,108,21,71,1291
"21117063603",6853,1017,120,11,595,169,472,244,9481
"21117063604",5115,542,43,0,144,70,268,0,6182
"21117063605",10217,639,182,0,417,0,151,0,11606
"21117063606",3986,234,52,0,67,0,16,0,4355
"21117063701",2947,192,0,0,79,9,139,0,3366
"21117063702",3574,597,0,0,3,13,0,0,4187
"21117063800",2386,617,58,38,54,10,32,0,3195
"21117064000",5413,401,60,0,189,38,100,33,6234
"21117064100",4643,372,14,41,373,114,50,0,5607
"21117064200",1161,93,67,0,29,0,0,0,1350
"21117064300",2655,282,32,25,72,60,73,52,3251
"21117064400",2081,717,251,136,554,74,187,60,4060
"21117064500",3278,305,14,0,30,0,12,23,3662
"21117064600",4486,355,201,87,161,334,93,181,5898
"21117064700",4820,70,0,0,338,0,0,0,5228
"21117064800",2827,201,53,0,101,26,142,0,3350
"21117064900",2160,365,7,173,250,44,164,12,3175
"21117065000",2237,798,319,51,310,225,213,115,4268
"21117065100",1091,690,346,885,0,316,21,93,3442
"21117065200",3363,266,133,0,99,61,105,2,4029
"21117065300",8336,1050,97,64,0,103,123,103,9876
"21117065400",1098,32,53,0,0,0,5,0,1188
"21117065501",4038,128,27,0,172,0,11,0,4376
"21117065502",3878,61,17,2,52,0,7,0,4017
"21117065600",4239,422,232,224,217,323,41,231,5929
"21117065700",1644,343,0,0,76,9,4,0,2076
"21117065800",2718,222,15,0,6,0,0,0,2961
"21117065900",1356,188,0,0,23,2,0,0,1569
"21117066800",7311,764,188,0,331,31,97,0,8722
"21117066900",3032,1199,40,2,11,8,27,49,4368
"21117067000",1622,442,270,133,76,9,40,0,2592
"21117067100",378,528,395,448,0,123,0,78,1950
"21119960100",1647,804,0,0,55,34,53,34,2627
"21119960200",1907,706,0,0,48,8,0,0,2669
"21119960300",2542,1194,9,7,49,0,25,10,3836
"21119960400",1658,704,0,2,2,2,0,0,2368
"21119960500",3081,736,13,87,12,24,0,0,3953
"21121930100",1048,670,0,10,0,0,5,0,1733
"21121930200",2326,1461,48,0,0,41,0,0,3876
"21121930300",1464,1356,0,0,0,0,0,0,2820
"21121930400",5173,2170,0,1,222,22,0,0,7588
"21121930500",3596,1316,0,0,0,25,0,16,4953
"21121930601",4122,1769,0,69,0,15,203,82,6260
"21121930602",1517,360,154,6,29,0,0,0,2066
"21121930700",1095,796,0,0,81,6,7,4,1989
"21123960101",1331,325,72,0,9,0,0,0,1737
"21123960102",3945,1107,273,83,371,25,292,0,6096
"21123960200",2326,183,15,0,16,0,7,0,2547
"21123960300",2946,657,19,9,56,71,44,59,3861
"21125970100",2420,507,0,0,0,7,0,7,2941
"21125970200",4432,1642,75,119,77,124,10,0,6479
"21125970300",3656,630,0,0,0,0,63,0,4349
"21125970400",2968,451,0,0,84,0,29,0,3532
"21125970500",3257,1050,17,0,10,13,0,2,4349
"21125970600",1873,904,141,26,53,63,71,206,3337
"21125970700",4442,1315,36,0,63,68,271,0,6195
"21125970800",3497,971,0,0,101,0,0,0,4569
"21125970900",2571,915,0,0,0,13,0,31,3530
"21125971001",3120,803,0,0,6,0,9,0,3938
"21125971002",4179,1639,0,0,121,12,0,0,5951
"21125971101",2132,174,0,0,101,0,81,0,2488
"21125971102",5600,2027,0,0,107,115,47,0,7896
"21127930100",5457,1283,10,0,43,0,40,9,6842
"21127930200",1159,452,0,0,34,13,0,0,1658
"21127930300",1242,342,4,0,0,18,11,21,1638
"21127930400",2068,873,0,0,0,0,19,0,2960
"21127930500",1974,509,0,0,96,58,6,0,2643
"21129950100",2255,1146,8,0,7,29,0,19,3464
"21129950200",1058,421,0,0,6,33,0,7,1525
"21129950300",890,350,0,10,29,14,0,0,1293
"21131920100",3830,993,0,46,8,16,4,0,4897
"21131920200",1747,897,0,0,0,0,0,0,2644
"21131920300",2088,1056,0,0,0,43,0,36,3223
"21133950100",1954,778,5,11,34,0,23,0,2805
"21133950200",3332,1083,8,0,14,13,18,13,4481
"21133950300",963,490,0,0,16,0,4,0,1473
"21133950401",2016,603,0,0,21,44,24,0,2708
"21133950402",2820,1888,0,9,105,0,72,0,4894
"21133950500",1349,157,0,0,32,0,11,0,1549
"21133950600",3924,1518,0,0,43,20,0,0,5505
"21135930100",2810,1266,0,0,6,22,0,2,4106
"21135930200",2509,1384,19,3,46,28,0,0,3989
"21135930300",2626,833,0,0,41,66,10,66,3642
"21135930400",1261,549,0,0,0,0,0,14,1824
"21137920101",1282,422,88,22,19,0,0,0,1833
"21137920102",3430,439,273,64,127,9,131,13,4486
"21137920103",1289,874,0,92,0,41,0,0,2296
"21137920200",4909,1134,0,2,19,0,71,0,6135
"21137920300",3516,1759,15,12,83,0,102,0,5487
"21137920400",3020,1108,71,0,10,61,7,60,4337
"21139040100",2473,387,18,0,80,71,26,2,3057
"21139040200",5291,904,0,0,48,0,61,51,6355
"21141960100",4390,659,94,8,331,11,148,31,5672
"21141960200",2736,624,18,10,28,0,55,9,3480
"21141960300",3994,977,429,106,27,0,206,52,5791
"21141960400",3894,716,172,55,74,0,34,0,4945
"21141960500",2591,874,213,405,143,13,23,13,4275
"21141960600",2064,546,119,76,54,23,79,46,3007
"21143960100",4187,614,67,36,16,58,25,0,5003
"21143960200",1698,283,0,0,54,11,6,11,2063
"21143980100",0,0,0,0,0,0,0,0,0
"21145030100",543,482,95,34,95,16,100,8,1373
"21145030200",589,459,418,262,96,68,9,32,1933
"21145030300",564,257,57,48,28,11,26,8,999
"21145030400",387,135,386,824,31,11,16,11,1801
"21145030500",530,180,378,92,34,29,0,0,1243
"21145030600",1866,706,462,288,48,133,18,31,3552
"21145030700",2049,906,575,195,243,0,52,0,4020
"21145030800",4252,266,273,0,246,0,122,0,5159
"21145030900",1819,585,523,63,88,35,89,52,3254
"21145031000",3452,654,143,122,108,17,155,0,4651
"21145031100",4767,379,126,119,135,0,89,0,5615
"21145031200",3761,550,24,63,137,9,0,6,4550
"21145031301",3745,498,245,152,98,9,152,0,4899
"21145031302",5079,292,284,37,97,43,116,20,5968
"21145031400",5135,482,65,15,410,76,250,0,6433
"21145031500",5775,856,287,0,95,23,10,0,7046
"21145031600",2527,282,12,0,104,0,104,0,3029
"21147960100",1615,885,0,0,32,0,14,0,2546
"21147960200",466,589,0,0,0,0,0,0,1055
"21147960300",3358,2559,0,0,0,0,0,0,5917
"21147960400",4129,2316,44,138,26,236,87,6,6982
"21149970100",2385,835,6,0,60,0,71,8,3365
"21149970200",2551,762,1,0,4,30,0,7,3355
"21149970500",2323,341,30,5,52,10,34,4,2799
"21151010101",1889,194,0,2,15,32,0,0,2132
"21151010102",6039,822,78,0,398,63,106,35,7541
"21151010200",2083,1391,73,189,55,42,18,14,3865
"21151010300",4275,1914,410,586,223,208,49,96,7761
"21151010400",715,419,104,101,70,32,6,0,1447
"21151010500",128,95,4,7,44,29,0,0,307
"21151010600",3788,857,153,90,16,119,37,0,5060
"21151010701",2960,973,115,191,38,14,16,15,4322
"21151010702",3155,379,153,0,86,0,146,39,3958
"21151010800",4098,607,41,0,189,45,80,44,5104
"21151010901",2998,141,28,0,52,0,134,0,3353
"21151010902",2412,324,25,0,170,0,59,0,2990
"21151010903",2630,1023,139,169,216,0,157,0,4334
"21151011000",4863,843,120,0,34,0,25,0,5885
"21151011100",5461,1156,1,0,168,15,96,0,6897
"21151011200",4171,999,153,46,0,169,28,100,5666
"21151011301",1536,668,10,22,22,31,38,145,2472
"21151011302",2602,1240,52,1,50,110,57,166,4278
"21151011400",3697,434,18,0,89,0,66,29,4333
"21153970100",1049,668,0,0,0,0,2,0,1719
"21153970200",4562,1309,0,0,0,0,43,0,5914
"21153970300",2264,997,0,0,0,0,0,0,3261
"21153970400",1261,693,0,5,9,0,0,0,1968
"21155970200",2652,764,482,252,155,4,110,0,4419
"21155970300",1655,196,49,2,136,26,68,0,2132
"21155970400",2226,679,4,3,48,0,0,3,2963
"21155970500",1518,210,0,0,0,0,0,0,1728
"21155970700",3903,978,357,336,75,0,286,0,5935
"21155970800",1524,329,0,0,42,5,0,0,1900
"21157950100",3936,613,0,12,101,54,68,11,4795
"21157950200",4200,376,0,30,68,38,54,0,4766
"21157950300",3963,322,0,0,30,0,149,0,4464
"21157950400",4550,694,0,0,38,0,0,0,5282
"21157950500",4796,553,49,0,68,1,16,10,5493
"21157950600",5368,594,0,0,51,0,68,0,6081
"21159950100",2465,948,0,0,10,23,0,0,3446
"21159950200",3787,2609,0,0,2,0,15,0,6413
"21159950300",919,316,0,0,0,0,0,0,1235
"21161960100",2486,785,25,11,65,48,8,0,3428
"21161960200",2267,585,278,250,162,6,0,6,3554
"21161960300",2770,414,336,78,100,74,46,0,3818
"21161960400",3724,635,64,0,66,38,0,0,4527
"21161960500",1449,136,88,18,2,9,0,0,1702
"21163970100",569,329,29,49,55,32,54,0,1117
"21163970200",1614,201,529,0,292,25,363,27,3051
"21163970301",2879,334,91,14,53,29,67,0,3467
"21163970302",4367,1096,52,40,171,102,22,0,5850
"21163970401",4022,1145,56,0,21,7,27,85,5363
"21163970402",6008,910,79,89,207,125,358,30,7806
"21163970500",2789,283,78,0,40,0,83,0,3273
"21163980100",11,0,0,0,0,0,0,0,11
"21165960100",2597,987,0,0,5,100,27,100,3816
"21165960200",1704,688,14,11,22,65,0,15,2519
"21167960100",3455,435,41,0,291,10,228,0,4460
"21167960200",3983,999,250,152,68,12,51,31,5546
"21167960300",2823,495,203,0,30,50,19,95,3715
"21167960400",2995,980,46,47,90,42,84,0,4284
"21167960500",2946,522,29,16,24,102,11,0,3650
"21169960100",1732,378,71,8,25,0,18,0,2232
"21169960200",2266,536,0,18,33,202,28,60,3143
"21169960300",3532,946,7,20,48,50,25,19,4647
"21171930100",1383,300,0,0,0,0,42,0,1725
"21171930200",1428,785,6,3,57,11,69,33,2392
"21171930300",1634,756,126,0,35,0,128,8,2687
"21171930400",2882,1008,80,34,51,40,0,40,4135
"21173920100",2488,572,63,8,7,0,71,33,3242
"21173920200",4431,1725,369,54,273,147,311,121,7431
"21173920301",2493,277,4,16,34,0,0,0,2824
"21173920302",4021,1764,130,60,174,12,39,0,6200
"21173920400",3217,1487,0,4,5,2,5,0,4720
"21173920500",2082,781,26,0,7,47,31,73,3047
"21175950100",1619,678,0,0,0,12,0,0,2309
"21175950200",1416,411,0,0,52,0,0,0,1879
"21175950300",1378,407,0,0,22,54,0,19,1880
"21175950400",2209,1026,48,0,78,0,50,26,3437
"21175950500",1622,645,0,0,26,16,0,0,2309
"21177960100",872,141,16,15,14,0,0,0,1058
"21177960200",4483,1369,54,709,31,108,0,24,6778
"21177960300",3562,589,0,0,19,41,5,0,4216
"21177960400",3716,634,109,139,131,55,53,25,4862
"21177960500",2628,470,55,20,74,7,22,0,3276
"21177960600",2281,535,139,0,4,14,0,0,2973
"21177960700",2718,771,33,0,17,28,6,0,3573
"21177960800",1673,231,77,0,4,0,0,0,1985
"21177960900",1319,124,0,0,89,0,0,0,1532
"21179930100",2691,431,66,12,16,108,7,37,3368
"21179930200",6616,907,125,11,135,6,0,0,7800
"21179930301",4063,511,210,1,0,348,0,348,5481
"21179930302",6046,1273,407,317,154,0,50,267,8514
"21179930303",1833,955,475,113,133,123,71,12,3715
"21179930400",2683,286,286,86,22,17,0,0,3380
"21179930500",5644,405,136,0,22,62,61,0,6330
"21179930600",2562,409,0,0,110,0,0,0,3081
"21179930700",2619,632,0,25,45,34,15,36,3406
"21181960100",1682,389,17,1,0,62,19,0,2170
"21181960200",3530,1120,71,6,0,46,0,25,4798
"21183920100",2488,593,0,0,2,38,0,90,3211
"21183920200",2727,695,6,0,216,0,216,132,3992
"21183920300",2968,855,49,15,52,0,68,59,4066
"21183920400",1297,379,0,0,0,6,0,0,1682
"21183920500",5287,1791,266,214,77,39,239,0,7913
"21183920600",1649,377,0,0,10,0,53,0,2089
"21183920700",1347,198,8,0,1,8,33,0,1595
"21185030100",1866,107,59,0,21,29,21,0,2103
"21185030200",957,79,25,3,55,2,13,0,1134
"21185030301",2142,362,34,20,377,11,312,214,3472
"21185030302",3569,779,89,0,285,304,186,306,5518
"21185030401",5676,244,262,13,362,6,33,0,6596
"21185030402",2521,56,79,51,38,33,6,0,2784
"21185030501",3496,140,56,0,349,0,158,0,4199
"21185030502",4836,82,130,0,110,15,112,0,5285
"21185030601",5378,213,394,30,322,46,229,43,6655
"21185030602",4900,226,0,0,185,0,336,0,5647
"21185030701",2285,111,0,0,114,0,28,0,2538
"21185030702",4958,338,178,27,140,0,57,0,5698
"21185030801",3969,101,109,0,263,0,112,0,4554
"21185030802",4412,75,38,0,159,0,115,0,4799
"21187970100",2636,407,67,0,85,0,76,21,3292
"21187970200",3687,734,101,0,123,19,126,0,4790
"21187970300",2093,620,0,0,18,0,41,0,2772
"21189930100",1655,845,43,7,0,101,0,0,2651
"21189930200",1091,738,0,0,11,19,0,24,1883
"21191930100",5984,573,7,41,64,70,78,0,6817
"21191930200",2295,370,15,0,29,0,14,14,2737
"21191930300",3662,1123,6,11,19,0,46,7,4874
"21193970300",2405,586,0,0,64,0,71,0,3126
"21193970400",2858,578,6,14,89,20,0,23,3588
"21193970500",3822,1438,226,0,277,0,44,0,5807
"21193970600",3483,1353,47,19,0,0,0,0,4902
"21193970700",1189,641,0,0,82,9,0,0,1921
"21193970800",1893,654,0,0,0,0,10,0,2557
"21193970900",1056,664,0,0,11,0,0,0,1731
"21193971000",2700,855,23,2,0,61,21,1,3663
"21195930100",2319,1013,0,0,5,0,0,0,3337
"21195930200",4785,898,15,17,289,10,239,7,6260
"21195930300",1493,820,116,32,91,7,7,0,2566
"21195930400",2612,707,19,16,109,0,0,44,3507
"21195930500",2327,457,52,0,25,9,54,36,2960
"21195930600",2624,688,0,31,17,0,0,0,3360
"21195930700",1921,655,0,0,17,0,17,0,2610
"21195930800",2043,899,0,0,4,17,0,0,2963
"21195930900",1286,424,6,0,13,4,0,0,1733
"21195931000",1739,376,0,0,26,0,0,0,2141
"21195931100",3965,953,0,0,19,0,0,17,4954
"21195931200",3250,861,0,0,12,0,12,0,4135
"21195931300",2290,500,0,0,0,0,0,11,2801
"21195931400",2104,504,109,0,189,15,0,0,2921
"21195931500",2785,1059,52,8,0,0,0,9,3913
"21195931600",1202,456,0,0,14,0,0,4,1676
"21195931700",3277,1119,0,0,0,0,0,0,4396
"21195931800",2288,921,0,0,0,0,0,0,3209
"21195931900",2469,775,2,2,23,3,7,0,3281
"21197970100",4184,1227,22,0,118,39,48,37,5675
"21197970200",4210,2103,0,17,135,6,68,6,6545
"21199930100",4511,1747,0,5,55,18,0,234,6570
"21199930200",3778,1337,0,5,0,0,25,21,5166
"21199930300",4221,621,0,31,20,17,0,0,4910
"21199930401",2473,826,21,0,71,0,50,0,3441
"21199930402",4516,770,62,25,47,0,0,47,5467
"21199930501",5129,921,0,21,252,5,58,17,6403
"21199930502",4059,1903,39,39,291,164,231,0,6726
"21199930600",2225,1322,118,4,66,8,125,71,3939
"21199930700",3118,1350,50,37,109,90,16,157,4927
"21199930800",3802,1974,100,2,75,137,17,157,6264
"21199930900",1637,1097,0,0,125,55,18,0,2932
"21199931000",1197,395,9,3,49,0,5,0,1658
"21199931101",2105,478,0,0,18,22,154,13,2790
"21199931102",1755,1037,0,0,8,31,0,0,2831
"21201970100",1665,462,0,0,9,11,0,0,2147
"21203950100",2511,484,0,0,34,11,5,3,3048
"21203950200",4977,1863,3,0,163,44,0,9,7059
"21203950300",3069,922,0,0,80,0,81,0,4152
"21203950400",1663,781,0,0,0,0,0,0,2444
"21205950100",4268,591,0,8,40,15,0,0,4922
"21205950200",5000,1387,21,2,192,109,41,0,6752
"21205950300",2818,2209,96,25,205,97,189,0,5639
"21205950400",2712,960,31,0,30,7,0,0,3740
"21207960101",2752,577,0,0,99,0,89,0,3517
"21207960102",3466,1168,0,0,53,238,123,81,5129
"21207960200",1266,249,0,0,22,0,10,22,1569
"21207960300",2863,1278,22,3,60,10,132,94,4462
"21207960400",2249,941,19,0,26,11,0,0,3246
"21209040100",3244,509,284,311,139,152,19,152,4810
"21209040203",4104,84,83,64,186,20,104,0,4645
"21209040204",2935,286,68,245,186,4,33,0,3757
"21209040205",2931,247,112,10,291,391,354,335,4671
"21209040206",2072,1061,308,135,154,121,80,114,4045
"21209040301",2417,155,99,0,270,41,357,58,3397
"21209040302",1457,0,8,0,20,0,3,0,1488
"21209040303",1147,61,128,14,152,13,17,26,1558
"21209040400",2700,336,36,0,48,0,73,7,3200
"21209040501",2064,397,4,2,2,5,13,5,2492
"21209040502",3846,107,66,6,70,10,36,6,4147
"21209040601",2707,98,47,0,111,0,111,0,3074
"21209040602",3752,130,46,0,203,0,74,0,4205
"21209040603",4026,224,201,93,396,0,99,0,5039
"21211040101",3401,480,0,6,21,0,0,91,3999
"21211040102",4169,502,20,0,87,0,113,5,4896
"21211040200",5276,759,354,26,379,60,308,471,7633
"21211040301",2868,1154,658,101,525,126,710,529,6671
"21211040302",2069,607,369,112,210,21,469,298,4155
"21211040401",5007,371,472,57,477,150,292,150,6976
"21211040402",3056,96,169,76,216,4,27,0,3644
"21211040501",2241,40,47,0,92,0,86,0,2506
"21211040502",4583,440,355,291,203,87,241,107,6307
"21213970100",1782,195,49,6,47,10,11,14,2114
"21213970200",3139,644,251,0,131,52,25,52,4294
"21213970300",3095,747,513,216,125,95,31,137,4959
"21213970400",4107,1225,457,273,112,10,10,48,6242
"21215080101",3607,175,113,0,29,0,42,72,4038
"21215080102",4830,381,75,0,144,0,0,0,5430
"21215080103",1654,283,0,0,92,0,0,11,2040
"21215080200",5194,622,47,5,165,0,195,0,6228
"21217920100",1764,884,0,0,0,0,22,0,2670
"21217920200",2395,348,20,156,0,0,0,0,2919
"21217920300",3614,739,70,70,18,215,20,4,4750
"21217920400",5453,1317,240,27,177,124,27,17,7382
"21217920500",4123,1488,218,42,96,248,150,165,6530
"21219950100",2571,318,0,0,0,21,24,0,2934
"21219950200",3780,702,234,157,330,3,243,3,5452
"21219950300",1613,457,344,170,60,118,47,86,2895
"21219950400",1021,146,77,27,19,158,6,80,1534
"21221970100",2069,445,128,25,0,0,13,0,2680
"21221970200",4553,1101,725,312,75,12,218,4,7000
"21221970300",3874,572,0,14,98,0,0,0,4558
"21221980100",0,4,0,12,0,3,0,0,19
"21221980200",0,0,0,0,0,0,0,0,0
"21223100100",2810,370,0,0,66,4,38,2,3290
"21223100200",4183,1112,0,0,13,0,223,0,5531
"21225950100",1091,288,24,33,14,0,0,0,1450
"21225950201",2882,1281,234,834,151,57,5,170,5614
"21225950202",2110,388,355,185,67,11,23,0,3139
"21225950300",3649,831,66,171,24,12,40,0,4793
"21227010100",778,746,40,79,21,79,34,5,1782
"21227010200",711,555,658,1087,228,373,110,104,3826
"21227010300",1316,999,279,325,448,756,296,632,5051
"21227010400",65,106,0,0,65,61,0,5,302
"21227010500",1310,827,43,15,47,48,12,35,2337
"21227010600",2440,463,284,11,186,283,50,287,4004
"21227010701",2620,536,135,434,469,540,34,84,4852
"21227010702",4512,375,550,0,305,231,224,199,6396
"21227010801",2202,111,166,0,413,99,82,116,3189
"21227010802",5876,155,45,36,239,0,109,42,6502
"21227010803",4015,1021,537,55,255,56,82,0,6021
"21227010900",2669,500,364,116,100,25,68,0,3842
"21227011001",1678,1129,338,120,492,306,230,123,4416
"21227011002",3169,810,1088,321,608,567,520,142,7225
"21227011100",4644,773,186,63,445,0,231,0,6342
"21227011200",2319,969,536,365,394,54,559,61,5257
"21227011300",2803,731,226,65,134,0,95,30,4084
"21227011401",6091,233,71,20,213,13,267,16,6924
"21227011402",2541,146,0,23,154,22,0,0,2886
"21227011500",5931,695,0,0,97,18,86,0,6827
"21227011600",4624,377,255,9,159,11,159,0,5594
"21227011700",5969,1171,612,71,239,60,237,32,8391
"21227011800",4906,488,0,0,126,34,152,0,5706
"21227011900",4950,184,480,32,63,64,35,0,5808
"21229930100",2224,431,7,3,65,112,128,112,3082
"21229930200",4781,743,512,115,71,255,8,151,6636
"21229930300",1855,354,0,16,24,5,20,0,2274
"21231920100",3753,735,322,0,70,0,55,0,4935
"21231920200",3172,1398,43,40,191,276,157,343,5620
"21231920300",2953,1241,0,16,35,16,23,0,4284
"21231920400",2247,1236,0,0,6,0,0,0,3489
"21231920700",1969,519,0,0,17,0,18,0,2523
"21233960100",3430,514,5,0,137,73,267,206,4632
"21233960200",2128,260,25,2,54,0,25,4,2498
"21233960300",1777,416,0,0,3,9,26,5,2236
"21233960400",2729,776,310,185,125,61,59,8,4253
"21235920100",1896,616,2,3,55,0,34,0,2606
"21235920200",2094,546,0,0,207,12,137,58,3054
"21235920300",4607,1803,55,1,92,110,0,63,6731
"21235920400",4059,1139,0,0,50,28,0,0,5276
"21235920500",5175,1280,8,0,27,0,0,0,6490
"21235920600",3071,1276,47,20,62,0,0,20,4496
"21235920700",2477,1380,0,55,59,46,14,0,4031
"21235920800",1162,541,0,15,28,0,0,0,1746
"21237930100",2122,1299,0,0,14,26,24,0,3485
"21237930200",1909,1724,0,0,11,9,0,0,3653
"21239050103",1618,654,301,55,323,70,189,331,3541
"21239050104",3167,332,135,38,36,33,27,12,3780
"21239050105",2810,237,12,37,146,7,186,0,3435
"21239050106",3031,135,113,2,21,2,0,0,3304
"21239050107",2640,678,319,37,156,5,279,146,4260
"21239050200",3134,236,22,0,127,279,0,279,4077
"21239050300",1747,153,31,0,6,0,18,0,1955
"21239050400",1661,229,52,4,87,36,81,94,2244
"22001960100",3081,982,834,818,127,37,127,70,6076
"22001960200",5321,238,41,166,93,0,0,0,5859
"22001960300",3007,347,176,0,88,0,21,0,3639
"22001960400",5468,803,104,74,121,21,0,24,6615
"22001960500",4818,863,322,141,185,147,52,15,6543
"22001960600",3957,517,1002,237,224,8,126,7,6078
"22001960700",1905,455,1040,696,147,20,9,6,4278
"22001960800",2859,745,209,411,178,89,26,0,4517
"22001960900",1359,189,1604,1348,135,114,26,0,4775
"22001961000",2472,1563,328,524,101,89,370,194,5641
"22001961100",3170,453,143,48,43,62,95,15,4029
"22001961200",3318,334,194,0,60,0,7,0,3913
"22003950100",3983,865,2,15,58,18,7,0,4948
"22003950200",2046,533,232,176,61,67,0,32,3147
"22003950300",1247,361,567,140,137,107,16,59,2634
"22003950400",3108,287,348,251,305,30,34,0,4363
"22003950500",4253,264,957,154,464,233,66,7,6398
"22005030101",5864,753,564,372,67,80,284,157,8141
"22005030102",4210,544,193,70,10,0,131,329,5487
"22005030103",5521,506,0,38,17,14,249,0,6345
"22005030203",9499,380,1070,0,528,151,163,0,11791
"22005030204",9464,544,1440,341,377,213,474,10,12863
"22005030205",7620,494,1644,91,709,118,417,0,11093
"22005030206",7241,446,1224,128,337,135,759,109,10379
"22005030300",8907,817,3214,199,496,25,793,0,14451
"22005030401",2845,431,1168,153,55,38,271,172,5133
"22005030402",2920,323,2441,1224,150,0,395,2,7455
"22005030500",7549,773,550,20,422,133,88,159,9694
"22005030600",3236,367,946,558,103,127,264,207,5808
"22005030900",1491,203,1456,909,7,9,248,0,4323
"22005031000",1566,150,3130,1570,0,0,0,0,6416
"22007050100",1724,128,1557,374,39,0,96,44,3962
"22007050200",4543,548,0,0,84,28,0,0,5203
"22007050300",1630,156,1228,442,4,3,0,0,3463
"22007050400",1929,169,726,315,8,49,27,0,3223
"22007050500",995,177,1130,524,131,0,165,0,3122
"22007050600",2998,556,302,169,135,5,149,56,4370
"22009030100",1749,600,49,108,37,15,9,0,2567
"22009030200",2418,259,0,0,23,0,6,0,2706
"22009030300",2356,471,317,217,66,16,77,12,3532
"22009030400",2895,883,1345,983,395,85,14,19,6619
"22009030500",4354,505,937,581,208,74,195,32,6886
"22009030600",1788,450,1840,853,0,6,34,13,4984
"22009030700",3189,606,938,640,220,13,81,90,5777
"22009030800",2151,400,0,3,25,28,30,28,2665
"22009030900",1051,293,638,649,3,12,0,0,2646
"22011960100",4684,1269,22,0,304,0,0,0,6279
"22011960200",3449,438,175,19,92,68,103,67,4411
"22011960300",1723,307,1147,813,305,56,226,25,4602
"22011960400",1560,340,748,446,64,60,58,110,3386
"22011960500",3026,1038,631,61,214,117,161,246,5494
"22011960600",2332,388,156,123,312,8,87,150,3556
"22011960700",7180,1586,0,0,47,0,0,0,8813
"22013970100",958,202,915,1166,122,18,54,0,3435
"22013970200",514,55,768,293,6,30,0,0,1666
"22013970300",1385,236,845,669,2,87,9,76,3309
"22013970400",1853,445,117,57,9,45,71,0,2597
"22013970500",1693,232,675,213,18,6,4,9,2850
"22015010400",292,196,558,529,28,24,65,64,1756
"22015010500",2672,283,734,647,99,34,168,54,4691
"22015010601",2146,968,2524,1231,683,99,592,459,8702
"22015010602",1466,384,628,430,181,1,174,119,3383
"22015010701",1710,508,857,380,281,216,215,114,4281
"22015010702",1736,112,1288,547,282,155,493,166,4779
"22015010801",1181,541,548,259,300,82,392,355,3658
"22015010804",5358,239,1286,60,769,0,291,0,8003
"22015010805",1506,376,429,181,282,48,181,8,3011
"22015010806",3500,243,260,67,241,51,100,13,4475
"22015010900",2012,18,393,6,264,75,131,0,2899
"22015011001",6097,361,967,173,212,62,377,37,8286
"22015011002",4001,294,360,56,70,0,112,14,4907
"22015011103",5942,432,417,283,142,0,271,0,7487
"22015011105",5418,547,553,2,556,156,632,326,8190
"22015011106",6121,1130,1391,119,205,26,318,53,9363
"22015011107",819,115,597,358,74,18,45,20,2046
"22015011108",10695,502,931,165,1142,0,638,0,14073
"22015011109",6114,302,668,268,425,0,223,0,8000
"22015011110",6522,671,773,159,209,105,302,0,8741
"22015011200",3083,646,1465,525,66,12,58,7,5862
"22015011300",281,68,801,740,58,18,114,12,2092
"22017020500",114,0,1585,932,18,11,40,29,2729
"22017020600",24,3,494,356,22,0,0,0,899
"22017020700",0,0,692,232,4,6,0,0,934
"22017021000",776,252,177,458,76,24,106,0,1869
"22017021100",536,282,888,624,21,23,35,20,2429
"22017021200",1741,614,443,225,119,10,53,38,3243
"22017021300",196,82,1057,954,172,21,148,0,2630
"22017021400",1223,192,647,87,206,17,213,17,2602
"22017021500",1734,257,169,64,68,0,112,14,2418
"22017021600",2821,254,122,175,112,16,140,0,3640
"22017021700",171,40,650,615,73,37,27,0,1613
"22017021800",53,2,695,656,13,0,0,0,1419
"22017021900",55,11,1144,311,37,0,37,0,1595
"22017022000",8,0,1245,728,22,12,0,0,2015
"22017022100",41,34,3613,2173,53,0,30,0,5944
"22017022200",375,16,2972,2034,35,15,0,0,5447
"22017022300",110,22,1164,1189,7,0,45,9,2546
"22017022400",331,70,1828,1227,86,18,0,0,3560
"22017022500",483,31,2960,1486,138,74,135,23,5330
"22017022600",2934,81,136,17,87,0,77,0,3332
"22017022700",2216,159,15,0,8,0,19,38,2455
"22017022800",3861,283,59,4,98,45,38,52,4440
"22017022900",3399,471,442,305,415,46,194,70,5342
"22017023000",3786,186,661,6,239,33,81,33,5025
"22017023100",1138,21,275,71,16,0,0,8,1529
"22017023200",205,76,801,370,51,30,0,0,1533
"22017023300",70,116,1430,871,0,8,6,16,2517
"22017023400",542,73,4004,2415,201,12,100,0,7347
"22017023500",0,0,2426,1447,22,0,0,0,3895
"22017023600",29,0,1738,1310,0,9,12,6,3104
"22017023700",465,73,3265,2449,65,0,23,0,6340
"22017023800",1488,266,2756,881,279,0,462,149,6281
"22017023901",4267,299,1296,72,413,0,79,0,6426
"22017023903",2582,415,511,265,235,86,51,188,4333
"22017023904",1781,318,493,170,221,42,57,45,3127
"22017023905",2874,473,583,107,715,59,58,20,4889
"22017024000",9844,357,667,0,682,0,400,0,11950
"22017024102",2480,131,864,291,297,0,224,11,4298
"22017024104",2030,352,2748,1501,253,147,286,0,7317
"22017024106",2918,240,3537,752,120,68,223,79,7937
"22017024107",2232,324,2520,221,218,7,20,0,5542
"22017024108",3767,259,1984,651,0,163,0,0,6824
"22017024109",2835,88,448,440,54,0,114,17,3996
"22017024201",941,119,2492,363,90,6,22,25,4058
"22017024202",4946,232,1177,325,187,7,41,0,6915
"22017024203",2868,749,575,40,193,19,72,0,4516
"22017024301",1479,92,4639,720,290,189,245,166,7820
"22017024303",2005,204,2754,511,102,98,206,0,5880
"22017024304",2560,344,1422,221,139,36,112,26,4860
"22017024400",1813,154,2205,369,405,21,384,0,5351
"22017024503",2598,340,1397,368,234,25,160,74,5196
"22017024504",4690,1011,299,177,234,9,112,0,6532
"22017024601",211,101,1836,2558,24,0,10,52,4792
"22017024602",28,33,1979,2146,7,42,12,42,4289
"22017024700",1184,94,397,119,61,107,18,0,1980
"22017024800",694,23,219,52,44,21,16,17,1086
"22017024900",2642,429,236,191,52,16,22,20,3608
"22017025000",1746,708,717,271,250,47,106,32,3877
"22017025100",979,159,254,251,133,58,18,2,1854
"22017025200",79,10,533,295,0,0,0,0,917
"22017025300",226,331,326,485,9,26,0,17,1420
"22017025405",2983,354,501,192,112,5,162,4,4313
"22017025406",3336,417,415,35,308,23,77,0,4611
"22017980000",0,0,0,0,0,0,0,0,0
"22019000100",983,276,480,357,0,6,42,0,2144
"22019000200",93,14,830,633,37,54,19,0,1680
"22019000300",149,9,874,894,7,27,137,27,2124
"22019000400",1,5,662,603,26,0,12,0,1309
"22019000500",2341,217,468,216,61,37,62,86,3488
"22019000600",409,184,4045,2014,327,33,131,25,7168
"22019000700",1507,440,1354,1164,142,70,419,0,5096
"22019000800",1276,320,624,664,131,20,98,0,3133
"22019000900",849,21,2650,190,115,0,52,0,3877
"22019001000",2960,414,81,44,234,0,24,16,3773
"22019001100",1733,668,541,517,268,197,51,68,4043
"22019001201",1181,275,2041,729,237,197,129,0,4789
"22019001202",412,134,1566,1062,24,153,171,32,3554
"22019001300",4952,496,539,101,215,39,340,0,6682
"22019001400",447,70,3488,1235,23,59,9,0,5331
"22019001500",9,41,974,574,11,93,0,0,1702
"22019001600",267,170,1569,944,85,11,14,37,3097
"22019001700",4956,867,2111,190,514,72,185,37,8932
"22019001801",8440,596,598,198,411,164,379,4,10790
"22019001901",2973,322,100,0,50,0,60,0,3505
"22019001903",4548,395,717,71,829,138,0,63,6761
"22019001904",4248,215,185,32,504,0,88,0,5272
"22019002000",6527,1090,1229,0,114,72,135,0,9167
"22019002100",1623,405,633,384,112,0,28,0,3185
"22019002201",7286,313,171,10,74,0,71,18,7943
"22019002203",5178,342,1168,0,355,99,338,99,7579
"22019002204",4735,177,292,27,222,0,11,0,5464
"22019002300",2421,138,31,0,0,0,203,0,2793
"22019002400",4190,837,635,31,179,49,13,27,5961
"22019002500",3435,249,103,48,64,8,26,0,3933
"22019002600",3197,546,875,96,63,99,44,13,4933
"22019002700",5962,1014,524,121,226,18,82,0,7947
"22019002800",2919,1217,186,132,23,17,238,221,4953
"22019002900",1677,313,103,12,11,11,211,7,2345
"22019003000",3687,663,105,51,97,0,19,13,4635
"22019003101",4563,424,32,1,98,0,60,0,5178
"22019003102",2045,53,72,116,98,0,83,0,2467
"22019003200",2033,234,34,92,33,0,69,17,2512
"22019003300",3769,792,159,170,132,0,129,0,5151
"22019003400",4388,489,0,0,15,122,77,56,5147
"22019003500",2188,611,357,364,24,0,266,43,3853
"22019003600",3168,783,57,63,81,10,77,0,4239
"22019980000",0,0,0,0,0,0,0,0,0
"22019980100",0,0,0,0,0,0,0,0,0
"22021000100",1696,538,46,47,22,0,29,36,2414
"22021000200",1812,447,528,155,60,18,42,73,3135
"22021000300",2914,500,361,348,7,0,46,24,4200
"22023970100",4197,363,141,66,22,128,72,129,5118
"22023970201",1660,93,0,0,10,0,81,0,1844
"22023990000",0,0,0,0,0,0,0,0,0
"22025000100",2453,312,414,354,13,22,9,39,3616
"22025000200",782,214,969,679,24,5,31,3,2707
"22025000300",2480,266,207,7,28,31,17,5,3041
"22027950100",1953,201,730,704,122,0,53,0,3763
"22027950200",1153,120,681,282,5,47,0,54,2342
"22027950300",986,140,768,693,71,17,0,21,2696
"22027950400",883,119,1076,1173,11,86,0,0,3348
"22027950500",1342,138,700,326,134,12,28,36,2716
"22029000100",1122,227,545,335,13,0,0,0,2242
"22029000200",1176,165,1685,2360,25,0,0,0,5411
"22029000300",2121,627,382,381,47,11,40,6,3615
"22029000400",2727,425,712,578,16,16,32,90,4596
"22029000500",2126,353,39,120,0,0,22,0,2660
"22031950100",6240,1112,1342,508,333,122,162,144,9963
"22031950200",2436,629,466,353,215,91,187,116,4493
"22031950300",1109,179,640,525,50,22,26,0,2551
"22031950400",852,123,992,653,42,73,53,0,2788
"22031950500",434,162,871,671,0,10,0,12,2160
"22031950600",322,33,1149,1402,28,0,13,0,2947
"22031950700",1789,179,280,186,44,26,8,0,2512
"22033000100",54,7,1141,494,0,7,0,0,1703
"22033000200",231,115,3407,2391,24,32,0,0,6200
"22033000300",80,0,922,704,16,9,0,0,1731
"22033000400",188,2,1879,1074,48,0,0,0,3191
"22033000500",39,13,2278,1712,1,4,2,7,4056
"22033000601",85,38,2134,974,0,0,0,0,3231
"22033000602",25,0,3498,1636,0,0,0,0,5159
"22033000701",177,43,1231,754,111,34,184,27,2561
"22033000702",64,38,1700,1134,32,0,27,0,2995
"22033000900",51,26,2899,1071,25,89,16,0,4177
"22033001000",0,1,2343,1542,17,1,0,0,3904
"22033001102",259,49,1984,609,115,34,0,17,3067
"22033001103",396,9,1353,1275,0,0,8,0,3041
"22033001104",161,59,1930,1833,90,44,36,48,4201
"22033001600",1642,187,1052,332,153,23,69,9,3467
"22033001700",3581,145,826,473,185,7,54,0,5271
"22033001800",1454,358,602,156,99,96,318,146,3229
"22033001900",2026,39,39,12,70,16,25,9,2236
"22033002000",2530,61,562,0,421,102,95,0,3771
"22033002200",163,64,650,338,86,10,15,9,1335
"22033002300",2335,97,150,0,107,7,122,0,2818
"22033002400",379,333,741,630,225,34,193,111,2646
"22033002500",536,732,1255,640,101,145,12,14,3435
"22033002601",2625,452,143,15,160,62,44,0,3501
"22033002602",2672,270,621,56,75,7,45,0,3746
"22033002700",550,6,792,182,18,0,11,0,1559
"22033002801",325,503,273,173,636,429,88,104,2531
"22033002802",268,369,62,42,44,112,28,41,966
"22033003000",0,41,1879,1130,0,0,0,41,3091
"22033003101",36,0,2791,1590,0,12,0,0,4429
"22033003103",0,0,665,545,0,0,0,0,1210
"22033003201",746,84,2277,687,24,0,56,0,3874
"22033003202",1154,42,1987,134,44,0,20,0,3381
"22033003300",12,27,3308,1612,56,0,0,0,5015
"22033003400",121,38,3751,1526,147,84,11,72,5750
"22033003501",688,420,1952,135,181,42,572,278,4268
"22033003504",221,14,4462,1184,70,0,0,0,5951
"22033003505",578,157,2452,751,18,3,293,48,4300
"22033003506",518,6,5751,1236,198,78,31,78,7896
"22033003507",637,134,3808,427,193,123,0,0,5322
"22033003601",904,126,2085,259,513,0,255,38,4180
"22033003603",597,153,936,860,36,79,136,47,2844
"22033003604",733,137,3059,1697,189,397,277,145,6634
"22033003701",3681,261,691,215,518,0,413,141,5920
"22033003702",1965,81,1042,183,201,47,58,0,3577
"22033003703",3363,51,1762,192,935,29,118,0,6450
"22033003801",3718,527,1648,339,479,6,210,105,7032
"22033003802",3419,351,986,41,145,0,127,0,5069
"22033003804",3376,392,312,52,475,0,216,0,4823
"22033003805",5267,342,598,462,258,42,126,0,7095
"22033003904",2620,178,2119,1340,356,132,107,0,6852
"22033003906",6258,142,1709,66,710,9,228,90,9212
"22033003907",3540,119,1381,216,512,131,160,0,6059
"22033003908",2239,164,1083,32,134,4,74,0,3730
"22033003909",1910,218,1397,1279,585,27,299,36,5751
"22033003910",768,567,678,414,306,49,351,533,3666
"22033004005",2740,329,2854,158,620,22,211,54,6988
"22033004006",5972,579,1002,422,495,0,228,169,8867
"22033004009",4464,273,2024,544,1077,0,420,12,8814
"22033004010",4048,94,398,211,374,30,254,40,5449
"22033004011",2182,1186,1549,868,629,283,1130,473,8300
"22033004013",1360,875,531,572,473,217,59,47,4134
"22033004014",4232,5194,1017,549,98,213,23,235,11561
"22033004015",2197,372,2534,1628,451,222,793,212,8409
"22033004016",5850,197,544,129,570,33,124,0,7447
"22033004201",595,159,3819,1302,160,2,43,59,6139
"22033004203",471,201,1771,539,18,0,25,0,3025
"22033004204",737,338,2660,791,148,14,165,247,5100
"22033004205",944,35,3387,1290,91,8,89,18,5862
"22033004301",4933,175,983,67,223,0,124,0,6505
"22033004302",4558,355,42,1,51,23,147,0,5177
"22033004401",3808,170,761,25,196,0,114,0,5074
"22033004402",5373,357,322,331,178,0,0,0,6561
"22033004403",4390,355,492,423,46,39,27,0,5772
"22033004503",2436,174,3032,447,13,224,809,297,7432
"22033004504",3150,347,1445,242,533,112,194,233,6256
"22033004505",3993,120,2019,1031,744,73,271,40,8291
"22033004507",3586,70,1038,87,269,47,146,0,5243
"22033004508",6608,154,581,0,251,342,110,0,8046
"22033004509",3770,99,1638,518,522,41,85,16,6689
"22033004510",6082,169,1026,27,499,0,140,0,7943
"22033004602",2685,244,2483,279,34,19,55,0,5799
"22033004603",2264,110,1851,370,103,12,98,0,4808
"22033004604",6951,543,3570,346,217,267,84,12,11990
"22033004700",4094,320,1398,1178,51,66,287,0,7394
"22033004800",1738,990,73,56,458,158,26,37,3536
"22033004900",3791,302,116,39,202,0,242,9,4701
"22033005000",2605,274,261,9,169,0,91,0,3409
"22033005100",830,209,1128,600,39,91,62,0,2959
"22033005200",330,86,908,646,23,0,0,0,1993
"22033005300",514,262,906,969,129,43,23,28,2874
"22033980000",0,0,0,0,0,0,0,0,0
"22035000100",844,78,373,944,0,32,0,0,2271
"22035000200",719,108,178,138,29,8,0,8,1188
"22035000300",23,4,961,1581,21,10,33,10,2643
"22037951300",1098,142,1413,374,0,0,12,0,3039
"22037951400",1310,160,648,848,19,5,10,0,3000
"22037951501",1059,17,296,18,26,49,14,0,1479
"22037951502",2295,446,1510,422,37,16,63,4,4793
"22037951600",2808,450,1248,370,37,0,56,16,4985
"22039950100",4135,830,245,74,75,18,52,2,5431
"22039950200",1372,510,65,0,7,11,0,0,1965
"22039950300",2634,729,548,195,30,126,9,55,4326
"22039950400",3742,891,361,826,98,4,86,13,6021
"22039950500",921,122,871,1376,54,6,0,0,3350
"22039950600",735,250,931,1033,0,22,42,15,3028
"22039950700",3058,94,212,167,33,0,0,0,3564
"22039950800",2250,299,685,787,34,3,0,25,4083
"22041950100",2717,615,451,266,9,0,10,0,4068
"22041950200",2249,328,430,285,0,5,0,0,3297
"22041950300",1245,681,1313,1786,0,194,0,0,5219
"22041950400",2049,538,56,89,0,0,0,12,2744
"22041950500",1127,317,24,3,4,0,0,0,1475
"22041950600",1049,170,491,570,0,0,2,3,2285
"22043020100",2092,348,12,5,79,16,36,6,2594
"22043020200",2155,383,144,55,66,22,0,0,2825
"22043020300",926,211,755,463,62,17,26,56,2516
"22043020401",4908,1070,60,26,78,1,169,101,6413
"22043020402",3897,706,9,20,190,117,69,0,5008
"22045030100",3179,415,2022,1236,115,0,57,0,7024
"22045030200",4983,351,1077,197,256,6,139,8,7017
"22045030301",2281,495,572,17,302,13,18,0,3698
"22045030302",4383,752,245,223,665,284,477,98,7127
"22045030400",3700,801,1419,936,326,426,137,0,7745
"22045030500",2825,314,565,344,234,121,177,64,4644
"22045030600",5284,172,663,61,240,0,204,0,6624
"22045030700",3122,261,354,124,141,57,145,7,4211
"22045030800",46,53,1636,691,38,12,0,0,2476
"22045030900",1047,178,831,1110,167,149,263,22,3767
"22045031000",439,105,1842,902,100,44,0,27,3459
"22045031100",2115,333,1131,686,134,82,155,171,4807
"22045031200",1743,513,664,111,91,70,195,59,3446
"22045031300",4033,595,1130,252,117,143,185,43,6498
"22045031600",887,58,1275,532,176,52,74,0,3054
"22045990000",0,0,0,0,0,0,0,0,0
"22047952600",855,86,1419,424,2,7,49,0,2842
"22047952700",3515,310,2327,92,188,31,189,0,6652
"22047952900",3032,585,1494,475,128,0,129,58,5901
"22047953000",1125,70,344,533,28,4,16,10,2130
"22047953101",1996,260,1888,1316,51,0,145,29,5685
"22047953102",971,101,1046,309,11,0,10,0,2448
"22047953200",1940,302,1284,702,122,5,45,52,4452
"22049970100",1456,484,874,179,67,0,28,115,3203
"22049970200",2369,138,393,445,21,10,40,0,3416
"22049970300",2609,383,67,113,57,139,40,0,3408
"22049970400",840,618,876,972,0,0,0,0,3306
"22049970500",1227,356,184,144,0,0,0,0,1911
"22051020101",2444,222,44,128,130,1,486,128,3583
"22051020102",2480,246,23,7,147,0,114,0,3017
"22051020201",1612,424,221,74,235,113,279,212,3170
"22051020202",1124,364,685,277,369,127,642,314,3902
"22051020203",6007,280,156,2,288,486,1235,364,8818
"22051020301",3021,47,122,2,144,250,97,0,3683
"22051020302",4844,223,27,123,764,13,1239,102,7335
"22051020303",3168,208,0,3,385,82,370,39,4255
"22051020400",2851,66,6,1,194,0,229,10,3357
"22051020502",4509,670,608,227,382,114,2168,89,8767
"22051020505",239,37,1158,334,6,0,237,32,2043
"22051020506",3159,390,1,196,288,86,1070,295,5485
"22051020507",3094,377,220,0,458,29,835,184,5197
"22051020508",5029,380,1228,65,875,32,1759,275,9643
"22051020511",2735,303,332,264,373,51,486,81,4625
"22051020512",1998,151,61,48,174,18,725,46,3221
"22051020513",3083,120,791,571,735,183,1084,117,6684
"22051020514",3381,142,0,0,485,0,386,0,4394
"22051020515",2176,244,390,44,266,52,755,118,4045
"22051020516",2180,461,1184,414,349,270,1316,682,6856
"22051020517",3132,48,188,0,342,0,441,8,4159
"22051020600",456,120,2351,1376,23,76,201,141,4744
"22051020700",247,93,274,121,43,79,18,93,968
"22051021000",1297,255,601,245,149,100,397,118,3162
"22051021100",1572,211,181,19,209,28,573,102,2895
"22051021200",1272,315,245,114,266,24,335,122,2693
"22051021300",2192,168,307,0,217,21,366,0,3271
"22051021400",1819,173,85,29,205,13,74,21,2419
"22051021500",960,379,473,409,231,94,409,184,3139
"22051021600",4630,696,432,55,399,301,1217,655,8385
"22051021700",4036,367,487,40,475,91,932,72,6500
"22051021801",1667,192,96,73,194,32,335,107,2696
"22051021803",1170,1226,1010,838,379,310,697,933,6563
"22051021804",651,614,220,172,98,61,430,342,2588
"22051021900",921,218,224,89,429,20,263,139,2303
"22051022001",1623,645,1597,438,1114,11,410,242,6080
"22051022002",2520,84,79,2,106,1,57,1,2850
"22051022101",1317,34,0,2,83,0,3,0,1439
"22051022102",1875,242,155,196,52,9,92,35,2656
"22051022200",1810,242,29,0,30,0,59,0,2170
"22051022301",2434,240,0,16,140,12,489,11,3342
"22051022302",1235,145,79,31,82,0,93,16,1681
"22051022303",2095,686,274,69,410,105,687,465,4791
"22051022400",3191,174,57,0,46,21,182,0,3671
"22051022500",2271,196,73,0,11,2,208,7,2768
"22051022600",2841,216,10,61,87,0,118,0,3333
"22051022700",2380,200,0,0,22,50,44,75,2771
"22051022800",2424,287,0,1,139,38,410,10,3309
"22051022900",2035,539,162,9,113,0,253,215,3326
"22051023001",1527,62,50,0,103,0,150,0,1892
"22051023002",4223,450,113,2,62,39,446,86,5421
"22051023003",2537,146,43,38,56,0,219,0,3039
"22051023100",1972,522,9,21,98,0,226,73,2921
"22051023200",1994,462,75,7,89,53,137,163,2980
"22051023300",1305,176,28,16,62,0,109,28,1724
"22051023400",2872,243,66,0,136,25,186,136,3664
"22051023500",3641,116,156,24,238,6,420,80,4681
"22051023600",3667,377,571,200,229,19,571,229,5863
"22051023700",0,55,1416,533,12,6,0,55,2077
"22051023800",2091,177,1077,223,100,16,214,7,3905
"22051023901",2277,177,9,0,26,0,154,6,2649
"22051023902",1943,117,59,0,187,0,141,10,2457
"22051023903",2209,101,0,5,10,0,125,0,2450
"22051023904",2565,122,111,0,34,0,354,0,3186
"22051024001",2518,191,0,0,23,0,42,0,2774
"22051024002",2732,335,0,2,119,9,26,0,3223
"22051024100",2605,312,92,95,96,0,190,40,3430
"22051024201",1576,156,175,27,226,8,260,8,2436
"22051024202",1809,128,637,69,462,16,276,24,3421
"22051024300",2202,384,174,14,23,24,308,161,3290
"22051024400",1836,369,540,104,63,79,81,115,3187
"22051024500",1165,182,6,18,86,0,57,0,1514
"22051024600",165,56,576,229,146,56,178,56,1462
"22051024700",834,142,430,50,143,33,281,48,1961
"22051024800",3160,398,15,0,96,0,139,46,3854
"22051024900",950,209,295,47,52,22,183,126,1884
"22051025001",1663,646,2898,1547,1360,211,547,230,9102
"22051025002",1521,260,543,329,696,0,708,151,4208
"22051025003",1850,73,656,255,757,185,1019,231,5026
"22051025102",2458,354,875,78,469,10,273,0,4517
"22051025103",1375,135,1307,333,705,218,533,70,4676
"22051025104",1629,351,1531,197,494,0,747,0,4949
"22051025201",865,154,581,540,527,46,724,124,3561
"22051025202",2505,489,1063,1131,1230,155,1374,299,8246
"22051025300",1484,108,53,76,268,14,344,26,2373
"22051025400",1501,231,1436,331,632,129,995,69,5324
"22051025500",664,232,960,697,369,157,317,209,3605
"22051025600",970,132,137,251,84,63,112,43,1792
"22051025700",75,112,580,244,121,27,13,22,1194
"22051025800",746,124,525,293,14,5,22,21,1750
"22051025900",1334,220,341,402,49,11,81,44,2482
"22051026000",1042,358,187,61,98,35,172,27,1980
"22051026100",1244,500,1208,808,166,222,444,398,4990
"22051026200",37,0,703,488,0,14,4,3,1249
"22051026300",2095,245,248,29,40,37,41,0,2735
"22051026400",1364,82,122,0,100,74,92,0,1834
"22051026500",1132,196,169,79,170,4,106,25,1881
"22051026600",1548,142,86,5,154,70,213,45,2263
"22051026700",907,289,473,96,79,37,56,95,2032
"22051026800",317,110,1236,815,7,164,18,233,2900
"22051026900",32,61,1975,775,42,6,23,0,2914
"22051027000",2014,453,1103,779,801,0,43,0,5193
"22051027100",1804,490,481,17,140,43,78,64,3117
"22051027200",2830,604,678,669,135,57,100,86,5159
"22051027501",2091,217,2406,1114,136,76,29,0,6069
"22051027502",0,0,2704,617,11,0,0,0,3332
"22051027601",2094,463,993,835,549,325,130,96,5485
"22051027602",497,242,1637,541,301,140,248,139,3745
"22051027701",112,46,3758,1955,23,13,15,76,5998
"22051027703",1205,313,1360,911,196,137,298,161,4581
"22051027803",608,347,1347,328,274,205,428,354,3891
"22051027804",3199,98,3432,223,1081,48,835,98,9014
"22051027805",1780,226,4087,390,1863,203,958,53,9560
"22051027806",4190,587,900,296,500,115,575,148,7311
"22051027807",5381,342,2152,0,910,27,879,40,9731
"22051027809",2978,1061,1765,66,568,13,376,51,6878
"22051027810",725,15,2838,411,490,71,338,0,4888
"22051027811",258,100,2324,346,192,55,29,55,3359
"22051027812",331,105,2061,1642,106,27,72,8,4352
"22051027901",2072,392,17,4,364,33,60,18,2960
"22051027902",1438,423,0,0,0,0,0,8,1869
"22051028000",2874,430,807,155,545,14,137,90,5052
"22051028100",201,43,1191,723,44,18,18,0,2238
"22051028200",1518,474,1155,537,386,60,473,141,4744
"22051980000",0,0,0,0,0,0,0,0,0
"22051990000",0,0,0,0,0,0,0,0,0
"22051990100",0,0,0,0,0,0,0,0,0
"22053000100",3323,641,763,247,222,72,196,24,5488
"22053000200",3513,763,246,21,46,30,43,0,4662
"22053000300",3133,730,675,323,191,0,90,77,5219
"22053000400",4216,1035,241,290,191,0,88,32,6093
"22053000500",3280,711,215,189,82,38,4,4,4523
"22053000600",1568,495,671,499,18,7,18,74,3350
"22053000700",1039,77,548,293,46,1,8,0,2012
"22055000100",987,318,369,404,15,28,5,41,2167
"22055000200",401,102,1244,506,0,3,96,43,2395
"22055000500",2020,413,33,45,87,2,259,0,2859
"22055000602",2386,706,780,576,131,95,42,23,4739
"22055000603",1621,498,551,40,76,0,466,220,3472
"22055000604",4197,1203,1280,94,270,85,195,162,7486
"22055000700",317,136,1103,1168,264,79,294,63,3424
"22055000800",107,66,2057,993,9,10,25,11,3278
"22055000900",0,52,973,536,3,0,0,0,1564
"22055001001",2344,433,1531,826,279,174,238,61,5886
"22055001002",1098,108,1289,504,209,37,145,19,3409
"22055001003",1874,111,1623,134,43,5,68,12,3870
"22055001100",1027,475,2690,2680,178,3,172,0,7225
"22055001200",1076,224,4511,1120,42,12,27,53,7065
"22055001300",1216,459,1812,1166,64,7,21,7,4752
"22055001401",7763,475,402,158,432,49,207,45,9531
"22055001402",6611,414,323,0,322,124,0,0,7794
"22055001403",3984,284,104,109,348,13,331,0,5173
"22055001404",8205,322,420,84,211,0,377,0,9619
"22055001405",6085,668,1454,546,213,0,564,85,9615
"22055001406",3551,500,656,362,283,0,90,269,5711
"22055001407",4936,101,194,1,328,0,101,0,5661
"22055001409",6660,353,1081,711,426,119,404,64,9818
"22055001410",11951,467,1033,244,337,177,218,0,14427
"22055001411",1586,197,182,19,18,0,22,0,2024
"22055001500",4601,421,167,50,104,61,196,84,5684
"22055001600",2758,244,0,0,43,0,68,0,3113
"22055001700",5780,271,265,145,138,25,366,0,6990
"22055001801",1787,617,648,313,131,129,251,160,4036
"22055001802",2748,470,479,335,245,10,463,10,4760
"22055001901",4357,383,588,143,95,110,20,45,5741
"22055001902",5202,627,1080,319,206,210,257,0,7901
"22055001903",3828,562,675,213,663,60,419,231,6651
"22055001904",3129,216,526,169,226,38,267,51,4622
"22055001905",4019,852,772,137,327,82,222,0,6411
"22055002001",2854,583,1036,1030,473,71,229,46,6322
"22055002002",3888,482,2095,42,106,1,116,74,6804
"22055002101",3112,274,1635,450,55,75,45,19,5665
"22055002102",3281,260,770,262,21,0,166,35,4795
"22055002103",2179,218,1036,405,105,28,95,44,4110
"22055002104",4539,234,449,299,68,0,192,15,5796
"22055002200",2435,924,267,264,292,99,95,0,4376
"22055980000",17,0,0,0,0,0,0,0,17
"22057020100",1946,192,520,124,180,15,213,0,3190
"22057020202",2622,237,495,10,12,29,132,29,3566
"22057020400",521,118,763,427,78,14,21,0,1942
"22057020500",3573,540,1654,543,48,29,8,16,6411
"22057020600",1475,236,293,324,39,14,31,40,2452
"22057020702",1980,410,267,376,253,120,26,0,3432
"22057020703",3842,222,468,475,221,16,180,0,5424
"22057020704",4467,558,282,106,237,0,133,0,5783
"22057020800",2735,413,30,0,96,57,50,0,3381
"22057020900",1016,86,650,368,64,18,30,0,2232
"22057021000",2422,344,97,83,146,0,19,0,3111
"22057021100",5908,445,72,44,523,306,482,18,7798
"22057021200",2878,632,58,5,463,191,228,66,4521
"22057021300",1728,368,0,0,194,46,146,46,2528
"22057021400",2861,461,5,42,508,90,276,29,4272
"22057021500",3470,327,214,101,403,441,209,239,5404
"22057021601",5609,369,278,398,74,39,41,0,6808
"22057021602",2763,179,0,0,702,172,312,47,4175
"22057021700",2978,546,149,45,324,36,277,6,4361
"22057021800",2795,307,1175,447,56,135,187,62,5164
"22057021901",5470,730,689,0,226,0,287,0,7402
"22057021902",3547,420,210,47,57,67,54,0,4402
"22057022000",1132,130,15,47,0,0,14,7,1345
"22057990000",0,0,0,0,0,0,0,0,0
"22059970100",2926,470,22,155,53,30,128,5,3789
"22059970200",3521,1048,608,363,0,15,73,29,5657
"22059970300",3504,776,0,0,135,0,26,0,4441
"22061960100",2617,397,541,176,120,2,32,1,3886
"22061960200",2014,282,957,383,274,199,226,0,4335
"22061960300",587,11,2563,1798,12,0,0,33,5004
"22061960400",2423,1259,401,575,231,283,8,35,5215
"22061960500",2941,513,260,287,203,146,12,182,4544
"22061960600",2204,605,807,1148,70,232,85,158,5309
"22061960700",4391,711,423,156,51,59,36,114,5941
"22061960800",581,507,1051,1596,33,65,10,68,3911
"22061960900",181,88,1017,890,10,0,10,0,2196
"22061961000",1754,449,1211,1289,29,40,0,123,4895
"22063040100",7321,2591,724,74,80,0,214,24,11028
"22063040201",4417,1102,41,94,0,0,23,0,5677
"22063040202",3907,621,48,2,71,235,126,32,5042
"22063040301",8108,657,119,13,140,0,270,0,9307
"22063040303",9139,443,289,0,483,0,510,0,10864
"22063040304",4586,1002,60,0,147,0,85,67,5947
"22063040401",5595,1394,0,243,132,31,39,0,7434
"22063040402",6810,550,520,92,221,0,30,0,8223
"22063040500",9753,1148,684,69,473,256,1016,212,13611
"22063040600",5756,712,826,462,291,77,91,57,8272
"22063040700",3066,736,0,5,0,29,149,0,3985
"22063040802",4771,707,15,113,173,0,43,3,5825
"22063040804",12816,1420,1409,90,661,135,563,134,17228
"22063040805",3949,717,60,39,86,0,114,218,5183
"22063040806",6150,736,139,5,13,0,209,16,7268
"22063040901",4197,1258,677,414,43,0,16,122,6727
"22063040902",3801,787,436,27,39,0,30,0,5120
"22065960100",1103,188,102,102,22,0,51,1,1569
"22065960200",892,443,433,366,0,0,34,0,2168
"22065960300",0,0,1048,1350,28,57,0,0,2483
"22065960400",14,69,1096,622,0,26,0,0,1827
"22065960500",799,140,812,528,15,71,8,71,2444
"22067950100",907,127,185,164,5,80,0,51,1519
"22067950200",3689,519,813,30,105,83,84,83,5406
"22067950300",1502,314,259,148,10,0,0,22,2255
"22067950400",182,59,1305,1660,4,0,0,0,3210
"22067950500",1527,302,1433,1268,101,45,0,12,4688
"22067950600",1509,432,517,395,26,0,0,57,2936
"22067950700",1726,191,595,144,0,89,0,0,2745
"22067950800",232,35,1954,1337,51,10,0,0,3619
"22069000100",1591,317,250,252,113,3,11,0,2537
"22069000200",2101,237,458,380,76,20,46,0,3318
"22069000300",3134,402,318,393,121,79,145,59,4651
"22069000400",392,77,2321,1172,99,17,45,0,4123
"22069000500",2321,567,569,203,263,28,95,0,4046
"22069000600",1606,1304,2403,2095,174,129,94,70,7875
"22069000700",378,456,1121,1281,50,16,28,11,3341
"22069000800",2916,732,499,168,132,37,12,46,4542
"22069000900",2347,211,1017,500,379,132,102,2,4690
"22071000100",1952,237,329,94,96,164,170,147,3189
"22071000200",170,9,851,274,20,10,39,5,1378
"22071000300",51,77,550,486,0,4,11,0,1179
"22071000400",379,4,1256,854,31,1,26,13,2564
"22071000601",8,0,313,524,0,0,0,0,845
"22071000602",226,26,1753,860,51,78,49,78,3121
"22071000603",63,32,522,469,25,26,63,50,1250
"22071000604",495,229,2347,1293,117,55,214,22,4772
"22071000605",536,10,758,730,36,0,95,53,2218
"22071000606",1449,237,2159,397,384,14,284,141,5065
"22071000607",2077,85,2348,107,39,48,238,0,4942
"22071000611",78,49,3085,724,487,233,70,93,4819
"22071000612",1057,36,493,113,123,0,123,0,1945
"22071000613",317,76,2299,2160,43,10,137,50,5092
"22071000615",1060,75,2150,697,183,40,193,0,4398
"22071000616",1355,66,1672,473,182,0,145,27,3920
"22071000617",570,6,2704,652,37,0,12,0,3981
"22071000618",1501,15,1973,357,295,0,33,15,4189
"22071000701",19,3,418,219,13,0,0,1,673
"22071000702",147,50,835,545,39,0,4,63,1683
"22071000800",131,7,711,531,56,0,3,0,1439
"22071000901",77,0,401,310,0,0,0,0,788
"22071000902",0,0,445,54,0,0,0,0,499
"22071000903",4,0,340,90,0,0,0,0,434
"22071000904",2,27,405,373,37,0,30,1,875
"22071001100",762,160,558,190,58,6,29,12,1775
"22071001200",1215,129,165,66,93,4,58,6,1736
"22071001301",328,62,806,417,25,12,5,3,1658
"22071001302",24,59,422,473,10,0,3,6,997
"22071001401",9,10,715,499,64,0,0,0,1297
"22071001402",137,17,1166,522,69,10,95,0,2016
"22071001500",139,8,480,202,11,7,19,1,867
"22071001600",0,0,0,0,0,0,0,0,0
"22071001701",38,0,1332,529,12,0,12,0,1923
"22071001702",290,158,2083,292,23,69,41,0,2956
"22071001720",35,23,1766,1252,99,0,84,39,3298
"22071001722",26,0,2779,1183,194,15,210,7,4414
"22071001723",105,43,3125,1581,139,23,0,0,5016
"22071001724",126,31,2334,1424,107,44,25,0,4091
"22071001725",230,0,4201,2068,74,235,111,235,7154
"22071001730",50,0,538,374,32,0,11,0,1005
"22071001734",766,46,0,0,132,9,26,0,979
"22071001735",0,54,1237,714,36,10,31,35,2117
"22071001736",5,62,1438,700,26,6,16,57,2310
"22071001737",111,27,1828,1209,7,17,16,0,3215
"22071001739",0,20,1299,375,0,0,0,0,1694
"22071001740",0,0,3578,1052,14,37,30,37,4748
"22071001741",58,8,626,434,584,67,10,0,1787
"22071001743",74,0,1359,944,15,0,0,0,2392
"22071001744",22,0,2635,2284,0,14,83,0,5038
"22071001745",119,33,1974,1333,57,2,11,0,3529
"22071001746",24,19,2810,1560,21,0,0,0,4434
"22071001747",41,0,3078,111,875,125,44,0,4274
"22071001748",121,11,3182,1042,328,219,3,1,4907
"22071001749",75,79,529,549,1366,350,145,252,3345
"22071001750",319,184,769,262,1367,652,379,306,4238
"22071001751",102,109,113,389,70,24,109,99,1015
"22071001800",911,181,34,67,224,9,163,0,1589
"22071001900",228,127,491,291,63,0,122,22,1344
"22071002000",119,9,502,436,11,22,26,0,1125
"22071002100",22,0,452,342,0,0,0,0,816
"22071002200",39,10,453,341,9,10,20,16,898
"22071002300",6,37,1030,603,45,4,51,0,1776
"22071002401",173,59,1230,408,69,71,40,19,2069
"22071002402",198,85,2031,661,27,0,81,0,3083
"22071002501",222,9,1363,376,24,6,87,6,2093
"22071002502",88,29,1408,664,7,13,23,0,2232
"22071002503",585,76,1230,202,112,58,81,63,2407
"22071002504",497,43,1417,504,102,12,168,0,2743
"22071002600",956,221,18,87,23,59,8,0,1372
"22071002700",192,83,725,567,0,13,21,83,1684
"22071002800",31,23,1024,634,0,0,0,13,1725
"22071002900",59,15,741,461,0,0,57,0,1333
"22071003000",72,4,540,400,15,11,40,4,1086
"22071003100",1,5,489,393,82,16,8,17,1011
"22071003301",840,54,629,261,83,11,75,15,1968
"22071003302",274,46,2522,538,96,0,66,7,3549
"22071003303",369,98,799,619,93,122,160,45,2305
"22071003304",160,58,1187,662,8,0,29,20,2124
"22071003307",12,7,1168,287,32,0,29,0,1535
"22071003308",56,0,2372,835,108,119,27,119,3636
"22071003400",239,89,514,304,31,18,5,26,1226
"22071003500",149,14,614,394,16,0,9,0,1196
"22071003600",161,67,765,539,38,21,26,18,1635
"22071003701",474,41,1223,416,32,0,42,4,2232
"22071003702",904,81,1073,1106,156,34,57,8,3419
"22071003800",1127,105,22,3,29,0,37,32,1355
"22071003900",472,87,251,416,81,13,99,12,1431
"22071004000",467,124,844,536,35,13,148,40,2207
"22071004100",1158,74,174,23,15,81,94,69,1688
"22071004401",146,47,401,599,34,0,48,0,1275
"22071004402",0,0,0,81,0,0,0,0,81
"22071004500",594,72,690,708,166,0,210,9,2449
"22071004600",2272,248,99,74,123,28,94,18,2956
"22071004800",0,1,89,576,0,1,0,0,667
"22071004900",307,158,333,719,108,0,165,40,1830
"22071005000",580,83,229,280,77,134,418,179,1980
"22071005400",1196,254,198,134,95,13,350,13,2253
"22071005500",2405,230,128,29,121,4,356,15,3288
"22071005601",2025,152,63,1,105,25,154,10,2535
"22071005602",2527,139,109,0,1,6,161,0,2943
"22071005603",1298,144,40,0,14,0,143,6,1645
"22071005604",1441,55,44,8,71,4,42,0,1665
"22071006000",162,89,637,578,26,15,46,73,1626
"22071006300",468,241,274,422,71,5,219,223,1923
"22071006400",945,215,768,284,144,3,257,66,2682
"22071006500",1527,255,430,342,196,11,382,27,3170
"22071006900",0,10,271,605,0,5,0,10,901
"22071007000",36,61,152,196,0,8,0,15,468
"22071007101",300,153,848,521,53,40,222,57,2194
"22071007200",93,121,954,971,129,67,61,31,2427
"22071007501",75,115,1575,852,51,0,17,59,2744
"22071007502",34,167,1499,1129,60,130,0,9,3028
"22071007604",1682,72,60,0,38,0,34,45,1931
"22071007605",121,108,794,540,35,3,36,24,1661
"22071007606",3106,213,372,108,213,36,333,26,4407
"22071007700",1824,143,181,81,121,6,424,30,2810
"22071007800",785,187,80,24,144,0,110,81,1411
"22071008200",1034,138,153,59,110,20,209,83,1806
"22071008300",930,82,148,18,17,6,108,36,1345
"22071008400",405,91,397,138,105,0,72,0,1208
"22071008500",15,30,526,581,125,43,0,0,1320
"22071008600",17,39,335,393,46,53,52,31,966
"22071008800",1131,184,334,82,95,6,79,0,1911
"22071009000",1561,180,27,0,106,0,12,17,1903
"22071009100",723,118,348,452,181,133,138,106,2199
"22071009200",31,4,656,706,21,11,10,0,1439
"22071009400",21,42,466,671,0,0,107,26,1333
"22071009600",891,82,453,79,36,10,163,7,1721
"22071009700",600,104,572,89,87,75,57,75,1659
"22071009900",2026,324,160,72,118,43,181,76,3000
"22071010000",311,93,673,621,39,9,51,16,1813
"22071010100",1204,268,340,71,39,18,46,18,2004
"22071010200",275,55,824,656,49,30,29,7,1925
"22071010300",404,64,1712,1019,27,67,36,14,3343
"22071010600",722,111,309,81,32,0,38,5,1298
"22071010700",1180,143,159,25,54,127,96,5,1789
"22071010800",1237,21,63,19,78,0,66,0,1484
"22071010900",1678,266,1361,130,157,0,118,9,3719
"22071011100",444,68,627,329,62,38,58,84,1710
"22071011200",764,188,376,92,160,56,129,7,1772
"22071011400",1698,181,35,1,62,11,69,1,2058
"22071011500",1246,49,21,42,20,0,95,0,1473
"22071011600",1225,88,18,0,89,0,26,0,1446
"22071011700",2549,175,0,24,94,0,351,12,3205
"22071011900",1298,292,101,50,49,83,44,39,1956
"22071012000",1062,150,38,10,92,0,113,11,1476
"22071012101",1525,438,29,60,124,170,173,67,2586
"22071012102",634,364,9,2,125,39,42,61,1276
"22071012200",1825,190,136,17,186,0,191,12,2557
"22071012300",940,141,654,61,188,43,192,86,2305
"22071012400",1093,89,306,177,39,26,43,7,1780
"22071012500",892,171,232,166,145,32,102,34,1774
"22071012600",1224,348,67,51,95,68,48,0,1901
"22071012700",1296,280,439,80,65,11,189,10,2370
"22071012800",1477,202,363,75,183,42,186,13,2541
"22071012900",830,94,152,337,74,61,42,5,1595
"22071013000",657,124,398,518,81,0,42,0,1820
"22071013100",192,162,510,593,21,22,186,100,1786
"22071013200",878,376,857,360,73,46,79,107,2776
"22071013301",3170,129,166,0,248,0,118,0,3831
"22071013302",1245,108,412,55,271,77,62,10,2240
"22071013400",1425,256,226,366,177,126,158,30,2764
"22071013500",1695,255,76,3,33,8,61,121,2252
"22071013600",395,54,312,146,22,0,25,12,966
"22071013700",14,61,786,1465,6,15,25,68,2440
"22071013800",56,14,1220,980,19,0,0,0,2289
"22071013900",600,116,546,131,159,37,122,31,1742
"22071014000",107,0,390,1129,23,0,107,0,1756
"22071014100",638,155,643,481,26,3,66,0,2012
"22071014200",1037,114,451,141,47,0,55,6,1851
"22071014300",150,39,564,1013,24,7,130,6,1933
"22071014400",789,117,422,158,31,71,82,24,1694
"22071014500",0,0,0,0,0,0,0,0,0
"22071980000",2,0,0,1,1,1,0,0,5
"22071980100",0,0,0,0,0,0,0,0,0
"22071990000",0,0,0,0,0,0,0,0,0
"22073000100",2672,604,1141,50,207,0,260,43,4977
"22073000200",4268,267,383,18,44,0,31,0,5011
"22073000401",393,195,699,262,64,32,4,0,1649
"22073000402",572,160,691,570,43,17,0,0,2053
"22073000500",1478,143,643,544,44,0,69,2,2923
"22073000600",9,11,1800,1992,15,0,0,0,3827
"22073000700",0,14,692,1185,0,57,0,0,1948
"22073000900",3,0,759,676,7,0,0,0,1445
"22073001100",58,0,1240,2038,0,81,6,81,3504
"22073001400",75,84,994,1244,16,0,22,3,2438
"22073001500",104,86,671,764,0,13,0,0,1638
"22073001700",1509,162,1067,168,317,222,147,0,3592
"22073005100",1689,170,18,72,53,0,25,12,2039
"22073005201",3101,411,0,0,53,16,29,0,3610
"22073005203",2474,305,115,277,61,0,15,0,3247
"22073005204",4917,509,0,0,126,0,17,0,5569
"22073005301",5487,218,136,127,67,0,105,0,6140
"22073005302",4222,1078,254,176,137,0,89,83,6039
"22073005400",1325,165,176,141,110,0,77,0,1994
"22073005500",1167,563,824,594,234,56,0,0,3438
"22073005800",1023,547,315,226,161,35,181,152,2640
"22073005900",1273,1211,57,258,15,77,40,37,2968
"22073010101",2881,667,403,465,198,0,51,82,4747
"22073010102",2557,690,2064,982,47,36,103,34,6513
"22073010201",1689,197,2454,580,253,0,43,0,5216
"22073010202",5302,173,759,0,360,0,107,0,6701
"22073010301",2388,155,289,120,183,0,62,0,3197
"22073010302",2534,331,1192,224,103,19,119,0,4522
"22073010400",8121,1160,141,158,24,0,353,0,9957
"22073010502",3700,549,29,0,20,0,18,68,4384
"22073010503",1475,265,0,0,0,57,95,0,1892
"22073010504",5758,1421,313,145,121,12,188,12,7970
"22073010603",334,155,2042,1407,0,0,0,0,3938
"22073010604",1134,161,363,240,0,0,5,0,1903
"22073010700",12,0,1428,1076,19,9,0,0,2544
"22073010800",162,104,779,521,4,11,0,0,1581
"22073010900",127,14,2936,1666,64,0,7,0,4814
"22073011000",92,68,2246,2352,13,0,13,66,4850
"22073011100",512,373,915,806,25,52,0,45,2728
"22073980000",0,0,0,0,0,0,0,0,0
"22075050100",203,36,960,297,0,0,11,0,1507
"22075050200",6756,853,214,0,584,77,415,307,9206
"22075050300",3383,340,543,16,722,26,449,39,5518
"22075050400",1537,185,1076,410,53,206,105,0,3572
"22075050500",395,36,392,424,153,34,0,0,1434
"22075050600",567,63,193,88,60,28,16,0,1015
"22075050700",932,61,0,0,105,48,0,0,1146
"22075050800",431,306,103,150,130,91,59,5,1275
"22075990000",0,0,0,0,0,0,0,0,0
"22077951900",1168,128,2710,1380,0,0,13,0,5399
"22077952000",1076,235,948,380,82,0,117,49,2887
"22077952100",3259,308,609,297,30,121,0,37,4661
"22077952200",2433,279,516,40,32,0,40,70,3410
"22077952300",851,53,238,341,35,0,106,0,1624
"22077952400",3443,598,465,127,75,81,91,10,4890
"22079010100",8518,1110,180,1,89,44,269,44,10255
"22079010300",3418,1287,141,91,76,0,38,95,5146
"22079010400",1921,119,98,2,50,0,8,0,2198
"22079010500",2155,528,1988,1957,176,3,243,3,7053
"22079010600",3694,540,98,14,201,28,44,3,4622
"22079010700",2960,362,492,26,32,36,29,0,3937
"22079011000",257,181,1321,565,356,25,29,6,2740
"22079011300",1440,391,258,48,70,37,0,0,2244
"22079011500",5070,915,1198,106,185,27,293,10,7804
"22079011600",1443,303,374,257,145,46,26,0,2594
"22079011700",623,266,548,449,115,19,21,0,2041
"22079012000",0,0,1092,688,35,4,0,0,1819
"22079012100",653,200,1211,590,76,326,8,7,3071
"22079012200",1086,228,916,1454,40,34,0,0,3758
"22079012301",3693,245,1045,69,280,0,0,0,5332
"22079012302",2964,51,422,109,162,196,33,80,4017
"22079012400",2739,86,1071,113,42,112,148,0,4311
"22079012500",2071,705,3063,1038,258,20,183,151,7489
"22079012600",809,134,847,144,144,61,72,5,2216
"22079012700",0,0,1934,1270,13,8,0,0,3225
"22079012800",8,0,625,183,41,0,0,0,857
"22079012900",11,0,1767,972,0,9,11,0,2770
"22079013000",99,28,1677,482,35,6,30,8,2365
"22079013100",1082,217,542,319,85,20,9,0,2274
"22079013200",6370,913,643,94,126,10,115,0,8271
"22079013300",3034,362,1154,388,10,32,96,0,5076
"22079013400",2843,229,186,0,102,0,34,57,3451
"22079013500",4503,717,519,325,103,38,888,227,7320
"22079013600",2237,710,0,0,136,45,0,0,3128
"22079013700",2723,675,55,12,121,185,71,9,3851
"22079013800",1773,279,971,476,213,77,140,0,3929
"22079013900",321,119,1170,1042,0,4,8,0,2664
"22079980000",27,9,0,0,0,0,0,0,36
"22081960100",3572,468,445,346,73,0,54,0,4958
"22081960300",939,176,1605,945,130,2,73,0,3870
"22083970100",802,108,1519,468,36,29,2,29,2993
"22083970200",1176,271,396,142,7,0,64,0,2056
"22083970300",2385,198,268,49,17,29,30,0,2976
"22083970400",2576,198,60,157,30,5,43,0,3069
"22083970500",1279,110,1681,1612,98,11,73,0,4864
"22083970600",2949,507,416,254,24,6,162,11,4329
"22085000100",1961,240,252,137,249,105,69,30,3043
"22085000200",2102,536,3,9,818,368,87,43,3966
"22085000300",704,160,464,501,547,114,128,75,2693
"22085000400",3234,432,323,109,472,51,229,6,4856
"22085000500",1163,249,859,696,119,32,12,0,3130
"22085000600",2492,495,269,89,149,48,156,20,3718
"22085000700",2710,245,151,10,27,0,44,0,3187
"22087030103",2795,724,864,122,52,0,299,0,4856
"22087030104",1240,292,27,0,117,0,180,16,1872
"22087030105",177,79,20,9,0,0,29,18,332
"22087030203",2055,565,135,96,290,223,442,238,4044
"22087030204",1039,172,2085,873,58,32,162,23,4444
"22087030206",1301,328,193,0,199,0,75,15,2111
"22087030207",2743,405,340,65,370,19,239,19,4200
"22087030208",2067,215,321,18,295,0,157,6,3079
"22087030209",2546,119,518,84,0,0,287,0,3554
"22087030300",1077,240,131,86,80,10,196,46,1866
"22087030400",810,185,28,0,30,5,56,8,1122
"22087030500",1165,272,184,118,75,26,57,38,1935
"22087030601",631,62,257,156,275,13,27,5,1426
"22087030602",1635,515,377,61,109,16,253,128,3094
"22087030603",567,179,414,358,6,48,149,107,1828
"22087030700",1172,204,125,119,6,0,44,10,1680
"22087030800",2641,452,338,575,249,69,612,182,5118
"22087990000",0,0,0,0,0,0,0,0,0
"22089060100",1458,111,393,46,20,13,70,22,2133
"22089062100",3512,671,1760,344,216,9,623,294,7429
"22089062200",775,33,1316,426,43,10,48,4,2655
"22089062301",4069,117,1458,0,331,0,312,0,6287
"22089062302",3436,237,571,442,51,1,300,13,5051
"22089062400",835,43,307,275,21,0,17,0,1498
"22089062500",2552,214,168,17,8,7,11,0,2977
"22089062700",1851,397,1534,613,34,9,206,113,4757
"22089062800",1867,406,2038,614,147,39,307,2,5420
"22089062900",1902,138,203,0,66,0,74,0,2383
"22089063000",674,35,472,60,0,0,23,16,1280
"22089063100",6416,261,200,30,351,88,282,47,7675
"22089063200",4458,422,98,24,156,0,65,102,5325
"22091951100",1935,164,1208,748,27,28,0,0,4110
"22091951200",2251,347,2129,1524,200,43,16,0,6510
"22093040100",1906,192,795,628,44,0,53,15,3633
"22093040200",1904,51,845,476,0,0,45,42,3363
"22093040300",2597,41,489,89,0,0,26,0,3242
"22093040400",626,125,943,890,28,19,28,16,2675
"22093040500",102,15,1457,691,3,0,0,0,2268
"22093040600",554,8,1811,350,24,65,43,65,2920
"22093040700",2137,149,1239,21,0,31,0,0,3577
"22095070100",1837,59,389,90,64,3,142,3,2587
"22095070200",1129,35,4531,1198,380,74,446,24,7817
"22095070300",3228,445,1626,284,322,0,214,236,6355
"22095070400",2613,143,1347,163,174,0,240,0,4680
"22095070500",1705,54,3081,940,205,39,425,27,6476
"22095070600",861,65,554,818,0,0,0,0,2298
"22095070700",2442,141,936,313,151,30,291,0,4304
"22095070800",156,15,1036,750,0,9,0,0,1966
"22095070900",944,206,810,596,4,0,99,0,2659
"22095071000",1330,373,783,254,134,0,161,11,3046
"22095071100",363,93,2417,703,0,0,0,0,3576
"22097960100",1002,397,476,610,188,62,112,44,2891
"22097960200",2203,233,982,413,33,31,0,0,3895
"22097960300",1945,551,741,419,55,3,22,0,3736
"22097960400",1623,436,0,0,9,14,13,14,2109
"22097960500",4490,850,222,218,64,0,88,118,6050
"22097960600",2328,274,1627,2131,77,0,0,0,6437
"22097960700",3097,519,1301,681,71,38,0,0,5707
"22097960800",2383,629,271,143,102,32,39,0,3599
"22097960900",1523,292,1312,674,17,0,93,0,3911
"22097961000",1403,236,361,11,77,46,189,0,2323
"22097961100",1790,753,322,514,20,180,90,0,3669
"22097961200",2761,340,1620,862,84,77,348,0,6092
"22097961300",305,58,1446,2213,35,67,0,0,4124
"22097961400",527,91,2053,1432,14,0,6,0,4123
"22097961500",1812,131,1345,1129,41,6,11,17,4492
"22097961600",269,66,1683,1804,46,11,27,10,3916
"22097961700",3645,627,1431,243,139,55,0,55,6195
"22097961800",4625,741,434,560,199,334,145,74,7112
"22097961900",1367,139,1286,594,27,0,1,0,3414
"22099020100",3721,913,110,175,30,0,18,0,4967
"22099020200",4780,480,1751,854,270,0,17,0,8152
"22099020301",3049,644,950,55,93,0,234,0,5025
"22099020302",4927,797,757,145,411,346,225,105,7713
"22099020400",3576,192,1049,654,240,32,57,18,5818
"22099020501",2251,307,1829,978,85,15,1,0,5466
"22099020502",2345,143,810,647,82,12,14,0,4053
"22099020600",2194,226,2131,1060,313,90,230,0,6244
"22099020800",1496,63,1075,102,158,44,118,0,3056
"22099020900",930,100,439,116,5,12,84,6,1692
"22099021000",1223,186,0,0,51,0,56,0,1516
"22101040100",1080,280,333,466,714,86,610,92,3661
"22101040200",3568,295,224,371,182,201,159,184,5184
"22101040300",1379,255,729,388,138,175,277,126,3467
"22101040400",1996,456,617,266,266,205,157,55,4018
"22101040500",3441,445,253,306,176,228,177,108,5134
"22101040600",3542,807,69,291,299,118,348,118,5592
"22101040700",1214,273,1006,483,197,97,158,17,3445
"22101040800",3127,366,973,194,236,0,58,63,5017
"22101040900",1584,148,581,260,213,27,32,0,2845
"22101041000",1926,188,728,209,525,43,42,4,3665
"22101041100",670,130,517,534,16,7,84,49,2007
"22101041200",465,149,857,490,61,25,19,0,2066
"22101041300",882,184,499,140,106,18,43,85,1957
"22101041400",885,267,1504,618,97,57,15,64,3507
"22101041500",1023,165,558,185,82,15,30,60,2118
"22101041600",177,50,874,749,21,36,0,0,1907
"22101990000",0,0,0,0,0,0,0,0,0
"22103040102",7358,1196,186,97,180,80,289,17,9403
"22103040103",4158,398,0,0,0,0,89,0,4645
"22103040104",5564,638,75,0,314,45,321,125,7082
"22103040201",7564,707,529,55,558,151,362,15,9941
"22103040202",5416,607,22,16,175,0,143,15,6394
"22103040303",7538,450,201,120,540,135,512,143,9639
"22103040304",6246,48,0,0,92,8,235,8,6637
"22103040305",10334,370,508,202,210,0,257,40,11921
"22103040400",7013,655,54,126,193,0,148,0,8189
"22103040501",1445,177,888,652,50,20,57,23,3312
"22103040502",2704,132,540,489,30,94,148,23,4160
"22103040601",1971,96,0,0,131,15,4,0,2217
"22103040602",2328,205,0,0,99,7,353,32,3024
"22103040604",7573,797,449,5,199,138,721,201,10083
"22103040605",5343,428,342,114,242,167,219,82,6937
"22103040701",6480,361,1756,596,379,65,434,17,10088
"22103040704",3050,1194,578,401,80,287,115,242,5947
"22103040705",4976,341,880,139,145,145,93,19,6738
"22103040706",4210,724,160,0,330,17,316,38,5795
"22103040708",5109,253,387,17,298,16,314,0,6394
"22103040709",3313,219,374,12,158,7,253,124,4460
"22103040710",4855,226,628,107,371,11,278,8,6484
"22103040801",2579,530,610,230,448,241,282,115,5035
"22103040802",5795,370,309,0,288,0,175,77,7014
"22103040803",3110,1142,4035,639,519,53,566,259,10323
"22103040900",760,334,1176,502,38,0,91,0,2901
"22103041002",2290,470,110,2,75,20,195,82,3244
"22103041003",4832,184,604,107,83,0,126,8,5944
"22103041004",3817,208,69,57,152,0,306,5,4614
"22103041101",2651,223,286,495,95,8,75,0,3833
"22103041102",3829,1377,1577,303,187,148,439,498,8358
"22103041103",1342,637,598,397,117,105,38,101,3335
"22103041104",2300,394,478,77,119,24,96,38,3526
"22103041202",1415,436,296,314,86,93,43,17,2700
"22103041204",5218,758,1468,270,110,104,254,105,8287
"22103041207",3625,131,117,0,326,29,126,38,4392
"22103041208",4091,120,7,17,151,7,150,0,4543
"22103041209",4463,243,129,9,255,10,229,0,5338
"22103041210",2106,127,21,0,123,0,78,14,2469
"22103041211",5755,158,0,0,232,13,273,13,6444
"22103041212",3392,121,42,47,68,0,272,9,3951
"22103041300",5209,410,532,0,322,10,209,128,6820
"22103990000",0,0,0,0,0,0,0,0,0
"22105953200",1986,239,221,467,0,21,14,0,2948
"22105953300",926,218,1206,1242,22,14,4,25,3657
"22105953400",2084,413,2139,834,54,142,36,0,5702
"22105953500",4631,1132,1001,112,235,59,178,0,7348
"22105953600",1657,309,2934,1777,48,204,288,196,7413
"22105953700",8258,1110,672,218,376,38,59,0,10731
"22105953800",3015,763,511,520,46,15,205,81,5156
"22105953900",4877,1128,1962,369,303,126,759,31,9555
"22105954001",1575,654,915,711,119,43,68,47,4132
"22105954002",3071,461,1549,358,43,0,113,137,5732
"22105954101",2530,320,1035,1058,102,39,142,0,5226
"22105954102",7658,707,530,1132,410,15,251,159,10862
"22105954200",1897,424,255,406,74,25,92,44,3217
"22105954300",941,16,1923,1204,18,0,18,0,4120
"22105954400",1028,279,1211,887,27,34,88,10,3564
"22105954501",3332,468,926,532,120,66,82,97,5623
"22105954502",4255,883,1285,890,348,0,287,54,8002
"22105954600",9225,1293,795,235,26,327,668,156,12725
"22105954700",3465,521,551,520,77,0,186,62,5382
"22105954800",3364,713,581,256,240,15,79,15,5263
"22107000100",960,84,353,360,6,0,9,2,1774
"22107000200",526,94,135,198,14,0,3,6,976
"22107000300",360,11,718,928,0,10,37,13,2077
"22109000101",4262,612,1068,231,122,45,85,11,6436
"22109000102",1772,220,1235,478,178,0,181,0,4064
"22109000201",1945,502,423,438,189,205,90,208,4000
"22109000202",5184,708,577,558,351,67,442,57,7944
"22109000300",2590,253,706,493,400,271,149,49,4911
"22109000401",3284,369,425,307,463,98,371,109,5426
"22109000402",3212,110,398,182,181,107,160,83,4433
"22109000500",3007,443,1147,884,234,104,513,94,6426
"22109000600",3816,736,672,155,581,165,98,168,6391
"22109000700",2017,508,1708,970,362,278,636,128,6607
"22109000800",3477,945,359,348,629,56,212,16,6042
"22109000900",2602,365,1233,556,181,0,109,78,5124
"22109001000",4190,725,333,139,362,0,32,55,5836
"22109001100",2323,549,0,1,431,331,0,0,3635
"22109001201",2143,306,140,163,114,63,0,0,2929
"22109001202",2962,527,24,0,226,119,62,0,3920
"22109001300",2623,1043,589,430,1816,1094,20,142,7757
"22109001400",1675,335,307,140,313,215,19,31,3035
"22109001500",6359,547,349,44,483,0,393,0,8175
"22109001600",816,213,616,620,13,0,66,0,2344
"22109001700",8317,526,174,672,564,58,116,183,10610
"22109990000",0,0,0,0,0,0,0,0,0
"22111960100",2808,620,599,821,95,0,259,230,5432
"22111960200",1601,352,732,453,98,21,143,126,3526
"22111960300",1514,497,164,497,61,0,67,34,2834
"22111960400",953,166,654,1413,21,132,35,14,3388
"22111960500",3511,692,120,35,86,74,0,0,4518
"22111960600",2662,331,89,55,30,7,43,15,3232
"22113950100",7631,1121,322,174,247,46,417,19,9977
"22113950200",4262,658,111,54,8,20,0,7,5120
"22113950400",3082,900,259,240,173,145,30,24,4853
"22113950500",5223,459,0,2,35,1,66,19,5805
"22113950600",2799,330,52,1,120,0,11,0,3313
"22113950700",1624,270,589,552,284,88,8,41,3456
"22113950800",1382,252,1818,1722,120,47,136,1,5478
"22113950901",2271,198,336,258,173,151,62,0,3449
"22113950902",4915,635,1200,83,478,175,122,0,7608
"22113951001",3480,569,153,33,102,208,198,65,4808
"22113951002",2967,276,235,92,134,3,146,4,3857
"22113951100",1282,595,0,0,32,21,103,272,2305
"22113990000",0,0,0,0,0,0,0,0,0
"22115950100",4473,815,76,38,392,24,210,48,6076
"22115950200",3786,552,106,23,240,122,81,59,4969
"22115950300",3239,521,124,3,464,21,55,2,4429
"22115950400",1409,257,1039,599,154,38,128,107,3731
"22115950500",2852,592,1484,292,626,143,492,118,6599
"22115950600",2452,426,644,19,452,63,398,32,4486
"22115950701",143,0,0,0,0,0,59,0,202
"22115950702",1701,419,965,101,527,6,630,101,4450
"22115950703",1501,159,416,35,269,11,389,114,2894
"22115950704",3070,457,321,126,176,35,534,73,4792
"22115950800",3474,502,87,35,149,4,209,6,4466
"22115950900",5170,885,469,67,425,13,446,91,7566
"22117950101",1366,622,620,316,8,37,10,1,2980
"22117950102",2551,588,798,389,21,0,0,0,4347
"22117950200",3266,858,1232,245,184,0,0,0,5785
"22117950300",1226,279,1617,702,19,56,75,35,4009
"22117950400",2337,592,393,391,84,40,0,0,3837
"22117950500",4494,1046,117,187,53,0,0,0,5897
"22117950600",3382,691,427,70,34,35,30,0,4669
"22117950700",2712,858,476,526,142,231,519,103,5567
"22117950800",1012,68,1220,1598,33,29,12,24,3996
"22117950900",280,344,265,349,13,6,0,53,1310
"22117951000",1650,346,801,312,32,0,32,0,3173
"22119031100",1521,185,122,37,27,8,8,9,1917
"22119031200",1506,234,408,315,69,0,67,0,2599
"22119031300",2503,617,661,1195,42,0,73,0,5091
"22119031400",2305,223,437,242,77,0,43,6,3333
"22119031500",3087,814,311,328,90,9,42,33,4714
"22119031600",2571,264,221,7,6,28,0,22,3119
"22119031700",324,90,1619,1102,0,27,0,0,3162
"22119031800",1350,277,1026,262,11,46,61,0,3033
"22119031900",236,86,1538,489,82,7,0,7,2445
"22119032000",1861,209,499,414,122,0,32,0,3137
"22119032100",4175,845,1294,956,153,11,264,30,7728
"22121020100",1637,196,1486,835,30,0,60,0,4244
"22121020200",736,224,1253,420,19,68,72,90,2882
"22121020300",3879,393,904,610,42,123,236,0,6187
"22121020401",2475,392,1264,954,67,12,37,70,5271
"22121020402",4312,299,1000,136,222,0,81,0,6050
"22123000100",3145,688,281,369,39,0,72,91,4685
"22123000200",2356,878,165,58,11,88,38,63,3657
"22123000300",1562,387,331,264,10,14,17,3,2588
"22125951701",1394,168,1449,375,16,0,4,0,3406
"22125951702",508,7,54,14,0,0,0,7,590
"22125951800",4699,534,1903,787,55,29,89,65,8161
"22127960100",2949,289,140,86,5,10,19,3,3501
"22127960200",2861,694,390,588,126,4,21,0,4684
"22127960300",1129,400,500,514,0,42,0,0,2585
"22127960400",753,216,794,569,8,54,0,23,2417
"23001010100",869,379,0,80,80,171,0,35,1614
"23001010200",3756,452,5,0,185,40,17,0,4455
"23001010300",1325,465,43,54,248,67,20,76,2298
"23001010400",1892,211,9,0,62,0,39,0,2213
"23001010500",1261,580,3,19,75,109,8,31,2086
"23001010600",2458,306,0,0,52,32,0,22,2870
"23001010700",2574,334,13,0,204,52,40,25,3242
"23001010800",3327,224,12,9,209,10,60,0,3851
"23001020100",595,436,20,171,14,58,0,48,1342
"23001020200",792,245,21,0,59,104,9,0,1230
"23001020300",2765,1424,113,266,215,428,105,255,5571
"23001020400",1117,1299,16,263,42,261,22,170,3190
"23001020500",3218,731,5,33,60,119,3,71,4240
"23001020600",2270,207,0,0,83,0,31,0,2591
"23001020700",4495,360,0,0,357,9,144,9,5374
"23001020800",6041,657,25,0,529,115,0,0,7367
"23001020900",3234,555,39,65,134,74,30,0,4131
"23001030100",3840,274,7,0,175,49,21,0,4366
"23001030200",3917,357,10,0,175,30,23,0,4512
"23001040000",3431,273,0,5,130,48,0,0,3887
"23001041000",4562,492,12,0,331,34,21,0,5452
"23001041500",4880,542,4,8,100,41,108,0,5683
"23001042000",5152,243,40,15,177,3,117,0,5747
"23001043000",1727,257,0,0,21,15,12,0,2032
"23001044000",2408,595,0,0,120,0,32,7,3162
"23001045000",1629,277,0,0,69,26,12,0,2013
"23001046000",3628,508,0,0,131,9,25,0,4301
"23001046500",5914,744,0,0,251,13,27,0,6949
"23003950100",1896,399,21,0,59,26,23,9,2433
"23003950200",1838,775,7,0,41,5,31,0,2697
"23003950300",3334,469,0,5,47,27,0,0,3882
"23003950400",1304,188,0,0,18,18,5,0,1533
"23003950600",3024,616,0,0,99,89,6,3,3837
"23003950700",2132,453,6,0,50,11,17,9,2678
"23003950900",1811,288,0,0,42,3,15,0,2159
"23003951000",2930,364,5,1,95,31,55,32,3513
"23003951100",2446,300,0,0,25,16,5,0,2792
"23003951200",1766,666,74,33,45,102,46,0,2732
"23003951300",2464,378,84,19,50,79,41,13,3128
"23003951400",1681,296,0,3,60,31,43,0,2114
"23003951600",1143,446,41,8,36,21,0,35,1730
"23003951700",3578,907,0,0,53,31,42,15,4626
"23003951800",2993,759,2,25,181,7,4,0,3971
"23003951900",2433,316,1,0,49,0,24,0,2823
"23003952000",1243,651,18,1,118,116,0,8,2155
"23003952100",2335,450,20,0,46,29,16,2,2898
"23003952300",1931,385,0,2,152,29,15,18,2532
"23003952400",2673,592,13,0,142,237,15,52,3724
"23003952500",1609,308,0,0,44,51,6,25,2043
"23003952600",2449,557,7,2,32,38,10,0,3095
"23003952700",2020,430,22,1,60,4,24,1,2562
"23003952900",2459,494,4,18,83,2,6,3,3069
"23005000100",1704,347,15,16,121,37,40,0,2280
"23005000200",2071,258,70,19,59,38,34,1,2550
"23005000300",1315,806,80,155,84,37,54,48,2579
"23005000500",927,438,373,367,185,144,230,19,2683
"23005000600",1528,677,193,378,84,51,136,43,3090
"23005001000",1368,690,166,285,43,52,29,15,2648
"23005001100",1990,531,19,121,63,31,52,13,2820
"23005001200",894,431,135,23,43,37,26,47,1636
"23005001300",2132,718,55,254,90,51,59,6,3365
"23005001500",2900,365,6,25,216,98,119,26,3755
"23005001700",3861,272,13,103,97,33,52,13,4444
"23005001800",3140,186,52,0,128,10,62,0,3578
"23005001900",3437,362,17,0,233,114,73,0,4236
"23005002001",2534,362,95,120,387,86,0,88,3672
"23005002002",1582,282,108,89,266,83,135,10,2555
"23005002101",4801,622,24,258,99,291,148,0,6243
"23005002102",3374,277,579,365,329,136,225,0,5285
"23005002200",4061,494,105,0,103,17,0,0,4780
"23005002300",2249,433,195,166,375,112,154,28,3712
"23005002400",1166,85,0,2,21,0,0,0,1274
"23005002501",3217,144,101,0,94,35,119,0,3710
"23005002502",7391,151,0,0,276,16,88,18,7940
"23005002600",3491,201,14,185,46,11,148,80,4176
"23005002700",3259,765,309,34,255,98,193,93,5006
"23005002800",2006,489,8,15,106,85,100,0,2809
"23005002900",4932,1058,0,0,147,136,95,0,6368
"23005003000",4686,1262,0,0,701,5,166,0,6820
"23005003100",2834,557,39,112,180,77,11,144,3954
"23005003200",2635,433,35,0,42,10,12,27,3194
"23005003300",2567,148,29,61,353,37,12,9,3216
"23005003400",3974,210,9,1,260,21,48,9,4532
"23005003500",2938,446,7,15,52,22,0,22,3502
"23005003701",4095,129,0,0,81,28,24,11,4368
"23005003702",4473,163,59,48,81,0,29,0,4853
"23005004001",2598,72,60,0,150,0,11,0,2891
"23005004002",5885,335,30,51,199,35,30,0,6565
"23005004100",5630,171,11,0,311,1,26,0,6150
"23005004200",7235,268,0,36,277,53,91,53,8013
"23005004401",4298,220,0,0,219,0,67,0,4804
"23005004402",3239,238,32,0,84,14,11,0,3618
"23005004501",2614,185,30,9,120,31,121,11,3121
"23005004502",4547,243,50,2,155,0,44,0,5041
"23005004600",3334,137,0,1,163,0,11,0,3646
"23005004701",1903,32,0,0,44,0,37,0,2016
"23005004702",4670,1005,20,3,215,30,31,0,5974
"23005004801",5735,429,169,0,167,0,25,11,6536
"23005004802",4275,338,111,3,65,16,0,0,4808
"23005004803",4904,387,0,0,64,0,47,0,5402
"23005011100",3477,482,35,0,174,18,50,0,4236
"23005011201",6001,701,67,0,44,28,35,0,6876
"23005011202",4083,671,19,41,314,23,32,18,5201
"23005011300",2248,159,7,0,43,0,44,0,2501
"23005011500",6562,336,0,0,177,18,114,10,7217
"23005012000",4186,166,12,0,101,7,74,0,4546
"23005013000",3132,481,0,0,60,129,27,44,3873
"23005014000",3340,504,9,1,58,0,39,0,3951
"23005015000",2424,298,0,18,40,0,0,0,2780
"23005016000",3784,1029,0,0,289,0,0,25,5127
"23005016500",2751,260,2,0,45,8,0,5,3071
"23005017001",5452,483,50,1,80,0,23,0,6089
"23005017002",3024,250,0,1,23,0,2,0,3300
"23005017101",1596,115,0,0,15,0,0,0,1726
"23005017102",2504,526,0,0,18,31,13,0,3092
"23005017301",7643,301,13,144,772,0,331,0,9204
"23005017303",3749,198,0,0,67,97,0,35,4146
"23005017304",5253,378,80,29,278,14,117,0,6149
"23005990000",0,0,0,0,0,0,0,0,0
"23007970101",1629,231,0,0,68,0,7,0,1935
"23007970102",494,114,0,0,9,0,3,0,620
"23007970601",1485,148,5,0,29,13,56,20,1756
"23007970602",1855,615,4,0,54,0,21,14,2563
"23007971000",3615,466,20,3,101,15,37,16,4273
"23007971100",2480,393,0,0,31,2,0,0,2906
"23007971200",5188,1159,38,41,130,0,91,0,6647
"23007971300",3130,678,9,0,72,108,34,0,4031
"23007971400",4375,332,0,0,88,0,8,48,4851
"23009965100",1563,259,1,0,33,11,6,5,1878
"23009965200",2038,210,2,0,8,8,34,0,2300
"23009965300",4126,803,0,9,0,0,0,8,4946
"23009965400",2358,264,0,3,51,13,4,9,2702
"23009965503",2543,698,31,0,27,28,26,0,3353
"23009965504",3751,381,43,66,68,14,74,0,4397
"23009965700",2159,431,0,0,107,57,0,24,2778
"23009965800",1866,374,5,1,5,7,0,0,2258
"23009965900",4064,509,0,21,253,84,160,0,5091
"23009966000",2137,171,3,0,27,0,13,0,2351
"23009966100",1705,186,0,0,52,24,14,50,2031
"23009966200",1711,194,6,0,47,26,44,1,2029
"23009966300",3490,529,17,12,93,30,17,9,4197
"23009966400",1553,385,0,0,52,2,0,0,1992
"23009966500",2433,301,10,0,63,7,38,44,2896
"23009966600",2556,360,13,0,46,5,39,11,3030
"23009966700",4709,664,11,6,154,43,72,0,5659
"23009990000",0,0,0,0,0,0,0,0,0
"23011010100",3896,874,0,0,201,0,117,164,5252
"23011010200",3300,477,95,0,29,8,0,0,3909
"23011010300",2184,728,51,0,41,165,33,0,3202
"23011010400",1360,502,0,0,114,25,42,21,2064
"23011010500",3037,559,0,0,198,212,84,30,4120
"23011010600",5887,805,11,0,200,0,59,0,6962
"23011010700",2037,266,0,0,92,15,0,0,2410
"23011010801",2241,253,12,0,48,6,0,0,2560
"23011010802",5221,829,16,0,196,77,16,96,6451
"23011010900",1089,329,0,0,14,0,0,0,1432
"23011011000",3378,654,5,0,164,27,140,21,4389
"23011012000",3248,246,0,0,60,0,0,0,3554
"23011013000",3495,456,0,0,106,11,128,24,4220
"23011014000",5472,340,0,0,74,29,74,13,6002
"23011014500",2004,195,0,0,44,0,0,0,2243
"23011015000",2368,134,7,12,35,0,18,0,2574
"23011015500",2728,513,6,0,29,20,50,0,3346
"23011016000",2621,427,0,0,48,0,42,0,3138
"23011017000",3513,414,55,15,41,30,47,0,4115
"23011018000",3655,503,4,0,54,10,8,0,4234
"23011019000",2292,240,0,0,26,0,17,16,2591
"23011020000",3667,415,75,0,55,67,29,0,4308
"23011020500",1474,263,6,0,36,3,31,0,1813
"23011021000",3018,330,5,20,0,0,0,20,3393
"23011022000",2381,270,0,0,27,11,5,0,2694
"23011023001",3008,720,0,17,48,18,27,0,3838
"23011023002",3200,446,26,0,141,0,0,0,3813
"23011024101",3098,641,0,0,205,46,140,0,4130
"23011024102",2882,1396,26,322,137,45,0,2,4810
"23011024200",4561,421,82,0,125,18,81,50,5338
"23011025000",5707,381,0,0,93,0,0,0,6181
"23013970200",4309,488,0,0,7,0,7,0,4811
"23013970300",5833,707,19,0,208,21,59,8,6855
"23013970400",5516,938,23,62,64,43,52,103,6801
"23013970500",2838,283,31,0,114,19,96,19,3400
"23013970600",2060,494,11,0,90,13,21,13,2702
"23013970700",3702,497,50,0,129,0,10,0,4388
"23013970800",2758,271,15,2,15,14,4,1,3080
"23013970900",2448,72,0,0,74,0,19,0,2613
"23013971000",2291,199,0,0,19,4,8,4,2525
"23013971100",1523,151,2,0,78,26,10,3,1793
"23013990000",0,0,0,0,0,0,0,0,0
"23015975100",4648,593,0,0,92,2,51,0,5386
"23015975200",3843,992,0,0,155,23,0,74,5087
"23015975300",2898,473,0,0,50,3,35,13,3472
"23015975400",3203,278,21,0,50,7,7,0,3566
"23015975500",5128,596,5,12,359,7,8,0,6115
"23015975600",3375,297,0,0,24,0,62,5,3763
"23015975700",819,103,0,0,0,0,8,0,930
"23015975800",2676,404,0,0,15,0,37,0,3132
"23015976200",2089,281,0,0,34,2,5,11,2422
"23015990000",0,0,0,0,0,0,0,0,0
"23017965100",1000,121,0,0,5,0,4,0,1130
"23017965400",2052,804,0,15,126,58,0,0,3055
"23017965500",1589,394,0,13,10,1,14,30,2051
"23017965600",2694,852,0,0,6,136,17,22,3727
"23017965700",2304,577,7,0,75,15,0,49,3027
"23017965800",3151,441,0,0,73,17,110,0,3792
"23017965900",2586,319,0,0,17,0,11,0,2933
"23017966000",2741,445,27,0,41,24,87,17,3382
"23017966100",1522,268,31,2,61,10,26,0,1920
"23017966200",3801,968,0,25,108,66,102,0,5070
"23017966300",2785,560,11,23,99,140,12,49,3679
"23017966400",5163,1137,0,1,30,90,31,0,6452
"23017966500",3744,1016,0,0,77,15,0,0,4852
"23017966600",2491,399,13,0,77,10,32,20,3042
"23017966700",3033,181,0,0,9,0,0,0,3223
"23017966800",2160,221,25,0,44,0,5,0,2455
"23017966900",2852,513,28,0,70,34,4,0,3501
"23019000200",2056,1134,43,10,133,39,43,21,3479
"23019000300",3216,353,92,65,456,13,83,53,4331
"23019000400",1762,520,0,39,69,8,149,43,2590
"23019000500",2200,1158,0,21,94,14,77,0,3564
"23019000600",1428,785,11,11,0,0,0,0,2235
"23019000700",2207,275,67,13,20,0,9,0,2591
"23019000900",3407,2544,110,37,199,204,22,56,6579
"23019002000",6834,277,42,0,156,0,186,0,7495
"23019003000",3310,299,0,0,105,0,12,0,3726
"23019004100",1466,370,0,11,33,33,0,0,1913
"23019004200",2336,65,0,44,0,22,0,0,2467
"23019004300",4465,292,0,0,74,0,0,0,4831
"23019005000",1546,410,0,0,61,22,6,0,2045
"23019006100",1402,1284,8,0,87,64,0,0,2845
"23019006200",2523,369,0,0,144,0,58,0,3094
"23019006300",519,384,0,0,96,49,0,0,1048
"23019007100",2996,1418,44,25,221,107,9,1,4821
"23019007200",2262,467,26,0,98,39,0,0,2892
"23019008001",3889,518,22,0,49,23,15,3,4519
"23019009000",5734,496,24,73,55,0,86,17,6485
"23019010000",5090,414,7,0,25,0,0,0,5536
"23019011000",2443,224,0,0,45,9,0,0,2721
"23019012000",1298,113,5,0,49,4,14,0,1483
"23019012500",2240,252,0,0,64,8,6,0,2570
"23019013000",2507,650,21,0,24,43,0,0,3245
"23019013500",2199,296,0,13,4,14,15,14,2555
"23019014000",1866,187,0,0,0,0,9,27,2089
"23019015000",2962,740,0,16,0,9,12,15,3754
"23019015500",1815,392,0,3,9,13,7,4,2243
"23019018000",2651,216,0,0,48,0,0,0,2915
"23019020500",2174,421,14,0,132,16,18,11,2786
"23019021500",1628,194,0,0,12,14,0,0,1848
"23019022500",1411,362,31,1,43,8,2,4,1862
"23019024500",1861,389,16,17,43,27,22,0,2375
"23019025500",1403,328,0,0,35,27,10,6,1809
"23019026500",1603,204,1,0,18,7,1,0,1834
"23019027000",3845,1071,0,0,68,0,0,0,4984
"23019028000",1292,184,0,0,98,0,13,0,1587
"23019028500",1138,333,0,0,50,29,0,0,1550
"23019029000",1598,285,1,0,26,6,21,3,1940
"23019030000",3632,560,0,0,187,0,289,0,4668
"23019031000",1426,379,2,0,43,33,41,0,1924
"23019031100",4726,642,2,41,375,143,44,0,5973
"23019031200",3219,502,1,22,101,18,45,0,3908
"23019031300",4981,351,0,0,286,34,52,0,5704
"23019940000",47,52,1,0,462,213,23,30,828
"23021960301",1320,432,0,1,44,105,8,11,1921
"23021960302",523,37,0,0,0,2,10,0,572
"23021960400",983,149,0,0,9,0,11,0,1152
"23021960500",1323,214,0,0,24,45,20,42,1668
"23021960600",2116,744,7,36,29,19,24,23,2998
"23021960700",3213,593,20,0,44,15,19,0,3904
"23021960800",2676,820,0,0,83,25,32,3,3639
"23021960900",821,283,0,0,79,0,7,0,1190
"23023970100",3011,288,8,0,49,6,26,0,3388
"23023970200",5368,434,75,19,46,31,105,0,6078
"23023970301",3977,166,0,0,390,32,74,22,4661
"23023970302",3405,479,0,0,175,28,53,0,4140
"23023970400",4172,360,14,0,34,6,6,0,4592
"23023970500",3566,1256,44,0,173,35,23,158,5255
"23023970600",2359,606,44,43,61,47,19,16,3195
"23023970700",3600,362,9,0,58,2,11,11,4053
"23023990000",0,0,0,0,0,0,0,0,0
"23025965301",724,130,0,0,20,0,5,0,879
"23025965302",1057,196,0,0,27,10,0,0,1290
"23025965600",1501,474,0,0,20,16,0,0,2011
"23025965700",2468,560,9,0,45,11,0,0,3093
"23025965800",2541,386,0,0,73,8,35,0,3043
"23025965900",1238,383,0,0,21,0,10,0,1652
"23025966000",3177,678,14,23,91,0,29,124,4136
"23025966100",2977,420,10,0,21,41,8,12,3489
"23025966200",1335,352,13,0,104,5,6,0,1815
"23025966300",1600,270,23,0,20,8,0,0,1921
"23025966400",2055,413,0,0,32,48,17,0,2565
"23025966500",3759,577,16,0,104,14,64,7,4541
"23025966600",3082,1042,21,0,104,0,0,0,4249
"23025966700",3097,865,0,0,157,48,0,39,4206
"23025966800",5177,1157,15,0,132,87,7,77,6652
"23025966900",2933,393,0,0,9,0,9,0,3344
"23025967000",1912,282,10,0,41,10,53,0,2308
"23027041000",3441,255,9,2,54,0,0,0,3761
"23027042000",5020,777,8,0,39,87,15,16,5962
"23027043000",4677,1541,31,13,162,95,49,61,6629
"23027044000",4116,355,0,0,53,40,52,9,4625
"23027045000",5019,811,5,3,71,12,80,6,6007
"23027046001",1950,187,4,1,23,22,14,14,2215
"23027046002",3606,966,2,9,93,21,94,7,4798
"23027047000",3377,897,0,37,64,112,10,0,4497
"23029955100",1426,524,42,16,439,446,19,65,2977
"23029955300",1204,247,0,0,30,0,10,0,1491
"23029955400",1122,148,9,0,10,3,21,1,1314
"23029955500",2241,611,0,3,14,0,35,10,2914
"23029955600",1138,189,0,0,454,316,4,0,2101
"23029955700",932,287,7,1,112,0,12,1,1352
"23029955800",1877,474,4,5,64,21,27,0,2472
"23029955900",2103,346,0,0,110,34,9,1,2603
"23029956100",1976,323,10,0,37,2,13,2,2363
"23029956200",1954,472,6,0,49,20,16,3,2520
"23029956300",2002,362,7,4,33,38,5,31,2482
"23029956400",2689,309,2,0,82,11,55,7,3155
"23029956500",2909,699,5,14,132,21,146,15,3941
"23029990000",0,0,0,0,0,0,0,0,0
"23031005100",4360,240,0,0,233,0,117,0,4950
"23031005200",3522,263,155,0,290,117,86,0,4433
"23031005300",5470,997,0,0,378,0,309,0,7154
"23031005400",2261,204,0,41,33,0,11,0,2550
"23031006101",4540,378,49,26,92,0,85,10,5180
"23031006102",2629,675,36,51,159,29,71,25,3675
"23031020000",6866,609,257,0,310,0,231,0,8273
"23031021000",4013,331,0,0,20,0,38,0,4402
"23031022000",3317,373,0,0,30,0,40,37,3797
"23031022500",2254,604,24,0,72,45,9,0,3008
"23031023000",2474,362,20,0,60,0,5,0,2921
"23031023500",5731,531,12,0,144,132,57,48,6655
"23031024000",6850,571,48,0,227,0,9,0,7705
"23031024500",5962,229,0,0,138,2,142,0,6473
"23031025100",3240,343,8,0,33,0,23,0,3647
"23031025201",3844,719,0,0,402,0,165,18,5148
"23031025202",4936,2057,0,16,183,235,0,378,7805
"23031025300",2683,77,0,8,27,0,10,0,2805
"23031025400",1003,185,2,5,53,0,0,0,1248
"23031026000",3424,285,110,79,169,1,62,0,4130
"23031027000",3398,90,0,0,40,0,55,0,3583
"23031028001",3304,88,22,0,8,0,5,0,3427
"23031028002",7084,345,0,0,33,45,13,0,7520
"23031029000",2443,324,3,5,23,3,7,8,2816
"23031030100",3383,658,0,0,182,62,23,0,4308
"23031030201",2358,734,47,0,123,116,82,0,3460
"23031030202",3688,1514,0,0,136,51,44,0,5433
"23031030203",3519,308,37,0,138,6,61,0,4069
"23031030300",3028,245,0,0,146,8,74,0,3501
"23031031000",5492,491,18,0,0,0,0,0,6001
"23031032000",6458,498,36,10,353,31,25,0,7411
"23031033000",4121,211,24,20,74,21,80,8,4559
"23031034001",5528,292,0,0,115,0,0,0,5935
"23031034002",5004,178,25,0,40,0,95,0,5342
"23031035000",6453,457,21,0,305,71,35,29,7371
"23031036001",6471,477,52,0,131,0,85,0,7216
"23031036002",5177,295,0,2,112,0,15,0,5601
"23031037000",5670,437,11,0,106,0,70,0,6294
"23031038001",5842,174,0,1,70,0,183,0,6270
"23031038002",3134,104,15,0,93,0,13,0,3359
"23031990100",0,0,0,0,0,0,0,0,0
"24001000100",2780,487,89,0,32,20,26,0,3434
"24001000200",2445,428,0,1,33,47,63,47,3064
"24001000300",1821,601,37,2,19,6,0,0,2486
"24001000400",2198,277,228,16,33,71,8,0,2831
"24001000500",1080,863,11,168,108,155,0,21,2406
"24001000600",2168,338,35,75,84,11,23,11,2745
"24001000700",2152,849,112,200,11,58,0,75,3457
"24001000800",1307,685,71,7,81,106,65,13,2335
"24001001000",1826,348,43,95,28,0,79,0,2419
"24001001100",1186,177,60,23,17,18,0,0,1481
"24001001200",2556,163,102,1,176,30,0,0,3028
"24001001300",1814,292,0,0,17,5,0,0,2128
"24001001401",3500,380,26,0,103,0,23,0,4032
"24001001402",1272,196,52,0,27,1,7,1,1556
"24001001502",1667,191,0,10,33,0,61,0,1962
"24001001503",1867,99,20,8,12,10,0,10,2026
"24001001600",1445,204,23,0,10,2,8,5,1697
"24001001700",3374,944,59,0,192,20,34,0,4623
"24001001800",1997,795,36,246,84,84,7,22,3271
"24001001900",2540,382,10,0,56,4,0,0,2992
"24001002000",4896,787,55,1,43,27,77,0,5886
"24001002100",2731,480,46,0,32,5,36,0,3330
"24001002200",3234,425,2,0,8,3,1,4,3677
"24003701101",3780,159,58,0,48,0,173,0,4218
"24003701102",6831,365,55,94,515,168,506,141,8675
"24003701200",8087,127,143,0,399,0,197,15,8968
"24003701300",6370,175,507,149,134,174,92,0,7601
"24003701400",3029,26,188,85,27,0,48,0,3403
"24003702100",6066,403,163,234,123,0,148,0,7137
"24003702204",3577,81,227,0,394,29,302,0,4610
"24003702205",4315,81,635,60,367,27,125,0,5610
"24003702206",4528,78,803,0,782,57,385,9,6642
"24003702208",4601,66,1707,0,729,74,264,0,7441
"24003702209",3766,138,278,35,305,17,276,0,4815
"24003702300",5230,85,82,0,180,0,137,11,5725
"24003702402",5249,114,215,8,809,0,668,15,7078
"24003702500",2630,268,2198,615,711,149,745,317,7633
"24003702601",4459,67,541,240,164,0,192,0,5663
"24003702602",4376,123,601,13,497,0,252,0,5862
"24003702701",4233,124,365,0,275,44,251,30,5322
"24003702702",3194,100,185,0,192,0,115,0,3786
"24003706101",2408,127,451,185,53,60,175,70,3529
"24003706301",3032,88,602,129,386,0,342,0,4579
"24003706302",2778,114,125,4,135,11,156,0,3323
"24003706401",3232,493,1065,45,2294,75,3066,327,10597
"24003706402",1824,66,557,308,87,0,381,13,3236
"24003706500",3766,143,1104,189,204,33,680,33,6152
"24003706600",3644,99,870,386,341,0,730,26,6096
"24003706700",361,4,60,0,126,10,16,0,577
"24003707001",5238,205,901,160,53,0,87,94,6738
"24003707002",4058,355,212,2,134,29,161,1,4952
"24003708001",3347,140,88,22,132,24,77,0,3830
"24003708004",3990,498,722,114,431,92,350,57,6254
"24003730100",6944,170,1072,63,693,23,383,23,9371
"24003730203",3753,438,1146,215,526,32,927,160,7197
"24003730204",3584,173,1471,170,579,122,144,15,6258
"24003730300",2526,262,200,0,286,0,365,0,3639
"24003730401",3061,229,939,269,561,0,339,67,5465
"24003730402",3478,536,1360,271,691,121,397,52,6906
"24003730502",3378,156,1018,342,538,14,186,14,5646
"24003730504",3658,417,2234,35,1101,72,386,136,8039
"24003730505",1641,103,2054,105,949,14,637,0,5503
"24003730506",1130,197,2084,61,304,151,257,47,4231
"24003730601",6357,73,0,0,773,0,507,0,7710
"24003730603",2382,135,136,2,243,0,0,1,2899
"24003730604",5700,151,333,0,385,17,35,0,6621
"24003730700",6407,267,290,0,440,0,258,0,7662
"24003730800",2316,84,4,0,62,10,44,0,2520
"24003730901",2092,5,308,7,74,0,67,0,2553
"24003730902",3693,69,158,0,132,7,280,52,4391
"24003731002",2735,196,236,31,178,14,221,72,3683
"24003731003",3898,38,68,0,189,0,239,13,4445
"24003731004",3879,192,57,0,321,0,292,0,4741
"24003731102",6812,182,205,0,415,36,361,44,8055
"24003731103",3912,306,326,41,255,145,47,145,5177
"24003731104",3654,67,174,0,430,0,236,0,4561
"24003731105",3140,92,34,26,79,63,62,1,3497
"24003731201",5869,181,129,2,250,0,101,0,6532
"24003731202",6919,199,88,3,53,1,178,1,7442
"24003731203",6067,172,414,30,490,0,129,0,7302
"24003731204",5126,311,290,0,396,0,266,0,6389
"24003731303",6201,62,160,0,194,0,0,0,6617
"24003731306",5593,196,219,0,175,0,202,0,6385
"24003731307",5816,234,462,5,235,35,74,5,6866
"24003731308",3184,175,49,0,187,0,34,0,3629
"24003731309",5289,151,236,240,170,38,135,0,6259
"24003731310",4539,155,161,0,244,0,259,0,5358
"24003731311",6617,241,398,31,1083,91,351,2,8814
"24003740102",4274,421,1908,79,1994,28,496,0,9200
"24003740103",3936,256,2498,236,1193,133,580,31,8863
"24003740104",3132,128,3411,549,828,69,459,112,8688
"24003740105",770,38,2545,317,279,219,457,14,4639
"24003740201",4003,121,2008,41,1008,130,634,0,7945
"24003740203",4185,238,711,23,553,32,337,13,6092
"24003740303",3002,265,437,4,586,27,389,61,4771
"24003740304",3017,211,620,8,310,28,192,55,4441
"24003740305",3803,226,5615,447,1440,48,932,147,12658
"24003740400",0,0,0,0,0,0,0,0,0
"24003740500",2903,0,5567,167,1331,0,790,0,10758
"24003740601",2667,101,917,0,641,9,527,73,4935
"24003740602",2249,241,727,158,566,57,541,14,4553
"24003740603",592,5,121,0,83,0,122,0,923
"24003740701",3589,148,924,147,320,98,231,0,5457
"24003740702",7210,311,1289,56,1273,36,498,0,10673
"24003740800",3535,99,270,1,422,66,300,0,4693
"24003740900",5150,168,1234,35,902,89,751,0,8329
"24003741000",1940,13,101,0,169,0,92,0,2315
"24003750101",2412,463,364,385,410,182,246,11,4473
"24003750102",1588,274,295,96,290,87,169,5,2804
"24003750201",1545,264,619,100,128,81,123,0,2860
"24003750202",2351,220,263,23,173,2,248,2,3282
"24003750203",1020,58,112,0,167,0,96,0,1453
"24003750300",2196,202,58,5,321,19,35,0,2836
"24003750400",3500,61,33,25,375,16,74,0,4084
"24003750801",4901,161,399,1,704,0,210,21,6397
"24003750803",3180,520,2128,168,1932,367,2069,205,10569
"24003750804",2908,219,272,0,456,52,226,0,4133
"24003750900",2017,164,206,2,304,77,340,39,3149
"24003751000",2921,284,325,0,241,7,286,0,4064
"24003751102",2084,262,837,72,179,7,108,109,3658
"24003751103",4404,286,367,189,237,12,156,0,5651
"24003751200",3465,309,278,25,154,0,81,0,4312
"24003751400",2489,202,524,13,678,10,74,10,4000
"24003751500",3419,209,2248,139,888,0,1490,82,8475
"24003751600",4367,163,56,62,263,4,24,0,4939
"24003751700",2318,37,239,23,82,5,80,5,2789
"24003980000",4,0,0,0,9,0,9,0,22
"24003990000",0,0,0,0,0,0,0,0,0
"24005400100",2921,151,566,120,519,0,4,0,4281
"24005400200",1979,128,153,170,103,6,129,9,2677
"24005400400",4537,230,196,40,524,17,117,17,5678
"24005400500",2417,45,38,24,44,0,48,24,2640
"24005400600",1791,108,433,156,227,32,8,9,2764
"24005400701",1564,58,1011,6,384,0,180,1,3204
"24005400702",985,26,520,41,178,1,100,1,1852
"24005400800",1535,56,620,76,365,0,225,16,2893
"24005400900",1380,218,323,55,149,7,415,157,2704
"24005401000",1888,35,281,40,73,0,42,0,2359
"24005401101",1034,111,4480,465,609,64,149,0,6912
"24005401102",101,32,730,101,92,53,22,1,1132
"24005401200",625,22,2029,210,196,35,144,13,3274
"24005401301",723,76,2754,33,157,31,103,0,3877
"24005401302",413,0,1854,191,136,11,53,0,2658
"24005401400",1555,33,0,0,102,0,41,0,1731
"24005401503",5560,166,102,51,865,11,345,49,7149
"24005401504",2595,268,2213,81,1302,104,228,0,6791
"24005401505",1844,160,1824,70,485,57,481,0,4921
"24005401506",631,23,3416,88,723,263,35,176,5355
"24005401507",1065,85,2703,267,1249,403,604,77,6453
"24005402201",1640,171,1211,526,131,12,43,32,3766
"24005402202",902,0,428,5,227,0,53,0,1615
"24005402302",470,52,4380,217,384,50,342,0,5895
"24005402303",496,204,5259,397,41,189,344,119,7049
"24005402304",271,35,3398,251,12,6,141,14,4128
"24005402305",349,27,1470,278,55,1,73,0,2253
"24005402306",257,54,3111,263,252,47,106,45,4135
"24005402307",597,44,3606,1229,243,0,337,0,6056
"24005402403",219,23,1744,178,44,21,71,0,2300
"24005402404",190,151,4328,392,85,116,27,116,5405
"24005402405",656,46,2155,233,165,0,376,25,3656
"24005402406",295,3,4948,638,498,43,284,37,6746
"24005402407",368,44,913,44,70,74,26,0,1539
"24005402503",458,63,3206,762,278,42,56,9,4874
"24005402504",679,11,3012,347,150,0,104,0,4303
"24005402505",169,150,2717,105,204,2,0,1,3348
"24005402506",569,37,3298,175,146,12,76,0,4313
"24005402509",3014,208,4675,4,992,30,592,0,9515
"24005402602",335,48,1414,255,69,20,71,20,2232
"24005402603",910,159,4637,143,171,0,95,0,6115
"24005402604",788,148,3982,741,150,0,199,20,6028
"24005403100",522,43,1479,69,93,10,34,0,2250
"24005403201",271,102,2572,155,152,0,138,12,3402
"24005403202",169,0,1518,104,174,32,38,0,2035
"24005403300",944,58,1096,27,227,0,112,0,2464
"24005403401",1662,120,1163,62,185,14,94,3,3303
"24005403402",1878,390,1909,185,153,68,280,73,4936
"24005403500",4258,184,147,70,651,69,30,0,5409
"24005403601",4038,121,160,11,280,6,11,6,4633
"24005403602",3814,151,396,209,930,133,110,43,5786
"24005403701",5015,353,992,210,686,76,202,123,7657
"24005403702",2948,94,876,160,326,0,146,0,4550
"24005403801",1404,68,13,0,176,0,26,0,1687
"24005403802",2525,140,136,0,51,0,10,0,2862
"24005403803",2917,139,81,0,137,0,36,0,3310
"24005404101",2248,150,1757,320,372,76,146,12,5081
"24005404102",2527,301,2228,88,637,138,647,0,6566
"24005404201",2537,163,2529,265,939,145,465,40,7083
"24005404202",2179,312,4132,525,1069,170,1088,296,9771
"24005404402",4433,207,810,57,543,0,151,0,6201
"24005404403",2154,443,1653,384,187,284,508,37,5650
"24005404404",2831,158,966,204,470,53,138,67,4887
"24005404501",4289,343,1518,207,597,16,774,121,7865
"24005404502",2242,195,658,578,333,70,735,45,4856
"24005404600",2305,155,40,15,81,0,94,31,2721
"24005404800",1717,16,211,0,68,0,76,0,2088
"24005404900",3762,310,177,28,359,0,102,0,4738
"24005405000",4089,247,112,9,117,0,20,102,4696
"24005406000",5184,144,90,3,85,0,135,0,5641
"24005407001",2787,88,87,0,147,0,36,0,3145
"24005407002",5476,63,26,19,427,0,98,0,6109
"24005408100",4713,65,315,0,552,0,233,0,5878
"24005408200",1712,29,78,0,59,0,45,0,1923
"24005408302",2360,95,0,0,493,35,54,0,3037
"24005408303",3035,35,172,0,290,0,46,0,3578
"24005408304",4096,132,179,0,453,57,154,0,5071
"24005408400",457,54,23,0,74,0,23,0,631
"24005408502",4273,66,0,1,429,12,180,0,4961
"24005408503",1523,243,735,27,426,211,114,21,3300
"24005408505",2892,245,118,86,567,21,125,102,4156
"24005408506",2152,405,1298,93,509,33,452,0,4942
"24005408507",2809,455,1291,15,1638,321,676,21,7226
"24005408601",3647,23,0,0,366,6,203,0,4245
"24005408602",1763,34,19,0,285,0,164,8,2273
"24005408702",2166,68,39,0,126,0,33,0,2432
"24005408703",5144,164,172,21,613,0,79,0,6193
"24005408704",4510,85,20,0,1010,22,122,0,5769
"24005408800",1908,148,11,17,307,53,74,9,2527
"24005408900",2301,103,245,49,173,0,0,0,2871
"24005410100",4856,276,79,17,161,0,113,0,5502
"24005410200",4372,195,9,0,354,0,40,0,4970
"24005411101",2099,38,80,0,25,0,5,0,2247
"24005411102",2839,18,28,1,17,9,10,15,2937
"24005411201",3130,44,26,0,22,0,44,0,3266
"24005411202",3224,26,59,34,135,0,15,0,3493
"24005411302",2487,160,296,11,530,125,91,2,3702
"24005411303",4034,174,566,106,558,263,175,185,6061
"24005411306",3925,94,605,0,1051,72,54,0,5801
"24005411307",2322,93,474,51,833,60,135,0,3968
"24005411308",2831,27,208,17,429,0,39,0,3551
"24005411309",6395,157,634,0,1237,71,133,0,8627
"24005411404",3089,60,219,29,345,12,33,0,3787
"24005411406",3800,215,207,1,233,6,110,0,4572
"24005411407",6423,910,1365,129,1266,96,121,0,10310
"24005411408",2074,244,393,0,476,34,216,78,3515
"24005411409",3791,80,521,286,604,30,236,70,5618
"24005411410",3427,85,358,80,691,85,101,0,4827
"24005420100",3210,291,2,31,305,0,9,11,3859
"24005420200",1897,122,123,7,172,7,104,0,2432
"24005420301",1766,219,138,235,145,37,0,57,2597
"24005420302",2060,165,75,83,173,3,239,28,2826
"24005420303",1217,102,5,0,26,0,4,0,1354
"24005420401",3786,537,810,99,995,0,88,0,6315
"24005420402",1685,120,20,27,203,26,125,10,2216
"24005420500",2352,371,149,35,336,0,259,21,3523
"24005420600",2756,884,241,30,159,83,181,78,4412
"24005420701",2181,322,174,0,758,0,281,0,3716
"24005420702",1369,225,142,0,179,65,57,23,2060
"24005420800",2665,336,123,0,269,128,168,107,3796
"24005420900",2310,541,181,166,54,167,37,138,3594
"24005421000",1076,410,132,50,36,51,23,0,1778
"24005421101",2054,312,359,13,268,66,276,0,3348
"24005421102",1697,257,116,0,83,33,84,18,2288
"24005421200",1415,129,130,17,34,0,17,0,1742
"24005421300",423,153,1446,543,222,25,0,0,2812
"24005430101",1612,424,899,457,643,333,1157,591,6116
"24005430104",2207,319,208,0,393,11,245,172,3555
"24005430200",1867,312,228,189,259,36,105,128,3124
"24005430300",2940,312,945,988,273,141,861,72,6532
"24005430400",3549,365,329,74,139,89,302,118,4965
"24005430600",2062,103,100,44,91,15,62,8,2485
"24005430700",4616,58,191,45,380,66,111,0,5467
"24005430800",2617,148,198,0,411,43,11,17,3445
"24005430900",2196,186,1189,20,1508,535,190,0,5824
"24005440100",3610,272,215,1,420,77,164,12,4771
"24005440200",1648,159,327,88,147,0,18,0,2387
"24005440300",930,45,493,136,371,38,95,22,2130
"24005440400",3545,185,832,111,601,0,297,0,5571
"24005440500",2325,64,186,33,345,35,104,9,3101
"24005440600",1529,58,447,0,246,16,48,0,2344
"24005440701",1961,359,2572,490,1242,37,887,106,7654
"24005440702",2885,56,1079,131,736,13,271,0,5171
"24005440800",1492,72,916,68,764,47,72,0,3431
"24005440900",1266,324,1545,235,401,23,163,66,4023
"24005441000",903,13,2159,421,91,84,27,74,3772
"24005441101",1373,66,634,53,74,0,138,0,2338
"24005441102",2634,283,1136,416,361,98,208,73,5209
"24005450100",3328,322,75,3,85,0,110,12,3935
"24005450200",2830,198,98,0,127,7,160,0,3420
"24005450300",2459,305,106,100,242,17,78,0,3307
"24005450400",1778,214,26,0,155,15,62,7,2257
"24005450501",2594,461,626,195,282,71,14,9,4252
"24005450503",1898,584,2486,369,662,68,924,54,7045
"24005450504",1803,99,2365,619,112,53,166,13,5230
"24005450800",1818,671,863,433,188,0,238,0,4211
"24005450900",3278,189,405,2,32,0,11,0,3917
"24005451000",1488,105,46,8,25,0,36,0,1708
"24005451100",1044,88,633,202,192,0,93,0,2252
"24005451200",2782,277,318,0,95,22,48,15,3557
"24005451300",2188,574,672,64,256,18,108,198,4078
"24005451401",1040,116,1769,211,755,4,219,6,4120
"24005451402",2226,896,1676,610,147,43,545,244,6387
"24005451500",2293,165,1229,99,199,2,0,24,4011
"24005451600",1743,188,73,0,89,0,22,4,2119
"24005451701",2423,145,490,9,23,103,32,87,3312
"24005451702",1731,81,0,0,20,0,0,0,1832
"24005451801",4045,307,892,148,70,16,0,32,5510
"24005451802",3000,317,66,13,159,43,16,0,3614
"24005451803",3238,262,530,45,69,32,101,32,4309
"24005451900",2211,88,132,0,20,13,0,0,2464
"24005452000",2007,141,233,18,0,0,25,0,2424
"24005452100",2766,317,263,0,16,88,243,0,3693
"24005452300",1901,419,352,0,177,42,309,165,3365
"24005452400",2579,205,302,0,205,17,0,0,3308
"24005452500",2882,292,113,0,264,24,184,52,3811
"24005490100",3587,164,81,6,140,0,128,0,4106
"24005490200",2332,81,112,13,301,1,83,3,2926
"24005490301",2953,1021,667,97,345,353,191,92,5719
"24005490302",1873,156,207,43,160,21,38,0,2498
"24005490400",1466,61,44,3,120,0,24,6,1724
"24005490500",3295,77,23,0,181,0,49,6,3631
"24005490601",1985,14,72,3,144,0,71,8,2297
"24005490602",2346,285,28,0,192,33,223,0,3107
"24005490603",1845,73,30,20,156,6,60,14,2204
"24005490605",70,232,0,18,5,1,0,0,326
"24005490701",1338,55,13,9,17,0,0,0,1432
"24005490703",2432,159,268,49,230,49,120,0,3307
"24005490800",2732,493,35,27,237,75,29,0,3628
"24005490900",2812,526,468,71,347,108,290,0,4622
"24005491000",1976,20,67,19,132,0,77,7,2298
"24005491100",2510,118,943,170,366,0,239,16,4362
"24005491201",1351,145,187,16,104,0,44,0,1847
"24005491202",1330,37,158,220,94,4,60,0,1903
"24005491300",952,382,1036,519,394,174,72,0,3529
"24005491401",654,63,4277,821,41,0,43,0,5899
"24005491402",921,126,1715,453,156,29,127,0,3527
"24005491500",2068,544,457,137,443,331,154,459,4593
"24005491600",1563,71,693,97,252,26,16,13,2731
"24005491701",2484,205,664,59,339,45,261,10,4067
"24005491900",1531,131,70,30,191,4,70,0,2027
"24005492001",1115,42,138,0,174,36,67,0,1572
"24005492002",2864,257,553,167,37,0,103,0,3981
"24005492101",2499,294,520,68,260,9,232,2,3884
"24005492102",1850,91,105,3,77,8,76,18,2228
"24005492200",3577,162,589,184,336,13,96,62,5019
"24005492300",2942,315,474,5,121,8,104,8,3977
"24005492401",259,106,2745,132,378,90,40,47,3797
"24005492402",2198,75,3094,587,636,15,282,50,6937
"24005492500",44,78,9,9,0,22,0,0,162
"24005492600",2058,112,825,187,553,106,30,0,3871
"24005980000",0,0,0,0,0,0,0,0,0
"24005980100",0,0,0,0,0,0,0,0,0
"24005980200",0,0,0,0,0,0,0,0,0
"24009860101",2488,174,284,9,280,0,81,0,3316
"24009860102",2132,48,156,0,94,0,101,16,2547
"24009860200",5138,146,858,48,263,7,249,12,6721
"24009860300",3487,74,471,41,168,26,57,27,4351
"24009860401",7659,691,598,85,589,201,293,0,10116
"24009860402",2493,255,454,0,184,0,38,0,3424
"24009860501",4958,138,703,13,191,0,41,0,6044
"24009860502",2581,179,339,0,131,0,282,0,3512
"24009860600",6376,111,781,45,501,0,85,0,7899
"24009860701",1928,209,232,19,266,1,164,0,2819
"24009860702",1778,114,820,235,160,16,58,0,3181
"24009860703",2423,101,1024,94,211,95,148,21,4117
"24009860801",5449,163,767,120,314,31,171,0,7015
"24009860802",4182,74,401,61,200,17,302,17,5254
"24009860900",4936,227,931,304,135,2,336,2,6873
"24009861001",1091,17,46,0,23,0,31,0,1208
"24009861003",4575,398,590,154,137,18,136,0,6008
"24009861004",5839,402,619,2,564,42,156,139,7763
"24009990100",0,0,0,0,0,0,0,0,0
"24011955000",1866,824,206,16,311,17,468,453,4161
"24011955100",4416,396,258,16,264,9,116,25,5500
"24011955201",2462,356,508,167,183,3,108,0,3787
"24011955202",1588,143,304,50,43,78,16,10,2232
"24011955301",2835,582,250,33,57,0,127,44,3928
"24011955302",1933,364,262,270,235,40,273,48,3425
"24011955400",1757,161,133,66,52,5,16,0,2190
"24011955500",3289,311,463,29,136,31,0,36,4295
"24011955600",2374,445,749,559,89,115,113,33,4477
"24013501001",3446,392,199,0,249,33,133,60,4512
"24013501002",4289,422,38,61,0,173,19,0,5002
"24013502000",3865,138,6,0,101,0,60,0,4170
"24013503000",4803,227,103,0,41,0,11,0,5185
"24013504100",4337,237,333,13,187,0,145,0,5252
"24013504201",5312,235,42,0,591,0,244,0,6424
"24013504202",5526,95,107,35,13,18,155,18,5967
"24013505101",4032,73,128,0,100,0,73,0,4406
"24013505102",5056,130,48,8,211,0,70,0,5523
"24013505203",2318,118,40,12,279,18,56,0,2841
"24013505205",2962,19,47,0,351,0,188,12,3579
"24013505206",3195,55,18,0,198,0,88,0,3554
"24013505207",3243,96,135,0,284,21,144,0,3923
"24013505208",5282,139,120,22,179,0,282,0,6024
"24013506101",4041,40,279,0,140,0,32,0,4532
"24013506102",3852,1,33,18,121,1,91,3,4120
"24013506200",4234,315,69,31,175,43,0,0,4867
"24013507500",2735,295,153,47,187,0,67,50,3534
"24013507601",3627,967,121,59,192,60,255,270,5551
"24013507602",3282,114,303,85,131,0,29,3,3947
"24013507702",2994,195,256,20,160,47,162,16,3850
"24013507703",2824,192,34,12,14,0,0,0,3076
"24013507704",5122,338,410,71,307,85,261,33,6627
"24013507801",4509,542,292,60,186,73,340,162,6164
"24013507802",4192,173,49,22,28,39,19,0,4522
"24013508101",4428,177,46,0,90,0,53,0,4794
"24013508102",2881,133,46,15,96,0,97,0,3268
"24013508200",6617,383,25,0,135,0,159,122,7441
"24013509001",3919,96,19,22,52,0,86,12,4206
"24013509002",2345,271,0,0,87,0,110,0,2813
"24013510000",1273,48,0,0,12,0,3,0,1336
"24013511000",3202,137,52,0,112,9,71,0,3583
"24013512000",1149,100,95,28,23,16,12,16,1439
"24013513001",4142,251,39,0,185,0,82,55,4754
"24013513002",5035,212,85,1,304,27,53,68,5785
"24013514100",3194,216,66,2,114,1,12,33,3638
"24013514201",4607,171,79,4,138,0,167,0,5166
"24013514202",2921,150,24,0,199,0,40,0,3334
"24015030100",3957,700,217,2,198,14,39,14,5141
"24015030200",4381,130,129,10,25,0,317,0,4992
"24015030400",2619,1169,371,335,35,306,159,293,5287
"24015030501",3618,213,78,9,46,22,2,0,3988
"24015030503",4113,507,212,2,350,59,348,132,5723
"24015030505",2791,96,303,170,246,0,224,0,3830
"24015030506",5262,328,1039,77,539,155,505,0,7905
"24015030601",3308,169,32,0,49,0,67,0,3625
"24015030602",3706,275,822,11,105,117,112,46,5194
"24015030700",4600,268,77,0,100,11,30,0,5086
"24015030903",3945,446,718,128,123,74,120,0,5554
"24015030904",6420,142,114,1,170,0,0,0,6847
"24015030905",2419,575,49,10,55,0,54,110,3272
"24015030906",7915,1167,387,54,338,26,90,0,9977
"24015031201",5571,553,349,52,98,33,381,4,7041
"24015031202",3546,293,561,66,621,88,502,70,5747
"24015031301",3432,199,58,24,115,9,170,0,4007
"24015031302",6233,616,13,1,214,3,37,0,7117
"24015031400",3524,464,31,0,73,0,80,0,4172
"24017850101",1931,54,3178,193,440,34,369,0,6199
"24017850102",990,161,955,63,155,73,46,0,2443
"24017850201",688,0,187,2,146,0,193,0,1216
"24017850202",2182,216,1898,187,388,46,99,11,5027
"24017850300",1378,54,509,231,187,36,0,21,2416
"24017850400",2230,222,1021,230,202,35,8,0,3948
"24017850500",2213,81,306,96,155,0,14,0,2865
"24017850600",2640,29,1576,61,447,19,65,0,4837
"24017850706",1718,60,2921,2,587,458,189,15,5950
"24017850708",1904,56,2593,204,551,14,138,28,5488
"24017850709",1153,14,4627,230,590,0,160,0,6774
"24017850710",1823,70,3017,131,387,8,269,8,5713
"24017850711",1056,28,2620,482,952,12,365,3,5518
"24017850712",2067,182,2722,47,408,10,156,0,5592
"24017850713",3030,118,3458,180,509,20,349,39,7703
"24017850801",2740,70,1690,171,401,10,208,0,5290
"24017850802",1711,210,1621,47,284,46,236,127,4282
"24017850901",1407,124,2762,864,407,0,63,57,5684
"24017850902",2729,495,2164,178,866,76,741,421,7670
"24017850904",1814,89,3847,233,770,0,433,0,7186
"24017850905",1755,26,1828,188,440,141,493,0,4871
"24017850906",1298,215,1944,807,238,99,58,20,4679
"24017851001",2081,161,399,3,150,0,78,0,2872
"24017851002",5886,395,1375,467,620,71,398,40,9252
"24017851100",1972,11,316,25,151,0,55,4,2534
"24017851200",3417,366,540,182,118,21,23,15,4682
"24017851301",3748,353,421,9,287,0,364,0,5182
"24017851302",3056,187,365,47,282,0,95,0,4032
"24017851400",5863,370,1694,373,630,37,315,56,9338
"24017851500",2232,52,4821,148,1063,89,614,10,9029
"24017990000",0,0,0,0,0,0,0,0,0
"24019970100",1847,157,610,68,115,15,40,0,2852
"24019970200",2817,283,907,506,220,107,192,71,5103
"24019970300",3696,353,413,49,242,0,148,42,4943
"24019970400",2031,483,423,277,162,35,190,5,3606
"24019970500",782,77,1510,1150,192,25,163,40,3939
"24019970600",1827,303,1825,668,123,98,147,12,5003
"24019970702",3264,321,49,39,107,25,80,31,3916
"24019970804",1953,87,81,19,46,17,105,54,2362
"24019970900",1103,98,337,7,102,8,74,0,1729
"24019990000",0,0,0,0,0,0,0,0,0
"24021740200",4038,163,97,150,185,22,140,22,4817
"24021750100",1053,105,136,5,53,5,44,0,1401
"24021750200",1451,145,23,0,55,19,40,0,1733
"24021750300",753,270,239,185,55,18,126,82,1728
"24021750503",3071,578,1613,103,1281,0,2095,214,8955
"24021750504",2606,163,1660,748,737,46,1008,39,7007
"24021750505",2706,736,759,171,2033,622,1635,1132,9794
"24021750506",2677,178,608,0,493,20,648,33,4657
"24021750600",1752,99,20,14,137,0,91,0,2113
"24021750701",3262,106,1109,44,671,0,590,60,5842
"24021750702",2194,143,671,322,324,77,455,83,4269
"24021750801",2006,338,414,136,97,8,45,113,3157
"24021750802",3496,40,332,66,263,13,416,0,4626
"24021750803",4326,192,794,50,569,102,579,44,6656
"24021751001",524,30,326,33,180,0,45,27,1165
"24021751002",3487,58,697,341,324,0,90,0,4997
"24021751003",2535,291,776,257,1142,157,661,149,5968
"24021751004",2813,155,665,11,101,8,465,78,4296
"24021751201",3411,94,505,35,744,45,441,0,5275
"24021751202",4292,102,673,129,690,124,423,0,6433
"24021751203",1737,74,85,0,39,0,72,0,2007
"24021751301",2550,175,48,0,132,0,96,0,3001
"24021751302",2481,172,45,0,272,0,147,0,3117
"24021751600",2620,155,70,0,73,0,101,0,3019
"24021751701",2252,66,32,0,30,0,106,9,2495
"24021751702",3416,322,1,11,142,99,50,24,4065
"24021751801",3673,230,194,13,334,0,423,8,4875
"24021751802",3877,32,18,0,22,47,40,7,4043
"24021751901",4333,47,181,0,86,59,160,45,4911
"24021751902",4997,280,108,22,328,132,314,22,6203
"24021751903",5687,0,263,0,270,0,31,0,6251
"24021751904",2692,72,325,86,231,0,148,53,3607
"24021752001",4455,70,136,0,258,0,33,29,4981
"24021752101",3056,10,49,0,177,0,68,0,3360
"24021752102",4150,47,0,0,10,6,15,0,4228
"24021752201",1840,46,94,18,186,0,33,1,2218
"24021752202",2707,0,284,0,1197,14,513,0,4715
"24021752204",4715,209,472,12,1568,60,526,0,7562
"24021752301",2799,250,785,148,775,82,493,160,5492
"24021752302",3787,116,79,12,162,0,199,14,4369
"24021752303",2583,72,249,0,355,0,308,5,3572
"24021752501",4563,128,19,19,66,22,49,11,4877
"24021752502",2390,49,57,11,65,0,9,11,2592
"24021752601",3595,32,50,13,308,0,76,0,4074
"24021752602",2481,18,14,23,148,11,89,0,2784
"24021752603",3639,42,53,0,149,0,184,0,4067
"24021752801",2052,93,0,0,16,0,8,0,2169
"24021752802",3149,169,46,0,121,0,155,0,3640
"24021752900",2677,289,18,10,78,0,73,0,3145
"24021753001",4589,304,37,0,99,0,113,66,5208
"24021753002",2607,253,4,7,60,0,40,0,2971
"24021765100",2039,306,608,128,547,120,266,59,4073
"24021766800",3418,362,56,74,78,142,15,10,4155
"24021767500",2351,82,23,0,297,0,40,0,2793
"24021767600",3216,252,28,4,87,5,263,47,3902
"24021770700",3198,246,17,0,51,48,107,0,3667
"24021772200",1015,157,125,105,52,146,45,50,1695
"24021773500",3282,137,301,23,577,24,341,0,4685
"24021775302",3345,347,346,0,255,0,312,35,4640
"24021775400",2914,551,105,0,168,0,67,7,3812
"24021775600",3173,114,140,0,404,0,253,0,4084
"24023000100",3377,600,0,0,15,10,55,0,4057
"24023000200",3360,398,0,4,43,9,10,0,3824
"24023000300",2380,233,0,6,89,18,61,0,2787
"24023000400",2702,361,0,0,22,75,15,40,3215
"24023000500",3395,468,0,0,67,0,20,9,3959
"24023000600",5316,565,0,24,103,0,14,0,6022
"24023000700",4548,797,2,0,90,47,1,3,5488
"24025301102",2688,297,283,22,355,50,218,0,3913
"24025301105",3488,175,163,16,125,52,136,0,4155
"24025301106",3565,78,88,13,156,0,67,17,3984
"24025301107",2078,258,553,29,316,21,134,1,3390
"24025301108",2735,115,332,34,113,0,57,0,3386
"24025301201",1848,193,4,0,0,0,20,0,2065
"24025301202",5337,340,384,88,1002,13,222,0,7386
"24025301204",3062,115,206,115,361,0,99,0,3958
"24025301205",3335,168,468,0,218,0,529,0,4718
"24025301301",2901,363,862,11,447,32,213,25,4854
"24025301302",1947,238,2697,1519,479,46,213,119,7258
"24025301401",5243,749,846,324,277,16,306,193,7954
"24025301402",1757,204,358,6,118,110,141,122,2816
"24025301601",3299,397,2230,682,403,1,854,45,7911
"24025301602",3733,472,2909,124,987,19,445,0,8689
"24025301702",4610,571,2581,178,623,131,436,196,9326
"24025301703",2933,232,1123,1,457,29,181,40,4996
"24025301704",1983,271,731,31,439,0,217,0,3672
"24025302100",1873,140,26,0,7,0,15,12,2073
"24025302200",2119,272,217,1,75,0,0,0,2684
"24025302400",1860,591,535,207,123,0,30,1,3347
"24025302801",2410,219,650,80,224,10,140,0,3733
"24025302802",2861,342,1120,151,506,175,489,63,5707
"24025302901",857,398,531,466,259,168,190,130,2999
"24025302902",2145,252,1384,18,438,123,196,0,4556
"24025303101",5125,314,278,67,218,0,0,0,6002
"24025303102",2816,16,68,10,216,0,170,0,3296
"24025303201",4959,203,270,1,294,23,82,0,5832
"24025303203",2993,137,101,0,105,0,147,0,3483
"24025303204",4295,38,61,0,252,41,199,0,4886
"24025303205",1487,46,7,0,0,0,0,0,1540
"24025303206",3146,15,50,71,13,0,19,0,3314
"24025303300",5711,143,0,0,78,0,94,0,6026
"24025303400",4013,84,66,20,101,0,105,0,4389
"24025303501",5141,277,230,29,201,62,117,0,6057
"24025303502",3236,66,203,4,217,0,57,0,3783
"24025303602",3376,114,0,0,267,12,18,0,3787
"24025303603",5595,417,301,0,760,0,173,0,7246
"24025303605",4665,251,451,0,655,59,141,70,6292
"24025303606",2983,72,46,22,160,0,147,0,3430
"24025303700",3228,201,68,2,211,0,214,46,3970
"24025303801",1930,135,292,59,33,0,10,73,2532
"24025303802",1362,116,160,11,63,0,42,0,1754
"24025303803",4631,163,195,0,552,0,150,30,5721
"24025303900",1963,58,78,0,88,0,14,16,2217
"24025304101",3969,183,17,0,25,0,47,0,4241
"24025304102",3512,104,99,0,60,0,0,0,3775
"24025304201",5799,256,213,1,58,0,116,2,6445
"24025304202",6314,238,128,181,95,0,145,0,7101
"24025305100",6346,742,114,3,71,15,3,15,7309
"24025305200",1895,421,42,2,57,5,0,1,2423
"24025305300",1974,78,25,4,118,0,84,0,2283
"24025306100",1942,432,666,400,168,75,188,51,3922
"24025306200",1739,221,185,93,82,16,46,77,2459
"24025306300",1686,71,359,0,358,9,41,0,2524
"24025306400",4754,203,1084,0,539,49,210,0,6839
"24025306500",1087,131,553,0,292,0,186,0,2249
"24027601103",3408,117,1096,20,1543,130,241,51,6606
"24027601104",4089,79,792,21,1247,0,216,0,6444
"24027601105",2623,12,526,0,1251,0,99,0,4511
"24027601107",2239,855,582,85,1625,95,838,420,6739
"24027601108",2100,31,506,0,1137,82,85,0,3941
"24027601201",5134,277,1476,171,1066,33,621,1,8779
"24027601203",1188,89,1364,127,802,84,343,173,4170
"24027601204",3630,83,700,0,1175,120,1021,13,6742
"24027602100",5904,51,358,1,1468,79,197,18,8076
"24027602201",2342,22,139,126,704,132,89,11,3565
"24027602202",3930,52,222,37,1082,43,158,6,5530
"24027602302",3841,140,1380,184,1707,85,331,12,7680
"24027602303",2169,17,319,0,1282,7,78,0,3872
"24027602304",3250,62,300,8,1310,9,196,9,5144
"24027602305",2797,29,178,0,818,0,54,20,3896
"24027602306",3719,88,592,19,985,69,182,1,5655
"24027602600",2417,61,681,168,2936,356,506,2,7127
"24027602700",3816,56,327,4,819,53,231,33,5339
"24027602800",3283,66,504,0,2084,274,103,0,6314
"24027602900",1732,135,798,144,1505,223,215,35,4787
"24027603001",3954,43,146,1,1587,0,0,0,5731
"24027603003",3375,53,139,8,548,0,126,16,4265
"24027603004",5352,216,401,4,971,95,190,0,7229
"24027604001",5692,80,58,4,376,4,138,3,6355
"24027604002",6958,82,323,3,766,16,101,1,8250
"24027605102",6619,405,964,82,2071,121,390,15,10667
"24027605103",3983,107,230,1,724,11,141,3,5200
"24027605104",3764,57,133,17,1168,0,95,9,5243
"24027605401",2496,335,1340,96,781,68,251,241,5608
"24027605402",3201,180,1739,374,975,47,514,0,7030
"24027605502",2980,133,1078,238,949,110,29,2,5519
"24027605503",2420,453,2676,461,580,28,297,443,7358
"24027605504",1461,0,172,0,1115,0,45,0,2793
"24027605505",3581,60,427,15,1836,102,115,0,6136
"24027605601",3163,244,1489,581,888,29,239,18,6651
"24027605602",4628,109,1248,69,1283,93,435,20,7885
"24027606601",1978,42,602,11,282,14,44,0,2973
"24027606603",3536,74,2237,229,1577,322,1030,264,9269
"24027606604",2339,37,1261,30,669,101,651,20,5108
"24027606606",1668,64,1521,255,1213,107,137,1,4966
"24027606607",2841,50,1257,50,1112,96,1190,110,6706
"24027606701",2456,5,143,1,245,0,255,0,3105
"24027606704",3319,54,2029,29,1573,285,696,29,8014
"24027606705",1285,55,283,18,303,0,96,0,2040
"24027606706",2356,29,1106,47,1311,132,260,9,5250
"24027606707",1440,56,1127,589,532,41,231,16,4032
"24027606803",3596,90,1636,289,379,50,135,48,6223
"24027606804",2360,52,601,9,430,16,194,12,3674
"24027606805",2732,104,279,25,1109,5,134,2,4390
"24027606806",4082,160,899,16,1534,155,262,23,7131
"24027606901",2393,200,1560,78,1370,0,100,0,5701
"24027606904",1528,9,1833,9,1137,183,366,154,5219
"24027606905",3536,153,1412,335,1340,0,550,50,7376
"24027606906",3013,94,1686,47,1173,0,591,0,6604
"24027606907",1878,16,2444,110,1213,185,683,0,6529
"24029950100",3337,222,351,20,85,2,527,69,4613
"24029950200",3622,263,682,91,30,21,34,27,4770
"24029950300",2702,376,453,564,97,14,82,0,4288
"24029950400",2227,131,461,58,42,45,7,0,2971
"24029950500",2116,128,127,116,9,0,51,0,2547
"24029990000",0,0,0,0,0,0,0,0,0
"24031700101",3553,37,258,6,526,81,186,81,4728
"24031700103",3915,40,463,139,1062,24,363,3,6009
"24031700104",2947,56,1538,6,1258,51,1846,51,7753
"24031700105",3474,69,1575,0,891,134,667,28,6838
"24031700204",1768,134,40,1,82,0,88,0,2113
"24031700205",5188,250,643,86,1910,114,676,234,9101
"24031700206",4889,104,233,94,442,0,480,9,6251
"24031700207",3715,274,572,97,809,108,775,280,6630
"24031700208",1889,57,126,0,123,22,172,8,2397
"24031700304",3176,17,1572,320,3261,89,952,22,9409
"24031700306",3382,0,1318,0,2270,117,1059,0,8146
"24031700308",3126,70,1024,146,1260,26,955,0,6607
"24031700309",2580,314,1608,140,894,54,1215,202,7007
"24031700310",3345,66,1249,321,1220,26,1079,26,7332
"24031700311",3708,109,1500,109,3418,81,918,1,9844
"24031700312",3157,68,876,0,1285,68,705,10,6169
"24031700400",1720,131,122,2,75,6,83,0,2139
"24031700500",5215,134,435,35,579,18,420,14,6850
"24031700604",5052,11,244,0,1465,0,602,0,7374
"24031700606",2776,61,60,4,1538,14,221,18,4692
"24031700607",2877,66,303,113,4182,120,411,0,8072
"24031700608",3405,182,36,54,2132,37,442,48,6336
"24031700610",1583,60,67,0,383,67,333,19,2512
"24031700611",2237,77,767,26,3812,97,706,44,7766
"24031700613",2613,138,777,133,2170,181,364,79,6455
"24031700614",2703,215,836,78,1056,41,1146,125,6200
"24031700615",2221,34,105,0,565,0,152,0,3077
"24031700616",2792,96,523,0,1257,0,529,0,5197
"24031700704",1661,188,143,42,1076,155,722,128,4115
"24031700706",1477,128,963,95,1379,112,875,70,5099
"24031700710",3789,182,1077,80,1312,84,1744,96,8364
"24031700711",3502,72,592,68,1458,189,1201,27,7109
"24031700713",2513,100,1464,83,1720,106,2384,181,8551
"24031700715",2349,52,1377,181,2196,109,1705,74,8043
"24031700716",3606,259,1737,155,2240,76,1805,182,10060
"24031700717",2721,148,1334,39,2174,78,2552,110,9156
"24031700718",2491,119,747,31,1175,54,255,23,4895
"24031700719",3022,772,1882,184,2556,1062,2278,1339,13095
"24031700720",1665,0,534,284,1324,22,1208,0,5037
"24031700721",1325,79,713,67,881,28,1180,11,4284
"24031700722",1515,116,1009,286,1264,122,771,30,5113
"24031700723",1919,389,385,58,420,110,496,281,4058
"24031700724",808,513,667,155,1188,94,1265,480,5170
"24031700810",2157,462,1210,146,1005,45,655,304,5984
"24031700811",2175,37,1258,76,989,87,1331,34,5987
"24031700812",2457,79,346,141,833,119,954,69,4998
"24031700813",3072,330,1107,134,1353,274,1695,536,8501
"24031700815",2719,117,1988,264,2094,274,1418,0,8874
"24031700816",2992,295,1571,346,3315,120,2123,230,10992
"24031700817",2531,346,545,121,1628,85,499,17,5772
"24031700818",2149,100,2067,658,1600,477,1546,363,8960
"24031700819",4090,134,1525,191,1257,190,1836,286,9509
"24031700820",1080,93,977,98,659,131,700,143,3881
"24031700822",915,154,177,27,436,15,230,79,2033
"24031700823",2071,78,131,0,901,0,251,0,3432
"24031700824",2258,41,371,35,466,0,178,8,3357
"24031700826",4271,78,315,0,1036,0,338,0,6038
"24031700828",1582,12,45,0,556,95,54,0,2344
"24031700829",1889,98,129,30,1319,23,395,0,3883
"24031700830",970,90,902,23,715,57,463,61,3281
"24031700832",1512,99,370,189,932,146,1232,34,4514
"24031700833",1678,113,647,42,1385,251,1108,8,5232
"24031700834",2315,150,1088,210,1274,96,1423,197,6753
"24031700835",1946,117,911,7,1634,10,608,21,5254
"24031700901",1929,124,349,7,1079,403,180,7,4078
"24031700902",1751,62,584,162,1191,30,1052,1,4833
"24031700903",1145,64,272,44,456,31,640,53,2705
"24031700904",1108,114,207,142,1339,147,867,26,3950
"24031700905",2086,87,233,0,1629,78,272,0,4385
"24031701001",3650,434,237,0,1380,72,725,129,6627
"24031701002",2673,39,10,0,731,52,215,0,3720
"24031701004",3427,151,609,55,972,198,496,55,5963
"24031701005",2606,46,227,101,878,0,496,19,4373
"24031701006",3423,130,36,0,1513,0,412,35,5549
"24031701007",1707,25,463,9,848,41,58,0,3151
"24031701101",2718,111,233,0,1584,245,1117,268,6276
"24031701102",3946,314,336,305,1402,46,2045,263,8657
"24031701201",3698,528,375,0,1526,109,1418,295,7949
"24031701202",2383,79,60,0,133,7,342,0,3004
"24031701205",5089,113,408,82,994,20,308,13,7027
"24031701206",4986,87,128,3,1498,18,1025,0,7745
"24031701210",3192,14,106,5,668,6,198,15,4204
"24031701211",3170,201,881,269,2036,144,561,0,7262
"24031701212",1993,26,138,3,532,7,168,21,2888
"24031701213",5138,215,257,56,979,12,398,87,7142
"24031701214",2250,279,301,61,674,8,227,27,3827
"24031701215",3426,244,366,27,825,0,604,0,5492
"24031701216",2602,177,304,51,1540,36,304,19,5033
"24031701218",1387,141,196,17,634,56,354,0,2785
"24031701219",1233,203,295,228,1759,345,1220,238,5521
"24031701220",2157,42,388,28,1540,88,237,34,4514
"24031701221",2244,120,275,31,1710,0,65,37,4482
"24031701303",2740,46,308,0,328,0,123,6,3551
"24031701304",4411,102,747,0,720,0,692,0,6672
"24031701306",2615,102,83,0,278,0,136,0,3214
"24031701307",2196,25,502,75,979,205,315,1,4298
"24031701308",2019,9,320,0,609,122,190,0,3269
"24031701312",4847,19,386,105,1025,72,608,0,7062
"24031701313",2272,0,422,31,836,0,364,0,3925
"24031701314",1883,70,576,0,653,20,548,33,3783
"24031701315",3310,0,609,84,713,0,597,0,5313
"24031701316",4305,102,932,20,641,106,540,24,6670
"24031701317",3193,39,452,17,682,0,110,0,4493
"24031701407",2770,28,1693,30,1216,119,401,41,6298
"24031701408",3867,33,1085,24,1572,0,524,17,7122
"24031701409",1888,58,874,65,1631,13,491,71,5091
"24031701410",1720,185,3713,128,2112,129,866,176,9029
"24031701414",1770,21,2592,149,2097,353,758,165,7905
"24031701415",2326,57,2344,283,2474,13,1073,50,8620
"24031701417",1051,14,2921,379,1332,42,345,42,6126
"24031701418",939,78,1525,55,817,36,447,0,3897
"24031701420",2901,197,1784,14,1560,226,383,217,7282
"24031701421",103,13,1191,84,604,26,434,26,2481
"24031701422",240,27,2267,294,229,57,123,52,3289
"24031701423",619,0,2483,477,1197,175,527,49,5527
"24031701503",2397,6,1965,75,1788,180,910,0,7321
"24031701505",2749,166,2512,162,1012,82,643,54,7380
"24031701506",2242,229,1576,134,971,10,467,71,5700
"24031701507",2218,19,1067,97,1133,125,352,73,5084
"24031701508",217,92,1963,441,856,205,463,108,4345
"24031701509",1295,83,2471,532,1739,165,1666,213,8164
"24031701601",138,8,930,139,825,333,730,233,3336
"24031701602",837,148,1043,262,4474,533,3837,671,11805
"24031701701",2214,38,609,64,456,25,332,27,3765
"24031701702",771,73,690,30,346,299,309,274,2792
"24031701703",1501,27,1186,105,787,1,749,4,4360
"24031701704",1761,18,655,50,403,9,457,17,3370
"24031701800",2324,83,1737,378,358,36,174,11,5101
"24031701900",1149,154,730,54,945,206,1105,155,4498
"24031702000",1222,263,950,122,2118,1032,2564,1146,9417
"24031702101",1063,96,1767,127,2496,485,2201,451,8686
"24031702102",2640,48,174,3,275,12,85,0,3237
"24031702200",2783,25,565,9,1333,0,1101,0,5816
"24031702301",1436,250,776,105,627,516,1157,738,5605
"24031702302",1856,121,1000,94,845,157,721,58,4852
"24031702401",1668,80,523,7,318,6,174,0,2776
"24031702402",2161,138,1442,194,372,57,489,48,4901
"24031702500",2332,352,2032,441,1030,275,484,69,7015
"24031702601",1996,187,1392,95,693,159,423,137,5082
"24031702602",2124,590,1105,185,754,97,664,85,5604
"24031702700",2985,162,1647,329,1759,148,1498,137,8665
"24031702800",2865,98,1017,46,780,0,684,39,5529
"24031702900",3493,24,927,63,839,34,377,25,5782
"24031703000",1315,14,225,5,334,22,335,0,2250
"24031703100",2432,33,749,14,1133,83,935,26,5405
"24031703201",4321,159,699,84,2174,92,1928,13,9470
"24031703202",4320,52,347,66,1198,31,817,58,6889
"24031703206",1730,100,761,49,1030,3,605,21,4299
"24031703207",1529,131,1024,301,2690,761,2735,738,9909
"24031703208",3639,140,544,6,478,29,240,12,5088
"24031703209",3060,173,1377,0,1346,706,1009,657,8328
"24031703210",1794,68,723,0,798,346,748,316,4793
"24031703212",2528,82,2689,291,3548,72,2198,50,11458
"24031703213",920,439,1704,814,2255,406,1997,577,9112
"24031703214",1285,31,3105,442,2180,861,2273,808,10985
"24031703215",993,79,735,85,1628,48,1305,41,4914
"24031703216",1925,98,739,32,773,202,550,9,4328
"24031703218",1549,69,116,0,62,9,41,0,1846
"24031703219",2735,129,373,0,226,112,80,27,3682
"24031703220",1685,108,1936,187,827,115,1030,30,5918
"24031703221",2148,43,1241,325,1456,71,715,53,6052
"24031703301",2418,117,421,0,1713,109,1727,67,6572
"24031703302",1391,77,446,41,2537,166,2414,169,7241
"24031703401",1696,168,406,8,2531,376,2352,314,7851
"24031703402",1006,10,347,143,1927,91,1475,21,5020
"24031703403",820,91,484,185,1729,216,1666,151,5342
"24031703404",632,15,328,31,1683,326,1624,271,4910
"24031703501",2125,191,1898,352,2588,79,2833,60,10126
"24031703502",1531,95,175,104,695,341,400,345,3686
"24031703601",2502,42,332,126,1506,15,1121,8,5652
"24031703602",2428,0,98,0,525,0,668,0,3719
"24031703701",1291,176,597,11,1620,142,1877,239,5953
"24031703702",1336,105,519,0,1988,481,1353,504,6286
"24031703800",1179,56,578,282,962,255,872,190,4374
"24031703901",1771,132,379,48,828,24,410,32,3624
"24031703902",3172,216,1394,3,2753,428,2373,427,10766
"24031704000",3444,129,1563,69,1478,266,1514,259,8722
"24031704100",3913,86,198,0,319,14,243,17,4790
"24031704200",1628,65,105,0,166,26,135,31,2156
"24031704300",3430,12,45,3,363,18,328,18,4217
"24031704401",2486,60,233,54,546,6,582,6,3973
"24031704403",1173,38,122,9,255,0,114,0,1711
"24031704404",3662,108,182,57,941,0,322,29,5301
"24031704501",2788,104,49,0,533,40,401,72,3987
"24031704502",2091,24,0,0,412,6,98,2,2633
"24031704503",3651,65,93,16,386,11,396,11,4629
"24031704600",3793,57,17,37,868,61,222,0,5055
"24031704700",3412,23,35,10,385,57,243,0,4165
"24031704803",2564,213,58,10,695,78,483,41,4142
"24031704804",1221,98,33,9,329,3,112,46,1851
"24031704805",1498,42,91,31,266,77,92,13,2110
"24031704806",2335,72,158,10,421,19,215,12,3242
"24031705000",3230,128,226,0,409,41,271,14,4319
"24031705100",4243,48,224,3,443,96,311,73,5441
"24031705200",2863,24,97,0,179,6,147,0,3316
"24031705300",1804,41,0,0,88,3,56,9,2001
"24031705400",2727,18,0,0,182,0,105,0,3032
"24031705501",2079,68,21,0,229,117,177,127,2818
"24031705502",3514,50,28,0,250,0,254,3,4099
"24031705601",2511,22,36,0,318,0,199,0,3086
"24031705602",3553,124,65,0,923,22,545,0,5232
"24031705701",3829,90,190,4,327,22,218,8,4688
"24031705702",4448,91,0,0,207,0,398,9,5153
"24031705800",5257,126,114,0,687,17,131,0,6332
"24031705901",3236,45,136,0,563,0,325,31,4336
"24031705902",2983,18,140,0,984,45,243,14,4427
"24031705903",3449,38,32,0,868,0,251,0,4638
"24031706005",3571,177,38,2,1019,9,454,40,5310
"24031706007",4865,71,400,84,1990,0,504,0,7914
"24031706008",3940,42,15,0,1062,0,166,0,5225
"24031706009",4288,89,139,6,769,64,311,1,5667
"24031706010",1661,59,600,0,651,0,60,0,3031
"24031706011",3322,203,238,77,1113,25,348,0,5326
"24031706012",1616,214,273,104,837,157,445,34,3680
"24031706013",2435,91,25,0,510,0,541,13,3615
"24033800102",1248,38,939,89,366,179,310,220,3389
"24033800103",735,234,542,52,437,9,408,52,2469
"24033800105",1097,116,2062,50,656,0,516,25,4522
"24033800106",676,72,1505,73,281,19,173,0,2799
"24033800108",699,48,1695,292,361,84,225,53,3457
"24033800109",1049,130,1264,112,1000,165,1198,250,5168
"24033800203",3198,123,569,4,464,2,409,94,4863
"24033800206",967,3,2268,69,457,64,335,20,4183
"24033800208",2199,45,4111,360,1144,41,974,15,8889
"24033800209",539,8,1978,289,863,377,587,301,4942
"24033800210",318,78,1915,204,391,22,185,79,3192
"24033800211",606,45,1646,151,388,0,251,0,3087
"24033800212",1060,23,2448,125,758,351,459,10,5234
"24033800213",843,184,1991,130,1114,48,691,153,5154
"24033800214",805,49,1192,222,246,0,417,0,2931
"24033800215",363,23,1503,101,443,19,209,19,2680
"24033800401",1503,30,542,17,316,0,143,0,2551
"24033800402",3209,96,941,48,441,0,324,0,5059
"24033800403",2208,81,1337,148,279,41,326,19,4439
"24033800408",1404,38,4435,514,464,125,534,146,7660
"24033800409",2247,122,2393,109,726,8,329,23,5957
"24033800410",1766,28,2604,77,648,0,233,0,5356
"24033800411",1111,0,2036,164,507,0,330,0,4148
"24033800412",649,92,2091,136,494,0,298,51,3811
"24033800413",231,0,2982,429,385,0,123,0,4150
"24033800504",3227,52,899,8,620,86,591,66,5549
"24033800505",1899,78,470,27,92,0,215,14,2795
"24033800507",922,18,1930,21,177,16,246,0,3330
"24033800509",449,0,8671,269,461,48,36,38,9972
"24033800511",1630,34,2768,176,566,0,218,0,5392
"24033800513",2771,35,2168,174,611,0,510,0,6269
"24033800514",772,0,4141,14,790,0,79,0,5796
"24033800515",1324,84,2019,118,529,0,373,10,4457
"24033800516",1027,61,2725,53,135,0,152,1,4154
"24033800517",541,11,4585,90,347,13,53,0,5640
"24033800518",596,0,2492,68,174,7,223,0,3560
"24033800519",1065,25,2390,121,409,3,206,12,4231
"24033800520",46,0,1658,54,82,0,34,0,1874
"24033800601",195,61,1622,43,84,0,7,0,2012
"24033800604",131,4,1403,104,7,3,69,0,1721
"24033800605",718,123,3193,4,122,0,84,0,4244
"24033800606",228,40,4793,108,217,0,16,0,5402
"24033800607",745,12,4986,42,684,74,988,33,7564
"24033800608",216,0,4012,61,237,0,39,0,4565
"24033800701",484,36,4373,106,419,18,101,10,5547
"24033800704",480,7,4125,156,127,4,44,0,4943
"24033800705",587,10,3375,177,361,0,69,7,4586
"24033800706",418,10,2969,142,241,1,30,0,3811
"24033800707",397,0,2262,94,154,0,187,0,3094
"24033800800",1986,73,1001,18,447,6,563,0,4094
"24033800900",731,35,727,12,59,1,8,0,1573
"24033801003",1528,156,3539,48,434,36,447,104,6292
"24033801004",955,23,3079,78,496,30,143,0,4804
"24033801005",666,0,2936,134,292,0,55,11,4094
"24033801006",460,4,2804,264,396,2,159,0,4089
"24033801104",1745,142,583,45,566,22,279,7,3389
"24033801207",597,34,3506,192,295,0,158,0,4782
"24033801208",224,14,3599,78,163,0,132,0,4210
"24033801209",301,41,4526,129,300,0,414,0,5711
"24033801210",297,72,3608,248,389,0,270,21,4905
"24033801211",557,25,2597,17,40,39,132,0,3407
"24033801212",380,40,2924,33,283,6,232,6,3904
"24033801213",273,0,2753,147,297,71,197,71,3809
"24033801214",1004,36,2499,253,346,0,337,0,4475
"24033801215",259,11,2141,130,77,0,143,104,2865
"24033801216",359,28,2893,3,103,14,159,0,3559
"24033801217",289,1,2597,88,475,0,209,7,3666
"24033801302",1167,27,1098,14,299,0,26,0,2631
"24033801305",458,410,4191,267,659,2,409,399,6795
"24033801307",491,4,2647,110,556,12,112,15,3947
"24033801308",303,12,2722,168,577,38,238,0,4058
"24033801309",638,18,2532,54,439,1,95,0,3777
"24033801310",1087,75,4774,36,411,0,179,0,6562
"24033801311",476,149,5197,138,554,2,162,1,6679
"24033801312",362,15,2183,125,567,38,523,38,3851
"24033801313",471,72,2426,96,224,20,336,0,3645
"24033801404",649,26,2360,576,1032,175,669,109,5596
"24033801405",951,37,1821,375,1252,185,1237,158,6016
"24033801406",148,0,2128,138,252,0,180,0,2846
"24033801407",388,246,4959,237,393,58,594,0,6875
"24033801408",141,65,2518,318,164,247,86,49,3588
"24033801409",236,0,2025,77,566,166,260,145,3475
"24033801410",474,10,1793,20,807,20,194,10,3328
"24033801411",464,0,1473,113,801,298,346,298,3793
"24033801500",95,8,1992,194,333,45,251,39,2957
"24033801600",84,37,1770,459,125,0,94,29,2598
"24033801701",205,34,3299,765,40,0,23,0,4366
"24033801702",123,46,3327,342,75,12,96,44,4065
"24033801704",314,11,4708,698,97,18,245,18,6109
"24033801706",37,73,1223,73,130,0,10,60,1606
"24033801707",338,7,4035,387,1116,518,1357,503,8261
"24033801708",139,45,2584,222,336,0,207,27,3560
"24033801801",59,39,1444,280,168,11,128,39,2168
"24033801802",35,0,3007,228,21,45,0,0,3336
"24033801804",158,25,1786,228,10,5,98,0,2310
"24033801805",123,42,1625,278,67,79,46,0,2260
"24033801807",104,5,3662,324,19,0,71,0,4185
"24033801808",174,0,3207,426,175,0,212,0,4194
"24033801901",442,43,3608,111,707,10,709,0,5630
"24033801904",391,44,1953,187,219,156,235,107,3292
"24033801905",506,0,4432,45,367,11,20,0,5381
"24033801906",451,40,893,114,272,19,302,0,2091
"24033801907",122,53,2255,176,135,1,59,1,2802
"24033801908",107,0,2525,466,82,0,0,0,3180
"24033802001",247,0,4340,780,324,44,505,14,6254
"24033802002",18,2,3094,364,185,62,217,36,3978
"24033802103",494,19,2275,143,237,95,304,19,3586
"24033802104",189,6,1158,357,10,1,141,0,1862
"24033802106",154,0,3169,297,146,0,259,0,4025
"24033802107",47,5,2821,451,78,0,42,0,3444
"24033802201",175,6,1376,101,93,92,36,0,1879
"24033802203",755,22,3050,354,129,1,718,75,5104
"24033802204",96,21,5432,532,95,0,0,0,6176
"24033802301",98,51,2993,232,280,0,148,0,3802
"24033802404",38,79,3004,479,61,101,43,190,3995
"24033802405",101,0,3471,234,21,65,78,65,4035
"24033802406",92,17,1775,270,108,33,97,0,2392
"24033802407",204,31,2877,356,109,0,158,0,3735
"24033802408",141,25,1042,99,74,0,129,0,1510
"24033802501",36,0,2310,251,61,0,0,0,2658
"24033802502",208,33,2082,162,72,0,294,21,2872
"24033802600",96,0,2576,323,93,39,97,9,3233
"24033802700",224,31,1988,482,206,4,446,31,3412
"24033802803",125,2,4176,466,80,2,60,0,4911
"24033802804",44,42,4266,645,148,16,160,0,5321
"24033802805",48,76,3915,668,69,9,152,62,4999
"24033802901",320,17,2924,618,141,0,360,10,4390
"24033803001",502,54,1812,292,208,23,551,53,3495
"24033803002",17,3,2477,245,43,0,98,0,2883
"24033803100",50,29,2434,300,10,6,21,29,2879
"24033803200",119,7,1970,421,247,41,374,48,3227
"24033803300",385,139,2919,600,471,58,754,166,5492
"24033803401",193,0,774,217,120,0,304,0,1608
"24033803402",20,42,3684,696,67,25,110,17,4661
"24033803508",161,0,2890,881,273,100,266,38,4609
"24033803509",126,41,1845,466,374,222,441,255,3770
"24033803512",131,13,5424,345,264,22,146,0,6345
"24033803513",81,15,3819,526,272,54,32,0,4799
"24033803514",156,0,3357,498,41,0,10,0,4062
"24033803516",327,8,3660,215,600,0,140,0,4950
"24033803519",272,0,4459,194,80,0,252,0,5257
"24033803520",466,0,3179,36,115,0,111,0,3907
"24033803521",248,42,4297,361,421,32,82,32,5515
"24033803522",216,1,2898,274,125,0,150,0,3664
"24033803523",69,0,3644,262,148,8,0,0,4131
"24033803524",86,0,3482,379,82,0,149,0,4178
"24033803525",184,0,1497,293,97,0,192,0,2263
"24033803526",105,0,2865,53,120,0,31,0,3174
"24033803527",71,30,2703,156,63,56,39,0,3118
"24033803601",89,0,2997,186,515,0,0,0,3787
"24033803602",148,0,1687,157,174,20,238,20,2444
"24033803605",1759,257,3263,347,1295,19,1732,256,8928
"24033803606",979,139,3031,97,1026,199,1029,279,6779
"24033803607",998,18,2152,168,665,8,1123,0,5132
"24033803608",671,274,3392,99,1348,278,1611,541,8214
"24033803610",515,39,1624,360,755,26,896,83,4298
"24033803612",587,0,1729,243,572,29,762,29,3951
"24033803613",563,174,3392,451,438,94,738,105,5955
"24033803700",1049,75,794,106,455,56,1022,74,3631
"24033803801",776,18,1119,19,546,88,1145,97,3808
"24033803803",1046,17,3131,351,1425,136,1924,136,8166
"24033803900",1356,338,1004,18,1232,107,2286,440,6781
"24033804001",406,233,2993,991,265,113,649,287,5937
"24033804002",967,97,1222,26,1635,354,2208,440,6949
"24033804101",588,111,2185,234,228,9,134,50,3539
"24033804102",1140,173,3759,273,768,8,1300,156,7577
"24033804200",1452,52,1078,34,204,8,323,24,3175
"24033804300",442,49,1983,438,339,7,509,7,3774
"24033804400",1120,173,883,160,466,39,1129,183,4153
"24033804600",809,159,1106,107,867,74,1147,219,4488
"24033804700",1731,57,1035,91,603,53,1312,14,4896
"24033804801",334,31,1222,318,191,219,376,133,2824
"24033804802",417,144,1115,126,1032,130,1364,265,4593
"24033804900",216,42,2552,199,648,114,600,116,4487
"24033805000",363,125,3143,258,1626,26,1853,61,7455
"24033805101",541,42,1027,165,1872,501,2080,515,6743
"24033805201",494,22,2128,210,1500,464,2189,485,7492
"24033805202",324,2,2382,481,554,37,769,37,4586
"24033805500",713,78,784,98,2255,631,2663,663,7885
"24033805601",820,275,320,229,4072,979,4701,1231,12627
"24033805602",794,81,298,78,3951,707,4463,749,11121
"24033805700",634,66,1097,154,3876,675,3963,705,11170
"24033805801",383,33,1099,116,2815,299,2752,271,7768
"24033805802",477,145,1406,42,1609,844,1751,956,7230
"24033805904",757,131,600,53,1266,122,1313,90,4332
"24033805906",439,230,978,147,1011,298,990,475,4568
"24033805907",329,63,1975,172,1060,456,952,462,5469
"24033805908",181,57,1232,173,608,92,420,23,2786
"24033805909",898,109,1900,375,1285,217,956,152,5892
"24033806000",910,147,1624,209,2234,397,2264,493,8278
"24033806100",1480,79,1502,57,1051,82,1037,144,5432
"24033806200",1744,93,1148,227,543,0,655,0,4410
"24033806300",844,123,513,75,492,37,817,132,3033
"24033806400",2558,195,318,40,628,106,225,85,4155
"24033806501",2667,767,1075,104,527,281,2491,900,8812
"24033806601",1878,486,1000,170,747,180,2268,696,7425
"24033806602",1782,298,1905,160,1005,315,1982,287,7734
"24033806706",827,94,1361,141,722,162,477,46,3830
"24033806708",1839,254,1313,12,583,107,258,0,4366
"24033806710",878,59,3399,305,989,16,254,0,5900
"24033806711",581,16,3319,267,683,76,477,0,5419
"24033806712",356,0,2631,194,385,28,186,28,3808
"24033806713",747,171,1877,249,523,270,790,267,4894
"24033806714",1019,131,1427,487,564,157,1358,255,5398
"24033806800",2173,151,610,37,940,196,1150,55,5312
"24033806900",2384,140,646,94,1004,138,1247,54,5707
"24033807000",2344,1046,772,731,940,533,727,88,7181
"24033807102",1581,373,339,24,149,17,365,15,2863
"24033807200",554,1700,101,153,185,327,105,103,3228
"24033807301",1198,164,801,358,849,274,344,98,4086
"24033807304",736,44,501,48,634,5,801,17,2786
"24033807305",535,33,1167,136,1495,59,1051,69,4545
"24033807404",2021,103,1126,161,1539,141,1431,84,6606
"24033807405",2914,422,1143,185,1419,151,845,255,7334
"24033807407",1494,72,2411,103,2117,364,1388,339,8288
"24033807408",2454,282,1667,39,1182,53,408,0,6085
"24033807409",752,14,1173,484,1239,274,1234,236,5406
"24033807410",454,55,2125,489,855,429,817,315,5539
"24035810100",2402,237,476,84,23,51,31,2,3306
"24035810200",2225,187,235,0,47,6,183,56,2939
"24035810300",3641,365,284,317,43,8,70,79,4807
"24035810400",5780,101,283,90,61,0,37,0,6352
"24035810500",3926,134,183,259,82,0,116,0,4700
"24035810600",4037,429,126,10,203,1,232,148,5186
"24035810700",2738,412,432,57,171,9,142,26,3987
"24035810800",5078,148,179,0,98,0,93,0,5596
"24035810901",4516,146,85,0,123,0,62,19,4951
"24035810902",2761,91,63,0,128,0,88,0,3131
"24035811000",3580,297,144,107,305,42,196,45,4716
"24035990000",0,0,0,0,0,0,0,0,0
"24035990100",0,0,0,0,0,0,0,0,0
"24035990200",0,0,0,0,0,0,0,0,0
"24037875000",5383,433,606,131,366,35,234,0,7188
"24037875100",3998,198,376,26,320,16,99,0,5033
"24037875201",4422,173,230,0,89,0,59,0,4973
"24037875202",5274,263,480,119,165,10,110,113,6534
"24037875300",2396,295,375,32,140,42,30,8,3318
"24037875400",5868,212,342,214,190,8,10,0,6844
"24037875500",7779,142,652,49,440,0,433,24,9519
"24037875600",7149,174,1027,84,592,0,180,0,9206
"24037875700",6372,342,219,29,296,0,262,0,7520
"24037875801",916,30,111,5,177,3,173,3,1418
"24037875802",3741,70,154,11,186,0,85,0,4247
"24037875901",3979,153,1157,264,1148,37,387,0,7125
"24037875902",4135,540,2408,954,955,24,764,371,10151
"24037876001",2367,414,1335,765,197,111,320,63,5572
"24037876002",5232,380,1508,520,783,161,331,316,9231
"24037876100",6400,432,492,21,216,63,327,83,8034
"24037876200",4489,347,448,38,316,14,70,0,5722
"24037990000",0,0,0,0,0,0,0,0,0
"24039930101",1370,202,1732,976,60,77,0,0,4417
"24039930102",2001,397,816,223,128,168,0,215,3948
"24039930200",919,250,146,58,17,26,16,0,1432
"24039930300",1546,262,254,37,49,0,52,0,2200
"24039930500",2833,478,457,95,57,77,119,0,4116
"24039930600",1378,562,391,536,108,247,36,197,3455
"24039980400",21,6,5,2,0,2,2,2,40
"24039990100",0,0,0,0,0,0,0,0,0
"24041960100",3623,372,281,72,142,0,8,0,4498
"24041960201",3233,42,203,90,93,23,30,0,3714
"24041960300",2018,287,778,301,148,57,245,121,3955
"24041960400",3347,519,387,225,575,111,771,160,6095
"24041960501",3915,310,187,0,290,103,193,85,5083
"24041960502",2870,282,668,119,328,45,198,121,4631
"24041960600",1496,92,72,14,53,0,23,0,1750
"24041960700",2582,250,336,30,56,13,86,0,3353
"24041960800",1736,177,104,0,83,20,31,54,2205
"24041960900",3030,569,469,76,73,3,93,25,4338
"24041990000",0,0,0,0,0,0,0,0,0
"24043000100",2828,76,123,54,268,0,98,0,3447
"24043000200",2546,175,260,85,272,0,62,0,3400
"24043000301",2120,584,93,194,124,74,109,49,3347
"24043000302",1394,471,446,267,189,53,43,7,2870
"24043000400",526,335,471,423,78,77,38,0,1948
"24043000500",2794,864,709,367,467,376,403,150,6130
"24043000601",1118,318,321,85,242,108,163,97,2452
"24043000602",2716,208,157,69,41,24,14,0,3229
"24043000700",1441,703,196,141,150,91,0,53,2775
"24043000800",2224,413,304,361,193,20,185,49,3749
"24043000900",1387,782,280,429,162,228,25,117,3410
"24043001001",2963,832,328,226,477,286,192,127,5431
"24043001002",3163,421,85,86,142,19,122,39,4077
"24043010100",1117,70,0,0,13,50,9,9,1268
"24043010200",4160,306,23,2,68,0,0,0,4559
"24043010300",6222,252,333,153,299,0,237,0,7496
"24043010400",6198,711,840,0,603,290,507,20,9169
"24043010500",5855,237,29,6,143,97,27,0,6394
"24043010600",4343,380,1,0,108,56,39,3,4930
"24043010700",3052,236,19,0,23,25,11,4,3370
"24043010801",3835,232,40,51,146,0,18,0,4322
"24043010802",2087,288,42,0,107,31,19,0,2574
"24043010900",7525,109,130,117,235,0,440,0,8556
"24043011000",0,0,0,0,0,0,0,0,0
"24043011100",4898,482,324,319,144,14,169,227,6577
"24043011201",6453,744,990,48,648,38,670,0,9591
"24043011202",3544,471,362,36,204,26,257,148,5048
"24043011301",4258,317,86,30,267,8,187,21,5174
"24043011302",3208,240,112,25,175,0,67,0,3827
"24043011400",4611,451,68,6,190,0,12,0,5338
"24043011500",7354,565,55,27,86,27,68,12,8194
"24043011600",2688,182,20,14,125,0,85,5,3119
"24045000100",1628,768,2046,1054,339,205,521,435,6996
"24045000200",1151,231,338,115,68,33,89,95,2120
"24045000300",83,79,696,506,51,9,60,59,1543
"24045000400",2075,842,708,214,181,92,233,140,4485
"24045000500",892,332,1284,201,78,215,67,41,3110
"24045010101",3657,533,1058,222,330,174,72,155,6201
"24045010102",2300,221,643,143,35,11,115,0,3468
"24045010200",850,211,3650,869,254,41,210,107,6192
"24045010300",5104,274,1092,287,1060,0,358,18,8193
"24045010400",3885,667,727,27,24,48,219,0,5597
"24045010501",2478,360,794,55,1058,45,266,0,5056
"24045010502",3448,1818,1404,448,863,264,98,46,8389
"24045010603",5063,640,797,256,292,0,246,0,7294
"24045010604",4067,492,318,3,307,7,205,0,5399
"24045010605",3543,47,236,16,97,13,51,0,4003
"24045010606",3461,172,237,0,64,21,52,21,4028
"24045010701",3254,278,510,83,98,61,112,0,4396
"24045010702",5166,595,1436,389,433,17,570,41,8647
"24045010800",5267,546,697,196,58,47,0,0,6811
"24047950000",1575,76,3,56,15,4,70,0,1799
"24047950100",2054,121,41,7,15,0,225,0,2463
"24047950300",2819,204,0,0,22,0,37,0,3082
"24047950400",2448,217,47,65,154,0,102,1,3034
"24047950600",2464,292,91,0,129,0,287,0,3263
"24047950700",1991,151,15,0,116,0,52,0,2325
"24047950800",4314,500,536,0,44,0,21,0,5415
"24047950900",1347,204,108,26,29,0,58,0,1772
"24047951000",2544,178,1035,361,209,8,277,95,4707
"24047951100",5358,179,301,0,104,20,163,0,6125
"24047951200",2745,292,248,63,0,7,32,0,3387
"24047951300",1141,337,639,257,65,71,12,0,2522
"24047951400",2661,319,308,163,72,13,142,13,3691
"24047951500",1863,310,1776,718,444,27,21,0,5159
"24047951700",3055,244,157,77,79,0,43,6,3661
"24047980000",0,0,0,0,0,0,0,0,0
"24047990000",0,0,0,0,0,0,0,0,0
"24510010100",2356,337,15,10,164,0,108,36,3026
"24510010200",2378,272,396,0,114,132,122,168,3582
"24510010300",2149,170,13,14,200,8,186,0,2740
"24510010400",1980,121,49,2,223,0,60,2,2437
"24510010500",1404,111,28,40,62,10,68,1,1724
"24510020100",1366,105,80,67,282,53,213,26,2192
"24510020200",1088,322,264,8,197,57,225,223,2384
"24510020300",2977,273,37,0,328,198,245,188,4246
"24510030100",341,225,1108,1421,62,110,117,261,3645
"24510030200",1145,109,429,316,293,10,114,0,2416
"24510040100",1475,626,519,63,584,236,209,16,3728
"24510040200",117,54,98,68,19,23,4,4,387
"24510060100",888,233,917,467,268,78,403,152,3406
"24510060200",1410,177,781,777,95,70,299,130,3739
"24510060300",656,103,562,321,119,33,69,49,1912
"24510060400",242,73,621,393,31,13,0,6,1379
"24510070100",262,7,1636,1132,119,74,190,153,3573
"24510070200",7,26,1616,1235,159,0,98,12,3153
"24510070300",18,55,322,500,0,0,0,52,947
"24510070400",20,48,708,461,78,44,0,0,1359
"24510080101",735,10,2329,484,208,0,34,0,3800
"24510080102",26,6,1440,408,19,0,0,0,1899
"24510080200",0,0,1208,385,0,0,0,0,1593
"24510080301",16,19,1088,470,12,5,9,0,1619
"24510080302",0,27,1905,396,41,55,25,19,2468
"24510080400",5,204,508,261,0,18,0,118,1114
"24510080500",0,0,1220,545,18,0,18,0,1801
"24510080600",4,37,1686,563,0,35,0,0,2325
"24510080700",1,2,506,234,0,0,0,0,743
"24510080800",20,42,384,550,67,0,67,0,1130
"24510090100",433,79,2273,851,130,35,137,0,3938
"24510090200",420,26,2270,444,20,0,72,0,3252
"24510090300",685,186,2216,455,196,227,86,13,4064
"24510090400",69,5,1105,434,16,36,0,0,1665
"24510090500",220,120,1538,205,49,34,0,0,2166
"24510090600",19,0,2457,710,57,0,57,0,3300
"24510090700",26,76,2023,947,21,42,0,83,3218
"24510090800",88,0,1731,1017,48,78,47,0,3009
"24510090900",103,2,1519,724,0,4,147,0,2499
"24510100100",58,14,1330,826,0,0,0,0,2228
"24510100200",0,7,1386,1124,11,0,0,0,2528
"24510100300",0,0,0,0,0,0,0,0,0
"24510110100",1553,439,422,216,433,60,136,0,3259
"24510110200",2528,606,874,264,561,221,292,81,5427
"24510120100",2846,282,84,151,872,347,128,71,4781
"24510120201",1086,256,242,74,236,85,53,57,2089
"24510120202",1229,685,99,61,905,614,43,81,3717
"24510120300",1102,282,970,878,271,59,106,30,3698
"24510120400",213,66,761,607,24,0,39,20,1730
"24510120500",532,138,971,388,127,50,64,0,2270
"24510120600",680,366,525,614,174,80,54,165,2658
"24510120700",1322,212,553,170,162,260,66,24,2769
"24510130100",377,35,1409,760,58,52,22,35,2748
"24510130200",525,55,1483,1094,64,206,0,114,3541
"24510130300",69,6,1389,567,15,11,16,0,2073
"24510130400",68,7,1618,666,8,20,7,2,2396
"24510130600",2965,375,225,19,325,22,137,8,4076
"24510130700",3658,288,180,0,496,12,159,10,4803
"24510130803",1876,118,151,7,456,30,174,25,2837
"24510130804",1438,233,62,61,79,18,86,20,1997
"24510130805",140,10,625,138,21,0,4,0,938
"24510130806",848,141,250,13,43,0,80,1,1376
"24510140100",1941,235,1038,366,474,171,169,39,4433
"24510140200",70,46,1091,1153,22,0,4,8,2394
"24510140300",79,31,1370,975,65,75,12,13,2620
"24510150100",2,7,1728,1625,35,0,0,0,3397
"24510150200",0,0,1993,737,90,29,0,0,2849
"24510150300",0,0,1581,453,24,0,0,0,2058
"24510150400",0,0,2830,713,0,77,0,0,3620
"24510150500",15,0,1176,401,5,0,0,0,1597
"24510150600",0,0,1855,708,0,0,0,0,2563
"24510150701",39,7,1111,167,55,16,0,0,1395
"24510150702",25,0,1485,496,40,0,7,0,2053
"24510150800",0,35,2737,1017,127,12,43,0,3971
"24510150900",109,10,2312,577,0,0,59,10,3077
"24510151000",101,101,3042,1031,151,112,2,0,4540
"24510151100",77,45,5468,1143,166,0,0,0,6899
"24510151200",95,53,3173,1428,40,13,65,53,4920
"24510151300",205,80,2378,1985,61,36,187,11,4943
"24510160100",20,9,1176,909,103,74,42,0,2333
"24510160200",0,8,1583,880,0,0,0,3,2474
"24510160300",39,21,734,568,0,8,0,0,1370
"24510160400",0,15,1661,1321,28,0,0,0,3025
"24510160500",0,0,3304,973,0,0,96,0,4373
"24510160600",0,0,1618,894,40,15,71,16,2654
"24510160700",62,0,2458,1436,34,27,23,21,4061
"24510160801",12,22,2538,612,35,9,36,0,3264
"24510160802",8,39,2480,829,32,0,47,23,3458
"24510170100",297,87,739,270,79,0,45,0,1517
"24510170200",84,47,1201,1775,36,22,0,6,3171
"24510170300",9,9,1140,620,47,34,0,8,1867
"24510180100",28,17,840,1211,17,0,41,17,2171
"24510180200",20,45,479,396,17,17,0,15,989
"24510180300",458,234,576,339,96,20,16,0,1739
"24510190100",164,8,1138,595,28,6,139,12,2090
"24510190200",605,71,652,524,131,32,138,32,2185
"24510190300",310,224,1025,442,257,54,243,29,2584
"24510200100",7,7,803,819,0,0,0,0,1636
"24510200200",55,0,1450,933,66,0,0,0,2504
"24510200300",133,146,651,570,103,147,71,57,1878
"24510200400",50,30,979,467,43,74,0,38,1681
"24510200500",691,469,810,800,78,356,212,86,3502
"24510200600",431,363,1228,518,97,115,7,62,2821
"24510200701",100,40,3175,1136,143,0,98,24,4716
"24510200702",8,7,680,346,19,0,0,0,1060
"24510200800",246,30,1398,489,24,5,39,0,2231
"24510210100",503,207,962,442,71,26,48,18,2277
"24510210200",1164,240,833,602,186,50,51,9,3135
"24510220100",2946,360,486,242,231,86,230,0,4581
"24510230100",976,84,367,282,159,0,32,11,1911
"24510230200",1643,148,143,4,140,0,155,8,2241
"24510230300",919,96,27,16,49,0,42,0,1149
"24510240100",2729,141,54,4,102,15,126,2,3173
"24510240200",2522,98,123,0,253,0,95,0,3091
"24510240300",1580,134,35,46,122,59,86,6,2068
"24510240400",2428,39,34,40,332,57,149,37,3116
"24510250101",321,0,2951,702,153,123,82,0,4332
"24510250102",163,0,2136,693,42,6,0,0,3040
"24510250103",2176,399,441,236,150,29,172,26,3629
"24510250203",203,56,1055,463,113,52,177,0,2119
"24510250204",0,58,1469,2829,11,6,11,94,4478
"24510250205",1042,453,2281,433,257,8,224,9,4707
"24510250206",1429,265,147,43,87,33,84,7,2095
"24510250207",107,14,1506,388,131,80,111,5,2342
"24510250301",179,5,1483,770,7,0,159,0,2603
"24510250303",1048,353,245,153,186,103,106,126,2320
"24510250401",1548,535,883,285,241,84,239,56,3871
"24510250402",1170,342,1146,1267,821,202,665,131,5744
"24510250500",2668,797,1056,881,531,144,447,119,6643
"24510250600",0,0,0,0,0,0,0,0,0
"24510260101",1013,258,2300,526,404,154,213,150,5018
"24510260102",503,89,3831,466,140,0,148,0,5177
"24510260201",556,76,3008,1025,478,46,294,46,5529
"24510260202",514,124,3765,606,466,336,35,0,5846
"24510260203",177,55,1937,374,51,116,15,1,2726
"24510260301",240,27,2611,1176,48,12,25,0,4139
"24510260302",377,79,4384,1542,23,1,62,0,6468
"24510260303",142,99,343,240,6,4,50,0,884
"24510260401",1993,520,82,203,431,73,640,169,4111
"24510260402",26,8,2011,370,109,12,0,0,2536
"24510260403",112,0,1150,359,13,26,0,0,1660
"24510260404",491,171,589,199,391,238,606,204,2889
"24510260501",4034,229,617,39,545,195,1335,195,7189
"24510260604",288,29,315,492,129,19,178,19,1469
"24510260605",2321,437,574,157,407,406,489,526,5317
"24510260700",1179,420,18,42,534,212,534,342,3281
"24510260800",1327,205,378,237,205,133,691,216,3392
"24510260900",2201,231,142,5,147,31,203,39,2999
"24510261000",1514,191,601,643,195,71,638,218,4071
"24510261100",1653,146,84,61,28,0,41,61,2074
"24510270101",761,57,458,415,61,0,48,0,1800
"24510270102",631,109,2568,150,187,12,55,0,3712
"24510270200",850,74,652,29,174,12,33,5,1829
"24510270301",977,133,1402,259,253,0,112,0,3136
"24510270302",751,17,634,196,175,13,35,0,1821
"24510270401",1010,253,4212,315,111,71,77,45,6094
"24510270402",1180,92,1561,122,181,30,30,1,3197
"24510270501",2498,53,1447,142,79,0,38,0,4257
"24510270502",1499,164,1976,271,177,76,48,0,4211
"24510270600",1734,148,1998,612,183,0,119,0,4794
"24510270701",56,31,1982,518,36,39,73,31,2766
"24510270702",556,91,1016,197,112,76,90,76,2214
"24510270703",1389,132,832,42,109,18,83,0,2605
"24510270801",381,0,3034,745,97,7,70,0,4334
"24510270802",220,0,4522,894,183,1,159,24,6003
"24510270803",394,80,5183,922,160,47,13,36,6835
"24510270804",1476,135,885,485,76,4,181,2,3244
"24510270805",426,8,3921,476,339,25,278,0,5473
"24510270901",44,0,3366,391,96,0,0,0,3897
"24510270902",92,0,3372,310,47,7,0,0,3828
"24510270903",338,33,1835,299,207,41,163,49,2965
"24510271001",33,16,1907,508,38,2,6,2,2512
"24510271002",90,19,2608,1560,120,11,74,29,4511
"24510271101",760,107,474,306,114,29,16,0,1806
"24510271102",1041,38,160,0,4,0,38,0,1281
"24510271200",4609,204,614,136,558,33,135,0,6289
"24510271300",2090,156,217,0,303,0,36,0,2802
"24510271400",2784,197,80,71,266,109,148,0,3655
"24510271501",2985,245,465,80,391,34,167,11,4378
"24510271503",793,36,36,0,37,11,16,0,929
"24510271600",30,57,3012,1941,86,10,66,18,5220
"24510271700",29,0,3898,922,21,19,0,0,4889
"24510271801",19,21,2290,972,148,0,66,0,3516
"24510271802",7,0,1936,1043,18,15,39,0,3058
"24510271900",719,172,2198,761,64,80,0,75,4069
"24510272003",4113,212,1485,68,178,121,58,202,6437
"24510272004",2719,310,642,185,668,0,26,0,4550
"24510272005",2383,475,305,14,125,8,0,0,3310
"24510272006",1512,394,1759,252,85,151,78,105,4336
"24510272007",1641,299,1526,676,639,172,411,125,5489
"24510280101",360,98,2182,1222,109,63,156,44,4234
"24510280102",41,65,4082,1184,34,0,37,0,5443
"24510280200",107,101,3278,1150,146,26,32,0,4840
"24510280301",212,135,2223,801,327,62,34,41,3835
"24510280302",91,6,1445,539,29,0,15,0,2125
"24510280401",391,51,2668,414,120,0,60,0,3704
"24510280402",7,0,1672,179,49,0,7,0,1914
"24510280403",1345,42,3231,329,139,133,123,114,5456
"24510280404",38,11,1533,561,28,12,0,0,2183
"24510280500",54,115,694,1508,0,10,0,0,2381
"25001010100",2196,347,73,29,271,46,202,29,3193
"25001010206",2639,321,22,13,69,28,0,3,3095
"25001010208",1457,176,0,0,11,0,47,0,1691
"25001010304",1893,19,0,0,33,0,21,0,1966
"25001010306",2611,197,0,59,81,0,43,0,2991
"25001010400",2792,125,23,0,25,0,89,9,3063
"25001010500",2615,186,0,8,30,0,9,0,2848
"25001010600",2786,249,140,57,38,17,65,60,3412
"25001010700",2369,201,49,0,53,23,7,5,2707
"25001010800",4527,271,48,0,64,13,0,22,4945
"25001010900",4249,231,31,0,80,0,0,80,4671
"25001011002",3497,317,87,0,195,4,108,5,4213
"25001011100",4190,222,17,0,131,0,85,0,4645
"25001011200",2819,286,104,0,150,10,11,0,3380
"25001011300",2700,154,0,0,55,10,118,34,3071
"25001011400",2627,336,0,82,0,0,0,34,3079
"25001011500",3056,262,71,93,236,0,13,0,3731
"25001011600",1871,400,88,0,18,0,0,0,2377
"25001011700",1575,217,6,0,67,0,95,0,1960
"25001011801",2033,145,12,0,108,0,24,0,2322
"25001011802",3656,239,50,0,111,6,8,15,4085
"25001012001",5374,441,25,26,96,0,56,0,6018
"25001012002",2080,359,74,0,207,129,68,10,2927
"25001012101",4791,148,187,0,225,74,204,0,5629
"25001012102",2380,182,22,0,243,0,0,0,2827
"25001012200",4115,750,50,1,39,21,56,0,5032
"25001012502",2220,299,198,0,247,89,208,15,3276
"25001012601",2900,371,97,1,263,74,297,0,4003
"25001012602",2473,801,445,560,183,46,363,162,5033
"25001012700",3763,179,28,0,149,0,116,0,4235
"25001012800",3432,253,0,0,195,0,13,0,3893
"25001012900",3768,171,9,0,119,9,129,1,4206
"25001013002",2752,276,19,11,28,0,44,0,3130
"25001013100",4701,307,0,1,180,22,11,0,5222
"25001013200",4568,88,32,0,55,31,126,0,4900
"25001013300",2762,237,0,0,96,0,97,0,3192
"25001013400",3566,198,0,0,147,0,64,0,3975
"25001013500",6246,214,0,1,121,46,76,0,6704
"25001013600",5875,613,0,0,45,0,158,27,6718
"25001013700",3499,215,158,0,117,10,58,1,4058
"25001013800",4053,687,93,0,140,0,105,20,5098
"25001013900",4666,429,72,59,125,0,49,0,5400
"25001014002",3545,247,91,45,223,13,118,0,4282
"25001014100",613,41,24,0,60,0,176,0,914
"25001014300",3984,119,0,4,178,4,62,91,4442
"25001014402",5353,604,212,20,358,0,34,0,6581
"25001014500",4585,418,363,117,167,67,159,0,5876
"25001014600",3216,158,258,17,385,95,54,2,4185
"25001014700",2945,225,142,1,257,20,30,0,3620
"25001014800",2409,218,144,23,312,56,42,0,3204
"25001014900",3199,270,0,0,114,6,31,1,3621
"25001015001",3596,106,49,7,534,229,35,0,4556
"25001015002",2686,259,104,0,318,0,34,0,3401
"25001015100",3128,276,148,0,211,0,278,0,4041
"25001015200",2071,94,0,0,79,0,109,0,2353
"25001015300",1554,505,250,53,252,247,132,151,3144
"25001990000",0,0,0,0,0,0,0,0,0
"25003900100",1485,910,217,134,103,203,201,170,3423
"25003900200",2518,805,165,51,377,97,236,76,4325
"25003900300",2114,201,102,54,39,44,101,24,2679
"25003900400",3711,564,46,208,263,326,198,211,5527
"25003900500",2784,104,54,8,51,32,38,25,3096
"25003900600",1679,1015,454,298,150,107,136,55,3894
"25003900700",2335,323,47,13,26,6,39,0,2789
"25003900800",4501,199,151,0,74,12,32,12,4981
"25003900900",4067,501,353,55,298,84,396,93,5847
"25003901100",3114,95,14,0,125,29,13,0,3390
"25003911100",2802,92,27,22,61,16,0,0,3020
"25003912100",5458,956,0,29,161,0,166,0,6770
"25003913100",3993,492,11,0,105,109,104,0,4814
"25003914100",4980,559,13,7,118,53,113,53,5896
"25003920101",2547,165,20,4,165,83,31,51,3066
"25003920102",1520,230,52,33,172,27,3,65,2102
"25003921300",2940,638,14,0,135,134,141,57,4059
"25003921400",1421,296,0,0,33,42,40,0,1832
"25003921500",2579,437,9,0,39,0,50,66,3180
"25003922100",2083,296,14,0,58,14,30,1,2496
"25003922200",3354,331,0,0,56,29,13,0,3783
"25003922300",1894,134,9,7,26,1,33,0,2104
"25003923100",3004,143,0,17,0,10,10,10,3194
"25003924100",1616,203,38,15,121,0,42,0,2035
"25003925100",4901,393,43,0,559,111,749,135,6891
"25003926100",2777,387,11,1,44,0,12,0,3232
"25003931100",1424,162,5,0,11,1,2,0,1605
"25003931300",1320,75,45,12,41,16,27,2,1538
"25003931400",1590,124,5,0,56,0,17,5,1797
"25003932200",2051,162,19,0,49,1,29,6,2317
"25003932300",1941,101,17,0,17,17,7,4,2104
"25003933200",1102,107,0,15,21,10,12,0,1267
"25003933300",1279,124,1,0,47,0,15,0,1466
"25003933400",2051,174,2,11,101,0,32,6,2377
"25003934200",1016,45,22,0,91,20,8,0,1202
"25003934300",1583,74,31,1,66,3,21,3,1782
"25003935100",2327,86,9,3,58,23,17,2,2525
"25003935200",3915,882,12,16,273,26,58,151,5333
"25003935300",2921,526,5,17,25,210,54,4,3762
"25005600100",3402,143,172,0,114,43,0,0,3874
"25005600202",3882,181,271,17,366,3,116,5,4841
"25005600203",5209,50,86,36,150,30,196,54,5811
"25005600204",3350,185,283,7,126,34,40,11,4036
"25005610100",4653,132,106,0,487,13,335,0,5726
"25005610202",4883,105,92,9,212,10,65,38,5414
"25005610203",5715,204,238,0,488,53,40,0,6738
"25005610204",5175,140,84,1,559,38,345,58,6400
"25005611101",4038,159,12,2,189,0,7,0,4407
"25005611102",3024,363,0,16,71,18,13,35,3540
"25005611201",2748,137,0,16,44,0,19,6,2970
"25005611202",6192,236,13,0,137,41,0,0,6619
"25005612100",3924,311,4,1,333,37,99,36,4745
"25005612200",6966,485,429,40,799,112,195,32,9058
"25005613100",6029,275,405,0,104,0,101,0,6914
"25005613300",6311,378,169,102,99,53,216,44,7372
"25005613400",3277,241,8,0,74,15,84,48,3747
"25005613600",2654,554,223,22,115,175,177,82,4002
"25005613700",3232,335,197,0,120,21,43,50,3998
"25005613800",3124,1003,186,4,255,84,805,239,5700
"25005613901",1695,349,172,83,153,192,77,226,2947
"25005613902",4034,408,156,6,343,76,164,83,5270
"25005614000",2422,897,441,98,472,247,320,302,5199
"25005614101",4734,777,619,209,496,28,362,96,7321
"25005614102",6172,245,119,0,102,45,199,0,6882
"25005615100",6573,386,0,0,193,4,58,4,7218
"25005616100",6166,232,15,0,123,1,199,0,6736
"25005617101",4556,207,19,1,84,26,16,0,4909
"25005617102",3661,115,11,0,183,3,76,0,4049
"25005630101",2034,287,129,19,246,10,56,20,2801
"25005630102",3317,318,41,73,259,0,80,18,4106
"25005630200",7313,228,80,0,251,232,69,316,8489
"25005630300",7756,253,312,17,540,31,212,0,9121
"25005630400",4489,149,93,0,217,16,31,0,4995
"25005631100",6684,468,437,102,790,108,460,227,9276
"25005631200",6337,432,79,0,256,129,116,61,7410
"25005631300",4666,212,113,22,256,0,66,0,5335
"25005631400",1156,768,195,0,269,115,387,6,2896
"25005631500",2087,385,11,0,87,0,53,14,2637
"25005631600",2685,449,315,0,638,73,580,215,4955
"25005631700",5162,359,216,0,469,61,264,129,6660
"25005631800",5606,615,303,39,167,30,103,0,6863
"25005632100",6442,298,16,0,221,0,155,69,7201
"25005632200",6503,566,86,0,194,45,170,0,7564
"25005633100",5227,236,36,0,108,0,54,0,5661
"25005633200",5886,115,30,0,146,0,34,0,6211
"25005640100",3457,733,0,0,401,149,237,250,5227
"25005640200",3356,1202,56,88,256,386,198,356,5898
"25005640300",2599,538,81,221,382,214,460,198,4693
"25005640400",2284,461,49,9,35,38,144,0,3020
"25005640500",3200,783,16,42,710,233,338,142,5464
"25005640600",3048,932,208,32,248,249,300,236,5253
"25005640700",2158,422,229,0,114,71,23,17,3034
"25005640800",2794,525,124,0,390,102,155,171,4261
"25005640901",2580,1074,33,87,490,555,50,580,5449
"25005641000",1259,707,45,26,80,159,0,168,2444
"25005641101",736,887,155,38,146,53,143,573,2731
"25005641200",1805,876,80,64,203,205,31,110,3374
"25005641300",2339,1197,376,345,511,504,132,515,5919
"25005641400",1606,382,5,0,173,206,162,85,2619
"25005641500",1572,332,40,0,156,146,58,118,2422
"25005641600",1516,223,64,163,41,3,28,0,2038
"25005641700",4139,400,152,14,312,94,249,35,5395
"25005641800",1688,173,62,36,110,28,51,25,2173
"25005641900",1091,432,64,0,346,67,182,67,2249
"25005642000",1470,539,296,16,276,294,101,246,3238
"25005642100",2778,1090,120,0,351,0,129,129,4597
"25005642200",2197,403,63,54,449,254,221,224,3865
"25005642300",2048,88,29,0,18,0,84,0,2267
"25005642400",2584,298,0,10,85,36,104,32,3149
"25005642500",4021,249,28,0,52,9,60,0,4419
"25005644101",5760,306,0,0,170,0,0,0,6236
"25005644102",4675,265,0,3,164,27,19,38,5191
"25005644200",5615,835,1,1,177,0,57,1,6687
"25005645101",4163,401,12,0,77,21,26,9,4709
"25005645102",5127,283,0,0,73,0,64,0,5547
"25005645103",5390,286,0,0,59,0,0,34,5769
"25005646101",7016,286,37,2,134,19,25,0,7519
"25005646103",5231,235,0,0,48,19,0,0,5533
"25005646104",2469,93,0,0,30,0,0,0,2592
"25005650101",4760,397,50,0,155,48,125,16,5551
"25005650102",3373,588,208,13,430,200,695,228,5735
"25005650201",2817,127,27,14,102,57,53,12,3209
"25005650202",1709,312,20,69,74,0,68,16,2268
"25005650300",2555,371,235,0,141,50,292,91,3735
"25005650400",2348,456,100,24,357,105,135,105,3630
"25005650500",2097,597,94,31,272,69,249,111,3520
"25005650600",1367,502,296,58,56,347,45,448,3119
"25005650700",946,381,31,47,495,336,610,363,3209
"25005650800",1370,771,265,330,456,304,500,373,4369
"25005650900",952,512,72,175,559,561,431,744,4006
"25005651001",2059,184,91,26,266,190,121,60,2997
"25005651002",2192,426,214,22,415,235,335,227,4066
"25005651100",1955,584,162,74,823,581,658,636,5473
"25005651200",754,386,183,60,453,551,507,490,3384
"25005651300",847,331,97,79,525,174,377,106,2536
"25005651400",1531,371,311,94,448,281,289,173,3498
"25005651500",1459,282,322,29,728,252,419,263,3754
"25005651600",1975,316,350,31,1364,122,623,39,4820
"25005651700",547,407,299,209,332,261,67,375,2497
"25005651800",673,436,92,193,140,246,108,131,2019
"25005651900",365,197,308,90,573,413,300,201,2447
"25005652000",1124,410,256,14,430,61,350,70,2715
"25005652100",1803,261,92,0,341,157,159,161,2974
"25005652200",2483,218,124,0,226,22,32,33,3138
"25005652300",1738,523,123,62,331,226,217,142,3362
"25005652400",1684,320,51,26,493,118,498,56,3246
"25005652500",1079,549,149,34,252,326,245,246,2880
"25005652600",961,542,209,35,508,520,651,660,4086
"25005652700",1565,843,131,140,638,178,860,565,4920
"25005652800",2763,190,116,13,21,12,58,0,3173
"25005653101",4716,841,109,14,463,52,87,125,6407
"25005653102",4043,128,7,0,166,0,0,0,4344
"25005653203",4392,232,22,0,373,45,17,5,5086
"25005653204",2490,146,12,0,243,105,27,37,3060
"25005653301",4379,372,40,0,443,2,15,0,5251
"25005653304",3078,115,0,0,68,0,0,0,3261
"25005654100",6344,196,0,0,394,0,179,12,7125
"25005654200",2865,277,0,1,153,0,112,0,3408
"25005655100",3595,182,0,0,104,46,30,0,3957
"25005655200",3263,498,19,1,390,279,49,1,4500
"25005655300",2831,336,0,2,210,9,62,0,3450
"25005655400",3587,257,0,0,59,0,0,8,3911
"25005985500",1062,106,29,0,34,0,14,10,1255
"25005985600",3064,84,156,12,16,0,127,6,3465
"25005990000",0,0,0,0,0,0,0,0,0
"25007200100",2912,734,224,0,134,34,0,8,4046
"25007200200",3775,541,69,30,154,0,0,0,4569
"25007200300",3705,259,128,0,84,0,52,0,4228
"25007200400",3430,295,77,27,232,50,38,27,4176
"25007990000",0,0,0,0,0,0,0,0,0
"25009201100",3076,168,38,0,118,0,160,0,3560
"25009202101",1791,45,0,0,141,0,23,0,2000
"25009202102",5237,504,49,0,177,0,387,12,6366
"25009202200",5528,173,43,1,155,30,201,1,6132
"25009203100",6288,247,161,0,85,42,194,86,7103
"25009203200",4415,166,29,0,198,0,58,0,4866
"25009203301",3698,258,34,0,68,0,84,0,4142
"25009203302",4037,264,115,0,32,15,161,15,4639
"25009204101",3257,352,61,35,209,286,176,298,4674
"25009204102",3007,88,289,11,508,92,399,82,4476
"25009204200",3396,841,31,222,403,153,687,203,5936
"25009204300",1477,591,239,252,1020,198,1340,416,5533
"25009204400",2791,143,27,9,578,39,427,45,4059
"25009204500",2609,126,62,10,232,9,79,9,3136
"25009204600",3845,382,198,0,237,169,117,169,5117
"25009204701",4200,482,214,57,1099,648,1044,677,8421
"25009204702",4147,209,377,48,278,418,288,412,6177
"25009205100",3610,268,167,0,1011,0,721,89,5866
"25009205200",3019,289,360,0,1398,361,789,261,6477
"25009205300",3612,129,208,24,371,130,420,0,4894
"25009205400",4399,46,135,0,231,0,191,0,5002
"25009205500",1824,249,529,27,1550,770,1744,742,7435
"25009205600",2106,527,310,258,480,337,531,455,5004
"25009205700",2700,326,736,63,950,182,920,113,5990
"25009205800",889,193,341,94,1556,417,1243,314,5047
"25009205900",1470,388,653,85,1038,804,1000,941,6379
"25009206000",716,131,363,81,1009,713,1103,652,4768
"25009206100",751,188,367,255,1685,777,1317,395,5735
"25009206200",940,518,353,103,2365,968,2042,847,8136
"25009206300",1474,139,605,184,1250,430,1327,463,5872
"25009206400",2548,335,877,221,1207,161,1233,354,6936
"25009206500",765,222,605,154,972,424,934,556,4632
"25009206600",2289,221,287,40,781,390,930,332,5270
"25009206700",1403,738,369,111,1256,403,1204,600,6084
"25009206800",633,460,473,102,979,759,1142,749,5297
"25009206900",1676,304,481,279,1361,311,1648,227,6287
"25009207000",422,220,309,224,664,375,566,364,3144
"25009207100",567,230,396,135,1491,397,1245,381,4842
"25009207200",624,186,298,93,1340,443,1030,283,4297
"25009208101",4317,221,96,2,334,12,482,11,5475
"25009208102",2807,261,132,11,370,52,275,62,3970
"25009208200",4448,497,151,43,253,0,126,12,5530
"25009208300",6295,607,160,0,184,4,69,4,7323
"25009208400",5582,87,49,0,436,0,126,50,6330
"25009209100",5676,91,236,0,405,0,127,0,6535
"25009209200",5461,58,0,6,273,45,66,0,5909
"25009210100",5833,169,0,177,225,23,301,161,6889
"25009210200",4676,301,30,1,98,0,8,0,5114
"25009210300",7026,503,168,0,354,120,97,0,8268
"25009210400",6451,422,329,0,90,0,242,92,7626
"25009210500",6032,183,167,0,154,81,226,0,6843
"25009210600",3074,214,227,0,791,246,945,241,5738
"25009210700",3121,359,24,56,765,178,871,196,5570
"25009210800",2908,866,71,124,700,141,576,148,5534
"25009210900",3299,335,26,0,330,150,305,56,4501
"25009211100",3477,134,1,1,203,1,115,20,3952
"25009211200",5257,419,130,0,254,2,76,2,6140
"25009211300",6434,162,10,0,95,8,129,8,6846
"25009211401",2990,293,64,84,544,69,227,22,4293
"25009211402",5946,95,29,0,96,0,136,0,6302
"25009212100",6801,370,106,0,449,37,150,55,7968
"25009213100",7577,216,0,0,345,0,113,0,8251
"25009214100",5652,323,0,5,272,5,27,5,6289
"25009215101",3943,150,158,0,264,232,88,0,4835
"25009215102",2883,198,0,0,103,4,65,4,3257
"25009216100",3441,96,0,0,30,0,0,0,3567
"25009217100",6606,192,163,13,625,15,180,2,7796
"25009217201",3794,239,79,0,99,18,140,32,4401
"25009217202",3264,86,0,0,43,31,6,31,3461
"25009217300",3601,718,29,0,174,15,241,65,4843
"25009217400",4504,706,100,0,93,97,108,105,5713
"25009217500",5244,613,13,0,318,0,325,0,6513
"25009217600",6003,264,0,14,31,0,13,0,6325
"25009218100",4779,359,0,0,124,8,103,0,5373
"25009220101",3756,187,10,0,11,15,62,33,4074
"25009220102",2763,175,108,0,0,17,0,0,3063
"25009221100",4064,282,16,14,87,8,59,14,4544
"25009221300",4136,290,0,0,22,2,22,2,4474
"25009221400",2592,227,137,0,327,9,91,4,3387
"25009221500",2405,375,0,5,53,7,45,7,2897
"25009221600",2084,279,23,27,104,102,124,180,2923
"25009221700",2039,176,0,0,57,0,21,0,2293
"25009221800",1488,88,0,0,5,2,0,2,1585
"25009221901",3183,311,0,0,43,0,14,0,3551
"25009221902",3313,508,76,0,197,0,17,0,4111
"25009222100",3274,236,0,0,98,0,24,0,3632
"25009223100",3721,360,17,57,62,33,87,12,4349
"25009223200",3211,366,6,0,71,1,64,1,3720
"25009223300",5415,119,0,1,71,0,59,1,5666
"25009250100",602,318,195,58,863,506,1200,791,4533
"25009250200",1748,362,361,12,2037,983,3030,1141,9674
"25009250300",563,127,109,56,915,481,1444,593,4288
"25009250400",818,596,78,64,1246,957,2058,1556,7373
"25009250500",591,573,68,70,1950,797,2412,1369,7830
"25009250600",1839,668,257,124,1988,755,3354,1297,10282
"25009250700",1660,364,272,28,2039,986,3344,1234,9927
"25009250800",3103,458,688,77,1803,933,3521,1154,11737
"25009250900",592,384,59,103,847,385,1475,840,4685
"25009251000",413,158,107,8,684,242,1093,388,3093
"25009251100",476,600,138,65,724,792,1088,1276,5159
"25009251200",354,183,39,0,456,384,774,497,2687
"25009251300",610,510,225,32,1279,536,1889,1002,6083
"25009251400",1551,349,567,133,1612,908,2846,1184,9150
"25009251500",1848,441,234,166,2440,773,3532,1231,10665
"25009251600",1576,479,231,231,2128,1596,2760,1835,10836
"25009251700",1847,596,455,2,2083,589,2682,857,9111
"25009251800",3748,551,478,311,2174,308,2416,676,10662
"25009252101",2606,195,169,73,477,73,874,161,4628
"25009252102",3471,192,58,34,285,51,211,85,4387
"25009252201",2789,222,27,45,136,20,124,86,3449
"25009252202",2898,43,28,0,145,6,179,0,3299
"25009252300",3700,741,106,0,2004,298,2620,535,10004
"25009252400",1553,345,320,134,1515,464,2329,667,7327
"25009252501",2664,290,226,36,608,140,977,204,5145
"25009252502",3666,259,144,0,129,248,702,61,5209
"25009252601",5867,451,133,0,814,126,572,192,8155
"25009252602",3601,151,91,0,373,9,224,0,4449
"25009252603",2509,99,74,0,334,0,468,0,3484
"25009253100",4093,518,201,0,533,66,206,276,5893
"25009253201",2260,196,63,0,243,0,54,25,2841
"25009253202",5114,253,30,0,453,94,575,63,6582
"25009253203",3955,29,0,0,231,0,115,10,4340
"25009253204",4663,102,50,0,774,0,49,0,5638
"25009253205",3837,80,53,0,258,130,120,0,4478
"25009254100",5090,160,30,0,743,184,190,43,6440
"25009254200",3312,327,22,0,309,162,180,142,4454
"25009254301",3232,44,170,0,560,9,62,9,4086
"25009254302",3809,96,32,12,784,31,52,9,4825
"25009254401",2508,81,60,0,648,7,192,7,3503
"25009254402",5067,162,186,1,1681,73,119,57,7346
"25009254403",3174,186,29,0,460,1,110,0,3960
"25009260100",2958,811,113,35,1424,414,1867,482,8104
"25009260200",2058,676,92,44,495,110,530,352,4357
"25009260301",3623,637,33,0,6,45,82,66,4492
"25009260302",2414,131,59,0,84,0,46,0,2734
"25009260401",3404,124,74,0,152,0,29,0,3783
"25009260402",5184,104,126,18,583,42,502,15,6574
"25009260500",3168,278,90,20,191,0,258,113,4118
"25009260600",1865,772,38,0,654,135,771,444,4679
"25009260700",3341,398,57,39,787,99,852,250,5823
"25009260800",2361,710,191,8,1447,310,1919,623,7569
"25009260900",3856,428,56,0,433,105,1050,165,6093
"25009261000",3223,317,72,16,301,30,424,51,4434
"25009261101",4102,148,103,11,112,0,160,0,4636
"25009261102",3689,294,97,22,361,95,240,113,4911
"25009262100",6170,408,0,0,0,0,132,0,6710
"25009263100",4035,318,0,2,70,0,0,141,4566
"25009264100",6350,143,51,0,71,31,160,16,6822
"25009265101",3627,77,0,0,131,0,26,0,3861
"25009265102",4311,150,11,0,134,0,47,0,4653
"25009266100",3704,161,0,2,81,30,53,0,4031
"25009266200",4807,267,82,0,283,12,77,6,5534
"25009266300",3195,217,13,0,169,0,142,0,3736
"25009266400",3425,160,5,12,62,0,24,9,3697
"25009267101",2829,437,17,0,109,80,30,0,3502
"25009267102",4674,309,51,0,114,0,56,10,5214
"25009268100",2607,26,0,0,35,1,51,1,2721
"25009268200",5234,286,68,0,370,57,111,9,6135
"25009268300",3498,541,50,1,103,1,164,2,4360
"25009268400",4149,377,23,0,30,2,88,2,4671
"25009269100",6360,245,73,27,128,0,93,0,6926
"25009270100",5564,301,63,1,56,0,52,0,6037
"25009990100",0,0,0,0,0,0,0,0,0
"25011040100",3862,447,10,8,124,36,48,17,4552
"25011040200",4032,246,6,47,101,44,143,41,4660
"25011040300",2778,128,1,2,84,0,75,0,3068
"25011040400",2920,333,45,1,112,38,54,13,3516
"25011040501",3347,864,9,5,62,15,65,0,4367
"25011040502",3036,199,0,0,131,0,32,8,3406
"25011040600",4220,302,15,47,98,38,88,51,4859
"25011040701",2943,627,4,131,205,160,277,80,4427
"25011040702",3484,320,0,14,234,66,40,20,4178
"25011040800",3635,792,103,26,473,3,169,71,5272
"25011040900",4308,331,45,24,227,15,42,20,5012
"25011041000",2628,409,0,17,205,14,36,11,3320
"25011041100",3285,255,0,5,66,35,110,4,3760
"25011041200",2770,306,33,0,28,10,117,59,3323
"25011041300",3377,661,65,35,228,69,183,38,4656
"25011041400",1678,329,37,87,120,179,231,267,2928
"25011041501",3100,155,5,4,61,21,46,0,3392
"25011041502",3353,300,9,0,57,10,7,0,3736
"25013800101",1959,599,500,264,334,340,710,536,5242
"25013800102",1999,917,510,209,326,500,980,997,6438
"25013800201",4065,556,660,95,706,869,1899,1087,9937
"25013800202",851,106,22,0,166,87,356,111,1699
"25013800300",2099,188,423,75,1026,627,1577,590,6605
"25013800400",2523,869,662,155,1210,408,2085,907,8819
"25013800500",1551,191,220,36,658,654,1368,804,5482
"25013800600",558,718,207,214,499,611,1125,1289,5221
"25013800700",1143,763,354,419,396,836,1614,1826,7351
"25013800800",506,692,116,36,372,466,815,976,3979
"25013800900",1126,1130,263,221,465,879,1453,1891,7428
"25013801101",488,610,117,283,181,457,507,1037,3680
"25013801102",379,185,86,60,194,109,164,222,1399
"25013801200",255,529,449,257,137,692,370,1182,3871
"25013801300",677,462,1358,440,951,932,886,1249,6955
"25013801401",131,507,1269,423,725,396,864,832,5147
"25013801402",836,121,621,51,353,7,468,71,2528
"25013801501",1669,210,2067,127,1231,407,1773,423,7907
"25013801502",1043,434,924,277,349,215,693,483,4418
"25013801503",1887,509,725,144,453,312,889,551,5470
"25013801601",2037,580,829,81,189,35,424,236,4411
"25013801602",2729,538,925,38,190,128,670,300,5518
"25013801603",2770,335,583,148,327,62,436,181,4842
"25013801604",3050,145,441,14,123,0,396,13,4182
"25013801605",2442,431,688,416,328,209,628,417,5559
"25013801700",604,781,2556,655,540,476,978,928,7518
"25013801800",606,443,1068,636,256,791,1003,1138,5941
"25013801901",660,689,607,171,793,1131,1146,1584,6781
"25013801902",670,888,403,442,426,542,523,1302,5196
"25013802000",533,493,217,250,539,920,794,1291,5037
"25013802100",3263,827,582,245,889,330,1749,661,8546
"25013802200",616,803,585,155,502,666,643,1225,5195
"25013802300",2084,1214,930,465,1329,1046,1642,1661,10371
"25013802400",2736,296,394,14,315,39,506,196,4496
"25013802500",5156,307,852,2,314,76,716,75,7498
"25013802601",3863,958,955,152,662,492,2043,782,9907
"25013802602",1546,140,32,5,193,13,95,4,2028
"25013810100",5580,361,17,1,18,17,70,0,6064
"25013810200",2398,358,11,0,7,0,41,0,2815
"25013810300",2433,601,11,0,55,64,132,61,3357
"25013810403",3380,524,54,5,97,40,158,36,4294
"25013810404",3574,81,47,1,116,10,174,10,4013
"25013810412",5803,139,0,0,128,0,95,0,6165
"25013810414",6089,161,60,0,212,37,427,0,6986
"25013810601",3298,272,175,0,525,63,889,89,5311
"25013810602",2315,83,21,0,79,0,16,0,2514
"25013810700",5056,637,266,97,403,259,562,239,7519
"25013810800",2924,478,36,50,242,127,410,280,4547
"25013810901",1248,382,37,66,113,67,142,131,2186
"25013810902",3031,342,9,42,340,82,660,307,4813
"25013811000",3803,261,0,0,381,35,475,75,5030
"25013811101",3195,743,214,107,393,181,818,587,6238
"25013811102",3711,628,45,17,953,416,1515,526,7811
"25013811200",4573,352,0,0,645,19,1094,0,6683
"25013811301",4618,598,261,0,89,189,189,501,6445
"25013811302",4693,358,129,277,205,141,36,196,6035
"25013811400",1241,868,43,33,197,267,1368,1070,5087
"25013811500",810,977,26,68,82,407,877,1253,4500
"25013811600",1019,1743,41,71,245,218,1125,1777,6239
"25013811700",837,994,82,78,177,180,648,971,3967
"25013811800",2820,1170,94,55,178,157,1534,1099,7107
"25013811900",3196,129,200,34,112,10,332,44,4057
"25013812001",1463,809,129,118,196,166,399,826,4106
"25013812002",2623,622,89,234,450,263,1204,590,6075
"25013812101",4444,127,0,0,573,0,779,0,5923
"25013812103",1888,568,258,0,438,177,1477,569,5375
"25013812104",3278,618,70,18,732,144,1457,499,6816
"25013812201",3563,190,284,179,843,169,796,104,6128
"25013812202",2324,448,225,2,655,105,187,221,4167
"25013812300",3659,1012,180,0,343,218,514,197,6123
"25013812401",5661,210,109,0,298,13,395,0,6686
"25013812403",3189,250,42,3,242,25,198,42,3991
"25013812404",3435,188,64,0,112,87,46,105,4037
"25013812500",6605,622,109,70,192,22,258,74,7952
"25013812600",5886,173,11,0,178,0,215,0,6463
"25013812701",2970,420,143,0,156,74,141,237,4141
"25013812702",3818,454,231,79,616,280,707,122,6307
"25013812800",5994,385,0,0,646,98,761,142,8026
"25013812901",3040,110,0,0,48,374,67,1,3640
"25013812902",3771,405,37,0,210,61,178,263,4925
"25013812903",48,7,0,0,0,0,0,0,55
"25013813000",6687,424,21,10,147,9,207,4,7509
"25013813101",5016,452,0,0,299,0,19,6,5792
"25013813102",3678,63,0,0,76,0,10,0,3827
"25013813204",2935,143,9,0,106,0,107,15,3315
"25013813205",6136,420,153,0,83,41,270,71,7174
"25013813206",3586,273,110,13,125,9,261,11,4388
"25013813207",3720,853,64,0,257,63,211,247,5415
"25013813208",2550,165,24,0,303,0,78,42,3162
"25013813209",5156,271,27,0,329,124,292,114,6313
"25013813301",6536,227,9,0,235,0,303,9,7319
"25013813303",3609,124,38,0,496,27,120,14,4428
"25013813304",3198,183,39,0,372,108,183,0,4083
"25013813401",4568,434,88,2,166,0,76,33,5367
"25013813403",3488,202,60,0,205,1,45,5,4006
"25013813404",5432,163,640,33,64,39,280,0,6651
"25013813500",4774,263,0,0,40,0,59,0,5136
"25013813601",7006,327,233,75,201,9,317,0,8168
"25013813602",5801,156,127,12,227,0,56,33,6412
"25013813701",3059,312,0,0,105,0,27,0,3503
"25013813702",4582,396,0,0,79,33,63,0,5153
"25013813801",4003,292,31,8,53,7,85,7,4486
"25013813802",3513,118,0,0,0,0,40,0,3671
"25015820101",5550,648,13,2,122,72,20,0,6427
"25015820102",2489,724,0,0,145,23,154,19,3554
"25015820202",1185,62,29,16,18,0,81,16,1407
"25015820203",7501,686,19,37,230,114,61,220,8868
"25015820204",5404,451,48,0,221,67,0,28,6219
"25015820300",3081,2227,215,0,883,401,320,85,7212
"25015820400",115,92,0,31,6,59,14,25,342
"25015820500",2879,1995,54,146,296,266,185,16,5837
"25015820600",54,0,0,0,8,21,0,0,83
"25015820700",2586,1037,50,249,891,192,253,189,5447
"25015820801",3211,598,93,314,799,453,253,27,5748
"25015820802",0,0,0,0,0,0,0,0,0
"25015820900",5937,279,0,0,52,0,258,24,6550
"25015821000",3630,264,18,15,321,12,127,98,4485
"25015821100",5515,759,313,65,121,1,295,33,7102
"25015821200",136,12,0,0,53,0,0,0,201
"25015821300",3589,318,97,0,64,64,92,77,4301
"25015821400",4585,327,29,16,187,10,209,23,5386
"25015821500",2909,237,63,5,83,0,36,27,3360
"25015821601",2255,349,0,38,480,199,354,219,3894
"25015821602",2952,442,11,63,134,244,339,96,4281
"25015821700",2826,328,27,45,114,117,81,98,3636
"25015821901",2458,326,0,10,131,50,63,6,3044
"25015821903",1842,820,80,92,183,71,221,151,3460
"25015821904",2019,347,71,23,123,0,95,21,2699
"25015822000",97,36,10,3,4,0,11,24,185
"25015822200",4548,700,46,0,490,5,110,359,6258
"25015822300",4447,410,44,1,168,16,129,61,5276
"25015822401",4771,229,0,4,491,0,277,2,5774
"25015822402",4095,610,213,49,294,155,546,0,5962
"25015822500",5538,259,0,67,145,0,6,15,6030
"25015822601",1631,206,89,0,54,4,9,0,1993
"25015822603",1639,36,0,0,37,6,63,3,1784
"25015822605",1139,93,0,0,13,11,12,0,1268
"25015822606",3263,268,11,0,54,0,69,4,3669
"25015822700",2878,196,36,3,108,19,35,9,3284
"25017300100",2858,236,21,0,25,17,47,0,3204
"25017301101",3609,178,0,0,152,34,0,0,3973
"25017301102",4947,114,8,0,145,16,71,0,5301
"25017310100",2284,877,350,134,871,545,489,806,6356
"25017310200",4406,322,411,0,1541,163,1155,116,8114
"25017310300",2735,728,448,247,995,423,828,489,6893
"25017310400",1691,628,194,59,408,402,577,448,4407
"25017310500",1893,235,258,51,435,390,142,52,3456
"25017310601",3172,138,571,1,1965,148,759,61,6815
"25017310602",3403,301,115,58,901,390,450,371,5989
"25017310700",1314,435,181,35,1970,474,570,371,5350
"25017311100",769,176,120,2,932,418,531,206,3154
"25017311200",624,164,129,300,1716,437,358,147,3875
"25017311300",1426,307,266,0,1524,312,281,47,4163
"25017311400",2252,662,637,134,2062,221,638,129,6735
"25017311500",1155,175,199,0,1181,405,265,287,3667
"25017311600",2750,506,274,13,1842,170,357,146,6058
"25017311700",1552,326,82,20,2116,529,490,170,5285
"25017311800",1052,282,51,51,1252,511,363,219,3781
"25017311900",1154,572,109,163,266,195,458,212,3129
"25017312000",1194,399,212,30,725,337,444,363,3704
"25017312100",1089,344,128,17,824,422,590,173,3587
"25017312200",1964,341,643,8,1322,220,601,171,5270
"25017312300",3099,191,0,1,1385,16,305,13,5010
"25017312400",1182,288,137,92,515,282,742,298,3536
"25017312501",3458,154,29,100,326,366,290,254,4977
"25017312502",3210,282,122,0,447,17,126,32,4236
"25017313101",5209,283,0,33,586,0,208,0,6319
"25017313102",5410,156,27,0,175,82,0,0,5850
"25017314101",5159,249,197,0,561,38,163,0,6367
"25017314102",6330,283,45,0,1009,55,332,63,8117
"25017314200",4614,396,189,0,37,0,288,0,5524
"25017314301",7164,225,284,0,591,76,519,0,8859
"25017314302",2716,38,76,24,216,12,137,0,3219
"25017315100",5377,202,111,12,280,0,181,24,6187
"25017315200",7049,293,25,0,441,0,151,0,7959
"25017315401",2910,293,0,7,226,17,67,11,3531
"25017315402",2682,176,41,0,135,0,66,0,3100
"25017315403",1678,27,5,0,39,0,11,0,1760
"25017315500",6997,390,0,0,201,9,54,0,7651
"25017316101",4699,69,0,0,249,8,223,0,5248
"25017316102",5912,845,0,0,91,10,142,0,7000
"25017316201",3843,163,54,0,72,0,30,0,4162
"25017316202",3709,85,50,49,620,0,123,0,4636
"25017316300",6577,440,219,33,863,18,62,0,8212
"25017316400",5026,191,120,0,386,59,187,25,5994
"25017316500",5462,215,240,0,322,22,214,62,6537
"25017317101",5274,185,0,0,509,70,277,43,6358
"25017317102",3680,130,0,1,659,75,190,0,4735
"25017317103",4621,84,17,0,347,50,41,0,5160
"25017317201",2551,53,0,0,174,0,28,0,2806
"25017317202",3170,84,83,0,287,0,73,0,3697
"25017317203",3548,93,11,0,433,25,20,0,4130
"25017317301",2231,93,0,1,484,9,204,1,3023
"25017317302",4848,199,48,0,480,30,70,0,5675
"25017318100",5319,108,0,0,1322,24,0,48,6821
"25017318200",3229,227,32,0,672,60,132,38,4390
"25017318300",6802,138,29,0,1114,16,164,0,8263
"25017318400",3315,76,73,0,563,48,129,0,4204
"25017320102",4682,110,25,0,522,0,94,0,5433
"25017320103",2383,125,21,0,286,0,43,0,2858
"25017320104",7248,127,116,5,181,2,94,2,7775
"25017321100",5276,331,58,21,1244,80,514,57,7581
"25017321200",4918,225,17,0,953,129,989,125,7356
"25017321300",4983,664,179,1,1680,316,1633,514,9970
"25017321400",2347,62,60,5,400,12,246,3,3135
"25017321500",5344,303,19,47,1329,153,572,117,7884
"25017321600",5768,275,439,20,1090,193,807,0,8592
"25017322100",4459,75,0,0,296,49,104,16,4999
"25017322200",3374,66,77,13,247,41,56,0,3874
"25017322300",5155,401,77,90,411,0,198,129,6461
"25017322400",4004,422,49,12,234,0,241,9,4971
"25017323100",6263,314,1,0,379,0,284,0,7241
"25017324101",4111,240,23,0,185,0,37,0,4596
"25017324102",3986,133,7,0,519,23,49,0,4717
"25017325100",6001,913,277,14,593,12,98,308,8216
"25017326101",3617,206,47,0,270,0,48,0,4188
"25017326102",6305,127,67,0,400,17,105,0,7021
"25017327101",3693,89,21,0,199,0,46,0,4048
"25017327102",3746,302,95,6,92,3,179,32,4455
"25017327103",3292,264,0,0,142,0,25,0,3723
"25017328100",3066,72,0,0,205,0,12,0,3355
"25017330100",7402,201,32,0,786,6,62,13,8502
"25017330200",5744,297,97,8,719,0,104,0,6969
"25017331101",2804,63,68,0,252,0,27,0,3214
"25017331102",6120,138,266,0,482,0,71,2,7079
"25017331200",4641,383,11,0,379,0,67,14,5495
"25017331300",6693,105,12,2,422,0,216,2,7452
"25017332100",5369,2,41,0,775,0,16,0,6203
"25017332200",5784,548,401,77,1588,82,164,116,8760
"25017332300",5255,260,268,0,1010,110,60,2,6965
"25017332400",3076,232,81,0,468,24,174,0,4055
"25017333100",6278,323,583,0,636,18,36,18,7892
"25017333200",4354,371,56,106,98,0,193,26,5204
"25017333300",3044,161,202,34,411,18,150,60,4080
"25017333400",5135,271,78,127,523,17,179,1,6331
"25017333501",4352,205,81,2,328,131,0,48,5147
"25017333502",2900,235,83,10,134,19,186,13,3580
"25017333600",5145,218,124,406,1391,244,239,41,7808
"25017334100",6424,172,109,0,437,172,503,0,7817
"25017334200",3667,81,0,0,199,0,77,0,4024
"25017334300",6893,52,94,0,337,0,15,0,7391
"25017334400",5594,216,95,0,618,18,80,0,6621
"25017335100",4960,219,60,3,256,16,46,0,5560
"25017335200",5297,261,77,0,356,0,223,0,6214
"25017335301",3448,272,51,0,334,249,226,23,4603
"25017335302",4784,130,13,2,288,2,143,4,5366
"25017335400",4481,48,32,0,129,32,142,32,4896
"25017336100",4572,147,445,18,285,14,220,0,5701
"25017336200",5664,199,9,1,104,5,73,0,6055
"25017336300",6226,77,8,0,346,0,364,0,7021
"25017336401",3429,261,123,7,544,24,185,0,4573
"25017336402",4436,158,81,16,212,14,112,19,5048
"25017337101",2923,177,47,0,92,130,45,24,3438
"25017337102",4494,139,70,8,197,1,98,12,5019
"25017337201",2853,39,10,0,94,112,21,32,3161
"25017337202",4623,72,31,0,0,0,207,21,4954
"25017337300",4631,202,118,0,483,116,190,98,5838
"25017338100",2271,9,42,0,727,0,35,0,3084
"25017338200",2925,54,32,0,749,114,89,0,3963
"25017338300",2935,12,28,2,199,28,63,2,3269
"25017338400",4724,313,31,0,781,0,60,0,5909
"25017338500",5170,135,35,0,474,71,147,9,6041
"25017339100",5028,424,62,62,261,32,279,15,6163
"25017339200",5029,109,14,0,314,37,140,21,5664
"25017339300",1511,161,836,56,321,33,54,17,2989
"25017339400",2255,487,34,41,229,163,138,241,3588
"25017339500",2831,412,628,11,144,16,30,0,4072
"25017339600",3700,661,619,20,482,86,141,0,5709
"25017339700",2737,361,584,91,422,125,164,65,4549
"25017339801",2996,302,348,27,1095,58,465,16,5307
"25017339802",2565,430,217,257,572,73,321,26,4461
"25017339900",3673,616,466,0,528,6,478,63,5830
"25017340000",1627,238,235,21,438,56,131,0,2746
"25017340100",4976,305,512,0,675,127,287,122,7004
"25017341101",2085,126,110,42,1112,292,151,6,3924
"25017341102",2208,157,212,180,977,602,253,99,4688
"25017341200",2977,364,614,164,2507,796,527,0,7949
"25017341300",1376,756,354,261,2016,615,197,98,5673
"25017341400",2900,358,1061,210,1627,126,491,0,6773
"25017341500",2020,231,1315,96,1490,496,965,132,6745
"25017341600",3680,366,549,176,1589,102,426,0,6888
"25017341700",3040,184,562,0,791,380,363,71,5391
"25017341800",2897,795,1013,406,1011,251,1135,240,7748
"25017341901",895,143,162,0,178,0,90,0,1468
"25017341902",4660,539,1115,119,1908,128,920,73,9462
"25017342101",2346,563,592,0,807,294,945,438,5985
"25017342102",2073,418,197,443,372,103,484,238,4328
"25017342201",3053,312,585,140,712,198,875,253,6128
"25017342202",2887,148,682,147,371,0,492,91,4818
"25017342300",4133,655,914,92,1274,110,1461,83,8722
"25017342400",3431,765,1059,371,814,196,1408,224,8268
"25017342500",4254,369,1631,176,939,90,951,228,8638
"25017342600",1930,397,996,172,1090,333,983,287,6188
"25017350103",1089,90,89,0,41,11,0,0,1320
"25017350104",3173,521,1136,654,1206,302,633,237,7862
"25017350200",4414,266,650,113,941,115,478,10,6987
"25017350300",1825,125,197,32,317,48,163,62,2769
"25017350400",4230,685,215,0,358,37,262,64,5851
"25017350500",1214,90,23,9,182,0,85,2,1605
"25017350600",1553,272,19,11,183,64,85,0,2187
"25017350700",4355,758,196,664,538,327,94,298,7230
"25017350800",1500,74,85,0,266,28,104,0,2057
"25017350900",2903,232,62,0,383,42,74,24,3720
"25017351000",5096,1246,97,89,946,283,334,257,8348
"25017351100",4540,415,26,56,798,233,517,13,6598
"25017351203",3014,347,35,97,761,137,315,40,4746
"25017351204",2588,495,126,21,860,76,142,141,4449
"25017351300",2582,428,34,60,612,146,170,14,4046
"25017351403",2648,258,236,227,686,103,1107,206,5471
"25017351404",2291,384,238,30,884,155,823,126,4931
"25017351500",1444,193,315,0,613,127,421,119,3232
"25017352101",751,261,31,13,582,145,188,174,2145
"25017352102",1647,188,23,36,455,54,126,40,2569
"25017352200",1041,190,287,62,218,99,82,51,2030
"25017352300",1869,444,125,18,861,349,249,340,4255
"25017352400",798,105,370,293,358,117,236,62,2339
"25017352500",1761,283,256,205,337,0,169,56,3067
"25017352600",1243,149,165,231,481,143,226,20,2658
"25017352700",1405,199,430,40,161,84,161,45,2525
"25017352800",1472,143,79,9,382,20,218,40,2363
"25017352900",2344,96,43,0,282,155,52,0,2972
"25017353000",2080,288,340,129,556,228,208,115,3944
"25017353101",1056,294,202,74,391,97,223,130,2467
"25017353102",185,49,4,0,157,181,11,0,587
"25017353200",2401,264,278,187,442,116,219,73,3980
"25017353300",2575,183,227,28,463,86,90,68,3720
"25017353400",1239,235,690,85,622,17,289,8,3185
"25017353500",1318,179,278,147,702,11,47,0,2682
"25017353600",2191,149,159,0,316,87,160,58,3120
"25017353700",1785,274,16,37,448,198,116,18,2892
"25017353800",2757,541,66,35,862,148,353,43,4805
"25017353900",1397,399,81,58,672,136,138,222,3103
"25017354000",2119,306,45,0,395,115,82,0,3062
"25017354100",1988,84,35,4,292,32,91,4,2530
"25017354200",2793,180,14,0,285,0,106,0,3378
"25017354300",1789,284,445,45,840,81,75,36,3595
"25017354400",1404,104,67,7,240,28,84,7,1941
"25017354500",1610,220,42,10,181,22,177,0,2262
"25017354600",2837,203,863,318,832,1,37,81,5172
"25017354700",2140,95,131,57,204,0,181,0,2808
"25017354800",1704,63,57,5,214,25,66,0,2134
"25017354900",2483,148,1357,550,1230,399,443,110,6720
"25017355000",2055,170,377,30,321,124,305,62,3444
"25017356100",2549,98,0,0,464,0,133,0,3244
"25017356300",3978,67,225,0,700,82,488,11,5551
"25017356400",6072,244,230,0,627,42,83,0,7298
"25017356500",5763,276,178,10,631,78,107,13,7056
"25017356601",3331,203,53,7,622,24,172,0,4412
"25017356602",3326,135,35,0,544,18,155,9,4222
"25017356701",4615,447,82,13,1230,83,47,13,6530
"25017356702",5691,197,72,0,657,165,196,15,6993
"25017357100",3231,79,126,0,893,28,131,0,4488
"25017357200",2769,93,7,11,406,0,260,9,3555
"25017357300",2549,51,37,10,391,78,132,0,3248
"25017357400",2009,76,18,0,177,13,126,0,2419
"25017357500",1569,30,59,18,384,28,56,6,2150
"25017357600",2143,68,14,0,291,75,207,2,2800
"25017357700",2616,113,104,11,486,187,268,22,3807
"25017357800",3230,123,19,16,388,23,123,0,3922
"25017358100",3884,61,38,0,1080,0,111,0,5174
"25017358300",3739,150,76,0,1742,63,87,0,5857
"25017358400",3692,139,52,0,1060,66,221,0,5230
"25017358500",3245,293,51,1,1540,98,35,3,5266
"25017358600",4134,150,0,53,1758,45,25,0,6165
"25017358700",3524,97,16,2,1431,17,67,1,5155
"25017359100",4897,169,137,0,1022,79,497,29,6830
"25017359300",5786,158,122,0,1058,93,182,0,7399
"25017360100",1544,112,115,0,237,0,246,0,2254
"25017360200",4212,116,147,2,697,69,253,65,5561
"25017361100",4944,415,0,0,434,0,128,0,5921
"25017361200",4764,313,29,0,588,11,202,17,5924
"25017361300",5123,226,0,3,475,3,50,2,5882
"25017362100",4288,110,37,0,625,14,72,0,5146
"25017363102",3482,319,153,0,1857,0,0,0,5811
"25017363103",2545,34,61,0,1023,0,20,0,3683
"25017363104",4744,107,106,0,1228,5,287,17,6494
"25017363201",2708,98,0,0,600,27,49,2,3484
"25017363202",2925,59,0,37,669,19,49,0,3758
"25017364101",4391,284,30,0,392,164,249,2,5512
"25017364102",4231,196,20,240,416,48,174,48,5373
"25017365100",6749,62,81,0,926,0,84,0,7902
"25017365201",4941,53,0,0,583,103,162,0,5842
"25017365202",4044,68,0,0,578,0,49,0,4739
"25017366100",3810,215,0,0,696,129,54,0,4904
"25017366201",3058,31,0,0,334,0,111,9,3543
"25017366202",4185,218,3,5,680,12,120,3,5226
"25017367100",3142,104,36,11,572,4,193,0,4062
"25017367200",5814,162,83,29,1153,31,106,11,7389
"25017368101",4125,293,93,121,1115,273,316,0,6336
"25017368102",2689,59,306,2,681,7,190,13,3947
"25017368200",3164,154,306,0,727,104,396,92,4943
"25017368300",3575,346,512,28,711,96,868,27,6163
"25017368400",3882,151,365,191,577,472,234,2,5874
"25017368500",1690,405,44,34,472,91,569,132,3437
"25017368600",3824,481,103,0,1188,51,1396,230,7273
"25017368700",1605,335,146,118,122,111,733,216,3386
"25017368800",3242,403,229,6,902,50,997,248,6077
"25017368901",3708,269,229,6,566,57,189,99,5123
"25017368902",1955,160,315,76,881,213,300,195,4095
"25017369000",980,140,45,15,167,0,38,29,1414
"25017369100",4409,121,35,44,298,57,107,11,5082
"25017370101",5599,876,196,6,738,32,954,486,8887
"25017370102",5462,646,260,0,747,116,654,86,7971
"25017370201",2773,196,68,2,520,70,103,3,3735
"25017370202",3802,63,0,0,544,37,485,20,4951
"25017370300",3922,458,272,0,726,0,623,45,6046
"25017370400",4085,269,157,23,479,28,336,15,5392
"25017373100",3453,193,201,65,1025,10,209,20,5176
"25017373200",3364,185,138,6,813,95,275,19,4895
"25017373300",2186,116,164,11,286,34,40,0,2837
"25017373400",2699,101,131,0,554,63,111,2,3661
"25017373500",4356,172,86,2,726,19,275,16,5652
"25017373600",2168,188,73,25,188,26,129,9,2806
"25017373700",3042,54,34,0,403,0,68,0,3601
"25017373800",4154,344,59,2,1256,32,120,204,6171
"25017373900",4922,333,264,0,1086,0,307,18,6930
"25017374000",2959,62,28,294,1124,30,128,0,4625
"25017374100",2857,84,40,146,1100,282,262,8,4779
"25017374200",3635,96,89,12,592,7,128,0,4559
"25017374300",2943,127,65,2,494,1,192,0,3824
"25017374400",4630,144,211,1,876,41,261,41,6205
"25017374500",3414,104,280,20,815,24,205,17,4879
"25017374600",3693,124,89,8,841,0,506,12,5273
"25017374700",3235,221,159,31,1133,70,338,12,5199
"25017374800",2448,63,34,1,570,8,69,14,3207
"25017382100",4282,112,15,0,512,0,113,0,5034
"25017382200",4549,46,96,0,782,20,96,0,5589
"25017382300",4916,410,86,14,447,18,185,0,6076
"25017382400",4095,217,19,0,343,37,204,0,4915
"25017382500",4000,80,114,40,365,32,226,0,4857
"25017382601",3159,163,47,2,992,117,235,0,4715
"25017382602",3573,79,39,1,727,39,191,37,4686
"25017383101",1194,459,254,67,800,360,488,337,3959
"25017383102",1953,864,570,333,1327,369,2274,899,8589
"25017383200",3672,360,284,347,1008,279,1481,382,7813
"25017383300",2196,169,53,6,215,35,262,0,2936
"25017383400",3913,479,257,188,1001,30,693,252,6813
"25017383501",2123,546,359,31,1777,121,882,208,6047
"25017383502",1722,182,92,0,294,2,166,0,2458
"25017383600",3711,304,171,655,838,28,444,251,6402
"25017383700",4972,120,67,0,297,12,352,0,5820
"25017383800",4439,90,163,21,463,1,479,1,5657
"25017383901",6544,177,361,97,619,25,154,35,8012
"25017383902",4345,121,206,0,651,8,155,0,5486
"25017384001",1062,63,36,0,370,17,109,16,1673
"25017384002",3438,588,303,78,1497,101,151,100,6256
"25017385100",5773,146,172,37,637,8,495,16,7284
"25017385201",2079,192,20,1,80,45,60,30,2507
"25017385202",6377,186,227,18,1074,39,178,0,8099
"25017386100",3967,55,0,0,223,0,80,0,4325
"25017387100",3709,172,67,4,241,9,92,7,4301
"25017387201",5217,132,73,1,350,100,213,0,6086
"25017387202",3735,107,0,0,217,23,173,0,4255
"25017388100",3831,197,22,0,1041,46,21,53,5211
"25017388200",3900,537,159,89,841,60,487,39,6112
"25017388300",1035,1015,130,207,787,1412,519,1514,6619
"25017980000",0,0,0,0,0,0,0,0,0
"25019950100",1213,77,24,0,23,0,44,0,1381
"25019950200",3564,568,412,351,192,13,288,215,5603
"25019950307",387,14,0,0,6,2,0,0,409
"25019950400",2003,39,161,10,247,0,454,0,2914
"25019950500",972,97,0,10,0,24,24,12,1139
"25019990000",0,0,0,0,0,0,0,0,0
"25021400100",3109,570,46,28,671,149,389,104,5066
"25021400200",3016,898,67,111,970,530,258,63,5913
"25021400300",3160,356,0,3,729,117,250,61,4676
"25021400400",4586,551,89,3,774,52,352,64,6471
"25021400500",3446,579,35,19,931,89,195,23,5317
"25021400600",3261,486,26,0,1122,11,315,14,5235
"25021400700",2465,107,19,0,612,113,121,19,3456
"25021400800",3401,268,93,0,1278,261,250,22,5573
"25021400900",2711,186,152,215,756,248,336,33,4637
"25021401000",2013,266,215,94,408,228,113,79,3416
"25021401100",3484,108,38,29,734,40,217,0,4650
"25021401200",4402,190,274,0,1515,91,142,0,6614
"25021402101",2638,238,314,0,163,27,64,0,3444
"25021402102",3078,238,528,32,404,163,433,169,5045
"25021402200",1772,33,143,0,179,0,210,0,2337
"25021402300",3460,50,88,0,344,5,283,0,4230
"25021402400",5476,203,340,44,442,14,369,38,6926
"25021402500",3174,111,102,0,326,10,44,0,3767
"25021403100",6021,212,56,1,407,0,276,1,6974
"25021403300",3757,62,38,0,203,0,43,0,4103
"25021403400",5082,169,74,56,836,68,12,75,6372
"25021403500",4919,60,104,153,912,93,176,6,6423
"25021404100",2822,76,23,0,1145,91,175,12,4344
"25021404201",3520,105,16,0,203,2,84,1,3931
"25021404202",2801,64,18,3,196,10,62,3,3157
"25021404301",4607,161,18,8,664,52,61,59,5630
"25021404302",2961,57,0,0,466,0,171,0,3655
"25021404400",3758,123,88,28,250,70,178,10,4505
"25021405100",5044,33,204,0,533,0,169,13,5996
"25021406101",5053,171,0,0,456,0,44,0,5724
"25021406102",5979,290,0,0,379,0,406,0,7054
"25021407100",7109,529,0,0,344,16,312,30,8340
"25021408101",7203,284,66,1,388,28,258,14,8242
"25021408102",4536,65,149,8,216,12,56,0,5042
"25021409101",3914,192,0,1,44,0,111,0,4262
"25021409102",4989,177,0,0,134,11,61,8,5380
"25021410100",5883,385,40,0,202,0,135,11,6656
"25021410300",4142,133,189,10,307,0,63,0,4844
"25021410400",5204,307,81,21,315,0,265,0,6193
"25021411100",7094,101,347,0,374,0,153,0,8069
"25021411200",6270,178,124,41,631,61,70,0,7375
"25021411301",5180,173,108,0,116,0,166,0,5743
"25021411302",3076,122,0,0,293,0,119,0,3610
"25021412100",5893,114,0,0,516,0,227,0,6750
"25021412200",3382,101,12,0,154,0,46,0,3695
"25021412300",4314,30,37,1,514,1,98,0,4995
"25021413100",5161,334,118,20,356,87,230,107,6413
"25021413200",4798,513,0,43,381,0,29,1,5765
"25021413300",4087,282,138,0,323,53,212,142,5237
"25021413401",2719,142,78,0,26,5,158,5,3133
"25021413402",3095,150,197,9,883,61,164,0,4559
"25021413500",2657,268,511,24,642,342,138,372,4954
"25021414100",3945,74,413,0,1010,35,211,0,5688
"25021414200",5698,106,294,14,1232,22,240,15,7621
"25021414300",4079,210,132,0,644,26,57,0,5148
"25021415101",3616,154,219,92,518,108,249,0,4956
"25021415102",6109,519,445,87,800,21,355,0,8336
"25021415200",4391,297,315,64,438,0,276,0,5781
"25021415300",3348,47,31,15,307,0,38,0,3786
"25021416101",4506,289,166,25,685,0,244,27,5942
"25021416102",1780,68,237,0,282,0,48,10,2425
"25021416200",3334,90,2285,109,641,0,256,0,6715
"25021416300",3452,114,826,161,350,17,387,11,5318
"25021416400",5595,78,30,0,371,65,256,0,6395
"25021417100",2891,112,92,1,1032,184,31,1,4344
"25021417200",3954,346,313,172,3199,351,76,43,8454
"25021417300",1933,151,134,0,458,10,88,1,2775
"25021417400",2096,156,44,17,46,0,72,17,2448
"25021417501",2525,111,47,0,1935,299,49,48,5014
"25021417502",1574,168,208,1,2367,342,0,1,4661
"25021417601",2913,216,12,0,1752,78,63,0,5034
"25021417602",3045,251,61,44,1257,423,17,0,5098
"25021417701",3105,196,197,0,1406,149,263,0,5316
"25021417702",2023,191,360,50,227,19,49,25,2944
"25021417801",4548,105,64,0,278,0,136,0,5131
"25021417802",899,555,63,74,844,561,5,128,3129
"25021417901",3783,600,528,0,1360,179,211,0,6661
"25021417902",2157,229,136,119,899,68,61,9,3678
"25021418002",3985,125,240,12,2134,295,261,0,7052
"25021418003",1542,272,183,12,628,71,239,0,2947
"25021418004",2481,476,145,16,1142,177,128,0,4565
"25021418101",2675,350,278,14,1127,152,88,19,4703
"25021418102",2099,181,230,31,572,135,276,0,3524
"25021418200",4295,569,679,15,1548,15,514,84,7719
"25021419100",4929,173,457,0,404,120,236,0,6319
"25021419200",4272,213,136,57,566,28,195,28,5495
"25021419300",2626,356,266,127,493,130,63,0,4061
"25021419400",2353,167,0,5,247,57,0,9,2838
"25021419500",2302,32,108,0,331,0,153,0,2926
"25021419600",5939,204,439,0,579,146,134,0,7441
"25021419700",3073,140,0,0,633,0,19,0,3865
"25021419800",3587,164,49,0,398,11,105,0,4314
"25021420100",3285,283,2279,479,1099,432,129,170,8156
"25021420201",1120,45,1143,489,638,59,270,9,3773
"25021420202",2348,83,2545,317,1114,42,252,1,6702
"25021420301",3218,146,2271,199,947,120,762,43,7706
"25021420302",2347,344,3803,483,1178,180,429,164,8928
"25021421100",4028,428,437,92,210,41,567,39,5842
"25021421200",4710,423,342,24,216,0,410,0,6125
"25021422100",4810,202,189,91,594,2,162,24,6074
"25021422200",6205,233,234,0,284,142,83,3,7184
"25021422301",2811,58,25,0,144,0,32,0,3070
"25021422302",5055,187,472,0,650,34,64,22,6484
"25021422400",5595,638,592,12,496,73,317,0,7723
"25021422501",3650,421,429,0,417,206,298,70,5491
"25021422502",3175,739,249,0,1074,60,184,77,5558
"25021422600",6150,288,60,1,571,0,102,80,7252
"25021422700",3285,173,0,0,142,0,28,0,3628
"25021422800",3532,131,5,0,164,65,0,13,3910
"25021423100",7657,416,9,0,139,0,39,0,8260
"25021440100",7756,420,59,0,500,0,20,0,8755
"25021441202",2696,86,7,3,34,4,52,0,2882
"25021441203",3604,226,0,0,6,0,31,0,3867
"25021441204",4035,261,46,1,41,0,12,13,4409
"25021442101",4738,90,16,0,244,1,48,0,5137
"25021442102",6437,39,90,0,450,15,145,0,7176
"25021442103",6616,16,35,0,496,0,211,0,7374
"25021442201",3518,63,46,0,252,35,35,0,3949
"25021442202",7464,739,0,2,245,32,243,52,8777
"25021443101",7307,56,66,0,495,0,270,0,8194
"25021443102",7791,432,77,2,304,14,54,14,8688
"25021456101",3035,71,727,0,135,31,44,7,4050
"25021456102",3754,273,535,0,259,134,229,141,5325
"25021456200",2322,130,588,39,257,15,74,15,3440
"25021456301",963,435,163,0,109,9,6,11,1696
"25021456302",3484,681,723,18,413,0,27,174,5520
"25021456401",1920,110,480,61,156,55,92,0,2874
"25021456402",4728,93,508,8,234,76,66,76,5789
"25021457100",3346,87,514,0,452,54,190,0,4643
"25021457200",5023,98,91,0,491,2,134,1,5840
"25023500101",3479,276,14,0,277,0,170,0,4216
"25023500103",2113,101,0,0,63,0,53,0,2330
"25023500104",3823,85,30,0,108,34,109,0,4189
"25023501101",3084,155,0,0,29,12,38,0,3318
"25023501102",7549,342,44,2,482,3,0,0,8422
"25023501201",3630,84,0,0,67,12,114,15,3922
"25023501202",6159,468,13,0,310,0,69,0,7019
"25023502101",5510,255,51,7,205,42,19,0,6089
"25023502102",4629,270,406,64,251,58,50,0,5728
"25023502200",4991,563,77,1,92,0,185,0,5909
"25023503101",6692,476,58,0,86,0,72,0,7384
"25023503102",6303,139,0,0,321,0,0,1,6764
"25023504101",4951,169,3,11,233,0,97,0,5464
"25023504102",4955,141,0,0,56,16,7,16,5191
"25023505101",6140,141,16,0,177,0,101,0,6575
"25023505102",4795,178,0,9,128,0,53,0,5163
"25023505200",5966,312,17,57,160,40,166,0,6718
"25023506101",6123,275,0,10,179,12,0,12,6611
"25023506102",4981,268,14,0,349,204,166,1,5983
"25023506202",2250,179,0,0,88,19,13,5,2554
"25023506203",4613,230,17,0,199,63,121,0,5243
"25023506204",5061,322,5,0,0,32,38,0,5458
"25023507101",4857,267,87,0,94,0,60,0,5365
"25023507103",4154,138,0,2,88,0,28,0,4410
"25023507104",5218,180,18,4,101,0,0,0,5521
"25023508101",5997,168,54,0,391,103,313,58,7084
"25023508102",4688,271,0,10,138,14,112,12,5245
"25023508200",5773,276,0,0,166,0,107,0,6322
"25023509101",5945,545,0,12,178,10,191,0,6881
"25023509102",5504,204,222,0,94,0,139,0,6163
"25023510100",3306,35,780,100,313,0,206,0,4740
"25023510200",3283,551,1861,143,963,8,1096,104,8009
"25023510300",601,311,1656,433,702,236,421,147,4507
"25023510400",513,148,1532,419,385,241,157,38,3433
"25023510501",1293,171,646,20,318,75,13,21,2557
"25023510502",1963,292,2100,567,213,95,302,18,5550
"25023510503",1678,427,1304,524,247,170,367,66,4783
"25023510600",1684,17,849,1,249,11,131,0,2942
"25023510700",2308,521,1807,353,494,365,415,500,6763
"25023510800",632,725,2512,1422,1003,258,393,564,7509
"25023510900",184,461,359,971,214,126,75,143,2533
"25023511000",690,361,1286,477,211,205,75,203,3508
"25023511100",2892,377,1412,111,395,114,352,0,5653
"25023511200",1920,220,2185,345,443,205,423,130,5871
"25023511301",2080,187,1469,400,928,278,472,96,5910
"25023511302",2055,195,767,195,297,70,528,43,4150
"25023511400",1030,201,1658,366,724,33,243,51,4306
"25023511500",1023,279,1843,589,608,139,434,192,5107
"25023511600",2458,526,1752,531,831,183,595,292,7168
"25023511701",2580,152,1216,212,233,26,95,32,4546
"25023511702",1804,57,486,18,357,4,220,7,2953
"25023520100",6104,149,0,0,279,0,72,0,6604
"25023520201",3108,180,50,0,295,17,46,0,3696
"25023520202",5184,116,349,0,197,0,240,0,6086
"25023521101",3955,205,24,0,86,27,0,27,4324
"25023521102",3102,183,0,1,131,162,41,40,3660
"25023521201",2774,202,0,0,104,38,7,7,3132
"25023521202",3473,172,42,6,27,0,9,0,3729
"25023522101",4287,180,182,3,120,8,0,3,4783
"25023522102",5154,190,17,0,203,6,197,0,5767
"25023523100",2885,113,18,0,199,0,72,0,3287
"25023523201",2622,65,7,0,118,0,25,7,2844
"25023523202",7462,340,13,0,132,17,68,0,8032
"25023524101",2843,81,13,0,99,0,165,0,3201
"25023524102",3250,127,190,63,128,44,126,54,3982
"25023525101",5033,553,487,16,304,1,84,0,6478
"25023525104",5564,350,0,0,207,74,63,206,6464
"25023525203",4640,505,199,225,117,0,114,0,5800
"25023525204",3197,61,430,19,99,0,27,0,3833
"25023525300",3,0,0,0,0,0,0,0,3
"25023526100",7169,241,0,0,204,19,285,0,7918
"25023530100",3149,359,30,86,234,153,254,50,4315
"25023530200",3114,425,35,59,167,0,105,11,3916
"25023530300",3437,268,35,1,262,21,29,2,4055
"25023530400",5308,123,52,1,330,0,90,0,5904
"25023530500",3983,334,95,30,234,144,0,0,4820
"25023530600",4674,320,65,0,238,0,25,0,5322
"25023530700",4262,215,44,0,12,25,9,0,4567
"25023530801",4860,503,0,0,151,7,124,7,5652
"25023530802",4766,330,22,2,75,11,108,1,5315
"25023530901",7526,189,42,0,423,0,118,0,8298
"25023530902",4154,180,72,0,211,0,10,0,4627
"25023540101",3712,195,26,7,48,0,21,0,4009
"25023540102",2539,79,0,0,37,0,125,0,2780
"25023540103",4048,130,0,0,87,71,78,40,4454
"25023541100",4731,195,63,0,316,80,105,2,5492
"25023542101",7083,159,111,0,155,0,106,0,7614
"25023542102",2150,107,86,0,4,0,11,0,2358
"25023542200",5826,192,210,0,113,0,15,0,6356
"25023542300",5479,971,113,22,310,195,204,0,7294
"25023543100",2668,135,0,0,58,7,50,3,2921
"25023544100",5240,165,87,0,217,19,32,11,5771
"25023544200",5319,227,172,0,103,0,51,0,5872
"25023545100",5714,557,121,15,686,68,134,21,7316
"25023545200",3809,761,141,2,678,29,32,37,5489
"25023545300",3254,205,26,1,200,122,0,0,3808
"25023545400",4006,647,138,33,660,170,77,63,5794
"25023560100",5734,241,48,0,153,0,30,0,6206
"25023561100",4281,171,6,73,295,25,51,0,4902
"25023561200",229,94,0,0,25,0,0,0,348
"25023990003",0,0,0,0,0,0,0,0,0
"25025000100",1947,401,106,72,972,173,629,65,4365
"25025000201",2456,273,90,53,287,125,186,113,3583
"25025000202",2079,263,173,192,583,297,297,369,4253
"25025000301",1692,373,10,11,433,79,153,69,2820
"25025000302",1885,253,88,61,304,209,84,0,2884
"25025000401",3060,721,103,34,865,482,213,165,5643
"25025000402",1635,542,22,63,679,105,346,48,3440
"25025000502",1780,685,29,2,279,161,130,78,3144
"25025000503",1277,382,34,0,143,191,56,44,2127
"25025000504",2191,1063,165,26,431,202,156,168,4402
"25025000601",1769,456,78,0,736,143,164,157,3503
"25025000602",1521,624,272,187,518,405,221,355,4103
"25025000701",1910,494,150,65,584,535,293,75,4106
"25025000703",684,452,56,203,364,225,87,76,2147
"25025000704",1991,747,278,0,877,368,263,214,4738
"25025000802",2859,1234,270,198,1676,585,1150,567,8539
"25025000803",502,303,112,70,229,122,83,172,1593
"25025010103",260,129,26,22,126,142,60,63,828
"25025010104",1795,348,44,32,333,299,188,111,3150
"25025010203",2014,1624,68,121,410,580,282,546,5645
"25025010204",578,367,14,0,335,362,28,29,1713
"25025010300",185,52,34,25,120,32,114,12,574
"25025010403",1136,623,57,103,509,447,196,179,3250
"25025010404",709,1089,190,68,203,397,137,178,2971
"25025010405",655,385,119,115,161,204,232,75,1946
"25025010408",946,119,52,7,191,169,94,35,1613
"25025010500",1292,571,282,36,413,244,173,200,3211
"25025010600",2093,233,243,108,297,59,101,44,3178
"25025010701",1856,262,20,0,323,6,166,55,2688
"25025010702",1966,184,25,8,77,18,73,73,2424
"25025010801",2428,137,0,1,169,25,138,33,2931
"25025010802",2216,216,7,0,237,18,137,83,2914
"25025020101",3997,200,39,0,180,0,19,17,4452
"25025020200",2759,506,90,17,372,150,269,68,4231
"25025020301",1378,165,33,2,545,124,124,2,2373
"25025020302",828,121,0,0,42,4,7,6,1008
"25025020303",1834,294,44,80,609,239,272,172,3544
"25025030100",1823,243,0,0,44,41,29,0,2180
"25025030200",1434,237,4,4,47,12,116,44,1898
"25025030300",3459,618,198,169,507,115,252,90,5408
"25025030400",2167,254,24,0,145,18,98,22,2728
"25025030500",2219,148,1,8,162,27,10,0,2575
"25025040100",2265,58,0,0,76,0,140,19,2558
"25025040200",747,165,273,142,197,317,273,265,2379
"25025040300",3117,245,14,376,151,311,49,105,4368
"25025040401",1678,346,45,0,250,204,10,149,2682
"25025040600",2344,208,147,3,166,4,78,2,2952
"25025040801",1879,232,352,521,551,504,596,283,4918
"25025050101",2241,870,214,21,1645,464,2421,1012,8888
"25025050200",3018,489,230,0,2054,284,3718,699,10492
"25025050300",847,474,166,62,405,188,644,315,3101
"25025050400",1726,155,25,25,404,102,1202,161,3800
"25025050500",1468,313,46,0,382,96,1128,165,3598
"25025050600",1202,231,105,4,647,103,1400,236,3928
"25025050700",2030,690,2,0,1947,641,2695,1086,9091
"25025050901",2066,543,74,0,1748,272,2614,656,7973
"25025051000",2396,716,35,43,1316,42,1520,402,6470
"25025051101",3940,596,121,200,755,760,1773,819,8964
"25025051200",1380,427,41,14,584,249,746,395,3836
"25025060101",3303,277,0,0,111,23,72,23,3809
"25025060200",2119,171,0,1,100,21,12,3,2427
"25025060301",3089,275,0,2,53,13,43,17,3492
"25025060400",4509,404,61,35,112,18,136,18,5293
"25025060501",3545,237,32,10,113,119,37,135,4228
"25025060600",2153,161,14,5,346,0,27,0,2706
"25025060700",412,258,555,255,542,535,513,456,3526
"25025060800",4078,369,0,0,383,259,42,147,5278
"25025061000",1222,658,193,182,452,483,278,694,4162
"25025061101",325,380,119,361,419,564,391,615,3174
"25025061200",3070,173,58,37,136,77,69,12,3632
"25025070101",2750,441,77,36,898,575,329,69,5175
"25025070200",389,101,63,9,2317,1061,15,31,3986
"25025070300",3073,355,73,0,725,119,78,209,4632
"25025070402",157,20,32,116,729,547,62,17,1680
"25025070500",3588,315,121,71,1304,522,786,160,6867
"25025070600",2008,52,11,3,240,10,61,0,2385
"25025070700",1548,230,854,28,289,17,183,26,3175
"25025070800",2214,444,533,125,251,155,287,137,4146
"25025070900",1371,215,703,193,365,301,408,207,3763
"25025071101",1683,618,238,196,608,641,341,430,4755
"25025071201",1086,265,570,233,699,497,511,434,4295
"25025080100",208,95,714,368,253,62,255,136,2091
"25025080300",130,134,889,291,481,133,500,148,2706
"25025080401",293,148,1210,524,478,322,603,498,4076
"25025080500",397,300,790,567,669,563,912,750,4948
"25025080601",197,227,631,579,226,284,248,269,2661
"25025080801",296,110,691,574,581,455,770,380,3857
"25025080900",1544,1185,251,60,319,447,157,51,4014
"25025081001",1144,855,288,580,992,696,351,440,5346
"25025081100",1421,692,292,259,675,442,461,275,4517
"25025081200",641,217,398,840,999,330,1125,575,5125
"25025081300",528,487,1368,890,1292,850,1298,1016,7729
"25025081400",626,370,990,359,397,119,246,119,3226
"25025081500",253,45,974,287,282,309,300,366,2816
"25025081700",107,113,1669,791,246,411,231,287,3855
"25025081800",102,133,2005,700,357,293,637,400,4627
"25025081900",302,110,1431,1084,252,336,497,497,4509
"25025082000",88,298,1579,573,128,59,200,343,3268
"25025082100",336,92,1954,1424,562,862,675,968,6873
"25025090100",289,85,2414,1079,542,403,539,501,5852
"25025090200",116,83,766,353,687,378,566,326,3275
"25025090300",136,157,1813,544,288,669,415,629,4651
"25025090400",168,312,2037,447,576,425,652,659,5276
"25025090600",173,93,1144,313,478,136,331,172,2840
"25025090700",2124,305,249,234,1000,701,429,302,5344
"25025090901",827,482,350,175,766,1229,461,476,4766
"25025091001",1737,97,331,146,777,129,53,26,3296
"25025091100",2660,298,191,54,1417,784,218,170,5792
"25025091200",1030,212,582,269,707,427,204,551,3982
"25025091300",407,195,758,296,748,173,594,162,3333
"25025091400",242,127,1040,255,644,394,488,389,3579
"25025091500",492,91,1431,485,1922,380,641,252,5694
"25025091600",360,174,1267,309,927,345,314,129,3825
"25025091700",232,130,1519,438,757,218,533,263,4090
"25025091800",198,224,1800,396,704,466,218,331,4337
"25025091900",272,80,2535,418,520,191,674,259,4949
"25025092000",341,324,2625,864,974,407,788,815,7138
"25025092101",1607,357,1330,355,2343,991,355,159,7497
"25025092200",812,77,1400,132,791,52,176,43,3483
"25025092300",219,129,2185,696,221,2,267,119,3838
"25025092400",289,201,4005,851,130,225,1027,539,7267
"25025100100",407,616,3327,1280,318,182,980,659,7769
"25025100200",106,40,1976,488,159,224,239,137,3369
"25025100300",192,120,2301,820,171,0,210,158,3972
"25025100400",409,52,3169,397,850,237,578,6,5698
"25025100500",1231,140,3491,1125,733,487,845,321,8373
"25025100601",1816,95,1387,342,1293,252,494,29,5708
"25025100603",1316,127,286,23,205,6,47,14,2024
"25025100700",3895,155,179,1,108,32,105,1,4476
"25025100800",2837,320,2150,116,1293,0,0,12,6728
"25025100900",912,117,2244,250,419,33,190,67,4232
"25025101001",124,117,3996,1368,145,16,270,371,6407
"25025101002",331,120,3260,788,130,187,695,626,6137
"25025101101",147,84,2786,597,164,8,705,211,4702
"25025101102",78,297,3470,1044,141,98,227,348,5703
"25025110103",2934,399,1210,381,949,564,1124,708,8269
"25025110201",836,114,767,162,391,104,670,135,3179
"25025110301",1051,162,870,49,503,7,657,65,3364
"25025110401",1677,359,1211,67,362,154,802,383,5015
"25025110403",2092,313,1036,389,812,82,1073,448,6245
"25025110501",2179,539,436,3,440,4,473,2,4076
"25025110502",3186,172,656,0,394,35,834,94,5371
"25025110601",2196,235,76,24,171,1,120,1,2824
"25025110607",3559,574,293,5,263,76,275,116,5161
"25025120103",1292,60,59,7,172,35,107,6,1738
"25025120104",1504,242,81,82,231,133,209,305,2787
"25025120105",1657,147,100,10,237,30,64,47,2292
"25025120201",2260,351,277,73,406,312,765,516,4960
"25025120301",2284,212,809,271,1277,217,1365,397,6832
"25025120400",4225,691,401,283,764,77,770,85,7296
"25025120500",1139,150,282,141,568,199,754,233,3466
"25025120600",2006,216,110,14,199,35,265,25,2870
"25025120700",1142,229,131,25,556,66,252,165,2566
"25025130100",5317,192,56,0,857,18,235,0,6675
"25025130200",4000,420,59,0,401,18,227,3,5128
"25025130300",4127,5,103,5,440,0,272,1,4953
"25025130402",4033,342,96,0,413,0,172,113,5169
"25025130404",2072,110,210,5,774,0,523,13,3707
"25025130406",1726,445,2160,419,482,117,760,417,6526
"25025140102",1988,47,1792,153,700,11,765,0,5456
"25025140105",1820,20,1387,28,648,94,1175,75,5247
"25025140106",516,66,697,288,217,93,317,122,2316
"25025140107",906,136,1367,59,363,81,638,187,3737
"25025140201",1323,121,395,2,491,36,645,37,3050
"25025140202",2399,245,1827,186,1349,125,1341,182,7654
"25025140300",1358,95,3280,577,993,475,1447,489,8714
"25025140400",974,246,5576,677,836,59,1065,310,9743
"25025160101",3449,821,410,4,3118,1462,5795,1700,16759
"25025160200",1339,375,123,67,1813,558,2746,856,7877
"25025160300",1588,136,191,0,464,123,577,112,3191
"25025160400",1015,181,182,67,1199,204,1611,345,4804
"25025160501",2262,245,153,71,1413,675,2928,717,8464
"25025160502",2161,505,177,2,1099,188,1883,588,6603
"25025160601",1826,426,392,167,1127,515,1236,714,6403
"25025160602",2226,415,278,125,1321,416,1745,549,7075
"25025170100",5324,637,404,0,1451,163,2320,155,10454
"25025170200",2645,902,463,22,636,47,887,313,5915
"25025170300",6627,741,272,47,1069,113,978,279,10126
"25025170400",3112,687,355,48,1060,163,1300,147,6872
"25025170501",2362,303,75,50,593,289,756,52,4480
"25025170502",1885,269,34,14,404,138,131,9,2884
"25025170601",4169,680,163,18,754,60,1580,306,7730
"25025170701",1285,461,31,31,238,74,624,74,2818
"25025170702",2626,1417,744,228,1197,57,1718,710,8697
"25025170800",3553,559,167,1,920,0,1412,239,6851
"25025180101",4199,334,105,0,173,58,785,58,5712
"25025180200",3389,272,19,33,85,168,95,33,4094
"25025180301",2789,153,0,8,145,6,55,40,3196
"25025180400",1720,87,18,0,88,7,170,7,2097
"25025180500",3499,382,87,28,93,0,194,40,4323
"25025980101",35,98,9,116,25,39,25,40,387
"25025980300",22,61,17,57,0,67,6,84,314
"25025980700",9,0,0,0,0,0,0,0,9
"25025981000",0,0,0,0,0,0,0,0,0
"25025981100",81,12,93,135,68,0,57,0,446
"25025981201",0,0,0,0,0,0,0,0,0
"25025981202",0,0,0,0,0,0,0,0,0
"25025981300",272,13,28,0,173,0,184,0,670
"25025981501",0,0,0,0,0,0,0,0,0
"25025981502",0,0,0,0,0,0,0,0,0
"25025981600",0,0,0,0,0,0,0,0,0
"25025981700",0,0,0,0,0,0,0,0,0
"25025981800",33,0,0,0,0,0,0,0,33
"25025990101",0,0,0,0,0,0,0,0,0
"25027700100",5493,356,0,37,86,54,0,31,6057
"25027701100",7370,614,8,40,238,99,140,97,8606
"25027702200",2718,317,12,0,176,4,48,24,3299
"25027703100",3306,949,23,1,40,54,43,305,4721
"25027703200",2708,557,10,11,117,43,218,32,3696
"25027703300",3104,298,11,0,227,9,158,0,3807
"25027704200",2634,93,26,3,105,0,62,0,2923
"25027705100",7040,819,0,1,29,0,0,0,7889
"25027706100",4042,261,132,0,39,0,28,0,4502
"25027707100",2645,1238,73,2,112,76,69,312,4527
"25027707200",1321,465,54,0,162,4,227,20,2253
"25027707300",2840,858,20,14,27,33,59,34,3885
"25027707400",3728,257,65,13,284,86,180,87,4700
"25027707500",3646,551,43,1,503,67,410,1,5222
"25027708100",6993,237,62,0,61,15,237,15,7620
"25027709100",3328,361,41,8,269,49,216,78,4350
"25027709201",5186,736,110,0,381,86,433,197,7129
"25027709202",4952,788,344,46,1256,67,1021,155,8629
"25027709400",2596,796,157,26,329,471,646,775,5796
"25027709501",1836,35,107,0,152,15,165,1,2311
"25027709502",4444,313,293,39,670,16,534,20,6329
"25027709600",1699,321,306,39,328,34,562,199,3488
"25027709701",3604,623,316,16,506,73,608,209,5955
"25027709702",1924,370,22,32,281,0,319,159,3107
"25027710100",2249,395,134,7,881,173,1066,220,5125
"25027710200",5402,459,77,165,266,533,433,580,7915
"25027710300",2620,338,50,9,122,10,379,135,3663
"25027710400",1796,243,34,0,262,22,438,104,2899
"25027710500",1870,533,186,59,293,245,550,426,4162
"25027710600",4240,800,47,74,845,164,1539,317,8026
"25027710700",553,533,13,37,204,110,241,279,1970
"25027710800",1954,820,174,41,417,606,743,969,5724
"25027711000",1695,544,129,44,712,98,580,340,4142
"25027711100",3208,275,183,45,377,68,91,97,4344
"25027712101",5336,792,230,1,270,0,152,72,6853
"25027712102",3777,142,33,0,176,57,129,58,4372
"25027713100",5690,613,66,0,262,0,95,27,6753
"25027715100",4689,65,8,11,266,16,153,26,5234
"25027716100",6594,469,152,0,408,59,631,306,8619
"25027716200",1896,150,87,10,380,44,432,76,3075
"25027716300",2690,480,38,6,231,33,496,83,4057
"25027717100",2778,78,17,1,73,0,32,0,2979
"25027718100",4017,144,49,1,212,3,63,20,4509
"25027719100",7136,378,94,0,208,7,279,0,8102
"25027720100",2941,252,32,7,224,0,182,8,3646
"25027721101",1675,103,2,0,23,0,32,0,1835
"25027721102",7854,199,16,0,222,4,104,47,8446
"25027722100",4995,270,0,0,91,0,49,0,5405
"25027723100",3392,484,14,11,61,42,59,52,4115
"25027724100",3236,195,97,0,71,0,42,0,3641
"25027725100",4340,263,45,1,58,9,29,0,4745
"25027726100",5622,271,0,25,157,102,123,88,6388
"25027726200",4385,904,8,40,241,0,492,16,6086
"25027727100",3751,107,52,27,383,0,487,3,4810
"25027728100",3925,178,15,0,55,0,39,0,4212
"25027728200",3664,55,9,12,96,16,76,16,3944
"25027728300",4434,123,119,3,48,7,125,13,4872
"25027728400",4545,148,37,2,416,15,139,38,5340
"25027729100",2991,157,26,0,50,9,85,13,3331
"25027729200",1824,216,76,8,70,75,22,6,2297
"25027730100",3573,447,1133,94,693,76,248,204,6468
"25027730200",4072,345,297,80,181,0,244,0,5219
"25027730300",3482,398,501,8,318,29,624,18,5378
"25027730401",2763,714,651,217,872,88,1237,251,6793
"25027730402",1138,74,175,77,227,0,404,9,2104
"25027730500",1584,790,587,175,180,126,110,260,3812
"25027730600",6027,274,523,26,524,208,508,107,8197
"25027730700",4958,481,589,46,659,49,734,15,7531
"25027730801",3072,107,65,11,305,9,134,2,3705
"25027730802",1553,200,67,0,111,137,55,142,2265
"25027730901",2775,326,120,14,181,48,278,24,3766
"25027730902",2197,358,209,42,155,0,260,31,3252
"25027731001",1700,101,116,10,373,11,268,0,2579
"25027731002",3328,701,599,94,779,359,600,259,6719
"25027731101",2251,810,233,271,358,88,564,479,5054
"25027731102",1865,210,253,7,159,50,160,121,2825
"25027731202",0,0,0,0,0,0,0,0,0
"25027731203",1878,1308,308,200,1157,788,1033,698,7370
"25027731204",943,429,179,51,299,308,715,350,3274
"25027731300",1104,814,358,327,619,375,1009,725,5331
"25027731400",1489,1159,247,398,669,496,1109,1054,6621
"25027731500",1633,1048,586,309,564,452,1260,1015,6867
"25027731600",1355,1078,343,163,458,627,150,135,4309
"25027731700",798,713,385,94,153,107,222,291,2763
"25027731800",2323,1663,831,230,1059,596,954,1304,8960
"25027731900",1879,857,831,204,867,493,902,460,6493
"25027732001",855,957,216,318,364,856,929,1512,6007
"25027732002",2425,202,579,30,615,67,368,47,4333
"25027732201",1809,210,360,47,226,124,154,22,2952
"25027732202",2038,679,158,0,202,30,49,218,3374
"25027732203",1488,419,235,248,727,154,438,177,3886
"25027732301",2996,126,556,0,485,78,331,59,4631
"25027732302",2079,506,661,86,257,65,331,287,4272
"25027732400",2504,2043,595,368,989,193,1202,1822,9716
"25027732500",886,450,253,26,309,203,658,186,2971
"25027732600",1778,762,409,248,905,272,1463,441,6278
"25027732700",1701,577,436,379,540,195,416,393,4637
"25027732801",3069,452,674,71,241,1,119,126,4753
"25027732802",3054,323,530,156,532,39,408,176,5218
"25027732901",3894,845,1017,117,1318,96,589,181,8057
"25027732902",28,13,0,5,0,0,0,0,46
"25027733000",1681,879,210,53,923,251,1014,455,5466
"25027733101",1567,151,204,17,291,5,219,25,2479
"25027733102",1630,134,130,32,237,22,351,53,2589
"25027735100",5824,298,14,3,50,99,163,21,6472
"25027735200",3895,141,164,0,223,53,197,42,4715
"25027736100",2382,105,39,0,101,0,60,45,2732
"25027736200",3408,157,15,0,160,0,103,10,3853
"25027736300",2360,126,22,0,63,11,109,17,2708
"25027736400",2528,81,191,8,53,22,66,17,2966
"25027736500",4151,171,0,12,91,0,214,0,4639
"25027737100",4520,382,9,55,65,50,26,102,5209
"25027737200",1600,118,0,1,24,13,92,0,1848
"25027737300",5423,297,51,1,588,21,147,1,6529
"25027738100",3073,260,164,64,1032,40,293,46,4972
"25027738201",3852,103,25,2,126,39,130,19,4296
"25027738202",4852,309,242,13,452,36,11,0,5915
"25027739100",6005,519,316,99,2440,153,0,103,9635
"25027739200",4382,368,421,0,1137,125,122,0,6555
"25027739300",2932,135,101,46,511,23,48,0,3796
"25027739400",6856,257,149,27,1445,4,554,24,9316
"25027739500",6189,82,242,2,1225,56,295,56,8147
"25027740101",4682,75,1,3,788,0,180,1,5730
"25027740102",5106,250,45,4,658,0,216,0,6279
"25027740200",2397,80,167,1,354,48,49,5,3101
"25027741101",3675,187,36,23,591,0,122,0,4634
"25027741102",4374,92,43,35,732,9,70,9,5364
"25027742300",3330,109,0,1,580,29,147,0,4196
"25027742401",4242,124,29,10,711,10,120,10,5256
"25027742402",1502,40,129,0,1862,129,24,85,3771
"25027743100",6786,325,15,0,440,48,210,2,7826
"25027744101",5796,655,31,27,680,0,497,34,7720
"25027744102",4221,358,20,135,302,125,151,213,5525
"25027744200",6400,333,85,13,292,37,326,29,7515
"25027744300",2399,452,431,6,505,579,319,568,5259
"25027744400",3212,234,64,25,586,167,562,180,5030
"25027745100",5424,138,18,0,303,0,310,0,6193
"25027746100",5586,85,18,1,214,15,120,1,6040
"25027747101",4697,229,10,0,342,1,319,0,5598
"25027747102",3286,243,93,1,83,44,67,0,3817
"25027748100",2763,233,0,41,166,0,82,0,3285
"25027749100",6713,175,44,0,366,133,59,73,7563
"25027749200",5533,337,36,271,13,0,0,0,6190
"25027750100",4835,580,205,0,348,0,224,34,6226
"25027750200",6655,447,0,0,278,0,215,0,7595
"25027750300",2378,159,0,20,8,13,77,69,2724
"25027751101",5551,313,66,0,213,1,1,1,6146
"25027751102",2867,10,0,1,106,13,0,0,2997
"25027752100",8086,286,39,0,183,0,497,0,9091
"25027753100",5915,652,0,40,388,281,368,301,7945
"25027753200",5859,364,24,0,43,0,92,0,6382
"25027754100",4814,301,236,13,14,194,152,235,5959
"25027754200",2552,504,50,33,331,250,217,176,4113
"25027754300",2067,394,152,244,160,102,378,67,3564
"25027754400",3178,492,19,9,300,6,405,6,4415
"25027755100",2456,605,124,0,118,13,81,32,3429
"25027755200",6655,383,0,2,119,41,0,0,7200
"25027756101",3979,304,91,0,84,6,22,21,4507
"25027756102",8129,277,32,0,118,23,47,0,8626
"25027757100",3321,346,191,9,367,334,1026,331,5925
"25027757200",1054,281,8,45,707,247,825,340,3507
"25027757300",1289,361,0,0,598,320,805,359,3732
"25027757400",2116,72,44,0,389,207,718,193,3739
"25027757500",3105,482,95,0,478,86,469,319,5034
"25027758101",1606,96,6,0,46,0,24,0,1778
"25027758102",7099,319,17,2,226,0,223,0,7886
"25027759100",2025,129,0,0,44,0,23,0,2221
"25027760100",2979,185,0,21,88,95,1,0,3369
"25027761100",4464,684,0,2,13,0,43,0,5206
"25027761200",3587,168,62,13,1451,148,425,55,5909
"25027761300",3017,78,0,11,268,108,133,84,3699
"25027761400",4586,267,97,184,380,0,207,8,5729
"26001000100",1602,129,0,0,4,16,0,3,1754
"26001970100",1957,287,0,10,55,4,15,5,2333
"26001970400",2174,553,2,0,38,13,18,9,2807
"26001970500",1548,347,0,4,42,3,45,9,1998
"26001970600",1367,183,4,3,17,23,6,7,1610
"26001990000",0,0,0,0,0,0,0,0,0
"26003000100",3034,447,0,0,271,90,31,9,3882
"26003000200",1955,439,0,1,147,38,22,22,2624
"26003000300",1800,191,0,0,62,7,33,0,2093
"26003990000",0,0,0,0,0,0,0,0,0
"26005030200",3099,141,5,0,71,0,120,0,3436
"26005030300",6593,460,0,0,404,4,231,14,7706
"26005030401",6913,342,28,2,163,85,345,1,7879
"26005030402",4606,328,0,0,64,0,0,0,4998
"26005030500",5975,891,27,0,335,6,107,13,7354
"26005030600",4316,524,8,4,153,2,26,0,5033
"26005030702",4288,333,6,0,176,12,156,15,4986
"26005030703",1673,564,31,11,117,38,478,189,3101
"26005030704",3837,780,39,0,163,53,525,335,5732
"26005030800",4194,451,8,0,231,1,211,25,5121
"26005030901",2210,492,10,14,92,41,284,65,3208
"26005030902",2151,293,0,3,91,38,196,97,2869
"26005031000",3764,1255,436,107,186,221,635,408,7012
"26005031100",5322,638,80,4,91,12,156,1,6304
"26005031200",4229,628,291,125,75,60,116,150,5674
"26005031300",4156,522,5,6,101,89,317,115,5311
"26005031800",3922,380,0,0,160,31,43,9,4545
"26005031900",4337,628,16,0,48,44,191,39,5303
"26005032000",4051,1072,0,0,18,11,45,0,5197
"26005032100",4024,321,69,0,107,25,72,14,4632
"26005032200",3787,537,70,143,208,149,539,62,5495
"26005032401",992,525,67,0,100,94,441,499,2718
"26005032402",3292,490,0,0,94,22,265,117,4280
"26005032600",1133,54,6,0,83,79,115,11,1481
"26005990000",0,0,0,0,0,0,0,0,0
"26007000100",3841,577,0,6,87,32,42,12,4597
"26007000200",3769,353,14,5,72,15,46,2,4276
"26007000300",2422,537,5,7,78,6,7,0,3062
"26007000400",2021,890,5,0,46,19,19,0,3000
"26007000500",1293,425,7,3,58,62,15,16,1879
"26007000600",2603,443,0,0,57,5,25,15,3148
"26007000700",2433,412,12,7,12,11,23,17,2927
"26007000800",2353,508,0,37,67,35,44,22,3066
"26007000900",2237,485,1,10,71,8,48,5,2865
"26007990000",0,0,0,0,0,0,0,0,0
"26009960100",2158,269,21,0,59,5,43,20,2575
"26009960200",2852,432,0,5,58,21,46,11,3425
"26009960300",2381,264,0,1,37,0,2,5,2690
"26009960400",2626,372,3,7,64,52,30,1,3155
"26009960500",2797,228,15,0,184,44,136,7,3411
"26009960600",2533,457,1,0,136,28,77,2,3234
"26009960700",3599,1068,0,0,67,63,42,28,4867
"26009990000",0,0,0,0,0,0,0,0,0
"26011970100",1829,499,3,0,34,17,80,25,2487
"26011970200",2497,544,7,16,64,0,34,0,3162
"26011970300",2257,489,5,2,57,6,48,6,2870
"26011970400",2249,488,2,2,41,10,22,6,2820
"26011970500",2937,874,0,2,174,64,43,17,4111
"26011990000",0,0,0,0,0,0,0,0,0
"26011990100",0,0,0,0,0,0,0,0,0
"26013000100",3129,476,6,1,193,93,6,30,3934
"26013000200",1783,309,15,6,238,107,29,1,2488
"26013990100",0,0,0,0,0,0,0,0,0
"26015010100",4499,808,0,0,276,49,260,32,5924
"26015010200",5137,335,9,0,111,50,159,2,5803
"26015010300",7295,403,59,21,39,1,151,29,7998
"26015010401",2662,525,0,0,97,0,159,0,3443
"26015010402",3590,418,0,0,65,0,0,0,4073
"26015010500",2766,152,4,0,83,21,104,29,3159
"26015010600",5721,735,0,1,153,7,32,1,6650
"26015010700",4470,490,62,0,116,2,78,2,5220
"26015010800",2805,223,0,0,75,0,55,0,3158
"26015011300",5929,1530,0,1,139,0,151,18,7768
"26015011400",5148,588,0,17,537,0,225,0,6515
"26017280300",655,410,21,15,63,49,29,95,1337
"26017280400",2055,483,113,22,227,23,434,73,3430
"26017280500",2907,335,0,0,140,22,217,0,3621
"26017280600",1927,614,58,0,99,54,238,172,3162
"26017280700",1540,1043,116,39,41,98,142,16,3035
"26017280800",3167,454,30,29,59,140,249,43,4171
"26017280900",1758,851,53,103,87,31,205,26,3114
"26017281000",3296,538,11,40,125,12,279,22,4323
"26017281300",2269,577,36,37,51,13,69,142,3194
"26017285100",2749,418,93,0,138,1,173,0,3572
"26017285201",4784,764,73,37,122,24,113,153,6070
"26017285202",2899,537,6,12,6,0,51,32,3543
"26017285300",4172,244,3,0,58,0,275,0,4752
"26017285400",2998,282,44,13,184,0,33,0,3554
"26017285500",6224,344,0,0,35,0,92,0,6695
"26017285600",6380,443,0,0,285,23,154,58,7343
"26017285700",3103,456,0,1,271,46,148,27,4052
"26017285800",4875,938,21,20,57,391,98,0,6400
"26017285900",3812,682,38,35,144,0,215,22,4948
"26017286000",2873,195,0,0,134,0,107,0,3309
"26017286100",6740,660,0,0,148,41,70,56,7715
"26017286200",4110,654,0,0,31,46,82,36,4959
"26017286300",2947,608,33,3,67,4,125,37,3824
"26017286400",2365,286,0,0,74,52,49,49,2875
"26017286500",863,569,50,49,96,84,140,117,1968
"26017286600",3949,682,98,36,430,92,319,0,5606
"26017990000",0,0,0,0,0,0,0,0,0
"26019000100",6337,690,7,17,120,64,104,13,7352
"26019000200",2702,210,0,12,89,53,22,0,3088
"26019000300",1382,194,0,0,23,4,38,30,1671
"26019000400",1898,277,0,1,38,0,86,7,2307
"26019000500",2480,389,0,0,152,78,53,8,3160
"26019990000",0,0,0,0,0,0,0,0,0
"26021000300",80,61,1042,617,30,106,52,0,1988
"26021000400",103,71,734,1380,18,69,56,69,2500
"26021000500",72,45,906,730,5,87,5,0,1850
"26021000600",149,88,1721,1086,113,71,0,0,3228
"26021000700",1931,90,762,163,39,0,23,0,3008
"26021000800",4118,520,132,0,242,0,14,0,5026
"26021000900",1547,74,113,0,136,10,21,10,1911
"26021001000",1591,81,0,4,63,0,34,0,1773
"26021001100",3497,80,118,0,304,20,25,0,4044
"26021001300",1714,82,53,2,206,36,26,31,2150
"26021001400",3654,308,206,21,200,8,86,0,4483
"26021001500",2658,177,43,59,208,11,84,0,3240
"26021001600",2369,24,51,0,18,0,21,0,2483
"26021001700",3790,211,22,11,482,0,131,2,4649
"26021001800",4014,270,74,0,247,11,129,110,4855
"26021001900",1445,107,121,18,158,3,155,0,2007
"26021002000",1117,217,1459,499,101,45,208,33,3679
"26021002100",625,585,358,471,330,144,288,151,2952
"26021002200",237,61,1022,1661,58,0,143,0,3182
"26021002300",655,61,322,544,160,429,183,409,2763
"26021002400",1193,110,209,50,147,5,158,14,1886
"26021002500",1148,291,452,238,7,0,26,4,2166
"26021010100",2781,358,177,17,118,184,43,163,3841
"26021010200",5407,786,12,10,271,86,49,18,6639
"26021010300",3633,855,6,38,166,152,57,78,4985
"26021010400",2465,190,15,7,88,21,195,78,3059
"26021010500",1813,406,59,98,87,13,103,95,2674
"26021010600",3562,699,145,49,331,159,339,205,5489
"26021011000",2382,206,3,30,137,0,150,6,2914
"26021011100",4412,311,27,24,59,9,24,2,4868
"26021011200",2772,190,85,0,30,0,40,0,3117
"26021011300",3456,527,13,94,185,43,122,53,4493
"26021011400",2041,327,23,0,100,31,74,12,2608
"26021011500",1246,206,0,0,31,10,5,12,1510
"26021011600",1393,191,3,3,131,13,112,62,1908
"26021020100",2086,221,0,107,56,31,31,0,2532
"26021020200",4034,646,473,92,142,0,161,3,5551
"26021020300",2345,174,22,0,84,5,89,29,2748
"26021020400",3048,256,142,1,245,126,243,196,4257
"26021020500",1395,899,231,109,68,54,394,180,3330
"26021020600",2378,586,7,92,35,80,36,18,3232
"26021020700",1791,594,232,129,54,0,35,33,2868
"26021020900",2666,573,133,80,226,189,122,19,4008
"26021021000",3733,765,232,172,229,202,16,0,5349
"26021021100",1555,206,11,9,101,0,69,0,1951
"26021021200",1079,274,29,9,21,17,7,0,1436
"26021021300",1167,170,559,348,476,180,168,51,3119
"26021021400",2312,434,213,155,281,168,342,214,4119
"26021990000",0,0,0,0,0,0,0,0,0
"26023950100",3174,681,18,0,65,10,91,6,4045
"26023950200",3025,527,2,0,91,10,13,10,3678
"26023950300",3274,485,0,0,134,11,49,0,3953
"26023950800",3181,1288,2,8,43,11,48,75,4656
"26023950900",1828,270,0,13,19,4,5,0,2139
"26023951000",1936,191,3,0,0,0,12,9,2151
"26023951100",2423,477,7,28,18,12,49,5,3019
"26023951200",2928,1037,0,14,316,30,240,179,4744
"26023951300",2872,173,0,0,33,5,7,5,3095
"26023951400",3424,493,0,72,194,35,188,208,4614
"26023951500",2289,584,29,1,40,15,97,184,3239
"26023951600",2523,823,0,2,30,0,110,192,3680
"26025000200",1780,717,330,387,244,58,131,121,3768
"26025000300",264,281,609,579,182,27,162,76,2180
"26025000500",1560,985,380,181,130,21,101,178,3536
"26025000600",884,846,371,198,65,199,94,330,2987
"26025000700",1273,742,227,276,0,188,131,159,2996
"26025000800",1803,695,302,121,344,81,199,77,3622
"26025000900",2554,134,510,180,126,87,55,39,3685
"26025001000",926,333,1721,518,171,66,183,9,3927
"26025001100",2623,625,522,155,161,51,132,10,4279
"26025001200",1603,468,255,0,41,0,33,81,2481
"26025001300",2166,845,112,84,616,162,44,287,4316
"26025001400",3289,484,109,17,254,45,188,30,4416
"26025001500",4735,66,314,0,352,101,286,0,5854
"26025001600",2070,196,43,8,317,22,99,0,2755
"26025001700",2957,460,199,34,573,35,199,0,4457
"26025001800",4212,300,672,225,421,0,179,0,6009
"26025001900",3216,216,40,73,147,2,33,0,3727
"26025002000",4305,434,63,0,145,9,36,0,4992
"26025002100",724,271,0,13,17,67,23,55,1170
"26025002200",3139,224,9,0,57,50,155,5,3639
"26025002300",3012,550,89,77,183,0,82,70,4063
"26025002400",2335,259,152,0,72,21,45,0,2884
"26025002500",3283,284,68,32,146,32,96,0,3941
"26025002600",763,280,172,135,253,235,39,0,1877
"26025002700",5338,556,4,1,290,19,32,93,6333
"26025002800",3843,394,14,2,174,8,36,10,4481
"26025002900",2453,495,4,0,86,10,20,10,3078
"26025003000",2009,231,43,0,51,3,39,3,2379
"26025003100",2301,541,10,5,46,0,35,7,2945
"26025003200",1751,393,10,0,53,12,35,0,2254
"26025003300",837,259,461,451,63,4,23,55,2153
"26025003400",826,294,33,73,16,2,9,3,1256
"26025003500",1272,241,424,63,100,0,95,0,2195
"26025003600",587,283,541,640,98,79,158,48,2434
"26025003700",3846,649,26,4,63,6,121,23,4738
"26025003800",4082,161,0,1,50,4,230,14,4542
"26025003900",3709,298,0,15,127,24,180,0,4353
"26025004000",3283,508,33,31,209,8,246,59,4377
"26025004100",691,286,501,293,120,37,293,116,2337
"26027001000",3216,503,50,0,26,0,104,0,3899
"26027001100",2399,415,8,0,85,5,6,0,2918
"26027001200",2537,178,0,3,133,32,21,0,2904
"26027001500",3361,366,105,0,109,29,102,26,4098
"26027001600",2548,535,301,88,209,40,27,48,3796
"26027001700",4178,625,55,3,119,19,85,25,5109
"26027001800",7473,501,54,12,422,12,211,0,8685
"26027001900",3663,554,53,83,241,105,21,0,4720
"26027002000",3188,478,94,123,230,544,47,470,5174
"26027002100",3321,793,551,190,434,252,193,140,5874
"26027002200",4164,447,311,342,267,299,59,122,6011
"26029000100",1486,196,10,0,55,4,17,26,1794
"26029000200",1158,141,0,2,9,30,0,0,1340
"26029000300",2041,138,0,4,55,0,32,0,2270
"26029000400",2401,208,0,0,169,11,28,0,2817
"26029000500",530,36,0,0,11,5,6,0,588
"26029000800",2512,265,4,1,71,19,14,14,2900
"26029000900",1475,93,3,4,133,13,123,3,1847
"26029001000",1810,281,0,2,51,48,39,0,2231
"26029001100",1622,263,10,3,75,28,47,7,2055
"26029001200",2530,444,9,0,188,6,41,0,3218
"26029001300",1183,196,11,8,64,12,5,0,1479
"26029001400",1008,176,0,0,24,23,0,0,1231
"26029001500",1845,521,0,0,40,0,2,0,2408
"26029990000",0,0,0,0,0,0,0,0,0
"26031960100",2368,397,17,2,166,50,40,15,3055
"26031960200",1854,730,0,0,44,75,78,0,2781
"26031960300",2823,790,48,3,153,234,0,16,4067
"26031960400",3020,297,0,22,174,117,13,0,3643
"26031960500",2147,320,3,6,100,2,20,0,2598
"26031960600",2090,210,0,0,95,23,20,0,2438
"26031960700",2497,560,7,0,150,8,28,32,3282
"26031960800",2862,697,1,0,72,52,0,0,3684
"26031990000",0,0,0,0,0,0,0,0,0
"26033970100",2044,81,21,34,824,73,31,10,3118
"26033970200",1769,435,14,232,724,275,57,5,3511
"26033970300",1640,937,87,11,269,234,4,16,3198
"26033970400",1560,369,63,0,396,220,20,10,2638
"26033970500",2248,823,0,135,525,108,37,23,3899
"26033970600",2617,228,36,7,1633,256,37,2,4816
"26033970700",734,104,0,0,81,6,2,0,927
"26033970800",3378,489,23,0,510,30,38,14,4482
"26033970900",1582,468,73,31,696,430,39,23,3342
"26033971000",2478,329,18,0,250,46,6,1,3128
"26033971100",1315,87,0,0,210,7,13,0,1632
"26033980100",0,0,0,0,0,0,0,0,0
"26033980200",0,0,0,0,0,0,0,0,0
"26033980300",0,0,0,0,0,0,0,0,0
"26033990000",0,0,0,0,0,0,0,0,0
"26033990100",0,0,0,0,0,0,0,0,0
"26035000100",1058,377,0,2,14,11,0,5,1467
"26035000200",1091,323,0,0,26,0,15,15,1470
"26035000300",1518,729,33,0,69,2,25,0,2376
"26035000400",2698,714,0,0,27,68,52,17,3576
"26035000500",1079,330,0,0,0,16,0,24,1449
"26035000600",2274,1194,0,2,64,52,9,9,3604
"26035000700",2717,520,7,0,81,53,16,22,3416
"26035000800",3463,734,3,2,173,0,132,6,4513
"26035000900",1354,526,1,8,56,21,12,5,1983
"26035001000",1868,996,0,5,20,5,40,31,2965
"26035001300",2532,1170,27,0,89,35,50,38,3941
"26037010104",2510,164,177,0,413,7,229,0,3500
"26037010105",3468,182,13,0,93,4,82,0,3842
"26037010107",3450,194,0,19,74,5,97,0,3839
"26037010108",3760,160,0,0,204,5,36,99,4264
"26037010201",1837,136,57,1,156,1,131,0,2319
"26037010203",837,492,20,24,44,66,40,78,1601
"26037010204",1522,181,0,0,92,0,92,0,1887
"26037010300",4533,178,126,3,231,0,132,1,5204
"26037010400",4803,170,10,2,124,1,316,0,5426
"26037010500",3167,223,1,0,67,0,124,6,3588
"26037010600",2257,178,0,0,46,46,101,4,2632
"26037010701",1733,273,18,0,48,15,45,13,2145
"26037010702",1986,205,0,0,109,0,77,3,2380
"26037010801",3228,719,40,19,74,0,154,73,4307
"26037010802",2837,712,0,0,131,30,109,6,3825
"26037010901",2192,310,0,0,116,17,57,13,2705
"26037010902",4474,157,6,0,74,21,67,11,4810
"26037011001",3134,593,7,0,9,3,218,44,4008
"26037011002",3132,185,59,0,103,1,47,0,3527
"26037011101",3616,85,59,2,136,55,193,30,4176
"26037011104",4514,463,177,0,300,292,148,216,6110
"26037011200",444,1789,66,210,124,335,50,144,3162
"26039960100",1855,245,0,0,104,14,88,6,2312
"26039960200",2945,525,0,0,75,32,20,37,3634
"26039960300",2785,464,5,26,1,68,0,5,3354
"26039960400",1993,280,0,0,50,33,28,0,2384
"26039960500",1769,338,0,0,22,48,6,42,2225
"26041970100",1234,219,2,0,158,14,5,4,1636
"26041970200",1967,302,0,0,151,78,27,6,2531
"26041970300",2015,255,4,0,71,31,39,2,2417
"26041970400",4752,552,0,0,79,52,36,18,5489
"26041970500",3435,524,1,0,146,14,8,0,4128
"26041970600",3159,507,0,0,223,23,39,0,3951
"26041970700",3230,313,0,0,137,50,7,3,3740
"26041970800",2928,889,0,20,108,148,15,9,4117
"26041970900",1705,427,0,5,71,112,44,56,2420
"26041971000",1499,876,10,7,29,167,8,34,2630
"26041971100",2688,564,0,0,93,78,15,0,3438
"26041990000",0,0,0,0,0,0,0,0,0
"26041990100",0,0,0,0,0,0,0,0,0
"26043950100",1415,247,3,3,19,7,2,2,1698
"26043950200",3657,377,21,1,98,16,18,0,4188
"26043950300",4072,469,16,0,121,26,90,0,4794
"26043950400",3476,816,10,5,77,42,100,0,4526
"26043950500",2224,492,0,0,117,7,44,5,2889
"26043950600",3236,700,36,5,79,43,29,10,4138
"26043950700",3264,267,0,0,82,0,27,0,3640
"26045020101",2267,75,344,63,87,13,57,0,2906
"26045020102",2326,47,499,30,274,92,273,24,3565
"26045020103",2671,166,513,153,461,85,221,59,4329
"26045020104",2315,303,597,107,641,80,305,115,4463
"26045020201",1954,138,474,40,178,135,221,117,3257
"26045020202",1762,222,1106,768,268,167,386,114,4793
"26045020302",5275,478,58,0,481,0,393,0,6685
"26045020303",2437,342,171,0,305,0,128,31,3414
"26045020304",3062,269,622,14,699,107,248,76,5097
"26045020402",2638,255,6,38,26,0,0,0,2963
"26045020403",2289,249,11,0,59,75,110,50,2843
"26045020404",4010,245,15,1,85,0,206,21,4583
"26045020500",3287,281,1,1,17,25,161,10,3783
"26045020601",3083,380,62,31,106,18,185,12,3877
"26045020602",3213,230,24,4,87,37,107,0,3702
"26045020700",3249,428,0,3,107,17,122,15,3941
"26045020800",4306,431,11,0,304,12,59,11,5134
"26045020901",2493,669,0,8,240,45,299,93,3847
"26045020902",3116,583,0,0,201,61,157,22,4140
"26045021001",3495,480,25,8,159,35,56,56,4314
"26045021002",3479,451,6,16,59,1,35,29,4076
"26045021100",3992,527,32,7,162,40,186,26,4972
"26045021201",2941,82,17,0,77,9,62,0,3188
"26045021202",3019,193,0,0,153,0,34,0,3399
"26045021301",2534,202,0,1,16,0,106,9,2868
"26045021302",2231,950,41,0,74,0,60,0,3356
"26045021401",2474,207,432,147,275,17,282,20,3854
"26045021402",4081,105,169,25,239,0,82,0,4701
"26047970100",1614,317,27,7,217,31,53,1,2267
"26047970200",4299,500,23,3,273,150,52,6,5306
"26047970300",3647,354,12,0,208,22,37,9,4289
"26047970400",2339,118,17,0,76,27,13,10,2600
"26047970500",3818,553,4,0,234,9,23,11,4652
"26047970600",5382,318,24,0,327,13,94,0,6158
"26047970700",3163,529,15,8,85,29,54,0,3883
"26047970800",2764,423,15,21,274,74,122,8,3701
"26047990000",0,0,0,0,0,0,0,0,0
"26049000100",11,59,1609,845,8,69,8,35,2644
"26049000200",24,91,735,681,23,61,40,12,1667
"26049000300",2,51,1713,1229,114,9,0,0,3118
"26049000400",53,73,667,635,25,0,0,58,1511
"26049000500",4,7,1177,614,101,0,30,31,1964
"26049000600",37,20,942,519,99,0,87,1,1705
"26049000700",54,0,1341,860,29,0,13,0,2297
"26049000800",4,40,678,437,1,23,3,23,1209
"26049000900",207,75,1672,1336,199,10,47,0,3546
"26049001000",25,21,1263,649,21,54,0,10,2043
"26049001100",25,6,1074,739,206,0,4,0,2054
"26049001200",157,76,1368,1667,29,23,13,33,3366
"26049001300",271,111,1189,851,59,131,0,0,2612
"26049001400",83,107,531,331,68,8,24,0,1152
"26049001500",113,295,453,282,32,53,16,5,1249
"26049001600",1650,829,1051,1296,157,68,88,182,5321
"26049001700",13,137,790,549,0,0,13,38,1540
"26049001800",210,197,502,851,0,41,55,0,1856
"26049001900",1049,584,334,645,30,187,137,109,3075
"26049002000",8,10,462,393,0,7,0,0,880
"26049002200",605,943,81,142,140,180,96,101,2288
"26049002300",635,1114,146,137,124,78,105,244,2583
"26049002400",1686,488,293,233,196,0,136,0,3032
"26049002600",1484,911,86,144,215,104,416,81,3441
"26049002700",2305,620,126,460,183,3,149,41,3887
"26049002800",380,521,226,253,52,207,9,4,1652
"26049002900",347,195,873,665,64,56,57,52,2309
"26049003000",2262,564,611,652,83,2,188,39,4401
"26049003100",132,25,1363,513,36,29,10,9,2117
"26049003200",17,298,1092,688,8,79,12,0,2194
"26049003300",603,132,932,369,64,66,51,31,2248
"26049003400",136,125,228,1340,36,49,20,25,1959
"26049003500",2025,404,659,135,23,12,126,11,3395
"26049003600",2781,1263,532,747,199,173,36,39,5770
"26049003700",1033,748,240,131,84,87,30,130,2483
"26049003800",671,465,46,216,36,162,86,10,1692
"26049004000",1744,982,244,375,57,170,10,15,3597
"26049010110",2017,416,0,2,56,77,0,0,2568
"26049010111",887,204,1,5,36,6,15,11,1165
"26049010112",2185,87,0,0,51,0,15,13,2351
"26049010113",1523,663,155,22,32,31,122,62,2610
"26049010114",2396,166,12,3,29,2,17,2,2627
"26049010115",778,121,3,37,56,6,19,0,1020
"26049010201",1563,70,0,6,19,0,44,0,1702
"26049010202",1495,66,0,0,53,13,10,13,1650
"26049010304",710,208,1012,876,140,294,82,36,3358
"26049010305",549,190,2137,1613,291,485,50,263,5578
"26049010501",706,773,579,104,70,24,45,32,2333
"26049010502",2440,153,264,649,54,48,113,46,3767
"26049010503",1961,144,78,2,34,0,81,1,2301
"26049010504",2585,498,843,262,88,34,161,0,4471
"26049010603",4228,748,105,22,202,2,163,57,5527
"26049010604",2146,473,0,0,20,27,92,0,2758
"26049010610",4886,273,117,16,95,0,329,3,5719
"26049010700",4220,346,54,14,294,26,179,1,5134
"26049010810",3174,71,1195,78,506,0,182,0,5206
"26049010811",616,54,902,376,84,0,21,0,2053
"26049010812",1335,327,595,741,66,71,21,2,3158
"26049010813",2755,602,655,95,387,64,183,0,4741
"26049010910",2278,382,690,170,53,0,57,78,3708
"26049010911",658,626,1449,432,236,359,246,9,4015
"26049010912",2232,607,213,49,25,9,37,0,3172
"26049011010",3591,775,162,81,249,64,11,9,4942
"26049011101",6935,595,450,95,588,0,105,15,8783
"26049011102",4003,406,294,94,215,33,120,0,5165
"26049011209",4629,521,369,304,240,0,106,0,6169
"26049011210",1444,307,78,104,21,93,45,6,2098
"26049011211",3695,391,932,18,125,23,141,0,5325
"26049011212",4171,524,745,427,157,60,168,31,6283
"26049011213",4043,372,214,15,749,0,268,0,5661
"26049011214",4135,159,649,284,730,49,43,0,6049
"26049011301",2138,1270,561,408,63,173,28,95,4736
"26049011302",2553,1081,1,0,251,168,196,0,4250
"26049011401",2099,601,60,198,26,0,9,7,3000
"26049011402",3499,246,164,0,132,0,113,25,4179
"26049011502",2415,541,96,0,163,0,131,25,3371
"26049011503",4076,574,29,1,133,0,196,72,5081
"26049011505",1959,392,98,0,71,56,57,88,2721
"26049011508",2139,454,136,53,6,69,53,87,2997
"26049011601",2543,225,287,0,52,0,295,0,3402
"26049011610",4732,515,565,149,373,128,164,23,6649
"26049011710",2042,458,0,0,16,19,0,18,2553
"26049011711",2060,375,26,0,25,8,31,8,2533
"26049011712",2406,224,0,3,102,1,77,24,2837
"26049011713",2813,372,303,92,61,25,57,0,3723
"26049011714",2892,164,10,0,70,0,132,0,3268
"26049011800",2959,97,3,0,63,0,143,11,3276
"26049011901",1869,354,121,0,79,106,51,88,2668
"26049011902",2454,291,0,1,77,0,19,0,2842
"26049012003",2007,691,98,27,204,24,0,24,3075
"26049012006",2045,277,103,21,87,55,130,38,2756
"26049012007",1249,231,5,9,12,19,32,0,1557
"26049012008",2512,155,14,26,64,0,175,0,2946
"26049012009",2292,253,26,1,32,12,78,0,2694
"26049012100",2401,246,102,33,10,0,20,69,2881
"26049012201",1698,533,125,49,31,43,28,85,2592
"26049012202",201,210,500,304,39,0,9,0,1263
"26049012310",1701,706,80,269,68,179,71,0,3074
"26049012311",1300,162,87,109,30,120,14,19,1841
"26049012401",1676,137,10,0,50,32,68,13,1986
"26049012402",2296,310,3,0,27,0,22,0,2658
"26049012501",1613,188,58,6,18,0,58,0,1941
"26049012503",1981,461,152,0,46,85,21,55,2801
"26049012504",1896,227,14,18,9,14,0,0,2178
"26049012601",2524,696,14,0,86,68,223,36,3647
"26049012602",1296,288,2,32,22,4,5,2,1651
"26049012603",2229,316,18,20,36,12,29,21,2681
"26049012702",4660,535,164,136,87,17,133,0,5732
"26049012703",2573,276,123,11,19,1,14,0,3017
"26049012704",3715,128,336,31,178,0,108,0,4496
"26049012801",4103,362,24,2,66,0,210,14,4781
"26049012802",1762,242,0,20,66,20,54,0,2164
"26049012904",5414,265,118,7,241,0,11,0,6056
"26049012905",2829,209,365,59,156,286,190,11,4105
"26049012906",2084,160,123,5,101,0,74,10,2557
"26049012907",2082,280,0,0,42,4,39,4,2451
"26049013001",2374,137,0,0,19,0,45,0,2575
"26049013002",3533,515,0,0,20,28,64,19,4179
"26049013110",1874,103,13,0,67,0,37,0,2094
"26049013111",2589,320,0,0,131,0,18,0,3058
"26049013112",3875,176,39,0,275,9,103,0,4477
"26049013113",3549,190,0,0,18,15,23,15,3810
"26049013202",4454,731,73,0,135,13,249,24,5679
"26049013204",4881,769,0,0,233,0,299,0,6182
"26049013301",5212,436,0,0,142,20,78,0,5888
"26049013401",5721,255,0,0,70,0,49,0,6095
"26049013402",1708,69,2,1,6,0,22,0,1808
"26049013500",1910,746,1679,1194,106,79,59,120,5893
"26049013600",36,119,549,526,13,8,6,4,1261
"26049980000",0,0,0,0,0,0,0,0,0
"26049980100",0,0,0,0,0,0,0,0,0
"26051000100",2232,520,3,0,53,5,31,11,2855
"26051000200",1119,160,2,3,17,0,18,0,1319
"26051000300",1459,288,0,0,21,14,5,0,1787
"26051000400",2642,642,0,15,41,19,45,3,3407
"26051000500",3045,784,0,1,37,10,86,6,3969
"26051000600",1347,372,0,0,25,13,12,17,1786
"26051000700",3263,1233,0,0,58,35,0,0,4589
"26051000800",2875,844,8,0,63,44,52,36,3922
"26051000900",1607,193,0,0,48,16,9,0,1873
"26053950100",942,72,0,4,260,77,7,0,1362
"26053950200",1803,359,0,0,37,22,9,0,2230
"26053950300",1984,355,0,6,48,25,14,0,2432
"26053950400",792,105,0,0,33,16,6,0,952
"26053950500",1430,735,0,0,21,9,43,11,2249
"26053950600",1970,808,17,0,43,0,10,0,2848
"26053950700",1896,249,0,12,38,5,0,16,2216
"26053990000",0,0,0,0,0,0,0,0,0
"26055550101",5456,181,62,4,75,14,90,0,5882
"26055550102",2939,162,0,8,161,86,10,0,3366
"26055550200",3820,320,27,0,136,9,30,2,4344
"26055550300",5455,498,8,0,251,62,86,21,6381
"26055550400",5895,661,42,146,224,44,304,101,7417
"26055550500",4829,417,1,0,132,60,80,101,5620
"26055550600",8667,781,71,0,236,13,39,0,9807
"26055550700",7427,948,0,42,266,0,568,0,9251
"26055550800",5327,273,0,0,45,40,34,5,5724
"26055550900",4547,283,0,0,6,0,0,0,4836
"26055551000",3493,405,0,24,107,8,83,0,4120
"26055551100",2679,602,0,8,400,58,95,0,3842
"26055551200",2485,475,27,0,38,0,24,50,3099
"26055551300",5217,1767,37,5,439,226,322,32,8045
"26055551400",3626,530,26,0,117,113,123,0,4535
"26055551500",2690,300,10,2,143,0,36,1,3182
"26055990000",0,0,0,0,0,0,0,0,0
"26057000100",2998,979,15,4,28,12,86,17,4139
"26057000200",4076,690,0,10,175,23,249,33,5256
"26057000300",3270,649,11,10,86,110,240,124,4500
"26057000400",11,0,0,0,0,0,0,0,11
"26057000500",3031,1321,11,34,60,37,51,87,4632
"26057000600",2579,802,32,0,113,79,242,110,3957
"26057000700",2557,572,6,0,98,0,176,78,3487
"26057000800",3654,470,3,0,43,6,159,70,4405
"26057000900",2861,395,0,5,107,37,39,56,3500
"26057001000",3282,391,7,113,44,43,121,53,4054
"26059050100",4072,402,8,0,43,0,57,0,4582
"26059050200",2426,390,6,0,71,0,40,3,2936
"26059050300",1854,428,4,4,23,6,47,18,2384
"26059050400",3639,951,36,7,74,27,42,33,4809
"26059050500",3262,421,0,13,111,46,81,0,3934
"26059050600",3236,351,12,0,65,0,85,32,3781
"26059050700",2497,1444,34,13,103,36,97,15,4239
"26059050800",1506,381,0,24,26,23,18,15,1993
"26059050900",3857,841,0,3,42,17,77,15,4852
"26059051000",3190,691,45,2,113,0,66,9,4116
"26059051100",2739,981,0,0,52,34,53,9,3868
"26059051200",2425,1435,1,5,25,6,3,49,3949
"26061000100",2251,382,11,0,90,52,54,0,2840
"26061000200",2229,462,0,0,36,30,25,7,2789
"26061000300",1690,535,0,0,103,28,20,9,2385
"26061000400",2643,714,0,0,69,16,19,34,3495
"26061000500",2962,334,1,15,41,17,68,4,3442
"26061000600",2316,1043,0,4,109,36,0,65,3573
"26061000700",2939,298,0,0,10,15,0,16,3278
"26061000800",2248,1598,32,54,299,452,45,69,4797
"26061000900",4106,722,42,78,247,233,9,13,5450
"26061001000",2598,272,9,0,47,16,15,16,2973
"26061990000",0,0,0,0,0,0,0,0,0
"26061990100",0,0,0,0,0,0,0,0,0
"26063950100",1167,279,3,0,22,1,12,4,1488
"26063950200",1893,270,0,0,47,0,34,31,2275
"26063950300",1863,381,0,0,21,18,10,0,2293
"26063950400",845,140,0,0,16,0,9,0,1010
"26063950500",1970,216,6,0,36,18,41,11,2298
"26063950600",2274,511,0,0,18,20,29,39,2891
"26063950700",2832,506,9,0,45,0,42,7,3441
"26063950800",2940,241,0,23,64,19,107,1,3395
"26063950900",3226,345,27,0,45,0,66,6,3715
"26063951000",2843,629,23,0,96,0,69,28,3688
"26063951100",1872,190,18,3,36,11,39,0,2169
"26063951200",2953,629,5,0,112,36,52,39,3826
"26063990000",0,0,0,0,0,0,0,0,0
"26065000100",1144,298,83,11,333,41,305,98,2313
"26065000400",1577,180,233,152,167,84,159,71,2623
"26065000600",579,374,204,186,155,177,62,103,1840
"26065000700",704,577,127,675,196,130,218,137,2764
"26065000800",1295,547,245,250,462,284,417,332,3832
"26065001000",1258,289,88,166,229,60,144,0,2234
"26065001200",1027,437,122,126,375,172,152,177,2588
"26065001703",1971,343,830,221,404,120,313,152,4354
"26065002000",1620,889,246,178,170,375,307,95,3880
"26065002101",724,345,458,248,157,203,225,143,2503
"26065002200",1202,163,109,0,60,0,96,13,1643
"26065002300",2555,147,143,31,391,12,472,5,3756
"26065002600",935,308,27,194,92,203,149,64,1972
"26065002700",1703,534,541,90,198,94,143,47,3350
"26065002800",1640,204,334,84,255,59,260,7,2843
"26065002901",1747,459,769,28,383,122,133,0,3641
"26065002902",1258,1250,347,263,719,319,242,141,4539
"26065003103",3978,898,815,82,591,177,394,96,7031
"26065003200",961,396,61,254,304,147,232,103,2458
"26065003301",1758,370,250,344,330,227,280,241,3800
"26065003302",1704,145,230,0,228,55,236,13,2611
"26065003400",1716,81,162,53,205,0,376,0,2593
"26065003500",1459,450,360,87,300,224,374,266,3520
"26065003601",887,167,1194,160,425,662,144,91,3730
"26065003602",936,435,829,261,407,431,281,288,3868
"26065003700",2279,757,1064,736,296,285,414,430,6261
"26065003801",2363,476,549,129,398,269,121,90,4395
"26065003802",2097,855,171,391,262,307,162,14,4259
"26065003901",1494,170,77,38,146,65,78,32,2100
"26065003902",2312,1261,41,100,123,82,60,72,4051
"26065004000",2017,1157,136,9,342,43,88,31,3823
"26065004100",885,2813,9,75,47,120,10,88,4047
"26065004301",2600,2426,10,34,386,111,291,32,5890
"26065004302",208,1302,23,111,154,383,0,89,2270
"26065004402",270,243,57,101,448,448,64,33,1664
"26065004403",389,510,86,7,175,107,14,35,1323
"26065004490",0,0,0,0,0,0,0,0,0
"26065004491",0,0,0,0,0,0,0,0,0
"26065004492",0,0,0,0,0,0,0,0,0
"26065004493",0,0,0,0,0,0,0,0,0
"26065004494",0,0,0,0,0,0,0,0,0
"26065004500",2136,619,285,69,351,345,133,68,4006
"26065004600",3643,81,218,0,417,27,156,0,4542
"26065004700",2244,282,48,2,102,106,101,2,2887
"26065004801",3284,736,57,16,403,69,258,65,4888
"26065004802",2868,190,71,0,134,0,80,0,3343
"26065004901",4699,505,223,24,1489,39,31,0,7010
"26065004902",2008,892,156,15,617,247,109,9,4053
"26065005001",3997,276,150,0,1922,104,251,81,6781
"26065005002",2799,61,129,36,470,20,98,12,3625
"26065005100",1255,491,805,390,460,394,381,77,4253
"26065005201",2430,494,1036,711,661,73,428,84,5917
"26065005202",2375,194,127,0,575,30,112,123,3536
"26065005302",5044,483,656,130,731,81,456,24,7605
"26065005303",2156,1172,279,187,324,456,329,73,4976
"26065005304",1119,415,671,567,372,377,121,92,3734
"26065005401",2908,168,45,56,149,32,234,0,3592
"26065005402",2897,373,409,1,55,125,124,49,4033
"26065005501",4413,124,377,65,162,278,129,95,5643
"26065005502",4239,445,253,96,283,35,302,0,5653
"26065005600",2592,142,45,0,93,28,221,9,3130
"26065005700",4826,271,75,0,196,4,149,12,5533
"26065005800",4470,673,12,3,149,6,237,58,5608
"26065005900",4483,375,2,44,36,157,61,8,5166
"26065006001",3091,334,0,2,28,20,167,57,3699
"26065006002",3231,434,0,0,24,55,42,64,3850
"26065006100",3652,416,19,14,100,0,193,27,4421
"26065006200",4974,302,20,0,65,0,154,0,5515
"26065006301",3442,374,0,0,69,139,164,34,4222
"26065006302",3891,189,53,4,130,9,138,23,4437
"26065006401",3569,292,62,0,97,0,103,0,4123
"26065006402",2595,394,4,5,18,5,44,5,3070
"26065006500",1468,1132,165,146,733,114,351,11,4120
"26065006600",1277,582,176,475,115,393,151,564,3733
"26065006700",961,766,990,284,653,434,180,364,4632
"26065006800",1293,691,446,575,276,185,501,270,4237
"26065007000",3413,724,673,206,364,104,376,48,5908
"26065980000",23,14,0,19,0,0,0,0,56
"26065980100",24,0,0,0,6,0,0,0,30
"26065980200",0,0,0,0,0,0,0,0,0
"26065980300",0,0,0,0,0,0,0,0,0
"26067030100",5071,1033,18,13,149,20,96,44,6444
"26067030200",1945,661,0,3,38,17,115,8,2787
"26067030300",1964,573,0,0,390,15,175,0,3117
"26067030400",5353,988,85,0,289,103,313,106,7237
"26067031200",4116,540,76,1,253,13,257,13,5269
"26067031300",6954,859,9,0,153,85,208,33,8301
"26067031400",4304,252,201,9,49,8,117,10,4950
"26067031500",5098,205,1,4,159,6,195,33,5701
"26067031600",3876,1243,6,4,331,50,132,41,5683
"26067031700",3086,934,42,31,245,232,519,42,5131
"26067031900",5168,503,14,0,330,17,232,6,6270
"26067032100",1127,484,0,0,6,178,12,14,1821
"26067982200",0,0,0,0,0,0,0,0,0
"26069000100",1941,288,0,34,19,57,26,0,2365
"26069000200",3429,551,2,11,51,28,36,0,4108
"26069000300",2079,554,11,4,65,66,64,0,2843
"26069000400",2630,473,19,16,157,0,111,0,3406
"26069000500",2813,411,8,10,107,0,119,18,3486
"26069000600",2293,300,4,0,100,26,33,0,2756
"26069000700",1970,874,5,0,61,16,18,28,2972
"26069000800",1142,331,0,0,8,0,15,0,1496
"26069000900",1573,316,0,0,14,29,28,0,1960
"26069990000",0,0,0,0,0,0,0,0,0
"26071000100",2116,280,0,10,65,12,20,21,2524
"26071000200",1316,147,3,0,60,5,6,3,1540
"26071000300",1951,513,6,8,51,17,25,0,2571
"26071000400",1900,486,1,18,23,34,62,34,2558
"26071000500",1902,188,1,0,34,31,19,2,2177
"26073000100",2579,582,0,0,176,30,107,19,3493
"26073000200",3704,886,15,12,78,24,64,36,4819
"26073000300",4374,765,41,0,130,32,101,26,5469
"26073000400",2009,1454,98,50,198,206,25,0,4040
"26073000500",861,1910,0,0,131,143,7,23,3075
"26073000600",2058,1380,153,161,438,143,91,90,4514
"26073000700",1241,3692,86,183,138,177,1,204,5722
"26073000800",1317,1699,35,133,223,319,238,116,4080
"26073000900",3387,485,22,8,212,4,202,0,4320
"26073940100",3540,473,16,2,230,46,32,10,4349
"26073940200",3608,885,5,15,1094,122,269,10,6008
"26073940300",3557,723,61,19,468,216,126,146,5316
"26073940400",2397,791,24,11,226,140,136,38,3763
"26073940500",1370,949,50,23,46,54,121,60,2673
"26073940600",4192,339,7,33,258,71,82,0,4982
"26075000100",1966,442,98,0,107,3,56,88,2760
"26075000200",1199,701,131,855,147,15,56,108,3212
"26075000400",2708,891,248,217,76,32,144,73,4389
"26075000500",992,453,132,70,158,36,94,6,1941
"26075000600",402,390,27,125,10,30,0,0,984
"26075000800",3334,285,446,30,142,10,178,11,4436
"26075000900",1607,798,141,532,100,69,24,26,3297
"26075001000",657,681,347,423,59,93,89,36,2385
"26075001100",75,441,663,841,59,123,13,130,2345
"26075001200",1047,696,132,225,79,107,228,60,2574
"26075001300",542,553,818,507,103,103,56,158,2840
"26075005000",1648,341,195,70,218,12,77,8,2569
"26075005100",3412,993,38,80,19,11,33,28,4614
"26075005200",5559,183,168,2,372,0,174,0,6458
"26075005301",3370,258,314,46,459,0,108,69,4624
"26075005302",3330,165,171,0,78,0,85,28,3857
"26075005400",4368,996,3,23,126,0,154,22,5692
"26075005500",3581,807,245,34,39,43,108,37,4894
"26075005600",6284,611,121,182,109,23,103,34,7467
"26075005700",2305,380,119,48,163,7,0,0,3022
"26075005800",0,0,0,0,0,0,0,0,0
"26075005900",1650,498,58,126,102,20,61,50,2565
"26075006000",5850,817,0,22,167,70,228,78,7232
"26075006100",5218,963,0,0,113,58,80,27,6459
"26075006200",5953,457,0,70,154,5,180,0,6819
"26075006301",2800,93,9,5,21,5,4,5,2942
"26075006303",4293,288,5,0,123,21,65,2,4797
"26075006304",2258,340,0,0,43,0,44,0,2685
"26075006401",2615,179,16,0,31,3,53,0,2897
"26075006402",6341,550,19,3,122,32,49,5,7121
"26075006500",5596,665,88,43,197,5,49,6,6649
"26075006600",4073,644,23,1,45,7,57,0,4850
"26075006701",4254,483,55,7,67,31,137,28,5062
"26075006702",3652,893,27,16,220,40,193,0,5041
"26075006801",2775,239,14,0,61,0,43,16,3148
"26075006803",2337,344,1,58,15,11,56,0,2822
"26075006804",5182,329,74,0,93,6,51,40,5775
"26075006900",1443,663,499,209,113,53,122,71,3173
"26077000100",445,268,804,910,135,386,146,135,3229
"26077000201",860,681,167,206,42,111,15,44,2126
"26077000202",39,7,545,307,40,80,32,12,1062
"26077000300",213,244,1471,1701,365,187,49,51,4281
"26077000500",1583,463,271,558,184,109,137,57,3362
"26077000600",2271,1424,58,165,271,272,89,95,4645
"26077000900",451,521,86,20,13,41,54,260,1446
"26077001000",2020,842,736,1235,483,227,532,61,6136
"26077001100",1084,402,187,140,61,37,155,18,2084
"26077001200",2477,139,313,0,142,0,51,8,3130
"26077001300",1410,183,139,83,113,88,68,22,2106
"26077001501",2810,486,775,107,163,95,200,69,4705
"26077001502",2711,786,577,194,249,30,98,193,4838
"26077001503",3407,394,503,0,303,175,113,175,5070
"26077001504",197,295,5,250,58,63,11,105,984
"26077001506",3481,2302,277,216,442,479,23,181,7401
"26077001507",1777,2761,548,492,262,522,180,453,6995
"26077001601",1853,157,171,95,195,67,108,13,2659
"26077001603",837,359,11,0,184,3,98,4,1496
"26077001604",1416,169,34,45,173,9,42,9,1897
"26077001701",2184,404,454,254,212,106,85,0,3699
"26077001702",2776,442,613,175,121,44,406,104,4681
"26077001801",2212,330,432,125,236,59,180,0,3574
"26077001802",2839,774,577,105,361,2,206,29,4893
"26077001803",1168,400,147,140,129,77,94,101,2256
"26077001905",4297,756,60,281,353,151,119,107,6124
"26077001906",3287,572,266,0,301,68,46,0,4540
"26077001907",3214,335,157,80,354,70,163,32,4405
"26077002002",2990,413,59,1,211,4,80,4,3762
"26077002003",4672,304,389,27,184,16,64,0,5656
"26077002004",3266,239,52,14,441,29,118,9,4168
"26077002005",2960,111,248,529,259,48,88,76,4319
"26077002101",6996,429,149,0,380,74,470,119,8617
"26077002102",2736,95,9,0,66,0,7,0,2913
"26077002201",1676,522,66,0,68,74,222,0,2628
"26077002202",5777,833,409,286,462,98,149,1,8015
"26077002601",4257,326,13,0,104,15,63,39,4817
"26077002700",7149,257,147,134,141,24,344,0,8196
"26077002801",3537,338,23,2,221,0,248,68,4437
"26077002802",4620,655,164,11,676,7,0,0,6133
"26077002901",3348,227,18,28,18,86,160,12,3897
"26077002903",1909,910,591,741,143,258,209,46,4807
"26077002904",7028,1365,702,13,571,182,357,47,10265
"26077002905",4995,867,795,135,663,78,105,228,7866
"26077003002",2110,185,6,16,35,0,52,0,2404
"26077003003",7606,256,131,0,248,73,47,0,8361
"26077003004",6089,244,240,0,780,107,262,0,7722
"26077003302",4850,978,31,0,342,7,249,0,6457
"26077003400",3437,295,16,0,87,0,43,2,3880
"26077003500",3251,399,170,47,298,84,218,0,4467
"26077005501",2614,264,490,145,167,45,217,3,3945
"26077005502",3248,504,1225,163,335,27,281,76,5859
"26077006102",3263,233,7,18,75,0,74,0,3670
"26077006103",4084,630,16,14,105,52,7,0,4908
"26077006601",3818,389,24,14,56,24,146,24,4495
"26077006701",1947,482,21,4,72,55,77,26,2684
"26077006702",5269,523,53,53,107,0,186,22,6213
"26079950200",3747,775,45,15,101,39,195,16,4933
"26079950300",3653,839,6,10,134,33,27,6,4708
"26079950400",2983,644,16,9,34,38,9,11,3744
"26079950601",1736,241,0,4,32,10,10,1,2034
"26079950602",1490,192,0,0,29,26,9,3,1749
"26081000100",1849,130,124,81,62,57,89,0,2392
"26081000200",1681,75,6,5,83,0,131,0,1981
"26081000300",3824,298,243,0,446,0,119,0,4930
"26081000400",2520,315,56,5,98,15,66,50,3125
"26081000500",3249,341,101,48,128,28,183,17,4095
"26081000600",3168,202,64,19,163,0,125,0,3741
"26081000700",2371,357,0,0,350,31,499,205,3813
"26081000800",1360,655,254,303,289,316,312,240,3729
"26081000900",1674,579,73,425,147,161,212,96,3367
"26081001000",2261,734,515,231,337,82,93,39,4292
"26081001101",2705,292,1149,623,273,22,222,18,5304
"26081001102",2377,479,504,591,145,44,53,176,4369
"26081001200",2225,308,267,289,276,88,256,41,3750
"26081001300",1600,690,179,601,163,285,319,382,4219
"26081001400",1203,728,88,114,63,32,74,111,2413
"26081001500",1449,893,103,367,312,358,503,517,4502
"26081001600",3133,1199,222,97,486,158,746,263,6304
"26081001700",3302,465,10,38,179,2,27,45,4068
"26081001800",5511,840,64,1,74,50,117,441,7098
"26081001900",2740,790,169,221,650,201,789,281,5841
"26081002000",788,412,180,343,72,65,80,56,1996
"26081002100",1653,651,98,282,86,28,92,54,2944
"26081002200",2950,853,441,164,95,162,125,166,4956
"26081002300",3178,411,41,73,175,70,201,10,4159
"26081002400",1737,662,60,22,36,18,0,61,2596
"26081002500",2616,1056,278,232,148,26,301,288,4945
"26081002600",860,1018,461,402,232,621,1003,1351,5948
"26081002700",1855,967,62,135,171,67,514,288,4059
"26081002800",217,213,375,436,144,272,269,296,2222
"26081002900",883,243,169,136,21,19,65,113,1649
"26081003000",788,221,398,160,80,74,102,65,1888
"26081003100",402,131,1405,797,353,61,437,134,3720
"26081003200",451,527,1464,1797,317,270,138,311,5275
"26081003300",2345,494,697,193,119,17,268,129,4262
"26081003400",3804,385,579,81,419,0,194,66,5528
"26081003500",1630,440,2063,1234,260,55,663,126,6471
"26081003600",184,482,783,561,452,276,413,564,3715
"26081003700",849,319,1714,1214,242,262,881,243,5724
"26081003800",748,1083,246,421,972,808,1417,1825,7520
"26081003900",1006,782,143,150,683,780,1423,1434,6401
"26081004000",1468,848,298,90,681,430,1836,1143,6794
"26081004100",2851,406,727,417,365,129,463,290,5648
"26081004200",2650,142,733,244,213,147,278,138,4545
"26081004300",2915,363,275,21,189,63,56,0,3882
"26081004400",4306,467,897,93,128,28,64,0,5983
"26081004500",3954,246,975,686,1226,469,328,114,7998
"26081004600",2103,77,2516,710,747,146,243,101,6643
"26081010101",4926,595,0,4,76,10,15,55,5681
"26081010102",2168,256,0,0,56,41,30,12,2563
"26081010200",2853,948,68,32,290,37,219,0,4447
"26081010301",4059,623,113,57,155,69,397,127,5600
"26081010302",4903,431,54,0,275,63,217,0,5943
"26081010401",4138,648,37,103,126,143,79,180,5454
"26081010402",3334,482,68,29,123,12,338,12,4398
"26081010600",9617,1081,0,0,232,108,294,28,11360
"26081010700",4658,496,9,114,111,39,88,15,5530
"26081010801",7281,368,14,1,311,56,102,32,8165
"26081010802",5067,428,220,9,169,0,153,74,6120
"26081010902",3523,224,17,0,66,3,48,0,3881
"26081010903",6445,118,83,0,295,0,201,0,7142
"26081010904",6026,614,0,7,238,0,137,0,7022
"26081011001",3700,86,0,12,37,1,45,1,3882
"26081011002",3457,200,0,0,91,0,32,0,3780
"26081011101",3981,238,70,0,45,7,123,0,4464
"26081011102",4510,191,22,3,347,3,104,0,5180
"26081011200",3569,494,11,20,234,0,205,37,4570
"26081011301",4099,421,0,79,205,14,290,0,5108
"26081011302",4816,500,350,75,338,20,227,8,6334
"26081011401",1997,108,7,36,34,0,52,4,2238
"26081011403",2181,274,92,5,76,6,72,0,2706
"26081011405",2509,140,48,0,182,131,217,112,3339
"26081011406",2598,1271,425,506,535,402,703,813,7253
"26081011500",5495,725,198,318,286,149,324,0,7495
"26081011600",6670,583,51,37,396,155,477,69,8438
"26081011701",4258,500,51,0,347,89,106,69,5420
"26081011702",3303,559,51,81,135,85,68,46,4328
"26081011801",6168,390,47,24,453,12,242,0,7336
"26081011803",3371,128,101,0,411,217,114,0,4342
"26081011804",4208,191,54,0,269,0,82,0,4804
"26081011901",6033,45,121,1,234,89,197,0,6720
"26081011902",6445,184,0,3,668,0,142,11,7453
"26081012002",5780,644,32,5,130,0,301,0,6892
"26081012003",5437,754,52,0,55,33,0,0,6331
"26081012004",4052,352,15,0,55,54,148,0,4676
"26081012201",6329,55,22,0,317,51,75,0,6849
"26081012202",6872,60,0,0,109,0,0,0,7041
"26081012203",3663,192,29,0,344,0,111,0,4339
"26081012300",3183,89,20,3,73,21,12,0,3401
"26081012400",3618,133,8,12,92,16,84,0,3963
"26081012500",4338,43,75,0,184,26,103,0,4769
"26081012604",3782,273,689,173,1018,13,246,22,6216
"26081012605",2130,378,208,42,208,21,59,0,3046
"26081012606",2624,574,761,682,624,149,390,260,6064
"26081012607",2846,531,1619,483,343,87,415,312,6636
"26081012608",2226,196,483,10,546,143,117,0,3721
"26081012701",3605,266,1028,640,1078,399,749,107,7872
"26081012702",3002,126,510,23,721,48,155,0,4585
"26081012703",3185,76,643,597,437,53,399,16,5406
"26081012800",3058,188,688,102,295,32,211,11,4585
"26081012901",2127,766,127,245,651,529,697,329,5471
"26081012902",2909,356,389,243,501,52,223,218,4891
"26081013000",2834,268,78,3,215,86,227,123,3834
"26081013100",3958,420,218,27,564,78,460,18,5743
"26081013200",6172,235,48,76,276,58,177,4,7046
"26081013300",2659,1129,221,33,539,81,1511,860,7033
"26081013400",4287,318,220,75,340,273,505,263,6281
"26081013500",2248,646,207,230,837,243,797,566,5774
"26081013600",1275,252,136,40,225,102,441,112,2583
"26081013700",4589,795,307,118,833,127,1047,522,8338
"26081013801",1124,140,65,66,122,30,215,30,1792
"26081013802",4311,664,392,400,872,471,1754,562,9426
"26081013900",5417,505,118,273,480,154,934,33,7914
"26081014000",4797,745,396,0,955,137,1107,443,8580
"26081014100",1551,127,71,17,100,21,277,46,2210
"26081014200",2180,228,355,55,950,336,1167,367,5638
"26081014300",2224,310,125,63,301,179,481,125,3808
"26081014501",8869,877,120,7,746,40,411,128,11198
"26081014502",6535,459,61,19,482,139,628,259,8582
"26081014601",7398,90,152,0,458,0,293,0,8391
"26081014602",8900,664,86,0,294,42,176,62,10224
"26081014701",1855,477,347,198,238,277,165,304,3861
"26081014703",2729,494,404,98,252,290,156,189,4612
"26081014704",2293,362,83,39,142,80,103,11,3113
"26081014803",2987,31,0,10,97,7,51,2,3185
"26081014804",5304,1070,1099,169,600,172,208,135,8757
"26081014805",5937,228,158,1,633,0,294,0,7251
"26081014806",4836,306,4,3,141,0,57,8,5355
"26081014807",6858,340,7,8,219,47,183,0,7662
"26083000100",1828,316,9,6,3,13,18,0,2193
"26083980100",12,0,1,1,0,0,0,0,14
"26083990100",0,0,0,0,0,0,0,0,0
"26085960100",1681,471,8,13,51,8,27,2,2261
"26085961100",1966,835,318,161,95,91,20,5,3491
"26085961200",1434,491,98,168,59,142,98,36,2526
"26085961300",2078,765,6,8,50,11,26,37,2981
"26087330000",3083,387,25,0,123,6,83,17,3724
"26087330500",2597,354,14,6,99,26,100,11,3207
"26087331000",1516,194,0,2,17,14,84,34,1861
"26087331500",2378,277,0,0,90,16,80,8,2849
"26087332000",5147,478,0,0,81,0,47,0,5753
"26087332500",3165,367,0,15,87,0,191,21,3846
"26087333000",2931,152,7,2,13,12,65,12,3194
"26087333500",4737,717,0,0,37,18,17,0,5526
"26087334000",1955,271,0,4,118,1,105,12,2466
"26087334500",1985,139,0,1,61,0,55,0,2241
"26087336000",4790,376,38,11,35,0,169,0,5419
"26087336500",0,0,0,0,0,0,0,0,0
"26087337000",2278,941,0,49,64,25,13,13,3383
"26087337500",2772,873,0,7,138,144,150,53,4137
"26087338000",4549,390,0,0,143,0,108,0,5190
"26087338500",4093,471,115,0,15,52,120,0,4866
"26087339000",2430,337,8,9,291,53,562,177,3867
"26087339500",2693,528,0,9,260,82,873,53,4498
"26087340000",3741,112,2,0,52,0,155,0,4062
"26087340500",2379,183,0,0,135,7,47,21,2772
"26087341000",4300,395,0,0,30,10,36,5,4776
"26087341500",3942,196,0,2,96,0,73,25,4334
"26087342000",4161,299,28,5,41,0,75,0,4609
"26087342100",3361,117,0,1,94,9,200,0,3782
"26089970100",1892,198,0,8,26,55,81,30,2290
"26089970200",3844,417,14,36,553,367,187,178,5596
"26089970300",2508,214,6,7,154,10,104,33,3036
"26089970400",1464,159,0,22,16,0,32,11,1704
"26089970500",4055,379,3,12,107,16,76,5,4653
"26089970600",4549,345,0,0,142,0,91,24,5151
"26089990000",0,0,0,0,0,0,0,0,0
"26091060100",3123,246,19,0,78,9,61,3,3539
"26091060301",4578,307,0,0,87,0,162,0,5134
"26091060302",3229,418,0,0,73,0,76,7,3803
"26091060401",2918,462,14,0,71,3,43,0,3511
"26091060402",2922,262,13,0,52,0,12,0,3261
"26091060500",2779,311,24,0,144,116,164,133,3671
"26091060600",5107,135,0,0,96,0,291,71,5700
"26091060700",6555,364,11,19,336,27,218,20,7550
"26091060800",2909,330,0,0,125,133,124,96,3717
"26091061200",1458,107,19,0,32,75,45,68,1804
"26091061301",2134,1601,27,67,78,135,473,496,5011
"26091061302",1726,798,69,126,136,69,411,200,3535
"26091061400",2290,629,25,16,214,109,352,149,3784
"26091061500",3921,406,162,45,189,19,405,72,5219
"26091061600",2118,984,100,54,334,413,676,589,5268
"26091061700",5250,814,52,16,319,126,512,109,7198
"26091061800",3050,641,19,0,111,10,162,19,4012
"26091061900",3666,748,32,12,129,131,136,86,4940
"26091062000",2347,386,13,41,52,54,93,60,3046
"26091062100",3783,347,20,0,74,0,198,15,4437
"26091062200",1889,310,0,0,44,118,50,104,2515
"26091062300",4590,355,28,0,105,0,82,11,5171
"26091062400",4218,472,20,34,56,17,91,46,4954
"26093710100",2323,30,18,1,63,0,41,0,2476
"26093710300",3565,339,74,0,234,0,43,29,4284
"26093710500",1546,110,0,0,162,0,14,0,1832
"26093710700",1657,61,0,0,14,0,7,0,1739
"26093711000",3841,158,8,0,164,16,32,0,4219
"26093712101",2779,39,2,2,103,0,20,0,2945
"26093712102",2370,180,5,0,176,0,77,0,2808
"26093712601",3590,99,28,0,121,0,0,0,3838
"26093712602",3059,118,25,0,146,16,228,0,3592
"26093713100",4277,186,0,0,35,24,41,0,4563
"26093713300",1505,42,9,0,41,0,13,0,1610
"26093713500",3320,418,0,0,150,0,106,5,3999
"26093713700",4416,164,0,0,156,11,72,0,4819
"26093720100",2943,433,10,0,181,0,165,12,3744
"26093721100",3073,175,16,0,78,2,8,10,3362
"26093722100",2770,229,0,1,28,0,54,0,3082
"26093722300",2444,391,10,0,17,20,127,2,3011
"26093722500",1877,223,17,0,16,0,9,97,2239
"26093724001",1724,185,6,0,13,0,48,0,1976
"26093724002",2257,97,20,0,110,0,16,0,2500
"26093724003",2135,107,1,0,32,20,66,0,2361
"26093725000",3966,680,0,0,227,15,91,0,4979
"26093725100",3000,798,53,35,130,119,96,91,4322
"26093730101",2493,86,1,0,31,0,112,49,2772
"26093730102",3827,156,1,1,45,0,59,0,4089
"26093730600",3451,182,0,0,166,0,110,0,3909
"26093731100",3713,39,14,0,49,0,51,3,3869
"26093732100",3164,137,6,6,76,0,41,3,3433
"26093733100",1789,30,18,11,106,17,10,0,1981
"26093733601",2303,230,0,1,87,0,45,0,2666
"26093733602",3419,227,0,6,61,23,78,13,3827
"26093740200",3537,102,21,6,78,5,115,0,3864
"26093740300",1747,47,12,3,12,0,0,0,1821
"26093740500",2180,76,0,0,51,0,27,6,2340
"26093740600",2849,117,0,1,21,1,0,0,2989
"26093740700",2433,58,30,0,59,10,28,0,2618
"26093740800",2489,168,0,0,150,5,69,0,2881
"26093740900",1790,39,24,0,49,0,75,0,1977
"26093741100",1766,350,21,0,9,137,42,0,2325
"26093741601",1655,127,0,30,4,0,4,0,1820
"26093741602",3131,111,8,0,76,0,35,7,3368
"26093742201",3002,159,0,0,12,0,28,0,3201
"26093742202",1602,270,46,1,11,0,70,1,2001
"26093742401",716,77,13,3,115,41,25,1,991
"26093742402",3694,154,71,1,63,7,56,0,4046
"26093742500",2147,71,0,0,37,0,46,0,2301
"26093742700",3659,20,12,0,66,5,111,0,3873
"26093742900",3672,42,17,0,126,1,184,0,4042
"26093743300",2344,107,0,0,34,0,4,0,2489
"26093743400",3427,178,1,0,125,0,96,0,3827
"26093743500",1828,71,0,0,32,8,58,0,1997
"26093743600",2597,38,10,0,25,98,45,0,2813
"26093743700",2536,123,0,0,71,45,7,4,2786
"26093743800",3577,156,18,0,45,0,19,0,3815
"26093743900",3747,48,0,0,81,0,131,0,4007
"26093744200",3172,188,9,0,169,0,152,0,3690
"26093744400",2118,114,6,0,80,8,43,0,2369
"26093744600",1710,98,0,0,87,0,42,0,1937
"26093744700",2788,196,0,0,97,0,96,0,3177
"26093744800",3864,159,0,0,163,44,89,44,4363
"26093744900",2364,275,39,0,86,0,9,0,2773
"26095960100",2171,622,0,3,378,88,20,33,3315
"26095960200",1700,298,0,0,111,48,15,18,2190
"26095980000",0,0,0,0,0,0,0,0,0
"26095990000",0,0,0,0,0,0,0,0,0
"26097950100",1319,165,0,0,137,47,0,2,1670
"26097950200",1594,315,7,21,371,59,16,0,2383
"26097950300",1259,255,9,1,208,42,0,7,1781
"26097950400",1551,118,57,74,712,245,42,14,2813
"26097950500",1410,242,0,3,500,143,7,9,2314
"26097990000",0,0,0,0,0,0,0,0,0
"26099206700",2880,347,179,58,265,16,207,10,3962
"26099210000",4054,272,29,0,91,0,64,6,4516
"26099211000",4113,1030,36,151,242,69,169,311,6121
"26099212000",5076,154,35,4,87,0,178,0,5534
"26099214000",2276,205,0,20,140,0,51,63,2755
"26099214500",4241,159,9,3,149,0,35,0,4596
"26099215000",4714,175,4,0,289,0,224,17,5423
"26099215200",6539,473,20,8,47,59,137,55,7338
"26099215300",3167,112,284,178,310,10,146,0,4207
"26099215500",6513,479,51,6,407,53,705,2,8216
"26099216000",3672,201,4,4,16,26,49,3,3975
"26099217000",2677,258,7,0,27,18,9,3,2999
"26099218000",4635,466,671,148,239,18,48,15,6240
"26099220001",7092,412,0,4,351,0,291,0,8150
"26099220002",3969,287,49,14,21,0,33,3,4376
"26099221100",5721,311,386,33,81,59,144,0,6735
"26099221200",5195,591,42,15,324,0,362,0,6529
"26099221500",891,95,0,0,98,0,36,0,1120
"26099221800",4607,126,295,0,195,1,98,0,5322
"26099222101",3893,935,70,144,197,0,85,0,5324
"26099222102",6426,336,863,108,288,301,183,272,8777
"26099222500",3428,161,0,2,64,0,40,0,3695
"26099222800",2794,269,107,11,50,5,31,0,3267
"26099223400",8563,141,455,18,408,31,267,0,9883
"26099223500",1119,102,25,6,78,1,0,1,1332
"26099223800",13067,353,437,2,652,0,168,0,14679
"26099223900",7484,155,99,1,320,0,213,0,8272
"26099224000",10936,494,673,0,966,14,366,0,13449
"26099224100",7548,177,332,79,910,0,327,0,9373
"26099224200",6476,397,701,65,345,33,241,67,8325
"26099224300",4311,265,153,0,163,0,0,0,4892
"26099224400",4377,233,88,0,303,10,52,0,5063
"26099224500",3264,150,127,0,362,0,0,0,3903
"26099224600",5040,596,227,126,156,28,189,292,6654
"26099225100",2385,319,159,87,73,16,20,0,3059
"26099225200",5345,410,17,3,220,0,54,0,6049
"26099225300",3837,396,33,18,181,47,69,0,4581
"26099225400",6677,406,36,0,392,0,132,25,7668
"26099225500",4644,737,37,0,108,29,138,21,5714
"26099225600",3422,475,198,0,316,31,140,18,4600
"26099225701",3136,831,410,363,811,40,247,0,5838
"26099225702",1268,150,20,0,46,11,47,0,1542
"26099225800",5180,364,39,171,576,41,86,48,6505
"26099225900",4430,246,0,0,329,0,86,0,5091
"26099226100",6836,479,168,13,243,0,30,0,7769
"26099226400",2146,17,36,1,84,7,69,0,2360
"26099226700",3831,596,49,8,119,5,60,0,4668
"26099227000",6423,204,106,9,466,28,206,0,7442
"26099227300",3492,185,141,311,146,12,77,0,4364
"26099228000",2761,229,160,42,66,45,81,0,3384
"26099228100",1151,184,0,28,74,18,119,15,1589
"26099230000",2982,236,371,96,280,111,20,0,4096
"26099230200",4307,277,105,0,204,0,104,2,4999
"26099230300",3271,1048,119,12,148,75,83,10,4766
"26099230400",3333,174,197,12,0,20,99,0,3835
"26099230500",2564,764,153,58,120,37,345,21,4062
"26099230601",5785,114,236,46,1115,40,118,0,7454
"26099230602",4710,569,64,16,1090,0,83,0,6532
"26099230700",3901,368,40,0,908,257,78,1,5553
"26099230800",2990,875,8,0,231,61,60,35,4260
"26099230900",6173,841,333,84,168,54,419,0,8072
"26099231000",3540,402,158,19,89,51,57,76,4392
"26099231100",2284,375,551,51,285,84,88,9,3727
"26099231200",3029,188,126,25,278,0,19,0,3665
"26099231400",4611,670,272,0,684,51,23,0,6311
"26099231500",3570,987,48,73,521,123,69,0,5391
"26099231600",2388,622,361,233,825,292,41,0,4762
"26099231700",4441,494,483,0,1117,34,134,0,6703
"26099231800",2850,610,114,0,377,51,80,0,4082
"26099231900",4176,807,221,1,390,22,96,3,5716
"26099232000",1621,89,51,0,122,0,16,0,1899
"26099232100",4862,245,832,188,627,72,250,0,7076
"26099232200",3226,593,392,0,643,41,0,0,4895
"26099232300",2519,1334,360,66,362,84,64,55,4844
"26099232400",3859,1117,125,0,829,0,33,0,5963
"26099232500",3718,57,358,0,241,6,170,0,4550
"26099233000",4979,337,68,42,66,0,16,0,5508
"26099240000",1844,637,513,875,98,41,40,149,4197
"26099240300",3347,396,322,59,141,66,63,11,4405
"26099240400",4849,269,81,43,94,0,60,2,5398
"26099240500",1680,281,206,0,173,17,198,117,2672
"26099240600",5616,228,764,72,278,36,213,0,7207
"26099240700",3770,144,46,1,162,8,41,8,4180
"26099240800",4312,562,1106,158,197,0,102,0,6437
"26099240900",1607,73,58,7,56,1,48,0,1850
"26099241000",2649,424,947,266,115,30,120,15,4566
"26099241200",3300,591,398,277,95,45,4,0,4710
"26099241300",1440,271,365,85,222,56,128,0,2567
"26099241400",2685,382,65,44,235,0,200,0,3611
"26099241500",2730,151,440,23,385,0,114,0,3843
"26099241600",1438,299,482,157,164,15,83,15,2653
"26099241700",2793,871,338,25,216,147,106,72,4568
"26099241800",2919,296,1599,671,154,11,69,0,5719
"26099241900",3648,244,544,240,146,24,16,0,4862
"26099242000",3812,485,875,210,198,62,150,0,5792
"26099242100",1569,172,575,239,47,13,156,0,2771
"26099242500",4963,290,492,0,160,23,19,0,5947
"26099243000",3897,262,175,14,227,22,39,0,4636
"26099243500",4134,329,597,100,240,20,89,0,5509
"26099244000",1768,200,30,0,132,0,6,0,2136
"26099245000",1164,424,1050,938,48,8,61,20,3713
"26099245100",2659,375,305,356,475,30,143,16,4359
"26099245200",1012,354,87,71,45,11,9,0,1589
"26099245300",3206,369,371,123,29,0,0,0,4098
"26099245400",432,102,494,128,79,0,111,0,1346
"26099247100",549,522,10,0,11,19,95,180,1386
"26099247200",5613,228,514,48,75,16,20,1,6515
"26099247300",5720,77,156,0,206,40,46,0,6245
"26099247400",2310,199,0,0,43,0,36,0,2588
"26099247500",1213,333,92,27,19,31,4,0,1719
"26099247601",900,87,521,288,58,101,0,42,1997
"26099247602",3415,481,413,124,253,2,187,131,5006
"26099250000",1996,386,148,6,26,0,21,0,2583
"26099250100",1900,191,67,0,26,36,34,0,2254
"26099250200",2268,406,0,0,57,10,0,0,2741
"26099250300",2573,161,87,134,58,109,78,36,3236
"26099250400",1312,88,11,0,101,7,22,0,1541
"26099250500",1862,120,29,1,19,16,0,3,2050
"26099250600",2459,277,19,10,20,0,86,0,2871
"26099250700",2381,183,263,0,57,32,32,10,2958
"26099250800",2577,121,137,1,110,0,93,0,3039
"26099250900",2127,237,166,38,60,0,59,0,2687
"26099251000",1318,186,29,0,14,61,11,23,1642
"26099251100",1845,120,0,0,11,0,26,0,2002
"26099251200",2866,328,0,0,31,24,9,0,3258
"26099251300",2054,183,12,0,103,0,55,1,2408
"26099251400",2516,197,0,0,61,36,48,0,2858
"26099251500",1442,138,142,22,77,7,18,0,1846
"26099251600",2622,274,100,73,88,13,25,10,3205
"26099251700",2384,243,66,70,106,0,0,71,2940
"26099251800",2847,318,370,160,123,83,59,0,3960
"26099251900",2308,242,116,0,21,0,27,0,2714
"26099252000",2170,183,219,13,70,10,73,0,2738
"26099252100",1806,139,139,46,95,0,41,0,2266
"26099252200",2438,99,214,0,60,8,35,0,2854
"26099254000",1406,100,71,6,116,6,40,0,1745
"26099254100",3610,146,212,91,133,16,90,0,4298
"26099254200",3432,298,361,57,168,11,79,9,4415
"26099254500",3108,568,395,60,90,8,18,6,4253
"26099255000",2871,399,830,185,156,45,13,63,4562
"26099255100",2316,368,198,12,123,223,51,0,3291
"26099255200",2156,370,616,624,219,24,66,0,4075
"26099255300",2230,199,1006,329,211,22,75,23,4095
"26099255400",2178,244,33,0,53,96,83,63,2750
"26099255500",1232,212,155,0,61,4,70,7,1741
"26099255600",2523,573,65,40,262,0,49,0,3512
"26099255700",1100,222,110,7,66,7,25,0,1537
"26099255800",1679,263,139,143,72,6,48,0,2350
"26099255900",1092,241,119,64,102,96,31,6,1751
"26099256000",1554,148,237,31,152,69,18,5,2214
"26099256100",1614,416,151,176,50,66,22,40,2535
"26099256200",1253,277,214,99,0,2,22,22,1889
"26099256300",1203,191,440,67,79,50,45,61,2136
"26099256400",860,236,165,6,24,0,24,0,1315
"26099256500",1123,278,110,5,26,46,41,62,1691
"26099256600",1835,244,471,405,339,6,82,0,3382
"26099256700",1214,270,148,115,78,4,8,27,1864
"26099256800",1228,233,11,35,44,45,16,5,1617
"26099258000",1493,170,1113,183,113,0,139,37,3248
"26099258100",2032,217,894,253,166,79,162,0,3803
"26099258200",1500,497,605,195,49,0,56,4,2906
"26099258300",1354,124,464,203,101,247,37,154,2684
"26099258400",2761,452,642,858,187,63,95,0,5058
"26099258500",623,61,953,162,113,3,17,3,1935
"26099258600",1704,301,1133,752,120,288,77,8,4383
"26099258700",1091,237,769,290,315,28,43,26,2799
"26099258800",1038,82,2175,534,120,0,127,0,4076
"26099258900",1050,143,614,609,20,141,41,0,2618
"26099260000",2671,93,102,0,271,48,66,0,3251
"26099260100",2367,169,366,96,19,29,21,21,3088
"26099260200",2096,172,30,0,52,0,18,0,2368
"26099260300",2313,279,115,3,150,14,40,0,2914
"26099260400",3422,305,259,14,332,0,106,0,4438
"26099260600",2324,326,71,0,89,0,193,0,3003
"26099260700",2269,282,84,33,554,130,23,0,3375
"26099260800",1988,396,131,0,251,67,13,0,2846
"26099260900",3016,518,316,36,729,205,50,0,4870
"26099261000",2193,195,405,0,296,0,97,0,3186
"26099261100",2694,976,735,69,231,104,0,0,4809
"26099261200",2416,139,69,88,118,0,4,0,2834
"26099261300",2252,338,199,35,124,0,37,0,2985
"26099261400",2423,189,0,13,114,45,57,0,2841
"26099261500",2001,366,422,78,177,126,110,0,3280
"26099261600",1141,95,47,57,16,28,34,0,1418
"26099261700",1180,126,530,153,62,11,27,0,2089
"26099261800",2026,173,351,2,260,0,21,27,2860
"26099261900",1924,218,190,138,219,30,97,0,2816
"26099262000",2636,403,66,105,65,176,180,14,3645
"26099262100",689,238,67,75,5,83,27,0,1184
"26099262200",3641,241,228,23,224,40,48,10,4455
"26099262300",2179,277,726,0,929,162,41,7,4321
"26099262400",1613,616,199,39,439,187,16,23,3132
"26099262500",3317,717,620,111,643,15,76,0,5499
"26099262600",1430,146,482,100,114,0,8,0,2280
"26099262700",2809,325,1114,377,363,177,36,134,5335
"26099262800",1457,194,290,106,118,27,78,10,2280
"26099262900",2684,739,346,51,61,262,46,3,4192
"26099263200",1316,613,450,260,45,93,44,25,2846
"26099263400",2319,467,224,130,528,197,27,25,3917
"26099263500",2473,557,391,161,554,251,26,0,4413
"26099263600",1389,784,905,735,409,369,0,59,4650
"26099263700",2337,533,403,489,145,554,21,9,4491
"26099263800",855,567,296,661,289,156,249,4,3077
"26099263900",1366,541,297,886,18,139,0,19,3266
"26099264000",481,274,633,510,72,152,9,4,2135
"26099264200",1915,437,846,587,82,53,106,13,4039
"26099267600",1040,84,152,0,119,27,0,17,1439
"26099268000",3726,647,480,193,167,106,51,15,5385
"26099268100",1559,339,319,264,270,34,45,60,2890
"26099268200",3735,414,47,46,59,39,8,1,4349
"26099268300",1192,266,722,558,42,128,13,0,2921
"26099268400",1974,376,174,579,116,50,77,19,3365
"26099982000",4,0,0,0,0,0,0,0,4
"26099982100",0,0,0,0,0,0,0,0,0
"26099982200",0,20,0,8,0,0,0,0,28
"26099982300",41,28,0,0,0,0,0,0,69
"26099990100",0,0,0,0,0,0,0,0,0
"26101000100",2491,640,0,2,76,13,52,23,3297
"26101000200",1609,320,16,8,16,6,15,56,2046
"26101000300",1761,244,0,19,66,2,33,38,2163
"26101000400",1765,180,7,10,177,56,67,4,2266
"26101000500",2118,389,0,52,118,11,26,3,2717
"26101000600",1089,409,0,0,3,1,7,1,1510
"26101000700",3292,581,7,2,190,62,18,3,4155
"26101000800",2443,547,11,47,148,32,46,64,3338
"26101000900",1704,256,0,1,113,28,118,0,2220
"26101990000",0,0,0,0,0,0,0,0,0
"26103000100",1480,631,0,12,4,21,26,14,2188
"26103000200",1528,706,7,11,15,45,0,0,2312
"26103000300",1412,324,8,6,80,39,16,17,1902
"26103000400",1450,423,17,7,96,10,13,24,2040
"26103000500",51,97,0,8,0,13,0,2,171
"26103000600",1069,923,19,11,106,149,0,0,2277
"26103000700",2493,645,0,86,161,0,32,0,3417
"26103001100",1424,81,13,0,83,20,7,0,1628
"26103001200",4875,460,10,7,297,92,24,7,5772
"26103001300",3450,405,17,18,74,14,91,0,4069
"26103001500",2795,219,0,0,68,19,8,0,3109
"26103001600",2100,123,6,0,78,0,24,19,2350
"26103001700",1802,268,16,0,47,96,17,0,2246
"26103001800",2339,318,0,0,98,5,49,9,2818
"26103001900",1269,325,0,1,3,3,0,0,1601
"26103002000",1515,700,0,2,8,7,0,0,2232
"26103002100",2806,146,0,2,64,0,27,0,3045
"26103002200",2902,302,0,3,32,7,12,0,3258
"26103002300",1707,299,0,0,10,20,20,6,2062
"26103002400",1642,1049,12,20,167,218,57,121,3286
"26103002500",1945,188,0,0,81,25,10,6,2255
"26103002600",1703,170,0,12,50,15,0,0,1950
"26103002800",2995,454,0,0,222,43,0,0,3714
"26103002900",3217,349,37,0,276,17,27,13,3936
"26103990000",0,0,0,0,0,0,0,0,0
"26105950100",1977,370,8,3,109,6,135,0,2608
"26105950200",2966,448,0,0,44,13,41,4,3516
"26105950300",2977,404,0,0,41,34,81,25,3562
"26105950400",3336,668,14,19,196,0,96,10,4339
"26105950500",2571,823,8,2,83,78,90,259,3914
"26105950600",3744,894,23,51,207,61,123,46,5149
"26105950700",2395,618,50,16,112,35,72,23,3321
"26105950800",2451,273,20,0,48,45,119,39,2995
"26105990000",0,0,0,0,0,0,0,0,0
"26107960100",1955,450,6,13,65,32,72,11,2604
"26107960200",2079,446,35,13,137,13,17,57,2797
"26107960300",2519,365,2,0,83,10,20,3,3002
"26107960400",3658,614,7,0,176,29,27,10,4521
"26107960500",2226,1488,89,71,170,26,26,38,4134
"26107960600",1927,1405,82,91,33,195,55,122,3910
"26107960700",4158,1262,0,101,162,140,72,0,5895
"26107960800",3748,1185,16,2,73,10,102,8,5144
"26107960900",2504,432,89,45,110,24,14,0,3218
"26107961000",4609,814,209,0,101,54,91,48,5926
"26107981300",0,8,0,0,0,0,0,0,8
"26109960100",2752,496,7,0,72,65,13,3,3408
"26109960200",2811,448,6,7,326,271,58,55,3982
"26109960300",2029,297,3,5,13,18,12,16,2393
"26109960400",3215,237,1,1,115,0,35,0,3604
"26109960500",2526,408,0,0,61,34,0,0,3029
"26109960600",3107,661,6,0,94,37,17,0,3922
"26109960700",2369,789,0,0,59,0,132,17,3366
"26109990000",0,0,0,0,0,0,0,0,0
"26111290100",2484,864,1,35,163,38,87,3,3675
"26111290200",2699,779,0,0,255,0,213,53,3999
"26111290300",3364,228,0,4,168,0,57,15,3836
"26111290400",1567,190,0,1,37,1,73,0,1869
"26111290500",1810,93,0,0,10,5,43,13,1974
"26111290600",1624,725,0,1,163,0,126,0,2639
"26111290700",1981,665,194,64,424,247,12,43,3630
"26111290800",3953,732,17,10,255,24,142,0,5133
"26111290900",6410,552,139,65,457,0,228,0,7851
"26111291000",4891,635,228,38,440,73,37,24,6366
"26111291101",2984,410,88,3,41,11,24,0,3561
"26111291102",8166,634,90,16,249,75,33,28,9291
"26111291200",4553,328,0,0,263,19,76,17,5256
"26111291300",4031,413,0,7,81,25,101,3,4661
"26111291400",3280,515,0,5,104,27,110,30,4071
"26111291500",3585,499,7,10,143,3,67,51,4365
"26111291601",2110,356,0,0,38,0,5,0,2509
"26111291602",4016,586,0,0,134,0,48,19,4803
"26111291700",3367,903,0,1,73,40,77,59,4520
"26113960100",2975,707,7,0,47,42,65,22,3865
"26113960200",2486,682,3,30,86,32,15,80,3414
"26113960300",4086,571,23,0,67,8,72,7,4834
"26113960400",2474,397,1,1,67,20,102,3,3065
"26115830100",3095,300,57,0,62,23,110,42,3689
"26115830200",4886,481,69,0,228,0,303,1,5968
"26115830300",2975,570,24,0,157,0,25,63,3814
"26115830400",3415,350,72,0,156,10,50,7,4060
"26115830500",3372,250,176,2,70,30,31,0,3931
"26115830600",2401,313,167,37,48,0,19,0,2985
"26115830700",3161,226,10,1,93,0,136,0,3627
"26115830800",5972,629,0,0,139,2,19,8,6769
"26115830900",2460,24,0,0,0,0,4,0,2488
"26115831000",2742,479,42,2,25,3,31,79,3403
"26115831100",1930,298,0,0,38,6,63,67,2402
"26115831200",5670,920,64,99,67,29,149,21,7019
"26115831300",4052,465,21,5,32,63,114,25,4777
"26115831400",4957,1386,322,20,231,309,130,326,7681
"26115831500",2492,291,80,17,38,7,30,1,2956
"26115831600",2765,371,44,4,114,28,33,112,3471
"26115831700",3064,542,7,296,37,24,41,133,4144
"26115831800",694,246,166,164,65,152,30,7,1524
"26115831900",837,257,101,48,65,30,63,120,1521
"26115832000",1279,187,22,136,66,58,16,13,1777
"26115832100",1949,697,12,67,58,6,90,7,2886
"26115832200",1545,137,28,0,55,18,67,4,1854
"26115832300",3362,863,161,0,140,0,218,15,4759
"26115832400",3531,481,83,10,187,0,87,32,4411
"26115832500",3524,500,90,119,114,58,92,0,4497
"26115832600",1994,169,22,0,88,0,169,0,2442
"26115832700",2369,121,0,0,69,0,19,9,2587
"26115832800",4647,123,0,3,102,2,226,8,5111
"26115832900",3965,354,70,0,134,20,123,27,4693
"26115833000",3939,193,244,32,84,10,73,18,4593
"26115833100",4759,248,18,0,73,0,136,0,5234
"26115833200",3841,248,0,0,98,5,0,0,4192
"26115833300",6051,281,23,0,84,0,279,0,6718
"26115833500",3946,739,0,0,80,22,79,0,4866
"26115833600",2752,212,6,0,160,0,232,25,3387
"26115833700",2290,253,0,30,59,16,30,5,2683
"26115833800",4559,410,0,0,133,0,206,0,5308
"26115833900",4845,215,32,8,110,0,218,0,5428
"26115990000",0,0,0,0,0,0,0,0,0
"26117970100",3751,389,17,0,140,15,95,26,4433
"26117970200",2400,579,93,0,107,107,141,56,3483
"26117970300",2479,504,14,0,119,0,112,9,3237
"26117970400",2406,586,26,0,134,13,90,0,3255
"26117970500",6433,1098,2,2,143,76,67,80,7901
"26117970600",4395,644,22,8,119,5,62,16,5271
"26117970700",4175,880,2,5,69,56,82,2,5271
"26117970800",3550,913,21,1,47,26,52,44,4654
"26117970900",2604,566,35,0,3,12,155,23,3398
"26117971000",3858,905,27,0,104,47,145,54,5140
"26117971100",3921,768,1,0,230,100,291,117,5428
"26117971200",3937,1679,10,2,67,89,74,74,5932
"26117971300",3723,781,0,3,24,65,71,0,4667
"26119910100",1881,451,0,0,2,22,25,0,2381
"26119910200",1310,214,0,0,29,0,0,0,1553
"26119910300",1526,231,0,8,48,31,45,0,1889
"26119910400",1828,281,12,0,70,32,0,32,2255
"26119910500",990,298,0,0,6,0,12,0,1306
"26121000100",1376,389,720,1063,272,2,27,15,3864
"26121000300",515,783,718,1038,63,94,40,115,3366
"26121000401",1645,918,909,260,443,236,401,221,5033
"26121000402",124,134,224,134,18,96,0,10,740
"26121000500",1190,938,1027,710,280,198,369,145,4857
"26121000601",583,214,439,173,129,77,77,49,1741
"26121000800",1911,591,134,523,164,14,216,103,3656
"26121000900",2661,590,90,68,136,23,95,0,3663
"26121001000",1062,59,11,0,43,0,46,0,1221
"26121001200",112,52,1321,559,80,6,37,6,2173
"26121001300",43,84,1055,1349,28,114,22,29,2724
"26121001402",822,536,1321,1305,88,149,81,38,4340
"26121001500",3282,217,26,2,181,0,45,12,3765
"26121001600",2649,32,93,0,131,0,191,0,3096
"26121001700",4033,319,101,48,70,81,74,2,4728
"26121001800",3465,662,199,19,95,8,72,36,4556
"26121001901",2549,556,106,111,276,91,74,251,4014
"26121001902",4014,791,65,114,160,47,380,0,5571
"26121002000",2938,720,0,11,50,86,178,129,4112
"26121002100",2264,431,254,127,71,7,115,32,3301
"26121002200",3051,282,127,132,168,0,184,21,3965
"26121002300",4714,375,88,16,233,86,371,0,5883
"26121002400",2751,250,155,15,146,51,126,0,3494
"26121002500",6947,112,38,0,271,25,103,1,7497
"26121002601",2662,415,33,21,255,41,149,75,3651
"26121002602",3135,542,204,20,188,82,103,146,4420
"26121002700",6350,661,19,3,324,75,184,103,7719
"26121002800",5547,324,64,61,179,6,248,24,6453
"26121002900",4694,390,28,0,93,18,312,115,5650
"26121003000",3648,425,0,116,98,24,233,56,4600
"26121003100",3092,792,0,199,148,48,228,59,4566
"26121003200",4016,1060,52,0,190,88,166,97,5669
"26121003300",3607,1304,0,4,55,120,208,201,5499
"26121003400",3174,589,157,41,18,5,133,48,4165
"26121003500",3277,289,15,42,241,0,0,9,3873
"26121003600",5422,809,76,13,99,106,126,4,6655
"26121003700",4778,398,52,21,68,82,116,25,5540
"26121003800",2942,410,18,6,63,32,125,15,3611
"26121003900",1471,259,6,0,76,28,98,44,1982
"26121004000",1786,133,24,6,82,6,77,2,2116
"26121004200",994,503,785,666,78,266,131,128,3551
"26121004300",308,34,642,627,66,37,33,29,1776
"26121990000",0,0,0,0,0,0,0,0,0
"26123970100",3394,889,92,55,94,24,65,30,4643
"26123970300",2778,709,45,0,202,106,142,106,4088
"26123970400",4333,562,24,5,215,42,253,53,5487
"26123970500",3774,609,36,2,90,125,118,215,4969
"26123970600",3042,473,10,0,136,15,120,8,3804
"26123970700",2814,1056,67,76,41,77,37,58,4226
"26123970800",2234,683,0,18,99,17,66,7,3124
"26123970900",3579,777,1,10,72,40,72,43,4594
"26123971000",3772,551,14,5,242,65,169,43,4861
"26123971100",3490,580,17,0,174,29,393,130,4813
"26123971200",3597,971,42,22,149,12,347,266,5406
"26125120000",2605,309,106,49,41,0,0,109,3219
"26125120300",2982,201,73,0,66,0,85,5,3412
"26125121000",2383,261,0,0,131,10,134,41,2960
"26125121400",4013,78,70,0,192,6,58,6,4423
"26125121500",3009,477,9,0,0,0,61,0,3556
"26125121700",5180,171,11,1,225,32,97,0,5717
"26125121800",4198,430,0,1,116,1,143,32,4921
"26125122200",3315,178,25,0,105,24,152,0,3799
"26125122400",5808,902,0,0,86,0,96,225,7117
"26125122700",2565,243,0,0,95,12,0,0,2915
"26125122900",1616,298,17,14,73,12,50,104,2184
"26125123000",1976,279,37,9,58,20,0,33,2412
"26125123100",2997,89,11,0,75,5,19,0,3196
"26125124000",4715,407,112,6,91,12,67,0,5410
"26125124500",4909,841,82,0,228,15,279,19,6373
"26125125000",3052,262,91,1,82,0,48,9,3545
"26125125600",2634,115,16,0,80,0,158,0,3003
"26125126200",2560,72,37,0,4,0,129,24,2826
"26125126300",3917,459,19,10,157,94,76,10,4742
"26125126400",3513,59,18,0,79,5,51,0,3725
"26125126500",3057,115,0,2,63,0,86,0,3323
"26125127000",5082,308,0,0,175,0,89,15,5669
"26125127100",4987,259,121,0,49,0,71,0,5487
"26125127200",1633,29,9,0,15,3,18,1,1708
"26125127300",3552,377,31,23,341,88,215,112,4739
"26125127400",1433,76,21,0,63,37,135,0,1765
"26125127500",5961,158,58,15,453,59,93,0,6797
"26125127600",3595,169,180,0,203,0,151,0,4298
"26125127700",5682,581,79,192,282,43,300,0,7159
"26125128000",3025,139,142,0,102,0,53,0,3461
"26125128100",2701,69,32,1,64,0,161,0,3028
"26125128200",2991,94,146,0,168,0,146,0,3545
"26125128300",3824,249,40,0,378,70,188,6,4755
"26125128400",2688,444,61,148,336,20,203,37,3937
"26125128500",3014,308,89,0,120,98,455,21,4105
"26125128600",2843,259,36,0,290,0,88,67,3583
"26125128700",1854,96,35,1,131,0,100,0,2217
"26125128800",1255,89,0,0,90,0,46,7,1487
"26125128900",4230,236,386,2,347,0,232,0,5433
"26125129000",2614,228,0,0,67,12,23,36,2980
"26125130000",2509,282,65,74,183,35,95,0,3243
"26125130100",2142,75,5,0,51,0,60,0,2333
"26125130200",5271,302,103,3,115,0,81,2,5877
"26125130300",3377,726,40,0,10,0,38,118,4309
"26125130400",2712,50,101,0,5,0,56,0,2924
"26125130500",2944,84,0,0,82,0,50,0,3160
"26125130600",2787,177,10,1,72,0,23,0,3070
"26125130700",5813,128,213,0,112,35,57,0,6358
"26125131100",2127,69,0,10,117,9,10,10,2352
"26125131300",4460,200,9,0,42,29,14,22,4776
"26125131400",1948,96,0,0,6,0,21,0,2071
"26125131500",3388,320,25,0,39,16,164,0,3952
"26125131600",2462,159,7,0,91,7,29,0,2755
"26125131800",3096,678,37,0,41,0,0,0,3852
"26125132100",4944,301,70,0,350,12,77,8,5762
"26125132500",3117,382,12,0,0,0,19,0,3530
"26125132600",3728,114,26,0,215,1,81,7,4172
"26125132700",2773,71,0,1,15,12,45,1,2918
"26125133001",2582,65,0,0,86,72,37,0,2842
"26125133002",2653,381,13,0,270,0,147,11,3475
"26125133003",2387,206,63,49,238,53,167,0,3163
"26125133100",1799,449,1132,467,345,365,276,390,5223
"26125134000",4380,338,45,0,224,0,72,0,5059
"26125134300",4228,421,69,35,48,0,90,0,4891
"26125134400",3759,435,76,0,222,11,40,0,4543
"26125134500",2489,192,90,0,267,18,125,0,3181
"26125134600",3686,333,0,0,79,0,208,0,4306
"26125134700",2613,132,247,43,203,0,161,0,3399
"26125134800",2589,94,75,0,226,10,88,0,3082
"26125134900",3019,338,66,0,363,57,194,0,4037
"26125135000",1992,739,73,169,291,23,243,166,3696
"26125135100",4832,428,72,0,181,13,90,9,5625
"26125135200",2527,129,122,0,369,0,114,0,3261
"26125135300",4659,15,101,1,191,0,44,0,5011
"26125136000",1380,124,333,67,610,26,44,9,2593
"26125136101",3026,294,120,0,1240,148,246,9,5083
"26125136102",2524,236,580,259,462,41,153,0,4255
"26125136300",3000,111,644,11,1144,0,54,10,4974
"26125136500",3672,145,453,13,963,33,91,0,5370
"26125136600",4767,110,97,337,2671,123,181,0,8286
"26125136700",4090,171,313,0,927,31,115,50,5697
"26125136800",2993,285,431,21,458,48,289,0,4525
"26125137100",5711,565,367,87,2626,302,211,6,9875
"26125137400",5087,43,109,0,1021,39,115,0,6414
"26125137700",1436,35,163,0,105,0,35,0,1774
"26125137800",3017,108,25,0,129,0,138,0,3417
"26125138100",4234,164,22,0,250,133,143,0,4946
"26125138301",3069,283,66,27,32,0,189,48,3714
"26125138302",5160,165,96,0,181,23,0,0,5625
"26125138600",2315,75,11,0,67,0,78,11,2557
"26125139200",5773,466,82,0,269,0,305,0,6895
"26125139400",4538,158,139,0,201,11,255,0,5302
"26125140100",866,56,153,9,49,8,137,8,1286
"26125140301",2188,400,695,85,481,117,104,81,4151
"26125140302",1955,263,322,49,550,159,55,33,3386
"26125140500",1576,216,288,0,251,36,189,14,2570
"26125140600",1365,122,939,27,207,26,123,32,2841
"26125140700",1678,136,265,155,346,14,303,33,2930
"26125140800",2280,221,562,75,1406,86,231,6,4867
"26125140900",795,715,1047,433,43,36,307,474,3850
"26125141000",2365,596,1920,405,447,57,553,235,6578
"26125141100",1534,352,521,365,279,70,548,134,3803
"26125141200",758,481,955,860,312,184,354,336,4240
"26125141300",1988,1054,214,162,239,155,564,617,4993
"26125141400",1663,528,889,489,402,240,1107,513,5831
"26125141500",571,816,2726,1638,489,151,528,339,7258
"26125141600",961,930,1146,724,275,284,458,430,5208
"26125141700",826,434,500,410,111,189,390,315,3175
"26125142000",525,402,832,386,142,69,210,303,2869
"26125142100",463,246,247,426,169,79,121,134,1885
"26125142200",223,253,894,1117,9,318,84,138,3036
"26125142300",249,73,725,1178,5,104,46,0,2380
"26125142400",190,99,1731,860,76,129,86,54,3225
"26125142500",314,75,1017,274,38,64,0,15,1797
"26125142600",1671,426,787,190,247,92,130,137,3680
"26125142700",75,288,2254,876,160,80,87,239,4059
"26125143500",5357,323,207,31,207,0,234,76,6435
"26125144100",3274,330,292,0,244,10,117,0,4267
"26125144200",3811,274,0,0,255,0,424,0,4764
"26125144300",3266,259,0,4,39,62,100,8,3738
"26125144400",3902,466,101,0,395,6,341,46,5257
"26125144500",2522,228,228,0,9,0,113,26,3126
"26125144600",3104,238,150,22,291,0,76,58,3939
"26125144701",1929,1054,240,98,337,92,243,312,4305
"26125144800",1698,397,167,41,389,0,190,51,2933
"26125144900",2838,525,74,290,163,37,199,34,4160
"26125145100",2036,103,10,7,98,0,61,6,2321
"26125145200",2885,342,139,14,189,14,50,0,3633
"26125145300",3495,650,36,65,394,74,416,260,5390
"26125145400",3046,396,306,50,461,51,600,138,5048
"26125145501",3036,316,123,0,145,0,139,79,3838
"26125145502",2596,476,242,127,257,136,191,67,4092
"26125145600",3709,405,227,52,142,68,214,71,4888
"26125145700",1857,245,124,10,171,0,185,60,2652
"26125145900",1624,513,254,249,120,44,134,44,2982
"26125150000",3388,492,649,22,637,14,126,18,5346
"26125150100",2129,190,1124,22,324,58,73,0,3920
"26125150200",1791,200,62,0,420,0,35,0,2508
"26125150300",3684,95,300,126,641,16,76,8,4946
"26125150400",2328,24,55,10,360,0,60,0,2837
"26125150500",2482,59,57,3,154,13,0,0,2768
"26125150600",2038,43,257,0,507,0,104,0,2949
"26125150700",3571,205,209,0,404,74,19,0,4482
"26125150800",3545,89,218,25,334,0,183,11,4405
"26125150900",2636,226,295,1,521,0,43,0,3722
"26125151000",4330,219,0,0,566,0,43,0,5158
"26125152000",3032,115,35,0,524,0,64,0,3770
"26125152600",3528,37,129,19,140,0,78,0,3931
"26125152700",2691,89,6,0,120,29,40,48,3023
"26125152900",3427,128,146,0,198,9,79,15,4002
"26125153000",1739,192,45,18,78,0,122,42,2236
"26125153100",1912,115,4,0,124,22,55,0,2232
"26125153200",1658,92,54,0,170,0,42,0,2016
"26125153300",3116,77,166,0,148,0,56,0,3563
"26125154000",1550,63,69,7,12,0,48,0,1749
"26125154100",2378,249,113,2,46,0,42,0,2830
"26125154200",2023,512,208,77,196,0,111,116,3243
"26125154500",1998,81,157,10,219,0,73,0,2538
"26125154600",2006,176,268,78,354,0,44,0,2926
"26125156000",1756,121,239,42,205,6,13,2,2384
"26125156100",3486,147,351,59,381,0,70,10,4504
"26125156200",5575,272,318,0,398,0,133,7,6703
"26125156300",3180,102,65,0,572,0,171,0,4090
"26125156400",2845,83,530,55,245,24,46,21,3849
"26125156500",3185,164,555,107,447,10,134,0,4602
"26125156900",1889,76,389,0,693,0,10,0,3057
"26125157000",2039,76,81,0,115,8,44,0,2363
"26125157100",1124,207,314,5,196,17,0,0,1863
"26125157200",2552,468,792,74,148,18,0,0,4052
"26125157300",2017,153,605,0,197,7,30,0,3009
"26125157400",1699,243,235,14,333,0,7,0,2531
"26125157500",1873,160,723,90,367,39,62,0,3314
"26125157600",2544,599,885,36,810,61,14,0,4949
"26125157700",1669,196,263,0,368,77,0,0,2573
"26125157800",2028,62,1059,10,374,11,17,0,3561
"26125157900",1700,105,479,23,433,23,39,0,2802
"26125158000",3489,51,80,0,310,0,94,7,4031
"26125158100",2485,58,316,9,160,32,47,32,3139
"26125158200",2953,47,144,5,153,29,31,5,3367
"26125159000",3471,184,266,0,426,6,38,6,4397
"26125160000",1550,37,2030,161,302,2,28,0,4110
"26125160300",484,290,1466,599,88,59,122,21,3129
"26125160400",269,53,2253,317,69,0,46,0,3007
"26125160500",1374,336,1784,265,273,79,30,0,4141
"26125160600",1380,198,2028,400,327,0,52,29,4414
"26125160700",359,7,1187,13,31,16,0,0,1613
"26125160800",971,84,2198,230,124,127,30,1,3765
"26125160900",739,8,2643,299,417,0,10,0,4116
"26125161000",287,23,1417,371,59,0,29,0,2186
"26125161100",840,556,1587,183,150,50,0,0,3366
"26125161200",745,342,3453,157,164,0,10,0,4871
"26125161300",1054,205,1698,252,401,0,116,0,3726
"26125161400",1242,334,1380,342,41,13,8,28,3388
"26125161500",277,11,1391,129,61,0,11,0,1880
"26125161600",175,52,1699,145,119,0,0,0,2190
"26125161700",543,104,1921,25,77,76,9,13,2768
"26125161800",488,75,2972,599,110,67,72,3,4386
"26125161900",321,105,1339,95,46,0,9,25,1940
"26125162000",562,91,2639,245,99,4,0,2,3642
"26125162100",12,9,2063,955,62,33,10,0,3144
"26125162200",54,0,1043,147,97,13,0,0,1354
"26125162300",225,80,2975,432,99,0,53,0,3864
"26125162400",339,44,1409,229,110,43,70,1,2245
"26125162500",880,202,1464,525,56,146,36,10,3319
"26125165000",2338,99,131,124,275,21,20,0,3008
"26125165100",2874,160,544,0,140,13,61,13,3805
"26125165200",1481,65,466,123,1497,57,122,0,3811
"26125166000",1477,245,464,31,147,0,50,12,2426
"26125166100",1973,246,1207,14,277,8,111,0,3836
"26125166200",2103,210,155,2,289,57,30,1,2847
"26125166400",2498,125,301,0,392,0,73,0,3389
"26125166500",2013,57,353,30,318,88,93,0,2952
"26125166600",1638,402,911,358,447,108,79,8,3951
"26125166700",1163,76,755,24,367,41,18,0,2444
"26125166800",1936,146,800,10,255,85,116,5,3353
"26125166900",2705,200,338,8,341,10,113,8,3723
"26125167000",3542,164,622,0,792,38,53,31,5242
"26125167300",1949,294,624,86,281,56,48,5,3343
"26125167400",3053,796,1096,349,291,15,114,207,5921
"26125167500",3497,205,1395,10,590,35,237,0,5969
"26125167800",2825,365,472,77,770,35,197,0,4741
"26125167900",1885,39,454,77,250,9,96,0,2810
"26125168100",1628,127,220,0,339,0,98,0,2412
"26125168400",2332,61,568,0,547,0,53,0,3561
"26125168500",1308,127,636,39,403,22,21,8,2564
"26125168600",4010,39,1104,87,809,77,184,0,6310
"26125168700",2218,133,456,18,1021,0,83,12,3941
"26125168800",1770,29,346,0,179,0,80,0,2404
"26125168900",1511,200,972,53,1802,186,88,0,4812
"26125170000",2431,36,13,0,90,0,27,0,2597
"26125170100",2278,127,183,0,148,0,98,0,2834
"26125170200",3128,120,119,0,84,46,64,46,3607
"26125170300",2365,187,7,0,37,0,22,0,2618
"26125170400",3357,212,38,22,94,19,127,0,3869
"26125171000",2843,745,670,70,399,20,118,0,4865
"26125171100",1313,71,1393,72,266,7,93,0,3215
"26125171200",1175,59,584,146,225,13,38,4,2244
"26125171300",249,160,2425,281,204,47,0,8,3374
"26125171400",1662,215,3952,407,506,18,43,6,6809
"26125171500",239,125,3978,1131,396,12,188,0,6069
"26125171600",650,227,674,274,94,112,26,16,2073
"26125172400",304,300,655,317,33,0,0,0,1609
"26125172500",58,2,1477,714,80,107,0,0,2438
"26125173000",2990,824,437,66,130,83,297,68,4895
"26125173100",1264,160,78,0,60,12,41,0,1615
"26125173200",2310,133,19,13,149,0,85,0,2709
"26125173300",1198,63,156,56,111,8,39,21,1652
"26125173400",3572,1000,332,297,367,17,176,14,5775
"26125173500",2210,182,79,50,102,179,33,24,2859
"26125173600",1065,102,61,99,21,75,36,0,1459
"26125175000",1976,635,207,24,47,0,28,0,2917
"26125175100",3785,609,71,550,97,217,25,0,5354
"26125175200",2587,954,278,0,333,19,15,28,4214
"26125175300",2072,1046,560,286,57,148,16,1,4186
"26125180000",2107,134,0,0,425,106,235,74,3081
"26125180100",2445,170,11,0,146,8,78,0,2858
"26125180200",3171,131,39,0,113,0,116,0,3570
"26125180300",2522,153,127,0,49,0,45,0,2896
"26125181000",1800,987,449,167,581,125,102,0,4211
"26125181100",2383,232,43,83,92,26,21,0,2880
"26125181200",4800,790,197,154,396,26,0,0,6363
"26125181300",4505,461,161,181,321,55,118,0,5802
"26125181400",2256,490,225,0,72,18,0,0,3061
"26125181500",1761,233,104,73,119,12,15,0,2317
"26125181600",3496,1241,40,349,337,54,173,18,5708
"26125183000",2596,257,204,41,303,48,98,13,3560
"26125183100",4124,134,29,12,104,47,162,0,4612
"26125183200",2698,253,40,0,70,18,19,0,3098
"26125183300",2717,100,27,0,207,55,50,0,3156
"26125183400",1958,253,114,142,141,10,74,0,2692
"26125183500",1408,147,304,45,108,32,9,9,2062
"26125183600",3720,191,177,32,154,0,82,0,4356
"26125183700",4566,383,26,24,421,0,211,0,5631
"26125183800",3932,253,243,0,153,0,104,0,4685
"26125183900",2313,110,30,18,145,16,33,5,2670
"26125184000",2632,181,80,0,41,8,207,0,3149
"26125184100",2367,270,65,0,168,37,78,0,2985
"26125184200",3690,211,0,12,321,0,16,29,4279
"26125184300",2589,109,20,40,64,0,56,11,2889
"26125184400",2500,193,155,0,7,24,45,22,2946
"26125184500",1968,223,101,2,55,10,64,0,2423
"26125184600",2444,199,42,0,225,0,29,0,2939
"26125184700",1355,121,15,2,168,8,33,16,1718
"26125187000",2242,81,34,0,188,10,48,0,2603
"26125188000",3503,49,119,0,249,7,44,0,3971
"26125188100",2229,84,57,2,34,0,23,0,2429
"26125190200",3304,64,0,2,219,27,39,0,3655
"26125190400",2909,235,57,1,26,0,58,0,3286
"26125190500",2315,110,93,0,121,0,17,0,2656
"26125190700",4062,41,227,2,788,0,132,1,5253
"26125190800",2982,138,136,0,288,0,145,0,3689
"26125191000",1450,220,32,0,67,9,84,11,1873
"26125191100",2062,172,28,13,69,16,0,8,2368
"26125191200",3849,137,150,0,402,0,159,0,4697
"26125191300",3475,146,126,0,486,0,61,14,4308
"26125192000",5121,205,395,0,419,99,234,0,6473
"26125192200",4821,103,364,9,665,92,107,10,6171
"26125192400",4351,141,135,0,419,16,123,0,5185
"26125192500",2501,66,131,0,434,0,97,0,3229
"26125192700",2220,148,213,0,544,0,84,27,3236
"26125192800",242,103,30,18,58,8,46,0,505
"26125193000",2733,107,100,1,222,0,165,0,3328
"26125193100",3043,161,26,1,366,0,115,0,3712
"26125193300",3124,353,318,51,430,86,216,0,4578
"26125193400",3635,61,156,0,780,0,175,0,4807
"26125193500",1740,468,105,11,132,90,435,66,3047
"26125193600",1645,200,56,0,305,127,203,0,2536
"26125193700",3486,265,40,23,872,0,167,0,4853
"26125194000",2929,271,617,0,1283,132,89,0,5321
"26125194100",2346,97,66,4,349,1,71,2,2936
"26125194200",1540,41,161,0,162,0,16,0,1920
"26125194300",2569,82,409,17,631,25,76,11,3820
"26125194400",2431,161,38,0,481,6,149,0,3266
"26125194500",999,31,6,5,8,0,0,0,1049
"26125194600",3456,81,69,0,654,24,17,0,4301
"26125196000",4224,200,97,0,1581,0,293,10,6405
"26125196100",4091,271,304,0,1173,17,59,0,5915
"26125196200",2910,96,162,1,673,79,28,0,3949
"26125196300",2594,183,22,0,634,100,65,2,3600
"26125196400",2722,96,155,1,752,2,34,18,3780
"26125196500",3432,37,27,2,1622,105,136,0,5361
"26125196600",1647,34,20,5,437,59,28,0,2230
"26125196700",2436,55,8,1,245,0,70,0,2815
"26125196800",2806,36,51,0,1639,52,0,0,4584
"26125196900",2083,164,99,0,1096,10,36,28,3516
"26125197000",2979,174,106,10,1294,119,116,0,4798
"26125197100",1682,69,121,0,700,45,10,0,2627
"26125197200",2587,60,205,0,703,86,39,0,3680
"26125197300",3822,452,172,9,407,68,231,0,5161
"26125197400",1354,271,74,77,153,27,169,0,2125
"26125197500",1934,322,457,124,1275,217,204,0,4533
"26125197600",1152,86,245,32,506,66,10,32,2129
"26125197701",2254,193,206,12,1931,141,92,65,4894
"26125197702",681,108,171,9,971,47,18,0,2005
"26125197900",2627,58,169,6,749,31,91,0,3731
"26125198000",2236,249,109,0,1012,9,123,0,3738
"26125198100",1187,697,67,48,619,128,86,49,2881
"26125981000",0,0,0,0,0,0,0,0,0
"26127010300",5341,1211,21,23,203,123,900,462,8284
"26127010400",2607,926,9,67,121,133,490,404,4757
"26127010500",2300,718,1,135,75,5,389,394,4017
"26127010600",4313,797,0,3,218,26,201,19,5577
"26127010800",2143,427,0,14,35,16,133,45,2813
"26127010900",1844,292,1,39,50,3,124,33,2386
"26127011000",1357,326,0,1,19,0,2,93,1798
"26127990000",0,0,0,0,0,0,0,0,0
"26129950100",1764,435,0,0,20,24,4,2,2249
"26129950200",2648,276,0,0,48,0,19,0,2991
"26129950300",1361,243,1,0,31,0,22,0,1658
"26129950400",2309,434,0,1,75,8,36,0,2863
"26129950500",3404,898,1,1,80,11,59,67,4521
"26129950600",1976,720,0,0,20,80,49,5,2850
"26129950900",2418,1326,10,18,149,62,74,50,4107
"26131970100",1416,328,0,0,36,20,10,0,1810
"26131970200",2134,374,0,7,64,15,11,10,2615
"26131970300",1538,209,4,0,67,14,31,5,1868
"26131990100",0,0,0,0,0,0,0,0,0
"26133970100",2953,991,0,16,93,33,24,4,4114
"26133970200",3269,556,0,10,75,6,14,18,3948
"26133970300",2498,508,0,6,47,23,3,22,3107
"26133970400",2085,935,8,31,42,27,50,35,3213
"26133970500",3487,635,0,6,81,21,56,16,4302
"26133970600",3140,1133,5,11,47,84,94,16,4530
"26135970201",1137,350,0,3,35,3,9,0,1537
"26135970202",1340,325,0,0,37,27,2,0,1731
"26135970300",1140,417,2,0,16,17,26,7,1625
"26135970400",1764,310,0,1,12,17,25,3,2132
"26135970500",1119,186,31,0,76,0,34,0,1446
"26137950100",2307,476,0,0,66,31,12,49,2941
"26137950200",4553,691,35,7,172,28,72,35,5593
"26137950300",3865,1037,0,0,112,331,66,0,5411
"26137950400",1901,158,0,1,17,2,0,0,2079
"26137950500",2835,221,0,4,70,16,27,16,3189
"26137950600",4362,266,5,1,62,0,70,0,4766
"26139020100",4637,293,5,0,131,24,94,0,5184
"26139020200",3475,645,3,2,54,140,131,50,4500
"26139020400",3382,609,46,32,139,0,62,31,4301
"26139020501",2702,202,0,0,36,87,23,0,3050
"26139020503",3381,271,0,0,271,7,19,0,3949
"26139020504",2069,380,0,0,87,0,38,92,2666
"26139020600",3059,199,35,12,22,0,136,0,3463
"26139020900",3930,358,0,0,92,13,8,0,4401
"26139021000",4861,405,0,0,4,1,45,2,5318
"26139021100",4401,225,7,15,119,1,54,27,4849
"26139021201",4399,399,0,0,114,17,87,0,5016
"26139021202",5588,609,0,0,521,0,278,26,7022
"26139021301",2926,157,12,0,121,3,48,3,3270
"26139021303",2484,93,0,0,84,0,125,22,2808
"26139021304",4546,332,0,0,107,0,102,52,5139
"26139021400",7151,404,15,0,201,13,91,0,7875
"26139021500",7309,359,162,19,226,0,208,0,8283
"26139021603",4171,322,75,22,0,55,45,7,4697
"26139021604",6896,195,26,0,184,26,203,0,7530
"26139021605",3817,72,37,0,206,0,111,0,4243
"26139021606",4278,386,15,0,10,23,10,23,4745
"26139021700",3633,271,58,0,298,40,183,1,4484
"26139021801",3774,528,0,0,108,130,12,0,4552
"26139021802",3381,459,77,0,418,2,94,2,4433
"26139021901",3945,247,47,0,423,1,369,0,5032
"26139021902",6322,227,59,0,407,809,339,795,8958
"26139022001",4037,132,0,0,563,1,774,2,5509
"26139022002",3771,241,0,0,199,9,134,121,4475
"26139022103",1354,46,0,0,21,5,115,8,1549
"26139022105",4183,356,51,64,486,46,573,238,5997
"26139022106",3736,85,0,0,33,8,191,23,4076
"26139022107",1092,27,0,0,37,0,65,0,1221
"26139022108",5856,320,62,0,393,0,357,0,6988
"26139022203",5331,942,313,407,2494,440,2662,704,13293
"26139022206",3307,453,36,24,423,24,298,0,4565
"26139022600",1605,60,27,0,176,0,169,10,2047
"26139022900",4855,550,53,22,748,53,574,114,6969
"26139023001",5377,245,2,0,119,0,280,0,6023
"26139023002",5490,200,18,0,572,190,242,89,6801
"26139023100",7029,495,146,0,2621,713,2474,726,14204
"26139023200",2468,105,0,11,56,0,16,0,2656
"26139023500",4409,39,79,0,113,10,45,0,4695
"26139023600",2238,74,67,0,83,14,32,0,2508
"26139024300",4425,589,0,13,159,9,170,39,5404
"26139024400",6316,1077,148,82,655,77,512,135,9002
"26139024500",769,3695,136,99,164,101,59,287,5310
"26139024600",4727,169,0,0,268,0,118,0,5282
"26139024900",2972,939,208,86,327,85,1334,254,6205
"26139025100",4605,555,151,21,963,268,1406,319,8288
"26139025200",3456,830,45,87,538,354,575,453,6338
"26139025500",3604,71,12,15,139,0,145,0,3986
"26139025700",3715,604,137,15,652,64,557,155,5899
"26139025800",4522,829,185,51,615,24,2674,317,9217
"26139990000",0,0,0,0,0,0,0,0,0
"26141950100",1659,145,0,0,20,0,21,5,1850
"26141950200",2205,249,1,12,25,10,0,0,2502
"26141950300",1612,339,2,0,61,32,30,29,2105
"26141950400",1833,443,1,12,37,5,10,8,2349
"26141950500",2195,408,2,0,31,44,10,6,2696
"26141950600",1368,62,2,0,20,0,13,0,1465
"26141990000",0,0,0,0,0,0,0,0,0
"26143970100",1290,435,0,0,27,10,17,0,1779
"26143970200",1375,472,0,0,0,16,0,14,1877
"26143970300",1828,594,0,0,64,217,36,56,2795
"26143970400",1788,281,0,0,28,0,6,9,2112
"26143970500",745,148,0,0,5,0,2,0,900
"26143970600",1687,310,0,0,43,0,9,17,2066
"26143970700",2346,312,0,14,6,0,0,0,2678
"26143971000",3172,859,4,0,73,51,62,13,4234
"26143971100",2373,547,0,0,40,66,53,4,3083
"26143971200",1927,535,0,0,50,18,20,0,2550
"26145000100",12,219,562,312,0,6,33,25,1169
"26145000200",36,28,710,428,71,54,27,2,1356
"26145000400",73,89,513,269,5,14,28,9,1000
"26145000600",290,106,766,565,167,47,222,51,2214
"26145000700",237,110,623,572,110,136,166,128,2082
"26145000800",240,126,1295,1067,40,60,159,122,3109
"26145000900",208,42,1265,1405,312,91,250,48,3621
"26145001000",345,225,1582,1197,266,75,323,139,4152
"26145001100",222,512,869,971,236,275,288,262,3635
"26145001200",1279,489,542,237,404,80,640,131,3802
"26145001300",926,350,333,542,147,109,237,126,2770
"26145001400",1907,214,188,169,197,11,357,124,3167
"26145001500",2187,546,422,291,265,229,436,26,4402
"26145001600",1525,930,625,360,187,87,366,508,4588
"26145001700",772,344,180,395,191,93,200,75,2250
"26145001800",571,435,449,149,0,43,30,208,1885
"26145001900",762,590,130,208,157,158,139,304,2448
"26145002000",1687,503,689,101,295,23,179,105,3582
"26145002100",2883,688,345,275,294,21,306,281,5093
"26145010100",7482,415,16,2,438,12,242,0,8607
"26145010200",2059,612,0,102,98,60,108,55,3094
"26145010302",5835,262,396,145,743,0,173,0,7554
"26145010303",3071,72,239,72,156,0,99,0,3709
"26145010304",3045,492,515,163,382,139,315,23,5074
"26145010401",1974,198,60,52,86,16,206,0,2592
"26145010402",4326,354,258,121,415,15,407,31,5927
"26145010403",4242,291,591,28,403,109,340,209,6213
"26145010501",2214,87,94,0,61,10,183,10,2659
"26145010502",3969,407,348,282,376,87,278,145,5892
"26145010600",1387,324,371,291,141,8,145,27,2694
"26145010700",3994,444,320,945,167,87,803,49,6809
"26145010800",1714,411,170,151,85,9,212,39,2791
"26145011000",601,322,2533,1641,520,89,99,200,6005
"26145011100",1388,391,217,0,29,21,111,54,2211
"26145011200",1733,87,7,10,9,0,62,0,1908
"26145011300",6554,313,4,0,37,0,84,0,6992
"26145011500",1502,473,351,172,66,223,242,317,3346
"26145011600",1480,169,1082,278,101,194,312,112,3728
"26145011701",1347,99,114,0,59,0,120,0,1739
"26145011702",2052,354,17,1,29,0,137,0,2590
"26145011800",1430,113,288,74,168,7,232,42,2354
"26145011901",1619,80,0,0,67,0,78,29,1873
"26145011902",2055,137,10,0,28,14,29,0,2273
"26145012001",2914,237,28,25,99,5,99,8,3415
"26145012002",3495,143,45,23,34,4,97,0,3841
"26145012003",4123,315,12,0,85,16,140,14,4705
"26145012100",3786,136,20,20,76,9,191,9,4247
"26145012200",1329,187,2,0,24,7,105,13,1667
"26145012300",2742,173,0,0,89,3,88,6,3101
"26145012400",1736,240,5,2,4,25,32,13,2057
"26145012500",3200,694,0,0,36,36,83,49,4098
"26145012600",2900,451,14,6,20,49,126,35,3601
"26145012700",3730,460,12,0,176,36,248,21,4683
"26145012900",4059,426,21,0,43,53,125,14,4741
"26145013000",3912,343,56,9,59,44,194,0,4617
"26145013100",5244,422,32,1,187,17,322,5,6230
"26147620000",2152,962,633,207,176,250,298,322,5000
"26147621000",2175,716,248,71,31,73,35,64,3413
"26147622000",2667,830,127,136,218,260,108,78,4424
"26147623000",1571,776,156,143,30,172,46,9,2903
"26147624000",601,669,62,138,0,131,7,30,1638
"26147625000",746,614,5,114,51,122,63,4,1719
"26147626000",1380,413,0,47,59,68,42,28,2037
"26147627000",2398,273,81,7,89,7,38,57,2950
"26147628000",2525,331,73,0,401,54,148,17,3549
"26147629000",1991,627,17,14,76,50,120,0,2895
"26147630100",1056,103,8,29,37,67,17,20,1337
"26147630400",4705,522,37,214,103,39,34,0,5654
"26147631100",1503,118,3,4,82,0,27,0,1737
"26147631600",1901,325,38,3,116,0,43,12,2438
"26147632000",3421,346,14,0,99,48,54,3,3985
"26147633100",2565,113,0,0,120,0,108,4,2910
"26147633200",2484,72,23,0,36,54,105,0,2774
"26147634100",3006,537,33,0,138,37,53,33,3837
"26147634600",4653,485,51,0,194,44,158,0,5585
"26147635000",4938,904,120,0,45,188,111,0,6306
"26147636000",2273,897,35,223,248,155,432,140,4403
"26147637100",3517,154,7,0,90,0,14,18,3800
"26147637200",3201,334,9,0,68,0,42,7,3661
"26147637300",2030,310,0,0,61,9,11,0,2421
"26147640100",1951,43,0,0,76,0,51,0,2121
"26147640200",2106,96,3,3,65,0,34,0,2307
"26147640600",2128,224,0,0,30,3,20,3,2408
"26147641000",3154,159,0,2,148,29,8,26,3526
"26147642000",4357,828,51,0,92,42,90,29,5489
"26147643000",3039,370,122,1,22,22,0,8,3584
"26147644000",3751,587,22,0,6,64,27,0,4457
"26147645000",2841,379,0,0,13,16,11,0,3260
"26147646000",4228,295,0,0,84,27,31,1,4666
"26147647000",2761,319,0,0,0,0,0,0,3080
"26147648000",1071,63,0,0,6,5,0,12,1157
"26147649000",3355,599,0,4,55,13,10,40,4076
"26147650100",3252,442,0,0,105,12,0,0,3811
"26147650200",1064,129,0,32,24,0,28,0,1277
"26147651100",1627,103,0,0,6,16,0,0,1752
"26147651200",1923,307,0,0,24,4,28,55,2341
"26147651600",3717,154,2,0,136,0,0,0,4009
"26147652100",2201,195,0,0,41,2,8,0,2447
"26147652600",2822,258,5,10,96,4,59,9,3263
"26147655100",4107,662,0,0,111,17,204,25,5126
"26147655600",2957,330,0,11,66,1,52,12,3429
"26147657100",1397,251,5,0,197,56,354,60,2320
"26147657200",4675,426,0,0,122,143,318,131,5815
"26147658100",2150,411,0,0,36,0,57,5,2659
"26147658500",3271,344,31,1,58,5,39,19,3768
"26147990000",0,0,0,0,0,0,0,0,0
"26149040100",3102,190,173,0,151,14,49,13,3692
"26149040200",804,615,176,155,43,16,3,168,1980
"26149040300",1918,508,124,75,69,43,30,110,2877
"26149040400",1002,424,230,250,75,129,17,96,2223
"26149040500",2246,462,19,0,194,0,373,59,3353
"26149040600",1850,561,18,63,226,90,410,162,3380
"26149040700",2142,596,0,8,318,137,767,368,4336
"26149040800",2230,818,17,31,148,58,271,324,3897
"26149040900",3281,446,24,0,184,79,71,0,4085
"26149041000",2925,379,12,8,75,9,28,9,3445
"26149041101",3280,712,95,27,122,44,238,22,4540
"26149041102",2706,185,13,0,166,4,40,20,3134
"26149041200",2430,193,29,18,246,23,174,16,3129
"26149041300",5766,627,5,22,70,67,20,110,6687
"26149041400",4069,1088,0,9,72,21,71,15,5345
"26149041500",3633,690,17,0,50,0,81,24,4495
"26149041600",3104,393,16,0,76,32,171,30,3822
"26151970100",1578,144,0,5,0,22,31,3,1783
"26151970200",2201,309,0,0,37,13,37,24,2621
"26151970300",2916,612,16,5,29,9,14,7,3608
"26151970400",2870,825,42,0,43,32,38,55,3905
"26151970500",1930,228,0,0,44,21,62,5,2290
"26151970600",1919,229,0,0,24,1,13,0,2186
"26151970700",1311,242,0,0,22,0,6,0,1581
"26151970800",5157,704,24,12,154,37,421,37,6546
"26151970900",3757,671,0,0,216,74,192,34,4944
"26151971000",3315,692,4,39,86,17,98,38,4289
"26151971100",2754,730,2,0,30,18,67,12,3613
"26151971200",4350,758,27,37,183,36,191,121,5703
"26151990000",0,0,0,0,0,0,0,0,0
"26153000100",1945,298,3,19,247,114,25,10,2661
"26153000200",1993,275,0,0,199,12,20,0,2499
"26153000300",1713,820,6,3,275,194,5,14,3030
"26153990000",0,0,0,0,0,0,0,0,0
"26155030100",5191,426,4,8,87,19,79,0,5814
"26155030200",3255,301,0,0,75,18,133,50,3832
"26155030300",3829,799,51,6,150,23,19,76,4953
"26155030400",2293,353,0,2,51,32,101,0,2832
"26155030500",2734,565,0,0,182,25,135,35,3676
"26155030600",1181,615,0,0,40,9,81,64,1990
"26155030700",1944,879,0,16,27,49,117,21,3053
"26155030800",2187,829,0,0,47,46,166,8,3283
"26155031301",3711,359,1,0,132,7,100,3,4313
"26155031302",3687,435,0,0,68,15,41,2,4248
"26155031401",5439,357,17,5,82,17,66,50,6033
"26155031402",3285,244,26,7,155,0,36,32,3785
"26155031500",5324,781,25,8,92,0,165,0,6395
"26155031600",2961,715,19,4,37,19,29,29,3813
"26155031700",3311,540,0,23,50,26,0,53,4003
"26155031800",3278,554,11,0,34,50,92,2,4021
"26155031900",3090,444,0,0,41,160,0,15,3750
"26157000100",3323,620,8,26,60,0,131,13,4181
"26157000200",2636,282,0,9,70,23,54,21,3095
"26157000300",2582,727,0,0,41,2,121,181,3654
"26157000400",2770,390,24,0,104,0,91,29,3408
"26157000500",4397,803,7,0,115,0,160,12,5494
"26157000600",3208,629,0,7,107,16,113,107,4187
"26157000700",2879,532,15,0,57,0,104,18,3605
"26157000800",3496,475,0,0,63,26,124,3,4187
"26157000900",3542,878,70,43,50,29,75,17,4704
"26157001000",4365,877,15,13,167,26,53,10,5526
"26157001100",2461,576,78,23,53,22,20,7,3240
"26157001200",3806,591,0,29,64,0,59,0,4549
"26157001300",4089,623,28,20,71,0,37,8,4876
"26157990000",0,0,0,0,0,0,0,0,0
"26159010100",5536,800,72,32,182,107,159,39,6927
"26159010200",3858,1179,304,104,412,191,570,570,7188
"26159010300",1543,243,45,33,99,0,12,8,1983
"26159010400",1910,145,148,339,149,37,150,28,2906
"26159010500",2588,406,115,114,174,4,209,17,3627
"26159010600",973,512,258,310,634,138,586,317,3728
"26159010900",6192,761,87,3,316,75,353,53,7840
"26159011002",5702,594,43,11,424,34,468,0,7276
"26159011300",3024,962,12,21,237,131,400,176,4963
"26159011400",3186,682,34,23,454,280,847,303,5809
"26159011500",2558,576,29,39,139,33,452,110,3936
"26159011600",4424,991,97,35,209,293,304,93,6446
"26159011800",4610,1632,39,0,224,285,222,181,7193
"26159011900",4536,313,41,1,162,50,277,36,5416
"26159012000",3970,1104,150,86,589,320,687,455,7361
"26159990000",0,0,0,0,0,0,0,0,0
"26161400100",601,474,25,9,272,351,29,55,1816
"26161400200",88,51,1,2,12,27,0,14,195
"26161400300",1197,3128,137,113,207,749,0,153,5684
"26161400400",2077,687,113,1,244,38,189,0,3349
"26161400500",1726,3259,99,93,263,877,106,215,6638
"26161400600",3412,562,34,57,200,64,46,0,4375
"26161400700",1562,339,297,76,218,77,108,56,2733
"26161400800",853,1286,35,16,172,383,58,97,2900
"26161402100",1394,485,78,30,424,271,125,0,2807
"26161402200",547,985,56,92,343,525,84,57,2689
"26161402300",1738,117,29,0,425,27,70,13,2419
"26161402500",1141,227,57,0,710,16,20,26,2197
"26161402600",522,208,37,34,786,390,86,150,2213
"26161402700",3187,319,138,135,1505,160,298,1,5743
"26161403100",1172,18,26,0,239,21,31,0,1507
"26161403200",2383,145,232,13,295,0,111,14,3193
"26161403300",3008,251,372,220,250,47,147,0,4295
"26161403400",2523,185,261,16,260,0,156,0,3401
"26161403500",2150,107,199,3,114,10,83,0,2666
"26161403600",1739,626,243,24,1574,1039,131,14,5390
"26161403800",1605,151,503,229,598,96,125,3,3310
"26161404100",2678,153,186,25,157,17,262,45,3523
"26161404200",1226,214,223,238,153,49,32,0,2135
"26161404300",2396,43,40,2,146,11,128,0,2766
"26161404400",1684,19,106,67,210,65,79,0,2230
"26161404500",2133,572,188,0,1115,230,117,48,4403
"26161404600",3043,275,255,202,656,128,63,61,4683
"26161405100",1181,296,385,161,291,33,276,107,2730
"26161405200",3657,325,220,18,441,105,58,16,4840
"26161405300",3909,195,182,0,911,70,104,0,5371
"26161405400",1473,73,110,44,134,117,90,3,2044
"26161405500",1349,166,183,26,463,112,33,0,2332
"26161405600",2130,514,814,73,1010,268,393,93,5295
"26161406000",2183,249,29,4,833,52,71,22,3443
"26161407000",3611,90,78,10,697,18,132,0,4636
"26161407400",2033,530,1685,687,563,304,347,352,6501
"26161407600",1519,22,1188,12,221,0,0,0,2962
"26161410100",649,355,945,503,406,206,250,134,3448
"26161410200",1141,302,277,213,192,74,71,26,2296
"26161410300",2505,590,343,211,164,57,113,22,4005
"26161410400",2333,256,683,153,421,25,541,0,4412
"26161410500",555,237,665,551,276,319,160,287,3050
"26161410600",136,544,748,717,71,127,22,24,2389
"26161410700",502,138,327,150,114,25,0,0,1256
"26161410800",616,174,219,413,105,56,33,0,1616
"26161410900",1115,125,32,22,83,47,41,0,1465
"26161411000",1419,728,277,161,108,133,90,21,2937
"26161411100",18,42,26,26,36,38,21,20,227
"26161411200",418,310,898,502,191,166,131,34,2650
"26161411700",1493,132,257,146,120,59,140,0,2347
"26161411900",1911,346,641,437,135,42,139,43,3694
"26161412000",2202,365,497,100,177,12,74,0,3427
"26161412100",1700,417,501,451,79,50,238,148,3584
"26161412300",705,32,1645,595,146,60,30,0,3213
"26161412600",1482,239,760,101,158,51,145,0,2936
"26161412700",2702,189,754,636,715,174,100,31,5301
"26161413000",1689,238,1107,432,79,51,98,0,3694
"26161413200",2616,453,650,103,434,253,259,229,4997
"26161413401",2447,64,973,331,628,0,113,0,4556
"26161413402",3004,172,1282,132,594,0,74,17,5275
"26161413403",1431,53,365,32,186,24,6,4,2101
"26161414000",1010,583,732,184,438,179,74,84,3284
"26161414200",1623,266,289,56,442,128,175,61,3040
"26161414300",1305,427,442,85,904,110,147,21,3441
"26161414500",1602,23,547,60,493,191,83,0,2999
"26161414700",972,81,76,4,346,5,48,29,1561
"26161414900",2232,10,80,0,1371,94,104,0,3891
"26161415200",1182,218,274,29,200,0,70,19,1992
"26161415400",1356,82,178,16,422,50,67,39,2210
"26161415600",1752,10,114,0,177,25,15,5,2098
"26161415800",2563,38,188,0,659,0,80,0,3528
"26161416000",2008,228,499,41,580,111,332,132,3931
"26161416200",3607,137,194,2,204,18,30,0,4192
"26161420000",2742,158,198,20,260,110,27,14,3529
"26161420200",3007,50,208,2,144,0,51,0,3462
"26161421100",3518,105,0,2,131,100,185,0,4041
"26161421900",11,0,0,0,0,4,0,0,15
"26161422200",6605,66,76,0,550,19,568,0,7884
"26161422900",19,68,0,72,0,7,0,13,179
"26161423400",6024,290,0,0,299,0,126,4,6743
"26161423600",2050,49,11,0,148,0,81,0,2339
"26161425000",4130,91,24,13,242,0,57,45,4602
"26161426000",3213,253,22,0,132,16,80,8,3724
"26161431000",4060,420,6,20,101,36,28,0,4671
"26161432000",4708,245,15,0,86,10,79,2,5145
"26161444000",5724,216,3,10,199,0,73,2,6227
"26161445000",2292,90,13,0,176,0,98,0,2669
"26161446200",1981,27,16,1,50,0,11,0,2086
"26161446400",2868,56,0,0,10,0,104,0,3038
"26161447000",2635,78,18,1,76,35,24,0,2867
"26161448000",3408,111,0,0,207,0,62,0,3788
"26161453000",4208,20,97,0,521,8,104,8,4966
"26161454000",4539,260,0,0,218,27,260,91,5395
"26161455000",3167,421,99,175,774,78,182,0,4896
"26161456000",3712,197,141,675,1103,334,139,182,6483
"26161461000",6667,153,0,0,186,0,99,0,7105
"26161464000",5336,99,116,0,203,14,156,14,5938
"26161465000",4858,498,0,2,342,122,151,45,6018
"26161466000",2447,43,1,0,98,0,98,13,2700
"26161984000",16,4,0,0,0,0,0,0,20
"26163500100",351,0,1821,1063,24,0,0,0,3259
"26163500200",116,22,1676,769,66,59,0,0,2708
"26163500300",50,3,1211,980,47,47,0,14,2352
"26163500400",43,39,450,475,55,38,0,26,1126
"26163500500",10,0,1094,489,5,17,6,8,1629
"26163500600",55,12,1472,1492,10,73,0,0,3114
"26163500700",94,77,2170,1950,62,11,25,0,4389
"26163500800",166,54,1092,885,46,61,0,0,2304
"26163500900",0,0,2163,1192,0,0,0,0,3355
"26163501000",106,36,1256,1228,202,140,0,43,3011
"26163501100",119,2,1644,1511,1,0,14,1,3292
"26163501200",57,10,947,795,0,0,0,0,1809
"26163501300",127,30,1370,1947,0,9,9,24,3516
"26163501400",394,31,2277,1035,38,0,39,2,3816
"26163501500",502,90,1815,1806,87,67,61,0,4428
"26163501600",273,91,779,615,94,117,0,93,2062
"26163501700",304,253,645,591,100,29,5,17,1944
"26163501800",935,109,2384,931,110,108,85,0,4662
"26163501900",91,89,1501,1370,26,124,0,80,3281
"26163502000",44,54,1625,770,9,1,0,0,2503
"26163503100",129,104,1934,810,0,49,0,0,3026
"26163503200",186,98,1371,1076,0,44,0,0,2775
"26163503300",94,71,2271,1205,192,51,86,0,3970
"26163503400",19,5,840,270,31,32,0,0,1197
"26163503500",86,24,1873,1356,52,29,42,0,3462
"26163503600",65,63,889,381,210,48,0,2,1658
"26163503900",22,20,1178,629,28,33,0,127,2037
"26163504000",10,18,948,621,0,1,0,0,1598
"26163504100",0,0,600,841,4,4,0,0,1449
"26163504200",18,4,1105,554,0,43,0,1,1725
"26163504300",29,17,1154,819,0,0,0,7,2026
"26163504400",24,0,1025,537,5,127,0,0,1718
"26163504700",53,11,764,949,70,0,0,0,1847
"26163504800",26,3,536,289,0,32,0,0,886
"26163504900",153,41,1879,1049,10,171,0,0,3303
"26163505000",18,0,683,412,17,8,0,0,1138
"26163505100",131,10,1434,1416,75,16,18,16,3116
"26163505200",92,67,2232,916,73,21,0,31,3432
"26163505400",16,2,1069,1159,36,3,0,0,2285
"26163505500",0,94,580,548,0,28,0,8,1258
"26163506100",44,50,965,944,102,0,0,0,2105
"26163506200",50,26,1065,1164,0,9,11,5,2330
"26163506300",41,12,1275,610,0,52,0,0,1990
"26163506400",26,46,562,387,0,29,0,1,1051
"26163506500",0,29,987,1367,0,21,0,0,2404
"26163506600",51,9,1367,965,0,47,0,0,2439
"26163506700",28,1,658,506,0,23,0,0,1216
"26163506800",76,16,2641,1027,8,70,28,0,3866
"26163506900",198,0,2539,1127,60,0,60,21,4005
"26163507000",0,9,1547,1363,9,4,0,0,2932
"26163507100",14,2,1396,1177,23,0,0,1,2613
"26163507200",0,5,580,546,0,24,0,16,1171
"26163507300",73,3,1898,206,44,0,0,0,2224
"26163507400",14,20,1896,627,15,25,46,5,2648
"26163507500",112,47,1079,715,0,87,20,0,2060
"26163507800",29,2,302,157,0,1,0,1,492
"26163507900",153,131,785,537,33,19,26,39,1723
"26163508000",52,106,428,554,23,22,0,0,1185
"26163508100",81,76,444,650,166,35,41,16,1509
"26163510400",4,10,411,201,0,0,0,0,626
"26163510500",272,90,377,796,1552,1794,0,0,4881
"26163510600",855,1019,456,467,526,1347,0,0,4670
"26163510700",423,735,158,273,112,217,0,6,1924
"26163511000",42,30,892,993,58,48,0,45,2108
"26163511200",105,32,698,493,17,0,0,0,1345
"26163511300",268,242,832,662,243,45,0,0,2292
"26163511400",53,2,1477,1080,42,16,25,0,2695
"26163511900",35,56,603,891,8,5,0,19,1617
"26163512100",53,14,1821,1274,0,0,0,0,3162
"26163512200",23,39,206,1042,0,0,0,27,1337
"26163512300",5,130,770,634,0,27,0,93,1659
"26163512400",32,8,471,644,14,0,0,0,1169
"26163512600",12,0,670,709,48,0,0,0,1439
"26163512900",48,67,434,921,21,0,0,0,1491
"26163513200",223,79,781,710,60,69,4,52,1978
"26163513300",146,86,1412,585,78,35,6,20,2368
"26163513600",21,21,402,913,53,0,0,0,1410
"26163513700",62,96,1802,1367,67,0,8,0,3402
"26163513900",16,32,1029,796,28,5,16,0,1922
"26163514100",16,71,1035,1581,0,127,9,56,2895
"26163514200",0,9,1210,1405,0,47,0,0,2671
"26163514300",0,5,1426,1561,0,5,0,0,2997
"26163514500",0,0,510,751,10,0,0,0,1271
"26163515200",96,44,789,550,1,22,16,0,1518
"26163515300",222,149,941,1391,66,16,82,13,2880
"26163515400",582,110,457,313,117,7,55,0,1641
"26163515600",5,0,787,496,0,10,0,0,1298
"26163515700",315,82,2407,609,92,0,0,0,3505
"26163515900",20,26,731,915,1,3,1,1,1698
"26163516000",13,49,1126,728,29,0,0,11,1956
"26163516100",0,0,232,232,0,0,0,0,464
"26163516200",8,22,302,468,13,27,0,0,840
"26163516300",4,12,279,316,0,4,0,0,615
"26163516400",93,106,457,164,24,7,0,0,851
"26163516500",278,125,647,336,57,73,18,0,1534
"26163516600",0,0,1214,1089,20,33,8,0,2364
"26163516700",25,32,1782,1151,63,28,0,0,3081
"26163516800",8,36,449,351,18,70,0,0,932
"26163516900",60,11,1846,576,10,0,0,0,2503
"26163517000",760,153,1670,326,48,10,14,19,3000
"26163517100",142,39,749,249,10,0,12,0,1201
"26163517200",408,108,289,58,117,9,39,6,1034
"26163517300",361,138,674,796,64,23,24,6,2086
"26163517500",232,122,911,928,84,110,0,8,2395
"26163518000",367,169,961,472,84,107,10,23,2193
"26163518400",44,66,204,163,0,7,0,0,484
"26163518500",106,90,378,294,6,57,0,5,936
"26163518600",12,2,201,221,0,0,0,1,437
"26163518800",88,19,292,302,12,14,0,0,727
"26163518900",67,17,698,1167,11,0,5,0,1965
"26163520200",392,379,187,147,371,97,0,5,1578
"26163520300",458,267,185,193,369,175,221,16,1884
"26163520400",313,228,334,858,48,8,10,17,1816
"26163520700",685,177,744,667,24,84,63,10,2454
"26163520800",375,39,568,105,205,82,88,11,1473
"26163521100",964,493,306,185,282,153,969,325,3677
"26163521300",177,36,370,231,15,13,102,2,946
"26163521400",536,189,273,179,143,0,206,138,1664
"26163521500",206,193,592,550,14,54,15,65,1689
"26163521800",5,0,701,620,5,0,5,9,1345
"26163521900",1071,303,525,1150,71,109,166,6,3401
"26163522000",9,123,780,987,0,10,34,25,1968
"26163522100",0,101,489,175,0,11,0,0,776
"26163522200",68,24,201,265,5,22,54,18,657
"26163522300",69,16,265,682,19,6,0,5,1062
"26163522400",89,28,437,453,0,0,0,0,1007
"26163522500",153,259,219,927,7,14,32,6,1617
"26163523100",1002,332,107,118,297,235,982,474,3547
"26163523200",1730,578,31,52,924,664,2365,1101,7445
"26163523300",1278,961,42,355,600,244,1593,998,6071
"26163523400",753,444,397,456,492,87,962,320,3911
"26163523800",1258,1726,120,17,628,729,1689,1774,7941
"26163524000",1189,1064,44,158,524,478,1566,1353,6376
"26163524100",1445,963,206,195,898,506,1917,913,7043
"26163524200",2437,1280,10,203,1335,482,2938,1235,9920
"26163524300",1360,781,124,20,230,378,1099,903,4895
"26163524500",148,301,12,45,17,66,28,286,903
"26163524700",42,25,2395,1377,42,65,12,82,4040
"26163524800",11,152,1498,1234,41,7,27,97,3067
"26163524900",668,340,179,41,39,177,295,454,2193
"26163525000",282,237,73,267,80,39,183,72,1233
"26163525400",370,288,621,687,675,233,877,496,4247
"26163525500",149,91,306,268,184,315,263,299,1875
"26163525600",509,767,35,31,178,269,450,926,3165
"26163525700",2005,1480,0,40,1105,586,2279,1673,9168
"26163525800",502,507,90,148,74,414,406,854,2995
"26163526000",992,1224,22,71,481,319,725,667,4501
"26163526100",838,1444,146,100,244,323,330,498,3923
"26163526200",997,1014,267,93,565,404,966,655,4961
"26163526300",915,965,290,148,752,428,1451,1151,6100
"26163526400",692,266,96,191,319,222,973,499,3258
"26163526500",233,39,987,539,87,208,294,240,2627
"26163527200",0,53,491,334,0,1,27,51,957
"26163527300",0,2,478,456,41,66,31,12,1086
"26163530100",49,46,1426,810,44,0,0,0,2375
"26163530200",171,222,1955,1433,96,59,31,1,3968
"26163530300",0,38,1008,623,15,0,0,25,1709
"26163530400",42,6,759,608,8,0,0,0,1423
"26163530500",36,32,1680,877,19,71,0,0,2715
"26163530800",0,29,998,838,0,5,3,5,1878
"26163530900",7,5,934,967,19,19,0,11,1962
"26163531100",0,28,209,653,0,18,0,22,930
"26163531200",118,18,2193,422,17,21,7,21,2817
"26163531300",20,9,980,212,0,12,0,0,1233
"26163531400",24,6,1167,407,0,23,17,7,1651
"26163531500",5,27,1237,2098,0,132,0,53,3552
"26163531600",6,38,885,528,38,0,27,1,1523
"26163531700",0,6,509,867,2,0,0,0,1384
"26163531800",19,71,1014,886,0,0,0,0,1990
"26163531900",61,133,301,398,51,14,14,0,972
"26163532200",50,38,593,595,9,4,0,0,1289
"26163532300",115,45,512,82,46,0,0,0,800
"26163532400",13,83,647,617,0,77,0,25,1462
"26163532600",57,25,1019,860,179,95,48,0,2283
"26163532700",26,18,555,195,0,5,0,6,805
"26163533000",17,94,697,528,39,0,0,82,1457
"26163533100",0,12,567,682,54,9,0,9,1333
"26163533200",17,3,728,517,0,0,7,0,1272
"26163533300",0,16,507,762,0,93,0,0,1378
"26163533400",0,35,963,1525,22,21,0,0,2566
"26163533500",0,0,564,462,5,0,0,0,1031
"26163533600",29,0,1059,1059,12,0,54,0,2213
"26163533700",0,43,555,529,0,0,0,0,1127
"26163533900",481,241,1199,1066,123,26,0,0,3136
"26163534100",1,3,1021,692,0,56,0,0,1773
"26163534200",69,21,1846,1999,37,103,69,0,4144
"26163534300",0,5,818,673,0,14,4,3,1517
"26163534400",20,28,717,689,52,20,0,0,1526
"26163534500",19,0,337,438,58,0,0,0,852
"26163534600",51,44,945,551,24,8,63,25,1711
"26163534700",15,0,1822,1429,0,0,0,0,3266
"26163535000",103,37,1617,1094,140,11,0,0,3002
"26163535100",26,10,930,774,26,0,0,0,1766
"26163535200",40,75,1092,1086,0,54,0,0,2347
"26163535300",56,17,2410,1296,24,9,16,1,3829
"26163535400",15,11,766,735,8,6,0,0,1541
"26163535500",184,0,1792,981,0,0,103,0,3060
"26163535600",54,0,2929,878,10,0,0,0,3871
"26163535700",0,0,708,543,23,17,0,41,1332
"26163536100",0,2,1850,1111,41,162,22,72,3260
"26163536200",0,0,1189,793,5,15,0,0,2002
"26163536300",18,9,1457,857,0,11,0,0,2352
"26163536400",26,0,1418,1040,70,0,0,0,2554
"26163536500",82,9,1536,739,86,0,38,0,2490
"26163536600",0,0,1838,1114,40,0,23,0,3015
"26163536700",8,0,580,603,7,40,0,0,1238
"26163536800",49,5,1058,452,62,17,0,1,1644
"26163536900",19,22,1788,1319,5,92,98,0,3343
"26163537000",88,10,2011,1058,166,0,39,0,3372
"26163537100",7,0,1138,684,30,23,0,0,1882
"26163537200",5,10,409,421,22,5,4,0,876
"26163537300",0,13,1307,1212,46,2,0,23,2603
"26163537500",105,1,1565,1129,11,0,0,0,2811
"26163537600",80,70,2230,929,31,104,37,163,3644
"26163537700",38,0,1896,871,41,5,17,0,2868
"26163537800",39,0,978,726,26,0,0,0,1769
"26163538100",238,126,1555,396,219,0,27,0,2561
"26163538200",327,0,1545,50,53,0,48,0,2023
"26163538300",108,2,961,588,20,0,20,0,1699
"26163538400",434,2,2907,331,87,17,0,0,3778
"26163538500",8,7,3633,1296,174,36,5,0,5159
"26163538600",13,1,4295,1216,35,34,15,0,5609
"26163538700",9,20,2650,1177,50,40,5,0,3951
"26163538800",23,0,1291,333,44,18,11,0,1720
"26163538900",39,0,2841,500,17,0,9,0,3406
"26163539000",2,4,1984,572,35,22,0,35,2654
"26163539100",5,4,1304,613,9,41,0,0,1976
"26163539200",26,44,2419,1468,126,18,0,47,4148
"26163539300",9,11,2652,1194,46,0,0,0,3912
"26163539400",34,48,2548,962,31,23,0,0,3646
"26163539500",13,0,2153,841,125,0,0,0,3132
"26163539600",38,77,1955,1097,25,0,25,0,3217
"26163539700",19,2,1315,667,6,0,0,0,2009
"26163540100",63,0,2232,830,20,0,13,0,3158
"26163540200",11,0,1793,1641,9,0,0,0,3454
"26163540300",0,0,3068,1469,15,0,0,0,4552
"26163540400",49,2,1277,1334,16,25,16,0,2719
"26163540500",42,0,2373,987,0,0,0,0,3402
"26163540600",15,0,2544,1038,42,0,0,0,3639
"26163540700",32,0,2642,1161,17,16,10,7,3885
"26163540800",16,25,1392,637,12,1,12,0,2095
"26163540900",47,0,2356,875,17,0,0,0,3295
"26163541000",64,85,2149,1790,8,43,9,0,4148
"26163541100",97,142,1162,1289,31,0,0,2,2723
"26163541200",65,30,1044,691,7,8,1,0,1846
"26163541300",386,191,801,1003,99,18,12,0,2510
"26163541400",240,132,1436,766,30,25,0,0,2629
"26163541500",123,29,2686,972,39,12,13,0,3874
"26163541700",52,4,1110,872,59,0,5,0,2102
"26163541800",361,68,1326,670,114,36,19,10,2604
"26163542100",74,16,2491,1348,72,38,88,0,4127
"26163542200",1,1,2087,1149,126,153,54,154,3725
"26163542300",32,9,844,920,8,0,0,0,1813
"26163542400",39,12,1505,620,16,18,0,0,2210
"26163542500",61,5,1971,831,21,0,20,0,2909
"26163542600",0,0,1987,1140,10,21,0,0,3158
"26163542700",12,60,569,378,8,4,6,3,1040
"26163542800",154,66,1858,241,34,32,0,10,2395
"26163542900",93,0,2721,254,112,0,18,0,3198
"26163543000",91,15,1643,568,59,0,67,0,2443
"26163543100",296,67,1743,422,85,0,0,0,2613
"26163543200",60,35,2006,912,100,41,12,25,3191
"26163543400",64,4,2013,875,181,41,0,41,3219
"26163543500",88,25,503,916,0,6,9,6,1553
"26163543600",54,64,395,650,15,16,5,0,1199
"26163543700",135,12,988,1185,117,40,0,40,2517
"26163543800",67,203,313,211,10,150,14,140,1108
"26163543900",36,32,466,195,5,16,0,1,751
"26163544000",179,27,1403,816,0,2,0,0,2427
"26163544100",166,5,1156,451,16,0,0,0,1794
"26163544200",243,318,988,782,85,0,11,131,2558
"26163544300",369,243,1352,521,22,53,19,8,2587
"26163545100",22,19,622,465,0,0,12,0,1140
"26163545200",12,4,1644,1234,33,0,12,0,2939
"26163545300",24,0,886,661,7,0,0,0,1578
"26163545400",169,19,265,441,0,6,0,27,927
"26163545500",610,414,1618,1290,265,180,175,65,4617
"26163545600",1102,1923,759,491,39,209,262,223,5008
"26163545700",771,651,431,410,96,117,212,269,2957
"26163545800",1005,571,1207,1006,200,592,378,479,5438
"26163545900",191,293,1258,1692,28,48,41,86,3637
"26163546000",144,11,1387,1002,37,10,0,1,2592
"26163546100",274,189,1861,1440,23,121,29,80,4017
"26163546200",622,130,1664,775,59,149,17,129,3545
"26163546300",410,45,1232,161,55,0,0,0,1903
"26163546400",46,0,560,667,0,0,0,0,1273
"26163546500",17,0,1412,666,107,6,6,11,2225
"26163546600",94,30,924,1186,50,4,59,0,2347
"26163546700",125,25,1720,884,0,175,0,0,2929
"26163546800",62,101,1381,2355,0,35,0,25,3959
"26163546900",4,11,732,301,0,18,0,0,1066
"26163550100",3495,101,420,50,108,0,60,0,4234
"26163550200",2788,252,522,112,279,0,204,18,4175
"26163550300",2930,180,53,0,53,0,58,0,3274
"26163550400",1258,70,32,0,160,5,34,0,1559
"26163550500",3452,72,19,0,192,0,90,0,3825
"26163550600",2127,50,0,0,52,6,89,0,2324
"26163550700",5039,275,191,13,62,0,83,0,5663
"26163550800",1306,3,39,6,112,0,26,0,1492
"26163550900",2689,31,31,0,123,10,45,0,2929
"26163551100",4238,132,40,1,193,1,69,16,4690
"26163551200",3120,224,399,0,213,7,42,50,4055
"26163551300",1768,195,1351,142,155,9,14,0,3634
"26163551400",1615,108,1836,358,306,85,161,0,4469
"26163551500",991,73,1193,126,61,27,189,0,2660
"26163551600",711,69,1781,655,94,0,4,0,3314
"26163551700",3278,51,22,0,158,1,17,0,3527
"26163551800",3143,200,208,107,101,0,26,0,3785
"26163552000",966,482,11,59,934,298,4,29,2783
"26163552100",1196,936,395,678,742,739,7,0,4693
"26163552200",1824,739,194,114,652,190,65,0,3778
"26163552300",828,1104,93,181,597,359,34,29,3225
"26163552400",417,609,237,134,526,523,4,4,2454
"26163552800",1331,1565,74,473,188,885,0,8,4524
"26163553000",4,5,612,650,4,4,0,4,1283
"26163553100",90,39,657,605,81,59,0,0,1531
"26163553200",1,82,340,268,0,0,0,0,691
"26163553300",2,4,352,369,64,6,0,0,797
"26163553400",0,1,522,1660,131,13,0,0,2327
"26163553600",62,55,1459,810,27,28,0,36,2477
"26163553800",10,52,1087,643,11,0,16,0,1819
"26163554100",1894,374,1146,412,226,0,53,24,4129
"26163554200",1796,165,639,44,130,0,170,22,2966
"26163554300",3884,261,562,429,144,122,87,8,5497
"26163554400",1377,226,851,338,128,18,120,18,3076
"26163554500",1876,240,511,176,232,0,54,0,3089
"26163554600",2886,289,191,223,45,66,76,13,3789
"26163554700",1818,102,482,2,79,66,184,10,2743
"26163554800",1270,379,1421,407,118,0,150,0,3745
"26163554900",1600,215,1228,397,78,47,45,0,3610
"26163555100",2520,368,722,487,155,160,95,114,4621
"26163555300",1368,209,1277,145,97,0,58,0,3154
"26163555400",344,231,1757,366,43,12,20,34,2807
"26163555500",1087,290,1000,320,15,121,20,0,2853
"26163555600",1667,52,724,37,127,0,16,0,2623
"26163556100",2956,204,153,39,39,32,104,0,3527
"26163556200",1761,370,278,73,136,46,20,0,2684
"26163556300",2217,223,253,9,318,60,86,0,3166
"26163556400",3803,86,48,0,350,8,45,13,4353
"26163556500",1665,118,98,52,113,0,19,0,2065
"26163556600",3209,198,0,2,171,0,12,0,3592
"26163556700",2285,134,58,0,43,0,61,19,2600
"26163556800",1718,52,0,1,49,14,55,0,1889
"26163556900",3177,94,118,2,413,0,197,0,4001
"26163557000",2162,374,439,52,96,0,17,6,3146
"26163557100",2045,59,89,14,167,0,0,0,2374
"26163557200",1696,145,31,49,99,10,67,13,2110
"26163557300",1972,73,12,7,56,13,53,0,2186
"26163557400",3132,39,0,0,135,0,61,0,3367
"26163557500",3515,139,0,3,59,16,87,0,3819
"26163557600",2999,23,39,5,58,0,27,0,3151
"26163557700",4272,89,5,2,102,1,50,0,4521
"26163557900",4122,190,27,8,193,8,51,24,4623
"26163558000",3820,168,63,1,131,1,102,0,4286
"26163558100",3141,141,11,13,91,92,8,0,3497
"26163558200",3522,222,328,53,98,8,77,0,4308
"26163558300",1455,278,69,25,52,5,70,0,1954
"26163558400",3384,346,135,36,144,0,85,0,4130
"26163558500",3676,169,16,4,48,44,42,28,4027
"26163558600",1689,108,19,52,57,0,55,0,1980
"26163558700",2639,44,7,1,22,0,51,0,2764
"26163558800",2339,106,28,1,159,1,68,1,2703
"26163558900",1639,80,5,3,108,11,72,0,1918
"26163559000",2322,160,126,0,170,12,21,0,2811
"26163559100",2099,11,42,2,293,0,180,0,2627
"26163559200",1783,138,11,4,70,3,133,0,2142
"26163560100",2298,192,0,6,123,45,11,5,2680
"26163560200",3696,366,192,1,1153,26,145,19,5598
"26163560300",2504,73,192,0,372,0,50,0,3191
"26163560400",5202,217,253,0,305,0,187,0,6164
"26163561200",3909,44,147,3,2063,0,332,16,6514
"26163561300",6428,165,150,9,1216,0,449,0,8417
"26163561600",3527,211,23,1,172,71,127,24,4156
"26163561700",1606,155,120,2,196,48,92,20,2239
"26163561900",6209,143,38,16,529,0,129,0,7064
"26163562300",1717,60,60,0,178,30,35,0,2080
"26163562400",4938,137,40,4,176,0,36,0,5331
"26163562500",1415,176,49,57,159,42,20,77,1995
"26163562600",3241,95,0,38,159,10,38,0,3581
"26163562700",3172,86,8,6,68,7,67,0,3414
"26163562800",2780,96,125,4,103,0,8,0,3116
"26163562900",3046,230,94,12,112,71,61,0,3626
"26163563200",1455,115,802,79,346,91,20,0,2908
"26163563300",2305,54,411,9,112,52,79,0,3022
"26163563400",4251,227,302,29,379,27,138,0,5353
"26163563500",5343,88,10,2,774,51,124,0,6392
"26163563600",1627,31,50,0,342,12,40,6,2108
"26163563700",1320,49,64,0,174,0,37,0,1644
"26163563800",2428,139,92,25,284,0,50,0,3018
"26163563900",1651,110,120,18,469,0,16,7,2391
"26163564000",957,63,146,58,420,5,18,0,1667
"26163564100",2349,203,346,1,1032,118,147,0,4196
"26163564200",2659,66,320,103,543,164,143,0,3998
"26163564300",1833,1,201,11,346,86,122,0,2600
"26163564401",4136,118,9,0,946,29,153,0,5391
"26163564402",2517,73,448,12,1415,72,83,0,4620
"26163564501",3345,34,462,0,850,0,66,0,4757
"26163564502",2311,117,307,9,713,56,54,0,3567
"26163564503",1976,53,722,10,495,0,272,0,3528
"26163564504",4457,256,585,58,995,127,209,40,6727
"26163564600",4567,166,307,2,1925,0,201,0,7168
"26163564700",2517,181,601,218,1093,107,55,0,4772
"26163564800",3269,110,489,42,803,51,210,0,4974
"26163564900",1437,503,255,115,52,62,44,30,2498
"26163565000",2606,22,285,34,1276,198,87,0,4508
"26163565100",1841,280,499,305,379,86,33,59,3482
"26163565200",3001,295,868,130,847,0,16,0,5157
"26163565300",1689,228,2524,288,407,177,0,95,5408
"26163565600",1868,238,134,0,42,0,11,0,2293
"26163565700",2441,326,480,56,370,74,72,0,3819
"26163565800",2814,298,282,63,158,0,111,0,3726
"26163565900",1928,523,128,55,38,24,60,10,2766
"26163566400",468,140,314,127,5,0,13,0,1067
"26163566500",1316,419,200,156,40,99,36,0,2266
"26163566600",1388,138,355,89,73,11,27,0,2081
"26163566700",2957,936,9,101,53,0,69,50,4175
"26163566800",2080,299,97,69,113,70,48,14,2790
"26163566900",2990,676,541,519,184,52,29,67,5058
"26163567000",982,450,1416,172,214,0,59,69,3362
"26163567100",2492,462,424,212,97,0,110,78,3875
"26163567201",2532,446,26,10,469,40,229,40,3792
"26163567202",2132,263,324,117,31,199,54,37,3157
"26163567300",3596,452,279,47,161,10,124,0,4669
"26163567400",2579,80,231,16,25,8,23,0,2962
"26163567800",3343,234,807,209,568,0,46,0,5207
"26163567900",2399,167,281,16,96,17,62,0,3038
"26163568000",1766,282,9,22,47,83,10,110,2329
"26163568200",3074,240,252,2,171,7,15,23,3784
"26163568300",2020,730,579,284,152,0,84,51,3900
"26163568400",2412,419,235,79,159,38,161,18,3521
"26163568500",1548,1504,503,577,206,60,134,39,4571
"26163568700",2375,203,605,92,133,13,129,0,3550
"26163568800",886,207,900,665,271,26,26,12,2993
"26163568900",1834,284,126,23,347,12,71,19,2716
"26163569100",2288,110,0,0,55,71,110,0,2634
"26163569200",2296,452,68,15,26,54,65,44,3020
"26163569300",2720,308,126,0,146,9,183,39,3531
"26163569400",2264,171,55,24,59,1,55,18,2647
"26163569500",2585,156,57,3,32,0,21,0,2854
"26163569600",3119,288,23,2,10,0,81,1,3524
"26163569700",3553,467,35,17,137,20,182,65,4476
"26163569800",2093,316,61,5,156,7,13,15,2666
"26163569900",1900,437,104,13,137,0,50,0,2641
"26163570100",1378,256,1783,383,172,0,163,0,4135
"26163570200",816,146,1116,432,94,5,54,6,2669
"26163570400",789,354,1657,1561,8,177,0,56,4602
"26163570500",466,183,1933,1010,125,91,32,0,3840
"26163570600",16,158,875,1108,19,56,12,0,2244
"26163570800",49,75,1680,942,128,39,80,15,3008
"26163570900",137,83,1506,457,132,12,3,0,2330
"26163571000",140,79,982,921,69,100,11,8,2310
"26163571500",2609,1269,525,81,177,12,37,13,4723
"26163571600",1132,310,56,65,189,71,21,5,1849
"26163571700",1078,461,473,205,121,93,53,5,2489
"26163571800",2046,525,351,78,191,2,132,2,3327
"26163571900",1978,254,303,62,180,58,70,0,2905
"26163572000",1314,294,13,0,76,0,14,0,1711
"26163572100",4427,1346,1,22,464,138,291,1,6690
"26163572200",4215,782,648,4,256,108,167,0,6180
"26163572400",612,301,64,52,58,60,54,15,1216
"26163572500",1214,244,52,19,61,0,85,16,1691
"26163572600",2973,508,224,521,324,3,235,63,4851
"26163572700",3183,365,78,11,392,109,346,53,4537
"26163572800",4227,924,121,7,263,38,239,166,5985
"26163572900",1657,643,36,17,127,0,115,0,2595
"26163573000",2812,408,42,16,80,0,139,0,3497
"26163573100",2655,672,370,90,329,6,23,0,4145
"26163573300",2178,1663,7,60,112,79,90,0,4189
"26163573400",2037,1334,218,35,85,75,80,7,3871
"26163573500",2218,1712,0,89,530,210,6,0,4765
"26163573600",2839,3146,41,10,228,206,122,127,6719
"26163573701",1558,572,26,0,0,35,21,35,2247
"26163573702",2678,3367,54,0,135,32,25,0,6291
"26163573800",2165,2137,68,66,90,243,58,6,4833
"26163573900",2354,2645,20,65,244,344,0,22,5694
"26163574000",2346,2202,20,8,261,92,65,52,5046
"26163574100",2364,1569,59,19,179,85,51,121,4447
"26163574202",1730,137,523,14,237,60,95,0,2796
"26163574300",1431,1155,398,136,391,6,71,26,3614
"26163574600",4231,284,250,12,63,11,205,9,5065
"26163574700",3870,431,2,26,184,0,264,31,4808
"26163574800",3863,238,0,0,128,12,40,0,4281
"26163574900",1469,91,46,30,14,0,16,0,1666
"26163575000",3694,252,52,27,76,13,192,0,4306
"26163575100",1801,372,192,0,171,30,87,30,2683
"26163575200",3048,222,297,31,264,7,230,0,4099
"26163575300",3008,421,17,0,241,0,146,0,3833
"26163575400",2789,250,52,0,116,0,196,0,3403
"26163575500",3104,302,107,35,106,11,136,20,3821
"26163575600",1095,126,45,0,100,85,163,85,1699
"26163576000",1496,122,56,10,160,72,265,80,2261
"26163576100",5254,197,95,125,238,88,728,65,6790
"26163576200",1906,230,0,0,83,0,218,55,2492
"26163576300",2008,206,41,3,82,0,141,20,2501
"26163576400",3133,265,34,0,90,13,166,0,3701
"26163576500",3544,221,0,3,28,0,217,28,4041
"26163576600",3889,131,46,48,115,0,558,59,4846
"26163576700",3087,114,61,1,132,25,132,25,3577
"26163577000",1781,565,460,423,672,168,737,169,4975
"26163577100",1609,836,143,36,313,0,539,199,3675
"26163577200",2392,656,129,133,282,28,757,39,4416
"26163577300",2238,448,37,9,212,138,358,101,3541
"26163577400",2520,536,71,28,298,26,571,50,4100
"26163577500",2326,573,53,0,309,96,373,262,3992
"26163577600",2489,724,97,0,236,39,437,16,4038
"26163577700",1840,209,16,13,79,0,269,7,2433
"26163577800",3764,705,8,111,175,25,673,210,5671
"26163577900",2775,417,330,0,100,111,286,119,4138
"26163578000",1959,255,72,96,41,25,368,0,2816
"26163578500",2675,837,669,114,289,420,549,236,5789
"26163578600",2991,1148,765,101,277,224,509,222,6237
"26163579100",865,269,222,168,33,35,257,69,1918
"26163579200",1526,417,466,542,280,168,514,45,3958
"26163579300",2,0,1105,1567,0,8,0,24,2706
"26163579500",460,512,251,260,302,114,329,86,2314
"26163579600",133,2,1951,827,7,27,7,0,2954
"26163579700",1666,429,352,123,92,147,536,88,3433
"26163579800",690,468,215,125,59,22,134,40,1753
"26163579900",3114,677,258,49,321,48,101,9,4577
"26163580100",1611,152,38,26,15,0,105,0,1947
"26163580200",2282,287,0,7,132,0,154,0,2862
"26163580300",2852,166,0,0,17,9,192,8,3244
"26163580400",2134,221,0,0,71,0,149,0,2575
"26163580500",3011,93,1,4,69,0,112,0,3290
"26163580600",2532,370,0,22,107,118,222,145,3516
"26163580700",2755,803,18,19,146,10,108,0,3859
"26163580800",1176,165,60,25,30,0,1,10,1467
"26163580900",3238,279,61,0,188,26,137,26,3955
"26163581100",2609,259,273,149,222,19,116,38,3685
"26163581200",2838,242,165,21,147,123,202,36,3774
"26163581500",2005,125,13,0,89,24,85,4,2345
"26163581600",4073,501,263,82,761,174,348,59,6261
"26163581800",2117,420,0,0,108,0,166,0,2811
"26163581900",4212,378,21,24,94,0,252,5,4986
"26163582000",2094,283,378,175,104,4,104,0,3142
"26163582100",3349,267,18,2,173,0,149,0,3958
"26163583000",1614,710,154,70,52,67,47,82,2796
"26163583100",3036,774,47,32,207,0,144,0,4240
"26163583200",1671,681,31,19,176,0,284,0,2862
"26163583300",1839,396,53,171,275,8,208,44,2994
"26163583400",3897,528,71,125,113,18,230,91,5073
"26163583500",2108,260,130,0,78,0,56,0,2632
"26163583600",2119,430,1,2,204,0,204,0,2960
"26163583700",3007,401,134,209,213,0,486,11,4461
"26163583800",3480,391,484,21,252,32,173,45,4878
"26163583900",2140,469,650,326,76,63,96,36,3856
"26163584000",2542,456,625,313,174,94,40,88,4332
"26163584100",1507,93,22,1,47,11,59,0,1740
"26163584200",1748,213,407,353,230,105,7,60,3123
"26163584300",1089,161,437,80,51,59,111,17,2005
"26163584400",1950,207,405,77,181,1,141,10,2972
"26163584500",1877,200,319,30,284,8,254,108,3080
"26163584600",889,295,342,255,69,155,39,22,2066
"26163584700",1973,132,13,12,312,51,264,75,2832
"26163584800",938,731,845,2774,169,289,114,91,5951
"26163585500",963,592,195,18,114,21,36,6,1945
"26163585600",259,185,2006,565,146,90,67,0,3318
"26163585700",669,60,841,115,140,31,114,0,1970
"26163585800",1668,744,1611,428,245,58,48,100,4902
"26163585900",1237,481,658,116,145,57,45,0,2739
"26163586200",2568,300,2693,693,599,71,41,0,6965
"26163586300",1666,147,40,6,83,13,0,6,1961
"26163587000",3086,589,216,48,62,0,217,7,4225
"26163587900",2636,571,2508,114,441,62,84,30,6446
"26163588000",3199,531,1876,258,121,58,142,3,6188
"26163588100",1601,510,198,5,180,7,34,0,2535
"26163588200",1309,235,988,212,226,15,47,28,3060
"26163588300",3815,344,712,23,299,0,20,0,5213
"26163588400",3319,148,1110,90,320,0,71,0,5058
"26163589300",2936,517,260,21,140,17,85,93,4069
"26163589400",3495,1223,371,207,75,68,22,242,5703
"26163590400",5950,551,175,17,85,55,93,42,6968
"26163590500",5194,688,115,118,349,113,84,35,6696
"26163590600",2121,64,16,20,49,8,49,8,2335
"26163591501",1891,140,258,212,265,162,143,0,3071
"26163591502",2017,161,187,103,465,0,60,0,2993
"26163591600",1644,81,71,11,226,0,226,5,2264
"26163591700",5612,103,201,64,321,0,767,0,7068
"26163591800",4371,606,350,189,741,76,419,49,6801
"26163591900",4492,518,180,41,174,62,301,13,5781
"26163592000",3806,117,260,1,290,0,190,2,4666
"26163593000",4557,253,120,159,329,57,192,0,5667
"26163593200",3486,84,121,0,143,6,85,6,3931
"26163593300",2716,248,107,0,86,0,137,0,3294
"26163594000",2210,215,0,0,60,9,129,29,2652
"26163594100",4081,113,16,2,83,2,98,0,4395
"26163594200",2418,21,0,0,45,0,37,0,2521
"26163594300",2875,285,35,6,41,0,147,0,3389
"26163594400",2034,433,77,28,57,0,143,32,2804
"26163594500",2605,195,53,128,121,19,100,22,3243
"26163595000",3209,481,32,3,42,5,102,84,3958
"26163595100",4063,711,216,61,197,15,239,198,5700
"26163595200",2160,93,125,159,84,36,65,10,2732
"26163596100",3284,170,0,3,45,5,12,0,3519
"26163596200",3686,68,0,2,276,0,212,0,4244
"26163596300",2515,48,53,4,34,16,96,0,2766
"26163597000",3847,472,53,49,87,19,85,0,4612
"26163598000",2726,299,0,9,193,0,63,0,3290
"26163599000",4162,583,489,166,131,20,132,127,5810
"26163599100",3717,419,54,40,68,20,181,50,4549
"26163985000",0,0,0,0,0,0,0,0,0
"26163985100",15,9,173,27,0,5,0,5,234
"26163985200",0,0,0,0,0,0,0,0,0
"26163985300",5,0,4,0,0,0,0,0,9
"26163985400",0,0,0,0,0,0,0,0,0
"26163985500",0,0,0,0,0,0,0,0,0
"26163985600",0,0,0,0,0,0,0,0,0
"26163985700",0,0,0,0,0,0,0,0,0
"26163985900",0,0,0,0,0,0,0,0,0
"26163990100",0,0,0,0,0,0,0,0,0
"26163990200",0,0,0,0,0,0,0,0,0
"26165380100",3928,883,22,12,138,15,140,24,5162
"26165380200",3643,886,41,13,82,48,21,3,4737
"26165380300",2151,604,0,18,50,22,20,4,2869
"26165380400",3531,547,0,25,50,11,21,26,4211
"26165380500",5451,894,0,0,144,34,148,5,6676
"26165380600",2466,552,0,6,56,109,29,14,3232
"26165380700",2033,584,0,0,28,48,0,37,2730
"26165380800",2674,303,25,17,163,0,67,15,3264
"27001770100",1954,159,12,3,69,24,13,0,2234
"27001770200",1723,211,2,1,113,9,15,0,2074
"27001770300",2618,562,4,3,42,32,10,4,3275
"27001770400",2335,437,11,0,240,63,99,1,3186
"27001790501",1618,206,7,0,21,7,5,2,1866
"27001790502",2838,202,5,1,37,17,17,0,3117
"27003050107",2624,133,12,5,58,0,13,0,2845
"27003050108",4136,389,6,0,276,60,48,0,4915
"27003050109",4713,271,0,0,105,25,0,15,5129
"27003050110",2399,206,0,0,42,0,32,0,2679
"27003050111",3648,86,0,0,76,1,10,12,3833
"27003050114",2586,64,50,0,21,35,13,1,2770
"27003050115",4533,187,84,2,632,11,472,14,5935
"27003050116",4024,257,0,1,95,122,90,122,4711
"27003050208",2817,176,75,0,206,0,64,0,3338
"27003050210",3568,177,0,0,222,0,48,0,4015
"27003050215",3729,137,1,0,256,0,52,0,4175
"27003050216",5412,154,7,1,152,15,193,0,5934
"27003050217",2581,109,0,0,199,0,74,9,2972
"27003050218",3096,66,0,0,77,0,0,0,3239
"27003050219",2550,157,151,0,116,39,33,38,3084
"27003050220",5590,273,217,0,411,198,123,100,6912
"27003050221",6399,212,90,0,256,47,68,0,7072
"27003050222",4694,109,117,14,405,0,109,0,5448
"27003050223",2621,100,0,0,187,0,36,14,2958
"27003050224",2809,54,0,0,103,0,9,0,2975
"27003050225",5908,139,27,0,277,84,106,0,6541
"27003050226",2589,105,13,0,220,40,62,0,3029
"27003050227",3816,169,48,0,440,0,118,0,4591
"27003050228",4261,95,200,0,402,7,285,17,5267
"27003050229",3575,229,8,0,319,78,122,8,4339
"27003050230",2217,12,0,0,145,4,55,0,2433
"27003050232",3570,49,0,0,220,14,41,14,3908
"27003050233",3070,78,0,0,93,0,0,0,3241
"27003050234",2607,98,47,0,156,0,164,1,3073
"27003050235",2446,273,0,0,143,53,51,34,3000
"27003050236",3975,81,61,0,90,75,38,75,4395
"27003050237",4776,349,7,56,154,53,0,34,5429
"27003050401",2175,289,105,18,104,18,81,0,2790
"27003050402",2688,371,179,9,196,23,28,3,3497
"27003050501",2322,260,19,120,218,179,241,129,3488
"27003050504",2082,162,90,8,146,62,71,68,2689
"27003050505",3574,550,275,160,305,30,225,5,5124
"27003050602",1675,342,323,17,175,23,12,67,2634
"27003050605",4229,522,95,145,192,72,175,247,5677
"27003050606",1358,280,74,107,67,39,21,0,1946
"27003050607",3572,331,67,83,403,318,186,80,5040
"27003050608",3416,321,197,57,485,44,378,9,4907
"27003050609",3113,90,5,24,109,0,25,0,3366
"27003050610",5657,209,256,0,553,0,377,0,7052
"27003050702",2665,110,25,17,197,12,94,0,3120
"27003050704",4052,237,138,16,257,41,192,0,4933
"27003050706",2449,282,335,64,276,168,134,40,3748
"27003050707",5394,351,296,0,395,0,0,0,6436
"27003050709",1793,125,73,0,280,7,154,0,2432
"27003050710",2760,381,148,11,164,81,51,42,3638
"27003050711",3941,63,303,87,322,3,76,0,4795
"27003050712",3327,217,64,104,329,115,30,0,4186
"27003050805",5164,219,426,0,501,222,0,74,6606
"27003050806",5039,134,370,0,787,38,240,0,6608
"27003050807",2397,465,364,13,521,74,176,49,4059
"27003050808",1776,90,32,28,104,0,29,0,2059
"27003050809",4643,212,90,20,1097,45,331,0,6438
"27003050810",2891,324,260,32,427,24,92,0,4050
"27003050811",2172,165,17,96,345,0,298,0,3093
"27003050813",5238,170,289,32,751,201,319,12,7012
"27003050816",3940,79,189,24,316,19,50,0,4617
"27003050818",4322,110,72,0,606,0,141,25,5276
"27003050819",3011,83,28,0,603,70,42,43,3880
"27003050820",2785,267,18,29,180,15,23,0,3317
"27003050821",3700,69,235,27,852,105,43,0,5031
"27003050901",1438,225,57,10,163,76,20,0,1989
"27003050902",4157,195,39,0,520,0,31,5,4947
"27003051001",1878,240,199,59,239,151,26,74,2866
"27003051002",2728,139,114,8,350,150,259,94,3842
"27003051101",3502,189,312,123,454,0,7,0,4587
"27003051102",2827,290,222,86,704,301,388,336,5154
"27003051103",1906,100,318,490,568,121,158,121,3782
"27003051201",1966,143,478,152,730,123,362,37,3991
"27003051202",1997,301,474,119,245,20,230,2,3388
"27003051203",3958,364,593,80,319,284,231,22,5851
"27003051206",1335,211,357,34,486,4,86,10,2523
"27003051302",2266,206,152,322,713,169,244,145,4217
"27003051304",1489,225,56,151,305,128,300,102,2756
"27003051305",1228,507,261,88,763,93,246,109,3295
"27003051400",2981,169,857,360,702,13,460,12,5554
"27003051501",1629,159,380,597,472,26,281,60,3604
"27003051502",1990,182,311,121,176,59,235,49,3123
"27003051600",4855,252,0,0,97,0,43,0,5247
"27005450100",2523,251,5,1,56,15,16,6,2873
"27005450200",2022,351,0,3,37,22,14,3,2452
"27005450300",4370,227,2,24,249,78,83,10,5043
"27005450400",2110,103,2,9,176,11,39,0,2450
"27005450500",2700,826,26,44,330,220,132,49,4327
"27005450600",2714,510,0,0,222,3,15,32,3496
"27005450700",2918,158,0,0,200,27,22,0,3325
"27005450800",1899,158,4,3,139,38,18,4,2263
"27005450900",2691,182,0,0,96,4,30,1,3004
"27005940000",1752,188,23,1,1177,703,50,39,3933
"27007450100",4792,547,16,4,482,124,30,38,6033
"27007450200",5377,770,47,58,444,125,7,80,6908
"27007450300",3966,305,5,2,186,57,27,7,4555
"27007450400",2162,377,36,0,101,83,25,29,2813
"27007450500",1321,212,0,0,51,4,8,0,1596
"27007450600",2083,729,25,34,638,148,24,51,3732
"27007450701",3096,536,38,8,732,257,25,0,4692
"27007450702",3514,594,33,0,630,467,91,0,5329
"27007940001",96,53,0,12,3385,2264,49,233,6092
"27007940002",1081,63,2,3,662,282,12,52,2157
"27009020100",4949,427,31,12,98,39,59,24,5639
"27009020202",2544,175,1,0,69,0,31,0,2820
"27009020203",2448,81,19,0,73,12,71,0,2704
"27009020205",2933,161,0,0,31,1,42,0,3168
"27009020206",2101,195,55,0,61,4,45,0,2461
"27009020300",3002,102,0,0,8,0,75,6,3193
"27009021101",6157,1640,105,18,104,198,10,171,8403
"27009021102",3385,585,0,39,48,255,121,3,4436
"27009021200",4224,1300,234,364,181,124,32,47,6506
"27011950100",1345,81,0,0,0,19,8,5,1458
"27011950200",1283,240,0,0,15,4,3,0,1545
"27011950300",1616,340,4,0,15,35,12,26,2048
"27013170100",4110,347,131,37,36,6,37,20,4724
"27013170200",4789,459,67,92,154,33,161,102,5857
"27013170300",2481,486,57,22,37,6,144,0,3233
"27013170400",2844,259,22,0,125,9,71,0,3330
"27013170500",3365,500,147,139,248,135,75,0,4609
"27013170600",1306,340,11,8,57,65,20,63,1870
"27013170700",1394,1151,10,43,74,123,76,79,2950
"27013170800",4160,256,19,55,200,58,122,3,4873
"27013170900",2685,250,12,66,40,11,66,33,3163
"27013171000",3293,164,0,0,51,37,18,26,3589
"27013171101",1890,1944,24,253,203,264,62,123,4763
"27013171202",3314,1983,138,123,416,111,0,118,6203
"27013171300",3459,228,2,0,72,12,46,56,3875
"27013171400",3019,441,10,0,78,11,60,44,3663
"27013171500",2441,163,0,10,51,52,40,17,2774
"27013171600",2453,805,186,107,83,81,0,54,3769
"27015960101",1737,161,14,0,42,0,17,0,1971
"27015960102",1126,115,0,0,28,0,53,13,1335
"27015960200",3736,139,4,0,29,1,45,0,3954
"27015960300",2442,379,0,15,77,0,60,67,3040
"27015960400",3897,186,3,0,12,25,8,3,4134
"27015960500",3025,306,17,20,142,60,455,152,4177
"27015960600",2724,205,16,0,46,20,49,9,3069
"27015960700",3124,252,4,2,28,1,14,1,3426
"27017070100",4204,486,0,0,249,373,85,0,5397
"27017070200",3180,563,79,19,171,36,73,0,4121
"27017070300",4907,80,8,31,130,16,35,0,5207
"27017070400",6454,625,24,57,202,103,86,37,7588
"27017070500",4751,1073,28,63,138,177,42,59,6331
"27017070600",2902,345,0,18,41,35,31,26,3398
"27017940000",1282,165,0,11,933,451,19,13,2874
"27019090100",4990,695,0,0,206,15,100,0,6006
"27019090200",3662,123,0,0,150,1,55,0,3991
"27019090301",6757,155,0,0,163,1,165,0,7241
"27019090302",4952,129,66,0,158,15,65,0,5385
"27019090401",4443,98,7,0,106,10,30,0,4694
"27019090402",5621,183,0,0,266,2,81,45,6198
"27019090501",2267,45,5,0,55,0,0,10,2382
"27019090502",2540,192,57,0,447,0,77,170,3483
"27019090503",2472,84,39,0,118,0,71,0,2784
"27019090601",3553,201,0,0,431,29,256,29,4499
"27019090602",2823,54,0,0,20,0,13,0,2910
"27019090701",5645,208,134,0,492,0,96,0,6575
"27019090702",2183,14,7,0,222,0,20,0,2446
"27019090800",7180,278,114,5,560,0,413,68,8618
"27019090900",4944,223,48,0,178,20,215,20,5648
"27019091000",8444,606,338,50,693,169,1325,259,11884
"27019091100",5336,129,191,0,433,5,37,16,6147
"27019091201",4291,195,22,15,194,104,79,20,4920
"27019091202",2491,68,4,0,91,51,90,0,2795
"27021940001",2720,353,0,17,437,530,59,16,4132
"27021940002",682,138,0,0,1242,828,28,58,2976
"27021960100",1478,277,0,16,122,14,24,5,1936
"27021960200",1616,224,0,0,168,297,5,0,2310
"27021960301",844,33,0,0,16,0,3,0,896
"27021960302",1085,78,0,0,13,0,8,0,1184
"27021960600",2521,395,30,6,85,67,12,14,3130
"27021960700",3255,514,6,1,52,16,8,0,3852
"27021960801",3296,226,0,0,40,0,25,2,3589
"27021960802",3617,623,6,0,87,3,142,21,4499
"27023950300",1561,144,2,0,181,29,29,0,1946
"27023950400",1921,161,0,0,21,1,56,1,2161
"27023950500",1824,156,23,0,143,68,65,33,2312
"27023950600",4734,724,0,63,59,108,389,111,6188
"27025110100",3426,209,21,7,84,5,33,4,3789
"27025110200",5363,359,79,27,182,7,42,0,6059
"27025110301",3440,296,0,0,182,0,110,0,4028
"27025110302",5543,322,28,5,105,16,191,15,6225
"27025110401",8264,182,0,13,467,38,160,0,9124
"27025110402",3999,297,0,0,190,9,18,5,4518
"27025110501",3393,198,2,3,132,9,20,13,3770
"27025110502",5956,443,0,13,89,0,127,16,6644
"27025110600",4683,185,70,0,26,1,86,1,5052
"27025110700",3602,225,11,0,85,20,27,0,3970
"27027020100",4017,547,67,36,203,0,229,151,5250
"27027020202",1943,132,14,46,164,68,319,19,2705
"27027020300",1585,596,0,5,131,174,104,52,2647
"27027020400",1142,640,40,53,168,128,72,148,2391
"27027020500",4574,454,40,59,140,13,71,0,5351
"27027020600",3570,415,42,171,113,117,112,2,4542
"27027030102",4260,719,59,0,139,124,86,58,5445
"27027030103",6274,1006,250,26,354,318,439,35,8702
"27027030104",6929,644,22,0,193,30,109,78,8005
"27027030106",1790,176,72,0,47,1,19,6,2111
"27027030107",1630,48,0,0,10,0,20,4,1712
"27027030201",5014,254,23,0,184,34,49,20,5578
"27027030202",4316,168,25,0,168,0,58,0,4735
"27029000100",1926,460,18,4,133,101,6,13,2661
"27029000200",1897,226,0,0,395,263,44,16,2841
"27029000300",2597,359,0,0,178,38,55,0,3227
"27031480100",2512,297,44,0,454,130,78,2,3517
"27031480200",1518,153,0,0,34,8,8,0,1721
"27031990000",0,0,0,0,0,0,0,0,0
"27033270100",2368,221,0,26,223,92,203,7,3140
"27033270200",2112,244,0,5,23,11,71,20,2486
"27033270300",2668,251,0,0,54,374,5,368,3720
"27033270400",1870,545,23,11,83,125,31,112,2800
"27035950100",1775,112,0,0,11,12,4,12,1926
"27035950204",1488,92,1,0,29,2,0,1,1613
"27035950400",4779,504,40,1,58,8,56,13,5459
"27035950501",2473,116,0,0,91,0,9,0,2689
"27035950502",2259,111,3,0,11,0,20,0,2404
"27035950700",4698,943,24,34,184,62,84,33,6062
"27035950800",4132,429,17,11,69,29,26,13,4726
"27035950900",4964,216,0,0,120,0,0,0,5300
"27035951000",3305,414,47,0,73,67,36,0,3942
"27035951100",2992,1081,0,19,65,66,104,51,4378
"27035951200",1847,379,54,36,40,83,23,68,2530
"27035951301",4656,267,0,0,37,0,37,0,4997
"27035951302",4961,951,28,13,160,60,0,103,6276
"27035951400",4709,385,0,0,163,12,54,4,5327
"27035951600",2213,281,0,0,117,17,32,7,2667
"27035951700",2525,212,0,0,37,3,9,0,2786
"27037060101",2477,142,285,16,781,50,616,146,4513
"27037060102",2145,108,23,11,203,0,292,11,2793
"27037060103",2212,31,13,0,205,0,184,0,2645
"27037060104",3501,481,446,46,844,301,476,331,6426
"27037060105",2943,425,280,260,983,225,1490,365,6971
"27037060201",2350,101,44,36,426,6,383,0,3346
"27037060202",2534,375,220,87,141,65,80,49,3551
"27037060301",3086,498,81,188,373,67,748,40,5081
"27037060302",2741,491,8,0,228,93,69,218,3848
"27037060401",1895,61,50,23,184,203,114,183,2713
"27037060402",2616,204,58,170,389,0,182,0,3619
"27037060502",3266,324,104,0,520,187,638,355,5394
"27037060503",3627,347,173,14,553,123,546,95,5478
"27037060505",3471,498,569,131,761,468,556,273,6727
"27037060506",4442,224,219,54,227,27,208,16,5417
"27037060507",2931,199,31,71,236,5,215,33,3721
"27037060508",5161,80,0,0,415,232,232,101,6221
"27037060509",3992,79,216,35,585,316,305,228,5756
"27037060603",4005,143,25,1,257,1,273,0,4705
"27037060604",3331,103,0,0,65,16,90,11,3616
"27037060605",1267,41,89,0,123,0,41,0,1561
"27037060606",2196,155,33,7,250,24,133,24,2822
"27037060709",4091,126,612,29,764,4,200,0,5826
"27037060710",2444,262,198,249,344,129,245,168,4039
"27037060711",2577,570,381,319,277,77,212,0,4413
"27037060713",2530,63,146,59,271,18,221,0,3308
"27037060714",3355,316,172,12,836,29,406,0,5126
"27037060716",2725,342,20,73,719,82,231,66,4258
"27037060717",1584,106,6,23,413,0,92,0,2224
"27037060721",1768,128,119,58,478,59,211,7,2828
"27037060725",2725,135,397,99,311,94,187,8,3956
"27037060726",1608,128,362,41,388,62,156,0,2745
"27037060727",2135,105,136,35,595,67,93,7,3173
"27037060728",3724,142,264,40,482,97,177,93,5019
"27037060729",3318,44,41,0,467,25,76,0,3971
"27037060730",5309,123,146,0,442,187,132,171,6510
"27037060731",3800,191,63,0,392,15,57,0,4518
"27037060732",4686,48,275,131,505,0,43,0,5688
"27037060733",3050,221,228,171,355,18,62,0,4105
"27037060734",3595,70,39,0,563,0,241,0,4508
"27037060735",3496,186,587,107,617,139,405,23,5560
"27037060737",3188,287,456,148,641,166,189,140,5215
"27037060738",2140,130,328,19,417,224,175,263,3696
"27037060739",3549,428,321,107,1317,69,1259,58,7108
"27037060741",5094,336,617,0,604,405,380,95,7531
"27037060742",2977,95,153,8,173,141,27,0,3574
"27037060743",775,225,364,83,112,60,76,113,1808
"27037060744",1151,15,187,0,164,0,136,0,1653
"27037060745",2473,260,475,421,405,152,158,202,4546
"27037060746",2725,309,57,181,66,55,101,209,3703
"27037060747",2691,128,486,226,273,0,163,0,3967
"27037060748",2585,45,350,226,349,0,80,0,3635
"27037060749",1239,36,69,0,176,19,183,5,1727
"27037060750",2681,246,501,107,245,183,63,198,4224
"27037060805",1710,453,214,83,285,455,389,518,4107
"27037060806",5126,94,88,0,287,34,150,0,5779
"27037060811",4094,369,122,15,403,135,50,199,5387
"27037060812",4821,152,357,359,274,24,165,0,6152
"27037060813",3823,317,29,9,492,142,271,30,5113
"27037060814",5502,167,61,0,412,168,327,17,6654
"27037060815",4310,161,53,8,485,52,110,0,5179
"27037060816",5235,107,77,0,414,0,222,0,6055
"27037060817",6999,215,125,0,631,62,203,15,8250
"27037060818",6191,396,59,0,723,273,203,148,7993
"27037060819",5671,492,68,14,500,0,151,132,7028
"27037060820",7412,106,0,0,296,0,56,0,7870
"27037060821",5193,302,281,0,269,201,245,33,6524
"27037060822",1089,164,30,8,26,8,0,0,1325
"27037060823",3250,12,110,0,456,0,16,0,3844
"27037060824",2838,194,162,124,274,10,39,0,3641
"27037060825",6350,91,28,25,397,45,123,0,7059
"27037060826",5889,329,270,111,534,32,252,63,7480
"27037060828",2766,107,327,125,603,85,123,9,4145
"27037060829",2662,61,90,12,314,35,151,6,3331
"27037060902",4442,59,229,0,157,6,22,0,4915
"27037060904",2596,401,0,11,236,37,35,117,3433
"27037060905",4536,133,151,96,355,0,108,0,5379
"27037060906",3167,18,109,9,225,26,144,8,3706
"27037060907",6568,5,13,1,640,11,389,0,7627
"27037061001",3077,123,3,0,119,5,14,0,3341
"27037061003",1157,79,1,1,107,7,5,0,1357
"27037061004",5454,76,316,1,387,23,175,0,6432
"27037061005",2058,161,37,0,228,22,171,9,2686
"27037061007",3967,179,360,0,363,0,52,107,5028
"27037061008",1647,84,250,62,225,37,540,0,2845
"27037061009",4361,126,101,0,773,37,102,0,5500
"27037061102",4001,474,74,83,73,34,91,47,4877
"27037061105",2066,228,18,2,42,120,46,124,2646
"27037061106",2760,160,61,0,40,0,61,0,3082
"27037061107",5503,272,0,0,308,0,358,0,6441
"27037061108",5250,406,24,10,294,18,103,37,6142
"27037061401",2852,103,7,3,101,15,16,0,3097
"27037061402",3372,277,0,0,96,50,48,34,3877
"27037061501",2381,99,0,0,36,0,15,0,2531
"27037061502",2681,73,15,0,64,1,5,0,2839
"27039950100",4345,164,14,1,77,0,147,12,4760
"27039950200",3359,487,0,5,141,13,240,130,4375
"27039950300",1975,324,20,0,77,19,195,86,2696
"27039950400",3215,155,23,40,28,22,60,0,3543
"27039950500",5492,104,5,0,60,8,113,0,5782
"27041450100",2684,328,1,0,23,0,22,17,3075
"27041450200",3278,277,0,0,94,10,50,0,3709
"27041450500",4257,173,26,0,83,0,27,19,4585
"27041450600",4822,754,24,16,130,0,0,0,5746
"27041450701",3946,847,63,10,76,71,45,47,5105
"27041450702",2544,166,0,4,0,20,56,0,2790
"27041450800",3071,473,25,7,49,15,50,49,3739
"27041450900",3259,96,0,0,12,5,23,0,3395
"27041451000",4055,154,11,12,22,0,38,7,4299
"27043460100",1717,146,0,0,25,1,30,10,1929
"27043460200",1902,251,0,0,14,1,133,3,2304
"27043460300",1688,193,2,2,7,12,17,17,1938
"27043460400",2490,516,16,0,103,0,149,143,3417
"27043460500",1931,252,5,0,18,23,59,17,2305
"27043460600",2014,476,0,0,57,5,157,109,2818
"27045960100",3074,316,4,23,19,4,29,6,3475
"27045960200",3952,332,9,0,41,26,45,73,4478
"27045960300",3099,327,4,0,73,27,11,0,3541
"27045960400",2747,400,5,0,15,0,4,3,3174
"27045960500",2493,474,15,8,13,10,33,0,3046
"27045960600",2569,320,8,0,32,13,29,2,2973
"27047180100",2696,142,4,0,84,7,161,16,3110
"27047180200",2308,143,2,2,22,1,30,3,2511
"27047180300",3099,252,8,0,55,11,102,13,3540
"27047180400",2806,184,37,0,33,22,81,37,3200
"27047180500",3363,414,1,10,241,20,244,143,4436
"27047180600",3057,658,15,59,202,9,858,243,5101
"27047180700",2175,162,5,3,50,38,59,21,2513
"27047180800",1721,359,56,110,26,44,177,112,2605
"27047180900",2341,800,0,0,119,53,265,151,3729
"27047181000",2093,176,0,0,74,0,116,0,2459
"27049080101",3183,509,9,29,125,8,18,0,3881
"27049080102",5264,345,0,46,99,19,302,0,6075
"27049080200",5319,891,4,106,345,254,333,134,7386
"27049080300",3511,250,0,1,71,25,17,6,3881
"27049080400",3726,210,19,5,67,3,124,26,4180
"27049080500",3190,138,16,0,69,21,71,15,3520
"27049080600",3713,538,10,47,25,187,2,62,4584
"27049080700",3043,228,0,12,90,14,181,8,3576
"27049080800",3443,529,49,0,97,18,4,15,4155
"27049080900",4811,574,6,42,64,55,106,12,5670
"27051070100",2857,199,0,0,54,2,22,10,3144
"27051070200",2368,324,0,0,75,8,54,11,2840
"27053000101",1471,129,689,151,723,76,280,32,3551
"27053000102",2027,274,873,463,1226,443,173,64,5543
"27053000300",2053,63,478,201,350,35,20,11,3211
"27053000601",3645,476,0,150,329,182,301,143,5226
"27053000603",2395,151,0,0,165,22,71,0,2804
"27053001100",1477,169,36,81,317,57,262,26,2425
"27053001700",1344,202,142,339,191,0,141,42,2401
"27053002200",194,33,299,239,287,366,116,100,1634
"27053002400",1356,286,193,206,173,37,66,84,2401
"27053002700",539,137,1108,397,515,52,209,28,2985
"27053003200",566,29,616,408,114,77,268,0,2078
"27053003300",171,18,752,502,594,511,81,33,2662
"27053003800",1740,1768,129,52,354,225,44,45,4357
"27053005901",837,339,531,831,110,112,32,65,2857
"27053005902",700,715,625,503,140,285,333,631,3932
"27053006800",2521,748,409,133,243,86,329,13,4482
"27053007700",1831,250,511,626,302,222,346,60,4148
"27053007801",317,120,354,336,335,211,301,162,2136
"27053008100",2950,221,24,11,144,29,57,11,3447
"27053008200",1783,686,583,663,579,126,814,55,5289
"27053008300",523,116,324,349,642,307,656,313,3230
"27053008400",854,174,517,157,608,338,855,214,3717
"27053008500",1948,871,504,151,1048,112,1530,490,6654
"27053009500",1429,285,429,184,596,365,734,459,4481
"27053009600",2334,339,383,329,257,28,388,255,4313
"27053010600",2431,61,165,10,160,0,81,0,2908
"27053010700",2185,35,14,8,211,16,78,0,2547
"27053011000",2966,141,216,127,111,38,156,78,3833
"27053011703",3595,68,123,0,170,42,56,15,4069
"27053011704",2723,110,88,11,262,0,161,0,3355
"27053011800",4035,261,265,12,170,0,500,0,5243
"27053011998",3312,136,226,56,413,65,152,0,4360
"27053012001",4439,347,40,1,750,98,396,89,6160
"27053012003",2977,448,391,159,746,570,606,148,6045
"27053012101",1521,214,108,353,633,135,500,144,3608
"27053012102",2155,164,224,66,294,11,132,0,3046
"27053020101",2890,36,42,2,249,0,63,0,3282
"27053020102",1834,67,51,0,199,36,25,0,2212
"27053020200",2746,459,2613,952,1654,121,734,298,9577
"27053020301",1254,134,394,144,405,180,193,31,2735
"27053020302",900,101,441,369,348,127,68,54,2408
"27053020303",1719,55,404,160,928,172,434,24,3896
"27053020304",1220,234,443,161,1087,66,222,154,3587
"27053020400",2047,502,697,573,449,209,51,35,4563
"27053020500",1910,285,318,286,1065,72,597,32,4565
"27053020600",1166,200,36,176,350,121,95,67,2211
"27053020700",3252,303,111,77,302,62,358,43,4508
"27053020801",1372,66,180,184,186,39,141,9,2177
"27053020804",1706,271,412,117,224,62,282,165,3239
"27053020902",1830,147,28,0,56,34,105,7,2207
"27053020903",2650,85,288,37,336,28,450,9,3883
"27053021001",4356,281,416,192,374,0,178,14,5811
"27053021002",1636,107,66,113,85,32,83,0,2122
"27053021100",1324,140,207,115,87,9,35,11,1928
"27053021200",3752,178,321,0,322,91,253,0,4917
"27053021300",2997,442,396,472,195,17,131,13,4663
"27053021400",2304,119,281,199,177,33,41,23,3177
"27053021501",2459,147,503,228,436,40,99,16,3928
"27053021502",1521,310,1160,292,261,215,411,271,4441
"27053021503",3535,201,809,95,377,48,668,160,5893
"27053021504",2514,92,299,198,195,53,35,0,3386
"27053021505",3085,204,468,222,262,87,52,13,4393
"27053021601",3215,89,349,64,397,84,96,0,4294
"27053021602",4294,364,432,438,135,68,117,0,5848
"27053021700",4023,323,244,5,380,49,114,0,5138
"27053021800",1782,74,89,0,195,0,26,0,2166
"27053021900",2825,84,84,8,368,33,155,0,3557
"27053022000",1242,91,51,15,155,0,86,0,1640
"27053022101",1835,104,174,42,543,42,99,23,2862
"27053022102",1935,242,74,87,96,9,184,0,2627
"27053022200",3962,136,85,15,388,16,148,0,4750
"27053022301",1755,42,96,3,128,4,56,0,2084
"27053022302",1824,101,343,288,185,108,89,20,2958
"27053022400",2633,132,8,334,591,75,198,7,3978
"27053022700",3149,151,490,18,421,72,546,0,4847
"27053022801",1852,47,4,0,100,0,19,0,2022
"27053022802",2510,222,93,80,276,1,111,16,3309
"27053022901",4243,295,147,5,172,118,125,32,5137
"27053022902",1653,42,15,0,22,0,61,8,1801
"27053023000",3393,87,372,85,436,46,66,0,4485
"27053023100",1632,49,11,0,146,0,54,0,1892
"27053023200",2410,319,979,464,1600,14,184,114,6084
"27053023300",3826,222,954,43,589,170,647,140,6591
"27053023400",3084,499,646,506,917,430,718,274,7074
"27053023501",3216,147,26,3,147,27,167,0,3733
"27053023502",4850,136,33,40,267,38,53,37,5454
"27053023600",3634,132,0,0,237,0,64,10,4077
"27053023700",3939,140,33,88,252,1,103,0,4556
"27053023801",4604,243,61,11,240,18,119,9,5305
"27053023802",2470,180,11,0,256,0,150,0,3067
"27053023901",3279,45,9,0,218,0,59,0,3610
"27053023902",1707,74,129,6,164,6,14,0,2100
"27053023903",2520,103,128,2,462,56,24,0,3295
"27053024003",3130,30,11,23,1722,55,541,55,5567
"27053024004",2728,207,82,113,1013,38,155,0,4336
"27053024005",1412,133,70,36,201,30,53,0,1935
"27053024006",1648,57,11,0,199,8,28,1,1952
"27053024100",2510,121,200,42,567,22,396,0,3858
"27053024200",2710,126,64,0,173,31,126,0,3230
"27053024300",2441,499,600,27,822,96,604,221,5310
"27053024400",2454,281,421,9,517,16,50,52,3800
"27053024500",1730,55,92,18,290,200,18,140,2543
"27053024600",2732,247,223,89,404,104,190,143,4132
"27053024700",2232,239,174,191,439,67,336,150,3828
"27053024801",1573,206,231,28,307,44,470,159,3018
"27053024802",1698,279,80,32,668,136,999,262,4154
"27053024901",736,9,131,6,88,4,178,6,1158
"27053024902",1432,405,118,118,365,285,361,520,3604
"27053024903",1199,249,338,121,404,88,560,116,3075
"27053025100",1386,125,685,125,397,44,316,34,3112
"27053025201",2962,187,669,298,951,223,1001,214,6505
"27053025205",3559,276,215,288,825,293,427,335,6218
"27053025301",2269,66,91,0,206,9,133,0,2774
"27053025302",2962,248,244,352,368,90,198,33,4495
"27053025401",2405,152,554,79,752,58,585,29,4614
"27053025403",2472,267,297,174,608,134,338,144,4434
"27053025601",1527,195,75,16,463,47,83,0,2406
"27053025603",3270,300,129,16,249,39,130,116,4249
"27053025605",2988,166,169,36,352,0,61,40,3812
"27053025701",5347,359,314,2,758,3,354,0,7137
"27053025702",3138,309,198,158,556,35,435,49,4878
"27053025801",2183,210,145,2,431,52,181,104,3308
"27053025802",1950,45,12,7,268,1,31,6,2320
"27053025803",2261,195,72,21,314,132,54,50,3099
"27053025805",2209,102,182,0,111,34,56,0,2694
"27053025903",5108,292,119,72,607,117,144,87,6546
"27053025905",2924,82,113,0,341,0,38,0,3498
"27053025906",4936,260,377,40,621,18,290,18,6560
"27053025907",4083,17,68,23,429,1,155,0,4776
"27053026005",2867,187,230,76,332,123,79,19,3913
"27053026006",2475,179,103,88,193,1,167,0,3206
"27053026007",3458,305,467,170,337,73,121,20,4951
"27053026013",4172,64,142,1,251,1,12,0,4643
"27053026014",4648,124,81,0,336,1,145,1,5336
"27053026015",4492,238,14,179,535,12,158,0,5628
"27053026016",5684,129,362,50,657,100,304,54,7340
"27053026018",5496,183,40,0,1480,36,253,0,7488
"27053026019",2896,115,250,127,2438,22,601,16,6465
"27053026020",2994,52,609,291,423,38,0,0,4407
"27053026021",3567,89,7,0,607,15,34,9,4328
"27053026022",5455,47,164,0,1118,0,158,0,6942
"27053026101",2674,135,25,25,119,150,40,0,3168
"27053026103",2568,42,0,0,198,0,74,0,2882
"27053026104",2886,29,806,267,343,0,58,0,4389
"27053026201",3100,14,47,0,120,7,59,0,3347
"27053026202",2419,37,11,0,294,11,30,11,2813
"27053026205",2854,184,0,15,186,1,119,9,3368
"27053026206",2928,213,0,0,146,11,84,0,3382
"27053026207",3446,311,57,43,273,122,139,0,4391
"27053026208",2814,100,28,10,146,32,12,1,3143
"27053026301",2956,181,22,0,116,0,35,7,3317
"27053026302",2948,101,28,0,235,8,48,0,3368
"27053026402",4360,300,461,20,627,41,157,35,6001
"27053026403",2460,110,105,21,481,31,55,0,3263
"27053026404",4568,166,31,0,276,2,85,0,5128
"27053026505",3068,116,145,16,157,22,112,1,3637
"27053026507",3577,264,169,189,443,3,237,0,4882
"27053026508",4122,294,134,0,325,56,84,0,5015
"27053026509",4059,131,169,16,281,0,184,7,4847
"27053026510",2975,122,177,0,243,60,129,8,3714
"27053026511",2406,376,337,94,520,3,73,272,4081
"27053026512",4531,364,238,208,427,67,121,7,5963
"27053026514",3621,284,153,1,686,38,333,0,5116
"27053026605",2995,10,18,0,526,0,66,0,3615
"27053026606",4418,129,93,46,279,3,126,0,5094
"27053026609",2610,118,14,0,112,14,0,0,2868
"27053026610",3802,129,64,6,272,29,118,0,4420
"27053026611",3647,90,191,75,278,379,248,0,4908
"27053026612",7511,83,156,123,1659,30,122,0,9684
"27053026613",5309,163,738,0,1525,82,486,0,8303
"27053026702",2121,147,49,20,106,14,23,13,2493
"27053026706",3137,107,4,43,180,4,44,4,3523
"27053026707",4324,70,70,0,272,9,69,0,4814
"27053026708",5206,196,68,54,204,74,119,39,5960
"27053026710",6437,277,442,0,1236,44,154,0,8590
"27053026711",2439,39,24,31,194,1,44,1,2773
"27053026712",2705,103,31,159,141,0,194,0,3333
"27053026713",3718,158,105,94,341,0,88,0,4504
"27053026714",8028,391,359,130,1020,37,313,0,10278
"27053026715",10875,1137,401,139,2107,0,570,0,15229
"27053026716",7397,23,27,2,748,23,0,0,8220
"27053026807",3305,304,1098,318,655,22,252,73,6027
"27053026809",1134,157,2040,470,670,532,634,440,6077
"27053026810",2208,256,1714,528,917,49,524,57,6253
"27053026811",2641,88,1241,570,1406,26,323,0,6295
"27053026812",3187,96,749,242,1568,124,213,0,6179
"27053026814",3650,259,1253,222,1393,0,714,114,7605
"27053026815",2734,80,775,68,1316,173,205,0,5351
"27053026816",2713,312,2130,369,1223,129,277,63,7216
"27053026818",2098,175,1207,376,853,59,387,0,5155
"27053026819",859,455,1759,919,479,212,171,248,5102
"27053026820",7464,203,1536,23,2328,311,279,35,12179
"27053026822",3509,91,438,122,603,0,51,0,4814
"27053026823",2745,34,630,115,950,115,36,0,4625
"27053026903",3387,207,454,30,297,24,257,6,4662
"27053026906",6450,100,496,32,543,0,184,0,7805
"27053026907",4776,132,155,109,333,0,65,8,5578
"27053026908",5196,169,568,1,234,0,97,0,6265
"27053026909",11336,257,85,0,687,1,55,0,12421
"27053026910",4243,331,61,0,204,10,156,9,5014
"27053027001",2986,99,0,0,65,0,10,0,3160
"27053027002",5029,198,100,3,117,13,125,15,5600
"27053027101",5513,158,24,0,256,127,80,112,6270
"27053027102",5042,122,19,0,313,38,320,10,5864
"27053027201",5931,214,59,0,197,73,92,15,6581
"27053027202",1529,104,12,3,46,3,41,0,1738
"27053027203",3218,132,17,35,115,5,18,0,3540
"27053027300",3560,171,274,16,110,21,87,0,4239
"27053027400",3964,93,0,1,132,1,78,0,4269
"27053027501",3943,264,40,6,138,8,105,0,4504
"27053027503",3880,114,30,1,85,11,57,10,4188
"27053027504",3224,72,0,0,64,0,87,0,3447
"27053027601",3373,251,64,21,170,7,169,32,4087
"27053027602",4670,370,0,0,256,53,34,0,5383
"27053027700",8139,532,60,0,431,29,211,29,9431
"27053100200",1789,148,750,417,218,64,267,0,3653
"27053100400",851,238,691,563,495,230,230,55,3353
"27053100500",1385,216,28,242,214,109,87,49,2330
"27053100700",1394,113,362,493,524,0,132,0,3018
"27053100800",996,98,659,717,739,264,9,73,3555
"27053100900",1261,151,789,1107,881,446,308,104,5047
"27053101200",3666,136,78,31,502,16,388,0,4817
"27053101300",338,51,832,165,218,148,238,105,2095
"27053101600",337,259,631,507,491,217,166,43,2651
"27053101800",1789,431,258,571,995,327,901,254,5526
"27053101900",1907,331,245,45,192,84,63,0,2867
"27053102000",431,249,944,138,562,104,43,153,2624
"27053102100",436,67,543,466,486,288,180,0,2466
"27053102300",215,69,434,384,161,125,33,5,1426
"27053102500",1894,294,56,121,333,64,456,34,3252
"27053102600",952,305,173,70,292,114,230,64,2200
"27053102800",397,148,858,854,256,350,0,22,2885
"27053102900",276,61,276,391,379,148,205,60,1796
"27053103000",1090,98,78,31,225,16,82,8,1628
"27053103100",1210,297,273,174,119,69,325,88,2555
"27053103400",306,102,876,1117,305,322,311,375,3714
"27053103600",1699,98,50,16,333,18,139,0,2353
"27053103700",1532,669,36,219,637,142,175,42,3452
"27053103900",326,1240,0,113,241,275,14,79,2288
"27053104000",2793,1963,154,997,1030,348,87,95,7467
"27053104100",976,183,731,709,535,195,320,20,3669
"27053104400",1090,273,101,286,287,135,19,36,2227
"27053104800",989,661,1966,1761,359,555,192,68,6551
"27053104900",765,1918,110,817,456,982,9,240,5297
"27053105100",2268,92,134,0,249,22,43,10,2818
"27053105201",2193,269,79,88,224,136,113,107,3209
"27053105204",1095,438,118,564,167,96,101,37,2616
"27053105400",1569,202,301,356,288,59,68,9,2852
"27053105500",3043,300,114,0,403,0,52,0,3912
"27053105600",2299,517,132,286,503,115,284,156,4292
"27053105700",1330,497,208,432,104,208,141,34,2954
"27053106000",464,240,395,1081,342,508,255,233,3518
"27053106200",957,414,959,961,217,159,34,19,3720
"27053106400",878,115,245,428,101,35,5,21,1828
"27053106500",3652,206,76,0,381,17,108,0,4440
"27053106600",2027,149,10,3,162,10,41,0,2402
"27053106700",3712,467,95,25,245,0,251,0,4795
"27053106900",1205,315,333,108,232,121,317,53,2684
"27053107000",2007,586,266,289,598,318,637,660,5361
"27053107400",926,65,144,62,238,100,218,98,1851
"27053107500",1578,140,64,6,163,11,84,26,2072
"27053107600",2937,157,110,1,510,35,204,28,3982
"27053108000",2980,163,0,13,283,58,104,0,3601
"27053108600",1287,420,324,220,637,125,637,418,4068
"27053108700",1887,222,326,54,874,112,124,56,3655
"27053108800",2093,479,572,229,266,54,163,335,4191
"27053108900",2013,75,30,0,158,0,145,0,2421
"27053109000",1594,59,102,0,60,0,35,0,1850
"27053109100",3794,436,143,20,464,40,53,14,4964
"27053109200",2612,198,16,0,331,0,140,13,3310
"27053109300",2505,284,356,86,693,72,380,45,4421
"27053109400",694,306,413,70,528,298,715,439,3463
"27053109700",1360,143,186,81,423,121,400,142,2856
"27053109800",3565,137,169,119,249,9,138,14,4400
"27053109900",3212,219,36,11,265,0,44,0,3787
"27053110000",625,190,240,319,461,106,442,168,2551
"27053110100",2024,88,198,36,459,0,395,26,3226
"27053110200",2682,154,73,32,484,163,222,95,3905
"27053110400",2037,267,244,102,194,120,41,74,3079
"27053110500",3900,398,93,9,233,0,79,220,4932
"27053110800",3534,209,144,26,505,120,191,15,4744
"27053110900",2060,70,697,80,535,9,325,0,3776
"27053111100",2793,121,88,10,249,9,133,0,3403
"27053111200",2885,60,32,0,121,0,24,0,3122
"27053111300",4215,79,201,27,265,77,137,0,5001
"27053111400",3458,182,35,0,266,0,27,0,3968
"27053111500",4171,137,385,1,376,19,54,0,5143
"27053111600",2861,58,174,20,153,1,58,0,3325
"27053122500",2502,178,136,221,418,58,68,0,3581
"27053122600",1914,43,59,77,108,21,48,15,2285
"27053125500",2486,165,231,311,301,185,55,134,3868
"27053125600",1693,329,23,0,325,186,68,0,2624
"27053125700",586,201,807,800,926,584,134,70,4108
"27053125800",1812,408,765,683,929,193,1211,352,6353
"27053125900",1171,503,681,622,888,794,962,662,6283
"27053126000",1075,349,930,1826,567,276,744,186,5953
"27053126100",3019,435,270,383,953,140,203,0,5403
"27053126200",3086,466,81,368,211,59,58,80,4409
"27053980000",150,102,32,7,16,59,72,139,577
"27055020100",4932,672,0,0,103,0,19,52,5778
"27055020200",3209,224,0,5,59,71,22,6,3596
"27055020300",2209,265,2,17,73,0,5,5,2576
"27055020500",2568,363,3,0,52,56,25,0,3067
"27055020900",3258,349,5,6,42,3,12,3,3678
"27057070100",3747,393,14,3,266,98,69,7,4597
"27057070200",2031,199,9,0,38,2,37,11,2327
"27057070300",1783,237,0,0,121,1,39,6,2187
"27057070400",2335,280,1,0,119,23,93,0,2851
"27057070500",2426,399,0,27,59,8,64,0,2983
"27057070600",2919,449,0,42,138,53,0,0,3601
"27057070700",1973,143,4,0,38,11,24,0,2193
"27059130100",3113,348,0,0,86,0,70,0,3617
"27059130200",2720,493,11,47,110,53,57,0,3491
"27059130301",7581,742,21,52,361,30,144,22,8953
"27059130302",2352,188,4,8,65,10,0,0,2627
"27059130400",3519,149,19,0,150,3,52,0,3892
"27059130501",4843,227,25,9,171,3,48,0,5326
"27059130502",6243,276,0,0,137,53,173,0,6882
"27059130600",3374,108,10,2,114,1,81,10,3700
"27061480100",2128,317,7,7,89,9,46,2,2605
"27061480300",3464,462,5,4,338,119,18,88,4498
"27061480400",3263,252,0,6,110,7,25,3,3666
"27061480500",2051,364,14,0,90,67,16,0,2602
"27061480600",2407,208,3,0,19,8,3,11,2659
"27061480700",4686,249,39,0,181,69,35,0,5259
"27061480801",1994,299,7,0,87,0,25,17,2429
"27061480802",4632,1099,0,0,184,18,0,2,5935
"27061480900",5248,1037,51,0,181,55,30,0,6602
"27061481000",4853,704,11,2,155,194,54,63,6036
"27061940000",1459,192,0,2,576,268,49,30,2576
"27063480100",2179,152,0,0,54,11,15,1,2412
"27063480200",1875,147,0,3,73,45,106,85,2334
"27063480300",2091,178,0,0,45,6,54,5,2379
"27063480400",2512,476,0,0,151,67,39,25,3270
"27065480100",2819,329,8,30,105,24,34,18,3367
"27065480200",3008,573,9,5,48,31,22,46,3742
"27065480300",3028,584,0,0,47,6,38,43,3746
"27065480400",4376,604,10,5,124,51,41,17,5228
"27067770900",2050,337,42,93,113,70,478,63,3246
"27067780100",2283,141,0,0,37,2,18,0,2481
"27067780200",2148,132,0,0,31,0,20,5,2336
"27067780300",3953,149,0,0,97,0,24,2,4225
"27067780400",3512,167,6,7,59,8,84,16,3859
"27067780500",3178,510,162,256,376,219,885,259,5845
"27067780600",4577,214,0,0,146,22,311,55,5325
"27067780700",3242,201,0,0,230,153,481,242,4549
"27067780800",1250,453,42,98,200,137,457,262,2899
"27067781000",3415,523,64,423,688,50,1019,0,6182
"27067781100",2402,278,10,1,70,2,44,45,2852
"27067781200",2487,206,6,1,43,24,37,45,2849
"27069090100",2056,306,1,1,19,4,39,4,2430
"27069090200",1769,162,7,1,28,0,36,0,2003
"27071790100",1479,458,0,8,106,55,0,0,2106
"27071790200",4224,695,0,84,111,69,3,0,5186
"27071790300",2845,182,0,0,172,64,0,0,3263
"27071790500",1822,282,0,0,43,40,2,0,2189
"27073180100",1935,182,4,0,95,28,73,0,2317
"27073180200",1598,136,0,0,15,5,4,6,1764
"27073180300",2603,207,40,0,22,3,29,8,2912
"27075370100",4018,463,0,0,87,28,39,25,4660
"27075370300",1908,221,0,0,59,7,16,0,2211
"27075370400",3037,593,0,5,58,47,52,0,3792
"27075990100",0,0,0,0,0,0,0,0,0
"27077460300",1261,202,2,0,127,16,39,0,1647
"27077460400",2065,143,16,0,58,2,0,0,2284
"27079950100",6276,353,0,0,156,11,96,55,6947
"27079950200",3510,431,0,0,345,8,350,130,4774
"27079950300",4068,401,0,58,122,61,56,47,4813
"27079950400",3134,346,0,0,41,7,58,5,3591
"27079950500",3496,352,12,6,224,53,478,170,4791
"27079950600",3444,313,6,82,67,0,44,0,3956
"27081201001",2582,246,2,0,62,4,42,2,2940
"27081201002",2385,272,16,0,65,2,49,4,2793
"27083360100",3426,236,4,23,71,8,136,56,3960
"27083360200",2988,82,20,4,111,98,76,89,3468
"27083360300",3961,566,251,63,161,35,90,35,5162
"27083360400",3183,553,34,7,236,96,68,125,4302
"27083360500",1947,709,186,83,304,364,363,395,4351
"27083360600",2446,203,2,8,40,27,42,9,2777
"27083360700",1504,281,11,0,210,10,0,0,2016
"27085950100",4801,385,46,0,46,5,6,36,5325
"27085950200",3913,136,0,0,93,6,54,4,4206
"27085950300",5052,376,0,0,69,33,205,33,5768
"27085950400",6516,453,0,28,464,99,210,57,7827
"27085950500",2587,179,0,0,72,14,76,25,2953
"27085950600",4030,314,8,0,132,15,332,66,4897
"27085950700",4559,752,15,0,180,71,512,245,6334
"27087940100",1350,237,6,25,901,426,27,72,3044
"27087940300",934,113,0,0,875,549,35,22,2528
"27089080100",1971,162,1,1,55,1,21,4,2216
"27089080200",2092,187,0,0,38,1,23,3,2344
"27089080300",2019,147,0,7,23,4,196,0,2396
"27089080400",2314,202,11,2,56,20,92,38,2735
"27091790100",2693,228,7,7,16,17,46,22,3036
"27091790200",2235,365,4,0,61,16,22,21,2724
"27091790300",2075,176,8,6,17,2,3,0,2287
"27091790400",1613,124,1,3,23,35,16,22,1837
"27091790500",5517,357,0,0,139,7,106,0,6126
"27091790600",3300,917,0,26,52,0,359,181,4835
"27093560100",4608,265,0,0,57,41,84,19,5074
"27093560200",4211,448,0,0,91,0,28,3,4781
"27093560300",3096,512,15,0,92,0,89,0,3804
"27093560400",2530,440,30,12,10,0,249,171,3442
"27093560500",2944,164,7,0,122,33,25,18,3313
"27093560600",2531,363,26,0,39,4,72,14,3049
"27095170400",4830,438,0,0,122,16,41,20,5467
"27095170500",3411,531,3,0,175,3,82,21,4226
"27095170600",2698,117,6,0,114,2,53,0,2990
"27095170700",4519,578,22,0,250,39,88,63,5559
"27095970100",1595,237,17,3,116,58,15,9,2050
"27095970200",1316,299,39,4,699,333,20,6,2716
"27095970300",2187,333,0,0,36,89,14,15,2674
"27097780100",2592,357,0,0,31,0,62,0,3042
"27097780200",3521,399,0,0,87,22,69,15,4113
"27097780300",5422,494,9,5,182,4,58,37,6211
"27097780400",2349,244,1,0,21,16,8,0,2639
"27097780500",4318,401,0,0,111,19,74,18,4941
"27097780600",4239,783,0,150,132,0,28,0,5332
"27097780700",1960,336,0,0,30,8,9,8,2351
"27097780800",3770,439,1,0,32,10,52,15,4319
"27099000100",1516,271,39,1,27,0,56,17,1927
"27099000200",2330,108,178,0,62,57,97,15,2847
"27099000300",2959,1239,204,132,317,37,451,593,5932
"27099000410",3037,633,76,9,563,0,733,13,5064
"27099000600",2636,154,109,8,150,19,544,51,3671
"27099000800",3180,733,0,0,146,39,376,386,4860
"27099000900",3619,409,127,153,130,44,405,184,5071
"27099001000",3302,361,0,8,46,51,92,107,3967
"27099001200",1696,215,10,6,15,4,23,15,1984
"27099001300",3714,477,15,0,68,12,35,47,4368
"27099001400",2989,167,33,63,35,0,3,7,3297
"27101900100",1849,98,3,0,15,34,17,13,2029
"27101900200",2800,265,8,6,127,33,170,8,3417
"27101900300",2772,327,5,8,36,0,10,55,3213
"27103480100",3254,116,6,0,13,1,30,9,3429
"27103480200",5180,249,5,7,62,16,187,43,5749
"27103480300",3157,801,25,18,159,175,201,210,4746
"27103480400",2621,966,8,170,243,60,107,41,4216
"27103480501",5432,525,215,170,216,68,269,18,6913
"27103480502",3177,121,68,4,19,0,66,0,3455
"27103480600",2911,268,54,42,89,37,111,0,3512
"27105105100",2473,240,12,0,31,47,64,31,2898
"27105105200",2918,277,21,2,65,4,60,30,3377
"27105105300",2003,195,12,0,56,13,106,14,2399
"27105105400",2547,440,274,89,884,291,1866,305,6696
"27105105500",2021,336,101,59,518,550,1080,515,5180
"27105105600",3350,443,149,131,547,203,974,395,6192
"27107960100",2139,266,21,0,117,51,37,14,2645
"27107960200",1563,188,3,3,127,29,108,13,2034
"27107960300",1674,259,4,3,49,47,66,71,2173
"27109000100",802,201,0,72,136,58,110,42,1421
"27109000200",3254,674,137,227,699,14,196,160,5361
"27109000300",2024,270,170,62,165,68,112,123,2994
"27109000400",2675,170,17,0,356,0,125,0,3343
"27109000500",1673,502,133,119,438,140,189,216,3410
"27109000600",3256,569,172,55,380,26,638,8,5104
"27109000901",4070,418,564,355,361,34,687,193,6682
"27109000902",2443,170,179,436,331,0,125,0,3684
"27109000903",2869,189,60,0,43,18,69,0,3248
"27109001000",3595,233,121,232,416,39,188,13,4837
"27109001100",2648,191,0,79,69,0,123,57,3167
"27109001201",3953,141,87,10,514,0,203,0,4908
"27109001202",3115,107,80,0,251,0,123,0,3676
"27109001203",4396,104,90,5,622,0,151,0,5368
"27109001301",3318,302,208,9,794,82,126,0,4839
"27109001302",4173,118,18,0,320,12,136,0,4777
"27109001401",2854,466,331,252,161,125,0,25,4214
"27109001402",9378,436,375,0,1701,89,435,284,12698
"27109001501",2197,170,289,37,295,2,54,14,3058
"27109001502",2211,96,8,0,126,0,137,0,2578
"27109001503",1847,233,20,0,92,0,55,0,2247
"27109001601",3141,298,302,203,393,0,98,0,4435
"27109001602",2751,149,180,0,241,0,287,0,3608
"27109001603",3138,91,13,0,429,0,40,0,3711
"27109001701",2468,557,232,175,566,92,51,23,4164
"27109001702",2849,344,344,479,605,131,121,116,4989
"27109001703",4220,232,83,0,563,0,153,0,5251
"27109001800",4658,175,9,0,84,5,0,0,4931
"27109001900",6528,318,42,7,211,37,76,26,7245
"27109002000",6253,419,13,7,179,0,144,4,7019
"27109002100",5311,496,17,0,120,146,231,0,6321
"27109002200",3670,167,15,0,67,0,32,0,3951
"27109002300",4484,292,23,0,812,0,147,16,5774
"27111960102",2403,120,8,0,40,0,26,0,2597
"27111960103",1889,132,7,0,64,0,16,0,2108
"27111960300",2291,229,34,310,379,64,582,64,3953
"27111960400",2024,148,6,1,13,30,23,11,2256
"27111960500",4303,491,10,0,205,0,229,86,5324
"27111960600",3878,413,35,15,55,6,44,8,4454
"27111960700",2195,213,6,0,52,1,42,0,2509
"27111960800",2794,155,18,0,98,20,25,3,3113
"27111960900",5069,597,2,46,43,27,114,5,5903
"27111961000",3641,410,0,0,47,35,250,19,4402
"27111961100",3740,481,61,15,28,0,41,4,4370
"27111961200",2167,119,4,14,87,23,6,0,2420
"27111961300",3298,497,19,5,23,10,24,3,3879
"27111961400",1997,202,6,0,25,78,11,6,2325
"27111961500",2594,380,4,0,40,2,12,4,3036
"27111961600",1995,180,0,0,31,5,8,8,2227
"27111961700",3018,152,10,7,60,2,22,1,3272
"27113090100",2086,244,18,7,73,12,145,26,2611
"27113090200",2061,298,140,0,112,99,0,0,2710
"27113090300",1863,119,3,0,28,0,16,3,2032
"27113090400",2554,252,0,0,71,21,204,24,3126
"27113090500",3322,201,50,0,166,33,19,22,3813
"27115950100",1922,305,6,0,61,22,26,7,2349
"27115950200",2301,279,1,1,49,3,7,9,2650
"27115950300",2330,361,15,18,77,24,8,8,2841
"27115950400",2847,512,57,9,253,125,97,45,3945
"27115950500",3728,681,24,0,344,179,42,8,5006
"27115950600",3556,427,31,41,206,8,18,43,4330
"27115950700",2716,660,0,2,35,34,0,34,3481
"27115950800",2804,322,0,2,64,0,4,48,3244
"27117460100",1353,113,0,0,9,9,33,21,1538
"27117460200",1252,316,4,92,234,95,109,117,2219
"27117460300",1728,275,9,0,60,23,61,7,2163
"27117460400",1535,115,2,0,14,4,37,0,1707
"27117460500",1743,131,0,0,23,9,49,1,1956
"27119020100",3766,425,138,28,201,109,215,36,4918
"27119020200",923,194,11,18,26,61,54,28,1315
"27119020300",2660,93,0,0,177,0,117,0,3047
"27119020400",1937,69,0,0,8,5,32,0,2051
"27119020500",2483,196,7,24,79,16,59,41,2905
"27119020600",3761,925,0,0,291,104,455,41,5577
"27119020700",1535,333,0,9,230,38,355,122,2622
"27119020800",2061,221,2,0,73,10,58,32,2457
"27119020900",2991,499,0,5,106,33,50,25,3709
"27119021000",2756,505,21,3,153,64,42,14,3558
"27121970100",2061,152,8,2,37,45,13,47,2365
"27121970200",2425,225,5,0,46,3,16,7,2727
"27121970300",2256,161,7,0,46,3,32,0,2505
"27121970400",2770,420,31,0,28,0,2,3,3254
"27123030100",3128,474,134,23,478,194,212,0,4643
"27123030201",4037,254,184,179,206,105,215,24,5204
"27123030202",1327,434,144,26,108,55,16,0,2110
"27123030300",4558,257,106,34,430,73,352,0,5810
"27123030400",2493,782,1027,341,1533,432,495,479,7582
"27123030500",672,257,742,733,1259,1830,382,71,5946
"27123030601",1055,182,417,447,2357,1524,480,282,6744
"27123030602",2577,130,102,68,950,194,95,0,4116
"27123030702",2965,138,198,198,1200,254,133,0,5086
"27123030703",1765,296,178,33,1053,518,178,91,4112
"27123030704",1582,332,492,109,1394,457,436,366,5168
"27123030800",1950,346,572,267,1435,630,453,46,5699
"27123030900",1360,289,170,339,1003,563,478,127,4329
"27123031000",1350,360,54,298,1308,873,323,271,4837
"27123031100",1964,377,167,55,1194,199,48,0,4004
"27123031200",1982,291,250,287,244,50,356,25,3485
"27123031300",467,138,139,613,642,405,105,46,2555
"27123031400",765,170,226,579,675,568,373,105,3461
"27123031500",594,258,321,253,903,265,105,96,2795
"27123031600",1394,285,200,578,1304,902,691,74,5428
"27123031701",972,221,209,171,787,641,273,40,3314
"27123031702",1672,865,442,1035,1529,860,498,799,7700
"27123031801",1673,353,484,401,1215,640,587,299,5652
"27123031802",2031,272,246,281,730,78,441,38,4117
"27123031900",1145,424,160,55,187,278,15,7,2271
"27123032000",1921,356,308,348,314,112,268,26,3653
"27123032100",1426,221,348,130,201,163,97,76,2662
"27123032200",1753,294,291,24,69,0,21,2,2454
"27123032300",2375,80,208,116,177,192,114,40,3302
"27123032400",795,46,873,241,588,206,118,8,2875
"27123032500",864,140,352,681,1102,1037,166,29,4371
"27123032600",747,120,491,353,1439,484,310,113,4057
"27123032700",338,77,333,321,914,670,188,163,3004
"27123033000",412,249,204,149,280,263,166,108,1831
"27123033100",579,188,53,87,224,272,289,90,1782
"27123033200",1549,225,470,81,336,94,119,41,2915
"27123033300",2356,453,77,111,244,17,319,26,3603
"27123033400",756,366,462,611,224,102,146,28,2695
"27123033500",523,218,1270,825,609,188,253,0,3886
"27123033600",23,20,568,630,146,222,7,31,1647
"27123033700",175,161,272,384,209,128,44,126,1499
"27123033800",795,85,423,567,267,18,74,79,2308
"27123033900",702,35,315,302,147,132,57,7,1697
"27123034000",1147,103,140,93,49,53,21,30,1636
"27123034201",1063,392,145,93,281,67,0,0,2041
"27123034202",3581,486,319,322,424,184,213,34,5563
"27123034400",717,117,199,206,430,430,64,96,2259
"27123034500",1282,524,508,313,1242,575,67,226,4737
"27123034601",2048,280,302,324,1172,750,540,220,5636
"27123034602",1654,251,160,270,1336,776,541,112,5100
"27123034701",1732,314,703,377,1215,315,465,128,5249
"27123034702",1763,154,363,256,1200,137,673,80,4626
"27123034900",2014,706,27,4,128,56,90,2,3027
"27123035000",2235,346,53,14,131,18,58,0,2855
"27123035100",1662,257,65,66,149,86,150,30,2465
"27123035200",2862,161,20,15,155,37,138,33,3421
"27123035300",3221,275,46,21,282,21,352,0,4218
"27123035500",1586,231,58,52,78,0,65,0,2070
"27123035700",2511,85,51,0,57,13,169,0,2886
"27123035800",2145,290,99,48,149,44,93,17,2885
"27123035900",398,108,98,13,70,24,43,5,759
"27123036000",1529,162,285,102,115,86,68,18,2365
"27123036100",293,192,109,125,522,358,322,180,2101
"27123036300",2834,177,38,5,52,7,69,9,3191
"27123036400",3072,143,156,30,298,101,85,0,3885
"27123036500",3315,211,75,0,195,0,59,0,3855
"27123036600",3577,115,232,23,311,26,63,11,4358
"27123036700",3591,166,151,64,812,58,720,0,5562
"27123036800",1836,188,87,7,144,50,92,14,2418
"27123036900",1370,205,97,99,82,68,40,68,2029
"27123037000",2188,112,65,2,158,179,311,93,3108
"27123037100",2312,546,278,524,787,502,957,543,6449
"27123037200",2263,603,841,356,1002,829,1213,912,8019
"27123037402",2384,184,574,37,865,89,270,56,4459
"27123037403",2588,66,1811,723,1248,185,356,52,7029
"27123037500",3946,217,492,16,437,26,333,27,5494
"27123037601",3067,170,100,15,424,24,173,9,3982
"27123037602",2614,571,1773,516,114,89,265,184,6126
"27123040100",6527,176,5,5,201,13,137,0,7064
"27123040200",1766,88,0,0,6,0,5,0,1865
"27123040301",1750,79,7,0,125,0,139,42,2142
"27123040302",4550,286,21,0,144,169,83,41,5294
"27123040401",2949,125,94,1,276,1,102,0,3548
"27123040402",4682,238,83,18,280,6,65,19,5391
"27123040502",2266,71,12,33,89,0,15,0,2486
"27123040503",2948,218,137,0,223,21,102,0,3649
"27123040504",3194,208,219,0,617,7,71,7,4323
"27123040601",4898,134,0,7,384,0,118,0,5541
"27123040603",4417,276,207,0,479,11,76,11,5477
"27123040604",5858,416,138,22,1041,103,268,22,7868
"27123040703",5719,304,122,0,922,0,36,24,7127
"27123040704",3979,520,52,96,849,17,211,85,5809
"27123040705",3455,212,102,0,467,0,128,0,4364
"27123040706",4228,63,11,15,496,48,113,26,5000
"27123040707",3929,105,0,0,204,0,80,0,4318
"27123040801",2713,105,0,1,396,17,141,17,3390
"27123040802",0,0,0,0,0,0,0,0,0
"27123040803",3951,238,34,0,219,33,90,0,4565
"27123040901",1725,130,59,34,254,54,29,44,2329
"27123040902",2696,273,202,35,429,354,236,27,4252
"27123041001",2718,346,40,32,143,45,99,144,3567
"27123041002",2380,184,198,60,337,38,178,35,3410
"27123041103",1971,311,407,32,371,38,133,79,3342
"27123041104",2255,152,41,2,335,0,0,0,2785
"27123041105",4209,382,127,13,373,24,70,13,5211
"27123041106",2546,74,392,188,405,20,129,0,3754
"27123041107",3512,511,618,248,968,207,189,25,6278
"27123041200",2458,370,628,163,321,124,314,239,4617
"27123041301",2745,144,227,65,501,78,113,0,3873
"27123041302",2444,82,112,13,331,91,236,2,3311
"27123041400",4073,554,388,184,546,6,223,132,6106
"27123041500",3827,131,244,0,203,101,184,17,4707
"27123041601",4674,237,417,0,812,28,425,26,6619
"27123041602",1830,318,218,25,327,1024,56,238,4036
"27123041700",2419,102,42,68,148,73,53,6,2911
"27123041800",2590,336,250,47,292,144,167,158,3984
"27123041900",2685,148,142,166,249,18,62,18,3488
"27123042001",788,85,60,17,480,116,54,0,1600
"27123042002",1433,278,109,95,484,69,42,126,2636
"27123042101",3749,356,404,8,876,104,371,0,5868
"27123042102",2675,464,323,78,774,200,43,34,4591
"27123042201",892,66,47,22,465,47,130,63,1732
"27123042202",3758,177,219,38,627,570,492,82,5963
"27123042301",2160,147,0,2,511,0,72,0,2892
"27123042302",2982,308,237,0,1049,179,353,125,5233
"27123042401",3970,305,748,338,660,279,256,39,6595
"27123042402",3643,114,257,34,1469,117,226,60,5920
"27123042501",3917,201,267,240,422,330,217,40,5634
"27123042503",2596,26,224,7,383,0,101,0,3337
"27123042504",2553,143,600,0,487,0,162,0,3945
"27123042601",3345,330,279,198,375,175,104,0,4806
"27123042602",1642,252,92,125,158,16,125,53,2463
"27123042700",3715,334,79,29,521,405,346,89,5518
"27123042800",382,124,493,438,348,587,75,37,2484
"27123042900",3099,233,352,112,164,11,105,21,4097
"27123043000",5400,245,33,9,259,0,160,19,6125
"27123980000",0,0,0,0,0,0,0,0,0
"27125010100",1641,196,18,0,71,27,22,39,2014
"27125010200",1778,207,9,0,78,1,56,6,2135
"27127750100",2154,163,6,8,344,111,78,74,2938
"27127750200",2674,291,56,0,115,74,0,0,3210
"27127750300",1590,167,6,0,243,67,32,0,2105
"27127750400",2555,193,7,0,68,0,41,0,2864
"27127750500",2021,273,1,0,217,210,16,18,2756
"27127750600",1505,229,0,5,56,34,99,58,1986
"27129790100",2381,218,0,0,89,28,186,0,2902
"27129790200",1517,186,5,0,21,3,17,0,1749
"27129790300",1741,117,7,0,25,4,84,17,1995
"27129790400",2172,203,0,0,305,40,334,22,3076
"27129790500",2668,394,0,63,46,5,172,97,3445
"27129790600",2043,308,27,0,124,77,137,27,2743
"27131070100",6185,536,10,0,64,4,21,43,6863
"27131070200",4886,262,11,0,85,0,81,8,5333
"27131070300",4276,343,13,0,49,26,254,92,5053
"27131070400",4051,207,4,0,60,6,16,6,4350
"27131070501",1841,95,0,0,178,18,198,13,2343
"27131070503",2773,59,69,29,87,7,34,0,3058
"27131070504",3115,409,35,169,56,24,151,0,3959
"27131070601",2267,465,10,0,603,117,703,68,4233
"27131070602",1749,197,15,0,86,1,97,0,2145
"27131070700",3371,984,19,149,117,0,130,189,4959
"27131070800",5484,621,362,256,422,20,296,180,7641
"27131070901",4264,418,0,310,222,71,869,184,6338
"27131070902",2890,428,31,100,297,138,657,254,4795
"27133570100",2176,139,8,10,14,33,8,1,2389
"27133570200",3185,260,0,0,38,0,36,0,3519
"27133570300",2771,506,9,22,85,97,38,149,3677
"27135970100",3149,374,3,12,487,155,7,20,4207
"27135970200",1940,169,5,0,15,4,7,0,2140
"27135970300",3211,393,5,14,79,27,37,18,3784
"27135970400",3073,313,12,0,88,8,33,7,3534
"27135970500",1641,134,11,34,9,0,20,0,1849
"27137000100",3811,379,0,8,64,11,53,0,4326
"27137000200",3866,269,13,0,190,13,28,0,4379
"27137000300",5032,938,19,145,273,86,205,0,6698
"27137000400",3237,901,0,0,216,102,14,0,4470
"27137000500",2393,371,25,16,250,51,23,10,3139
"27137000600",4209,440,108,0,161,2,9,0,4929
"27137000700",2810,41,18,0,55,0,67,0,2991
"27137000900",2893,671,33,9,232,103,23,15,3979
"27137001000",1635,464,0,0,64,43,28,16,2250
"27137001100",1127,124,10,0,30,7,51,0,1349
"27137001200",695,634,26,86,103,123,28,35,1730
"27137001300",823,828,12,7,138,142,5,0,1955
"27137001400",1502,737,30,129,65,155,65,25,2708
"27137001600",715,436,98,79,50,74,66,30,1548
"27137001700",636,600,3,104,45,76,32,0,1496
"27137001800",1003,471,0,147,70,198,52,44,1985
"27137001900",665,497,0,193,31,192,6,18,1602
"27137002000",936,309,21,18,38,65,10,27,1424
"27137002200",874,78,0,5,19,22,0,3,1001
"27137002300",3697,208,9,6,52,44,0,0,4016
"27137002400",851,94,0,0,52,14,14,0,1025
"27137002600",1350,354,7,2,146,48,14,5,1926
"27137002900",1498,200,0,0,23,11,24,0,1756
"27137003000",1105,122,12,1,70,13,18,11,1352
"27137003300",1827,351,91,37,136,65,16,14,2537
"27137003400",1066,287,13,0,56,10,0,0,1432
"27137003600",1475,157,0,0,25,0,5,0,1662
"27137003700",1259,441,2,69,97,18,29,1,1916
"27137003800",2442,314,3,0,57,58,33,0,2907
"27137010100",2307,254,0,8,94,0,10,0,2673
"27137010200",1568,40,0,0,41,0,0,0,1649
"27137010300",7816,584,108,0,139,59,72,14,8792
"27137010400",3063,289,15,0,95,5,0,0,3467
"27137010500",3403,319,22,0,98,5,87,0,3934
"27137010600",5751,257,24,2,244,22,62,16,6378
"27137011100",6411,327,8,3,202,12,71,3,7037
"27137011200",2342,326,6,23,405,213,27,0,3342
"27137011300",1840,242,2,0,31,13,3,0,2131
"27137011400",2655,258,0,0,40,14,14,2,2983
"27137012100",4172,431,0,0,64,24,21,7,4719
"27137012200",1093,605,0,18,146,9,55,0,1926
"27137012300",1846,499,0,0,115,7,71,1,2539
"27137012400",3093,819,0,90,34,56,74,0,4166
"27137012500",2442,328,1,0,92,56,24,0,2943
"27137012600",4203,531,23,0,43,126,131,0,5057
"27137012700",1961,226,9,3,146,23,12,14,2394
"27137012800",2488,350,0,0,67,7,5,0,2917
"27137013000",1520,433,0,2,57,25,0,0,2037
"27137013100",1561,554,28,29,157,306,0,0,2635
"27137013200",3035,501,0,0,33,139,29,0,3737
"27137013300",2749,624,27,0,116,84,25,0,3625
"27137013400",2635,235,0,0,136,4,9,25,3044
"27137013500",1619,149,8,24,2,2,0,0,1804
"27137013600",1649,187,0,0,12,7,22,0,1877
"27137013800",1327,269,2,0,60,0,0,2,1660
"27137013900",2049,179,0,0,42,5,0,0,2275
"27137014000",1776,152,1,0,29,0,0,0,1958
"27137014100",1299,164,0,1,40,10,0,0,1514
"27137015100",2461,222,0,0,58,19,8,7,2775
"27137015200",3013,178,5,2,139,35,27,12,3411
"27137015300",2719,483,0,2,27,0,0,0,3231
"27137015400",2731,268,0,2,290,19,7,8,3325
"27137015500",2434,423,0,2,601,239,38,16,3753
"27137015600",1373,600,128,397,51,306,67,0,2922
"27137015700",1074,692,0,0,41,36,5,5,1853
"27137015800",2878,770,17,0,107,83,15,26,3896
"27137990100",0,0,0,0,0,0,0,0,0
"27139080100",1296,106,122,18,525,64,168,27,2326
"27139080201",2107,30,150,19,291,0,0,0,2597
"27139080202",3725,38,123,13,885,14,41,0,4839
"27139080203",6210,462,79,167,843,76,363,29,8229
"27139080204",2488,147,87,0,239,54,119,0,3134
"27139080205",7035,277,295,0,662,37,265,0,8571
"27139080301",8532,402,521,49,1924,188,802,189,12607
"27139080302",10274,234,580,181,3309,399,1291,326,16594
"27139080400",2450,414,167,68,391,121,401,148,4160
"27139080500",1591,150,8,57,100,27,36,40,2009
"27139080600",3395,57,224,1,670,111,69,0,4527
"27139080700",2251,171,86,0,454,208,281,249,3700
"27139080800",7540,314,0,0,481,0,382,60,8777
"27139080903",5885,322,184,2,1124,136,134,0,7787
"27139080904",6225,348,27,248,352,169,175,0,7544
"27139080905",4835,123,0,0,223,49,16,0,5246
"27139080906",4419,258,86,0,318,0,112,0,5193
"27139081000",7384,326,171,31,170,1,197,0,8280
"27139081100",10306,311,20,6,259,0,59,28,10989
"27139081200",5537,310,0,0,206,25,186,3,6267
"27139081300",7832,227,77,21,90,160,64,0,8471
"27141030101",10003,680,16,0,333,10,280,31,11353
"27141030102",6982,502,0,0,208,0,44,0,7736
"27141030200",6769,265,5,0,231,0,130,0,7400
"27141030300",5708,238,15,11,88,12,13,12,6097
"27141030402",8442,501,165,0,473,0,861,0,10442
"27141030403",7883,929,181,0,264,0,185,0,9442
"27141030404",7992,272,0,0,467,17,29,0,8777
"27141030502",9800,899,34,15,552,84,48,36,11468
"27141030503",5192,535,84,16,107,115,0,0,6049
"27141030504",4707,121,92,0,194,1,28,0,5143
"27141031500",3757,1203,383,367,86,173,142,64,6175
"27143170198",3879,321,12,2,78,0,128,0,4420
"27143170200",3039,484,9,13,72,25,105,214,3961
"27143170300",2634,221,0,0,83,53,243,70,3304
"27143170400",3359,458,5,7,68,0,304,125,4326
"27145000301",2333,694,45,126,157,78,54,0,3487
"27145000302",2834,2763,621,841,336,391,113,40,7939
"27145000401",3586,844,117,384,241,0,23,37,5232
"27145000402",4670,124,0,0,252,0,47,0,5093
"27145000500",4906,680,421,339,498,197,312,246,7599
"27145000601",2561,323,161,329,345,38,97,70,3924
"27145000602",2402,324,32,14,58,3,40,0,2873
"27145000701",1975,359,34,0,234,144,50,0,2796
"27145000801",2479,407,36,236,78,20,29,32,3317
"27145000901",3433,434,303,432,242,0,139,20,5003
"27145001001",6135,725,0,0,681,194,94,55,7884
"27145010101",6409,199,209,0,285,0,87,0,7189
"27145010102",7692,278,139,0,395,0,235,0,8739
"27145010200",5578,167,0,0,153,0,23,0,5921
"27145010401",3538,229,0,0,19,0,16,2,3804
"27145010402",3461,358,0,0,74,13,62,25,3993
"27145010403",2891,149,0,0,6,0,14,0,3060
"27145010500",3534,276,0,1,15,0,11,0,3837
"27145010600",3150,488,25,0,280,18,617,197,4775
"27145010900",3062,305,47,2,20,0,34,4,3474
"27145011000",3332,327,10,0,80,0,72,0,3821
"27145011100",6562,555,20,0,65,10,45,7,7264
"27145011200",5958,451,14,3,90,25,48,0,6589
"27145011301",4286,1729,81,59,157,71,44,93,6520
"27145011302",6250,605,0,0,30,2,134,152,7173
"27145011304",4291,207,25,0,133,181,114,189,5140
"27145011400",4677,336,65,8,118,38,147,0,5389
"27145011500",5608,578,83,0,145,47,111,229,6801
"27145011600",350,257,25,96,67,59,13,5,872
"27147960100",4087,403,0,9,223,44,341,150,5257
"27147960200",5498,196,0,109,182,21,250,0,6256
"27147960300",4910,378,0,476,367,190,340,158,6819
"27147960400",2766,415,118,83,459,32,655,28,4556
"27147960500",2544,149,14,0,50,3,15,6,2781
"27147960600",2755,463,49,9,175,202,92,166,3911
"27147960700",4708,92,8,0,197,4,204,8,5221
"27147960800",3049,414,0,0,11,29,81,95,3679
"27149480100",2127,135,0,9,12,8,60,17,2368
"27149480200",2910,949,15,0,88,167,43,20,4192
"27149480300",2328,346,44,0,145,113,121,132,3229
"27151960100",2075,224,0,0,70,0,136,24,2529
"27151960200",2579,402,20,100,22,9,88,34,3254
"27151960300",1530,99,7,0,8,0,7,8,1659
"27151960400",1811,269,4,25,80,39,64,22,2314
"27153790100",2531,546,8,2,99,4,24,16,3230
"27153790200",2047,533,4,4,71,8,17,0,2684
"27153790300",2392,552,13,2,85,27,29,30,3130
"27153790400",2830,502,13,0,86,31,15,2,3479
"27153790500",2116,314,0,0,43,3,9,0,2485
"27153790600",2678,532,0,0,443,0,892,271,4816
"27153790700",3409,356,10,5,68,10,8,0,3866
"27153790800",1591,117,0,0,52,0,20,0,1780
"27155460100",1810,125,3,11,37,71,29,28,2114
"27155460200",1055,91,0,0,91,43,4,0,1284
"27157490100",2409,268,6,15,72,29,113,24,2936
"27157490200",2901,194,0,0,39,11,51,0,3196
"27157490300",3762,238,0,0,42,0,161,0,4203
"27157490400",3996,225,10,1,102,36,76,4,4450
"27157490500",3104,249,0,0,106,16,60,0,3535
"27157490600",3067,258,0,4,17,3,31,86,3466
"27159480100",2723,490,18,15,42,43,23,13,3367
"27159480200",4676,605,42,49,125,19,93,8,5617
"27159480300",3554,909,0,0,51,81,19,65,4679
"27161790100",3133,250,40,0,144,0,118,18,3703
"27161790200",2219,210,0,0,35,1,100,1,2566
"27161790300",2726,89,12,0,61,18,44,32,2982
"27161790400",4925,364,140,127,114,0,66,0,5736
"27161790500",2737,396,0,53,19,36,177,247,3665
"27163070103",3946,544,20,26,223,220,66,137,5182
"27163070104",2749,358,0,0,45,13,227,0,3392
"27163070105",3850,129,11,0,88,26,21,0,4125
"27163070106",6285,134,0,0,394,1,194,0,7008
"27163070203",7123,266,227,0,320,177,98,177,8388
"27163070204",5396,257,19,0,183,24,200,45,6124
"27163070205",3533,342,28,0,84,0,84,228,4299
"27163070206",3322,81,4,0,151,3,33,0,3594
"27163070301",1532,73,15,0,31,2,50,8,1711
"27163070303",4564,67,16,130,218,8,30,0,5033
"27163070304",4075,418,24,40,151,61,131,54,4954
"27163070403",3830,50,0,5,82,3,40,0,4010
"27163070404",3304,160,41,0,118,42,15,13,3693
"27163070405",4183,163,0,0,98,25,0,0,4469
"27163070406",3342,301,0,0,87,0,53,71,3854
"27163070501",3267,105,0,1,85,9,46,14,3527
"27163070502",3650,347,10,0,89,8,135,0,4239
"27163070601",5718,126,0,192,416,29,245,7,6733
"27163070602",2379,247,84,44,62,48,25,126,3015
"27163070701",5926,199,11,0,447,0,24,0,6607
"27163070703",2636,317,10,0,133,41,41,0,3178
"27163070704",1965,153,21,6,53,3,10,0,2211
"27163070801",0,0,0,0,0,0,0,0,0
"27163070802",0,0,0,0,0,0,0,0,0
"27163070906",3900,51,386,6,575,16,202,0,5136
"27163070907",3695,387,368,213,464,63,71,0,5261
"27163070909",4288,113,126,34,742,8,168,0,5479
"27163070910",3787,406,120,86,653,41,555,154,5802
"27163070911",3454,200,454,32,560,68,210,43,5021
"27163070912",2048,153,282,13,583,58,76,0,3213
"27163071001",3376,213,280,109,663,0,132,27,4800
"27163071003",2555,387,106,117,259,8,188,32,3652
"27163071006",3245,122,358,0,721,26,348,15,4835
"27163071010",4194,105,245,0,789,0,132,0,5465
"27163071011",2869,56,0,0,149,1,101,16,3192
"27163071012",3689,416,430,56,771,0,147,293,5802
"27163071013",4131,241,130,9,511,9,166,6,5203
"27163071014",3502,43,47,0,507,10,61,0,4170
"27163071015",5092,94,371,35,781,0,292,0,6665
"27163071016",3808,138,120,0,546,0,100,11,4723
"27163071017",5163,180,648,0,1128,66,175,66,7426
"27163071018",11565,308,1322,0,1986,24,504,0,15709
"27163071101",3305,130,13,0,80,0,59,18,3605
"27163071102",4260,143,16,1,231,0,164,1,4816
"27163071206",7652,491,642,17,1652,106,668,11,11239
"27163071207",6187,79,144,28,275,0,230,0,6943
"27163071208",3885,169,141,0,687,143,353,0,5378
"27163071209",5159,179,80,0,539,48,28,52,6085
"27163071300",4421,412,12,0,361,123,123,10,5462
"27163071400",6290,294,12,0,695,1,356,0,7648
"27165950100",3096,286,0,59,128,3,611,21,4204
"27165950200",3721,495,0,0,187,72,1280,363,6118
"27165950300",2405,251,6,1,170,15,131,40,3019
"27167950100",2868,171,5,0,61,0,42,0,3147
"27167950200",2679,425,0,14,93,17,102,0,3330
"27169670100",6486,538,24,2,437,3,372,10,7872
"27169670200",2692,297,0,12,54,31,93,0,3179
"27169670300",4049,417,115,26,88,16,25,4,4740
"27169670400",3649,907,0,92,47,3,39,0,4737
"27169670500",1981,1500,15,56,22,36,0,0,3610
"27169670600",2659,749,27,31,182,28,10,0,3686
"27169670700",3143,536,66,94,62,12,12,18,3943
"27169670800",6625,411,41,0,96,2,69,9,7253
"27169670900",3235,349,12,27,83,1,155,28,3890
"27169671000",3661,729,7,0,580,28,175,219,5399
"27171100100",12547,517,253,0,728,2,102,0,14149
"27171100202",1235,34,0,0,49,0,0,0,1318
"27171100203",4852,527,37,0,299,0,331,4,6050
"27171100204",7996,528,55,0,463,0,442,51,9535
"27171100300",5052,329,63,0,53,4,256,5,5762
"27171100400",4263,375,53,50,120,14,78,8,4961
"27171100500",4155,449,2,2,9,0,22,14,4653
"27171100701",5067,734,0,0,234,56,67,154,6312
"27171100702",6375,788,14,82,234,35,61,49,7638
"27171100703",8456,373,6,0,79,2,80,6,9002
"27171100801",11322,155,356,116,1103,0,270,0,13322
"27171100802",12966,267,34,0,796,0,109,0,14172
"27171100900",6366,627,62,30,309,3,424,3,7824
"27171101000",7885,287,0,0,278,7,52,0,8509
"27171101100",6842,567,4,5,248,8,239,55,7968
"27171101200",3452,333,16,0,265,12,285,0,4363
"27171101300",4429,356,7,7,101,165,90,132,5287
"27173970100",2349,226,5,21,327,149,76,94,3247
"27173970200",2020,313,0,0,27,11,21,7,2399
"27173970300",2128,208,0,0,18,18,16,24,2412
"27173970400",1694,190,3,9,115,30,157,8,2206
"28001000100",3282,368,1022,1168,0,0,0,0,5840
"28001000200",513,166,2150,1018,0,0,14,41,3902
"28001000300",23,23,1567,666,0,24,0,0,2303
"28001000400",9,217,1219,1348,11,0,11,0,2815
"28001000500",1014,171,1435,697,22,68,22,8,3437
"28001000600",930,182,827,402,0,0,0,0,2341
"28001000700",857,76,239,386,0,0,5,40,1603
"28001000800",1079,180,1231,1135,8,43,0,0,3676
"28001000900",2564,291,507,269,179,0,106,0,3916
"28003950100",4546,926,60,0,87,15,45,102,5781
"28003950200",4616,812,1017,590,305,127,352,0,7819
"28003950300",1934,819,142,22,245,60,265,17,3504
"28003950400",4904,480,0,0,80,0,21,0,5485
"28003950500",2966,1226,935,779,31,333,64,203,6537
"28003950600",3139,940,0,39,113,77,0,1,4309
"28003950700",3443,436,291,71,2,0,58,0,4301
"28005950100",2482,304,991,380,5,3,46,3,4214
"28005950200",1701,462,852,684,7,0,0,0,3706
"28005950300",2042,352,1783,665,12,2,0,0,4856
"28007060100",1951,249,737,309,16,29,10,0,3301
"28007060200",1591,185,381,301,0,0,12,0,2470
"28007060300",1025,61,892,841,26,0,26,49,2920
"28007060400",1980,192,673,208,40,0,133,0,3226
"28007060500",1370,298,1229,537,87,29,0,42,3592
"28007060600",1093,422,851,1163,21,84,81,0,3715
"28009950100",2551,268,1792,779,203,13,123,0,5729
"28009950200",1826,479,251,222,2,3,57,0,2840
"28011950100",449,72,1616,1596,2,34,0,60,3829
"28011950200",254,52,1328,1000,22,2,5,0,2663
"28011950300",314,47,1774,996,0,98,25,24,3278
"28011950400",717,159,1466,1289,1,67,0,67,3766
"28011950500",2103,562,1113,1248,28,358,81,334,5827
"28011950600",4359,694,125,0,186,27,38,0,5429
"28011950701",206,54,2133,1940,42,41,54,0,4470
"28011950702",290,98,1641,1466,15,0,0,0,3510
"28013950100",2837,459,259,133,14,110,32,181,4025
"28013950200",651,212,398,236,16,28,16,22,1579
"28013950300",1711,285,770,161,30,32,31,1,3021
"28013950400",1812,623,369,236,217,86,165,199,3707
"28013950500",972,371,646,703,36,88,87,56,2959
"28015950100",3478,485,588,318,89,9,0,26,4993
"28015950200",2284,375,1558,878,47,21,10,0,5173
"28017950100",908,294,1868,966,91,5,65,13,4210
"28017950200",1778,627,717,294,46,2,59,0,3523
"28017950300",1712,506,1253,612,112,7,477,62,4741
"28017950400",3224,310,820,865,52,5,10,0,5286
"28019950100",1974,456,187,39,0,0,0,0,2656
"28019950200",1907,275,726,806,54,21,34,0,3823
"28019950300",807,155,385,384,11,11,5,7,1765
"28021950100",567,49,1395,903,80,0,0,0,2994
"28021950200",121,20,511,805,5,25,0,20,1507
"28021950300",308,17,2101,1866,0,0,36,28,4356
"28023950100",2905,212,567,320,67,0,33,0,4104
"28023950200",3750,653,1115,345,11,0,11,78,5963
"28023950300",915,139,1457,1064,3,0,0,0,3578
"28023950400",1511,356,454,371,48,0,6,0,2746
"28025950100",2568,303,1704,903,0,0,126,0,5604
"28025950200",934,66,896,420,9,7,0,0,2332
"28025950300",705,45,1624,1281,12,0,12,0,3679
"28025950400",1472,254,1668,1308,12,36,21,10,4781
"28025950500",1665,32,1229,627,161,20,19,13,3766
"28027950100",587,51,1615,1412,3,36,9,0,3713
"28027950200",964,233,873,295,124,11,33,0,2533
"28027950300",945,78,1107,997,30,14,30,4,3205
"28027950400",1571,84,1637,261,91,0,0,0,3644
"28027950500",773,171,2524,2036,25,0,0,0,5529
"28027950600",12,0,604,532,0,0,0,0,1148
"28027950700",48,0,2714,2209,35,0,0,0,5006
"28029950100",1525,395,2288,1613,102,167,102,187,6379
"28029950200",2180,608,1019,619,29,9,76,115,4655
"28029950300",1570,255,1372,844,52,13,82,0,4188
"28029950400",657,154,2523,1277,210,20,93,101,5035
"28029950500",3837,372,587,479,163,0,52,0,5490
"28029950600",1194,315,1136,489,0,0,0,0,3134
"28031950100",1982,189,1787,1462,0,39,88,0,5547
"28031950200",630,101,639,354,72,12,0,0,1808
"28031950300",2556,332,994,1039,100,40,164,19,5244
"28031950400",4856,1352,361,242,0,0,143,0,6954
"28033070101",1725,96,682,334,80,39,116,39,3111
"28033070102",2886,67,1030,44,247,0,118,19,4411
"28033070210",2740,547,2273,315,535,41,218,260,6929
"28033070221",2532,340,565,351,102,42,9,97,4038
"28033070222",2568,265,1016,176,68,76,281,74,4524
"28033070310",2083,524,1137,22,26,51,131,264,4238
"28033070322",2038,172,1415,146,96,0,109,0,3976
"28033070323",2432,256,2303,307,321,0,418,33,6070
"28033070324",2286,537,2214,114,102,22,240,23,5538
"28033070325",1715,634,398,36,73,167,239,286,3548
"28033070411",1329,183,93,116,72,6,3,2,1804
"28033070412",2760,217,1052,245,407,63,468,23,5235
"28033070421",1803,127,386,0,212,156,27,147,2858
"28033070422",1657,245,271,168,95,0,84,13,2533
"28033070520",6074,458,2736,99,494,70,369,0,10300
"28033070521",2302,411,454,146,276,94,352,7,4042
"28033070522",2911,167,873,0,94,9,69,0,4123
"28033070610",1249,308,990,415,39,20,13,7,3041
"28033070620",5481,99,854,633,135,0,68,0,7270
"28033070630",8007,136,1423,149,481,60,199,0,10455
"28033070710",4119,103,1523,232,66,0,176,0,6219
"28033070721",2545,111,1284,221,193,0,158,0,4512
"28033070722",4538,196,334,0,178,0,128,0,5374
"28033070811",2771,208,1791,254,548,9,186,0,5767
"28033070812",3726,311,1591,106,189,56,584,78,6641
"28033070821",4121,288,498,9,208,6,53,9,5192
"28033070822",3051,357,1098,117,394,9,617,0,5643
"28033070830",3977,118,1427,79,390,20,602,12,6625
"28033070900",3190,181,683,164,82,16,41,16,4373
"28033071000",8020,421,434,103,350,0,118,0,9446
"28033071110",5961,349,362,0,82,83,150,97,7084
"28033071120",4901,555,571,527,7,31,189,284,7065
"28033071200",2544,429,256,138,70,10,35,10,3492
"28035000200",1442,288,699,276,149,6,41,101,3002
"28035000300",827,262,1709,794,150,47,110,43,3942
"28035000500",237,191,478,410,11,44,56,216,1643
"28035000600",56,22,3455,3104,38,50,0,9,6734
"28035000700",1886,398,426,101,56,15,22,126,3030
"28035000800",2970,1027,830,489,0,12,11,19,5358
"28035000900",275,393,209,557,34,140,45,30,1683
"28035001000",790,1335,923,930,153,176,156,72,4535
"28035001100",662,138,1613,1157,157,25,35,7,3794
"28035010101",4843,420,735,63,105,0,294,35,6495
"28035010102",5476,362,186,3,74,0,33,116,6250
"28035010200",3018,939,2135,600,57,75,20,16,6860
"28035010300",2569,275,504,80,469,29,194,56,4176
"28035010400",2189,497,231,213,201,0,137,21,3489
"28035010500",1190,418,1230,916,59,0,20,129,3962
"28035010600",6078,1786,66,144,22,113,25,158,8392
"28035010700",59,52,606,807,95,0,65,0,1684
"28037950100",3311,527,880,439,2,9,34,9,5211
"28037950200",923,181,1140,308,32,0,0,0,2584
"28039950101",4912,560,124,8,60,6,23,31,5724
"28039950102",3544,810,156,0,173,47,113,11,4854
"28039950200",1544,289,173,331,13,114,24,104,2592
"28039950301",4952,1186,517,91,0,195,0,153,7094
"28039950302",2059,494,172,23,14,0,0,0,2762
"28041950100",3556,447,296,287,39,0,6,0,4631
"28041950200",4195,797,954,33,201,2,23,25,6230
"28043950100",3549,553,1423,687,42,0,0,0,6254
"28043950200",2829,567,1303,124,20,0,0,0,4843
"28043950300",258,159,1570,877,6,0,0,10,2880
"28043950400",257,165,1538,616,0,8,15,0,2599
"28043950500",2892,592,701,375,97,10,0,0,4667
"28045030100",3215,634,369,257,74,60,46,2,4657
"28045030200",3562,1127,742,168,63,50,98,4,5814
"28045030300",5807,2557,1211,384,303,145,290,39,10736
"28045030400",1768,158,318,191,13,34,70,24,2576
"28045030500",7389,684,77,6,179,0,269,176,8780
"28045030601",5017,1930,54,163,369,33,0,33,7599
"28045030602",4464,1165,122,21,397,40,516,61,6786
"28045990000",0,0,0,0,0,0,0,0,0
"28047000100",142,56,0,23,61,52,0,0,334
"28047000300",172,205,635,642,196,180,16,173,2219
"28047000600",901,145,54,14,26,63,18,19,1240
"28047000900",475,53,123,59,50,14,3,0,777
"28047001201",2751,368,375,244,516,75,263,68,4660
"28047001202",3045,701,1128,662,554,31,325,279,6725
"28047001300",1349,251,526,289,340,13,308,7,3083
"28047001400",1360,222,159,151,12,30,81,0,2015
"28047001501",2504,229,585,177,40,0,220,0,3755
"28047001502",3216,540,505,344,356,223,578,60,5822
"28047001600",2942,203,0,0,166,9,66,0,3386
"28047001700",2591,700,1160,704,151,149,65,47,5567
"28047001800",188,200,1000,1098,14,0,73,23,2596
"28047001900",1493,605,645,243,13,0,116,299,3414
"28047002000",1209,486,787,657,94,75,185,78,3571
"28047002300",418,245,769,526,17,71,28,0,2074
"28047002400",438,228,1264,1800,10,113,147,26,4026
"28047002500",1148,75,64,0,75,0,230,46,1638
"28047002600",535,68,1511,1017,71,59,17,0,3278
"28047002700",3920,645,397,407,224,231,71,88,5983
"28047002800",2043,231,131,0,82,17,86,98,2688
"28047002900",1077,30,185,12,107,0,64,12,1487
"28047003000",1610,636,839,269,298,18,0,0,3670
"28047003101",5068,487,472,964,382,29,206,121,7729
"28047003102",5365,1007,576,37,370,8,330,0,7693
"28047003204",1855,373,949,410,11,0,364,0,3962
"28047003205",3783,543,2046,126,90,0,16,0,6604
"28047003206",5183,757,1517,1035,668,87,155,185,9587
"28047003207",2444,610,1486,1056,312,97,210,121,6336
"28047003208",1451,493,904,581,106,198,207,258,4198
"28047003301",5099,804,1507,157,1257,50,549,65,9488
"28047003303",3756,618,669,208,615,312,425,18,6621
"28047003304",2975,189,391,155,435,51,243,0,4439
"28047003402",8129,1436,1044,324,1155,452,251,0,12791
"28047003403",1837,129,0,0,47,16,61,27,2117
"28047003404",4428,388,82,30,135,37,32,0,5132
"28047003501",7019,1278,274,139,307,163,154,0,9334
"28047003502",4827,795,98,28,193,0,56,0,5997
"28047003504",4803,599,639,227,286,13,93,0,6660
"28047003505",4729,704,1257,425,250,10,653,49,8077
"28047003600",264,61,276,158,136,124,87,22,1128
"28047003700",1492,420,306,728,199,100,217,150,3612
"28047003800",816,145,134,53,66,0,81,29,1324
"28047003900",1477,578,417,511,158,173,98,184,3596
"28047980000",0,0,0,0,0,0,0,0,0
"28047990000",0,0,0,0,0,0,0,0,0
"28049000100",2662,203,1596,178,162,8,32,8,4849
"28049000200",3816,240,857,468,0,0,47,0,5428
"28049000301",75,101,1515,874,0,0,0,0,2565
"28049000302",182,244,2612,946,53,7,0,180,4224
"28049000400",935,113,1192,654,77,58,13,59,3101
"28049000500",0,51,4240,2049,12,79,0,0,6431
"28049000600",10,0,2164,1279,9,0,0,0,3462
"28049000700",240,11,3725,2140,0,22,0,0,6138
"28049000800",0,25,1650,2400,6,0,3,0,4084
"28049000900",0,2,1168,699,4,0,0,0,1873
"28049001000",0,0,828,755,4,0,4,0,1591
"28049001100",0,0,820,775,0,0,0,0,1595
"28049001200",0,16,1163,830,22,0,0,6,2037
"28049001300",2107,458,545,332,20,13,21,0,3496
"28049001400",2251,115,153,0,21,0,25,0,2565
"28049001500",2317,331,119,10,79,11,20,0,2887
"28049001600",731,192,1391,507,90,103,57,59,3130
"28049001900",12,0,893,874,18,0,0,0,1797
"28049002000",0,0,604,374,0,0,0,0,978
"28049002100",67,8,1223,1099,0,0,0,0,2397
"28049002200",42,48,1017,1012,0,13,8,0,2140
"28049002300",89,7,1247,1494,0,0,0,3,2840
"28049002400",18,0,2896,1232,19,24,0,0,4189
"28049002500",18,19,1157,909,62,12,0,3,2180
"28049002700",201,113,294,299,3,18,0,18,946
"28049003000",166,81,725,637,6,18,34,0,1667
"28049003200",15,2,719,553,16,0,0,0,1305
"28049003300",646,12,3359,2668,37,92,24,25,6863
"28049003400",137,201,1240,1593,46,11,0,72,3300
"28049003500",250,54,1886,1545,7,8,0,0,3750
"28049003600",264,0,2205,1385,127,0,0,0,3981
"28049003700",439,69,1838,1096,40,0,75,0,3557
"28049003800",556,191,1394,835,29,16,188,0,3209
"28049010101",1974,249,3625,625,311,65,148,36,7033
"28049010102",1667,190,2280,965,35,529,0,698,6364
"28049010201",48,0,2067,1051,72,0,61,0,3299
"28049010202",79,3,4806,1193,12,0,104,0,6197
"28049010203",49,31,1600,1216,8,0,0,0,2904
"28049010301",26,4,2256,906,0,0,0,0,3192
"28049010304",2966,174,2466,189,253,70,188,0,6306
"28049010305",1456,333,1143,465,127,28,112,0,3664
"28049010400",2122,348,704,212,131,127,22,48,3714
"28049010500",2992,373,2891,1259,248,35,115,0,7913
"28049010600",975,177,2813,1128,59,22,40,0,5214
"28049010700",3095,377,1359,141,84,0,0,0,5056
"28049010801",60,30,772,599,73,32,78,28,1672
"28049010804",640,162,439,66,167,18,77,9,1578
"28049010805",2051,59,1087,289,282,131,211,11,4121
"28049010806",1947,303,760,29,303,74,63,10,3489
"28049010807",2365,73,1128,27,29,0,3,8,3633
"28049010808",381,0,3617,609,157,12,0,0,4776
"28049010809",259,39,2443,101,0,0,0,0,2842
"28049010901",188,82,1525,560,44,9,21,2,2431
"28049010902",93,48,1176,433,50,31,51,31,1913
"28049011001",646,390,3393,1897,0,30,0,116,6472
"28049011002",419,40,2790,1479,51,0,0,0,4779
"28049011101",239,89,1945,455,33,0,33,0,2794
"28049011102",2503,298,6726,622,199,0,52,0,10400
"28049011103",1794,216,3729,330,43,0,0,0,6112
"28049011201",1766,17,919,217,30,0,21,0,2970
"28049011202",3869,720,3959,304,47,10,48,38,8995
"28049011300",1739,101,1698,685,17,22,109,22,4393
"28049011400",0,105,536,371,0,2,0,32,1046
"28049011500",54,56,643,820,0,0,0,0,1573
"28051950100",763,102,1891,1683,0,20,6,9,4474
"28051950200",436,130,1413,1641,127,3,0,0,3750
"28051950300",125,80,855,1525,0,4,0,0,2589
"28051950400",477,196,1063,826,0,0,0,0,2562
"28051950500",451,91,2664,1559,0,0,17,14,4796
"28053950100",607,72,882,1031,118,0,114,0,2824
"28053950200",507,125,622,515,10,32,0,40,1851
"28053950300",511,181,2063,1552,19,0,22,57,4405
"28055950100",285,98,323,312,0,1,0,1,1020
"28057950100",3566,918,255,66,62,39,56,110,5072
"28057950200",5392,878,55,11,69,0,45,0,6450
"28057950300",1575,508,220,23,27,26,5,0,2384
"28057950400",3902,840,17,9,28,32,7,26,4861
"28057950500",2593,642,343,215,117,0,84,0,3994
"28059040101",6409,430,415,4,4,17,0,0,7279
"28059040102",5978,848,17,0,157,16,0,16,7032
"28059040201",7112,587,136,143,259,29,27,0,8293
"28059040203",3427,450,289,98,245,55,44,14,4622
"28059040204",5811,509,761,0,372,0,303,0,7756
"28059040300",4419,918,672,255,1267,152,69,84,7836
"28059040400",5858,963,1107,85,368,112,173,0,8666
"28059040500",2835,349,235,51,74,0,118,8,3670
"28059040600",4452,190,556,0,205,211,294,264,6172
"28059040700",6181,860,954,14,714,26,824,0,9573
"28059040800",4102,485,1392,213,269,0,287,39,6787
"28059040900",8878,690,709,745,1018,179,732,245,13196
"28059041000",2593,251,1272,379,440,31,586,47,5599
"28059041100",3211,609,1873,553,195,24,342,461,7268
"28059041300",4029,825,595,216,94,214,0,178,6151
"28059041400",1375,125,1252,391,0,0,33,68,3244
"28059041500",252,26,657,166,26,0,27,0,1154
"28059041600",287,126,1626,690,21,23,38,49,2860
"28059041700",26,32,1791,295,18,16,15,10,2203
"28059041800",44,71,1977,560,19,0,0,0,2671
"28059041900",1208,200,488,261,93,17,64,25,2356
"28059042000",1819,371,1519,709,235,94,459,218,5424
"28059042100",1033,584,563,593,108,0,214,37,3132
"28059042200",1701,699,590,898,207,253,179,298,4825
"28059042500",1383,156,124,305,58,33,207,17,2283
"28059042600",2679,25,178,132,33,52,123,52,3274
"28059042700",727,127,98,55,0,0,1,0,1008
"28059042900",1162,248,435,260,147,21,118,46,2437
"28059990000",0,0,0,0,0,0,0,0,0
"28061950100",1895,254,1588,695,15,0,34,0,4481
"28061950200",613,124,834,457,0,2,0,0,2030
"28061950300",3095,627,1010,404,0,2,0,1,5139
"28061950400",938,99,2593,1170,0,110,0,64,4974
"28063950100",936,7,2062,2781,0,0,0,0,5786
"28063950200",0,0,662,702,9,0,0,0,1373
"28065950100",1237,401,1827,1705,24,0,17,0,5211
"28065950201",943,261,1196,596,10,0,0,0,3006
"28065950202",1336,316,1133,741,0,8,0,0,3534
"28067950100",4102,427,926,849,131,185,84,0,6704
"28067950200",3826,589,980,289,40,0,56,0,5780
"28067950301",3211,653,364,613,72,0,0,0,4913
"28067950302",2826,631,81,0,56,0,51,116,3761
"28067950401",2246,112,680,196,97,0,33,0,3364
"28067950402",1773,374,2332,373,79,0,21,96,5048
"28067950500",1689,448,775,818,334,88,657,186,4995
"28067950600",1422,986,2445,1905,97,48,323,264,7490
"28067950700",687,255,1708,926,0,31,0,0,3607
"28067950800",4439,399,67,259,31,0,58,11,5264
"28067950900",5680,1425,384,104,50,37,160,367,8207
"28067951000",1187,578,762,576,18,0,0,0,3121
"28067951100",5473,888,588,135,0,0,328,0,7412
"28067980000",0,0,0,0,0,0,0,0,0
"28069030100",1054,374,1756,1701,11,0,15,88,4999
"28069030200",1840,192,1654,325,164,249,120,0,4544
"28071950100",2316,241,1521,397,249,17,116,196,5053
"28071950201",2096,543,289,550,23,0,0,0,3501
"28071950202",1883,1656,552,48,0,70,70,226,4505
"28071950301",193,621,220,695,92,164,38,106,2129
"28071950302",1730,601,559,337,202,93,72,0,3594
"28071950401",4208,1064,1750,672,252,37,131,19,8133
"28071950402",1956,884,1051,367,6,5,2,44,4315
"28071950501",5648,318,309,25,188,0,18,0,6506
"28071950502",2079,215,228,65,68,6,5,0,2666
"28071950503",2855,1511,1415,525,236,176,16,58,6792
"28073020100",5905,720,642,80,111,157,47,120,7782
"28073020201",5291,289,423,369,81,314,23,200,6990
"28073020202",7674,257,514,25,258,88,72,0,8888
"28073020301",4995,594,2599,519,557,49,477,11,9801
"28073020302",3896,1730,2426,1797,381,83,27,200,10540
"28073020400",5121,525,454,108,104,57,120,34,6523
"28073020500",4489,929,504,19,36,27,25,0,6029
"28073020600",1564,373,637,548,21,91,31,0,3265
"28075000200",200,101,1458,947,122,100,165,20,3113
"28075000300",474,32,1108,1036,21,0,12,5,2688
"28075000400",128,190,1500,3094,412,11,0,2,5337
"28075000600",73,33,684,976,18,4,0,0,1788
"28075000700",558,275,1605,1414,42,14,29,14,3951
"28075000800",171,96,856,657,8,0,0,1,1789
"28075000900",1031,248,2553,1263,299,113,268,47,5822
"28075001000",2131,358,1309,363,21,16,23,2,4223
"28075001101",2137,139,384,426,73,2,51,2,3214
"28075001102",2572,216,1098,136,39,11,40,0,4112
"28075010201",3153,220,2277,1002,193,35,48,0,6928
"28075010202",4128,484,1077,463,162,0,243,0,6557
"28075010301",4414,434,906,0,0,0,14,8,5776
"28075010302",4545,460,753,34,231,0,97,0,6120
"28075010400",1134,247,170,98,16,6,0,0,1671
"28075010500",4441,639,234,81,132,0,117,0,5644
"28075010600",5548,270,1119,94,140,37,251,0,7459
"28075010700",283,73,407,361,0,0,0,0,1124
"28075980000",27,12,0,4,0,0,0,0,43
"28077960100",1993,497,1251,480,30,3,71,0,4325
"28077960200",2429,271,983,1162,45,10,0,8,4908
"28077960300",2866,291,164,26,54,29,0,0,3430
"28079040100",2070,170,274,207,81,27,0,0,2829
"28079040400",3013,519,1688,717,492,265,0,0,6694
"28079040500",1999,179,618,183,1,8,35,0,3023
"28079040600",1784,851,1060,1350,420,174,283,613,6535
"28079040700",937,284,1677,1100,6,0,29,0,4033
"28081950101",3722,332,537,101,105,91,36,60,4984
"28081950102",2554,400,713,244,18,0,0,65,3994
"28081950201",6206,772,828,64,0,0,64,46,7980
"28081950202",5260,297,36,18,148,0,74,0,5833
"28081950301",4553,439,31,98,10,50,265,0,5446
"28081950302",2105,356,543,125,45,0,37,0,3211
"28081950401",1389,206,1471,1063,261,52,74,0,4516
"28081950402",6018,289,628,160,213,203,7,0,7518
"28081950500",3028,484,935,791,55,54,0,7,5354
"28081950601",2700,287,822,287,44,113,26,66,4345
"28081950602",1755,400,1045,526,15,0,68,0,3809
"28081950700",1112,383,1085,655,77,44,61,187,3604
"28081950800",1304,79,823,749,184,20,26,130,3315
"28081950901",1574,116,671,509,67,76,71,0,3084
"28081950902",1613,370,1365,924,297,76,211,320,5176
"28081951001",2193,340,998,336,0,10,87,0,3964
"28081951002",752,315,1713,1048,47,98,28,75,4076
"28081951100",3570,517,1167,350,129,10,23,12,5778
"28081980000",0,0,0,0,0,0,0,0,0
"28083950100",322,65,345,313,0,0,0,0,1045
"28083950200",612,185,675,1550,0,0,0,0,3022
"28083950300",682,66,1987,1936,36,0,147,0,4854
"28083950400",793,51,2592,1570,41,0,234,0,5281
"28083950600",3668,521,162,565,118,15,42,0,5091
"28083950700",317,197,987,627,0,89,0,177,2394
"28083950800",32,15,2003,1925,180,101,0,9,4265
"28083950900",69,52,1777,2579,14,136,0,120,4747
"28085950100",1887,484,870,510,0,0,33,19,3803
"28085950200",3773,428,370,633,0,0,0,0,5204
"28085950300",4631,1424,982,442,116,0,53,30,7678
"28085950400",5094,1375,835,180,17,0,29,197,7727
"28085950500",935,337,1360,1886,12,4,5,0,4539
"28085950600",2860,162,1161,1226,188,0,16,0,5613
"28087000101",5505,453,383,160,129,1,43,1,6675
"28087000102",1597,282,669,215,33,86,0,93,2975
"28087000200",1084,12,166,0,166,4,159,0,1591
"28087000300",5104,386,1793,492,268,29,120,65,8257
"28087000401",3976,725,1500,903,70,0,33,0,7207
"28087000403",1760,204,1541,814,15,0,15,0,4349
"28087000404",3018,384,479,32,0,0,78,110,4101
"28087000500",1284,177,1759,707,56,136,64,136,4319
"28087000600",603,107,1676,1391,17,0,0,0,3794
"28087000700",903,231,1301,1808,61,10,0,0,4314
"28087000800",164,13,1258,1586,14,0,23,7,3065
"28087000900",1590,269,1355,1034,232,10,118,5,4613
"28087001000",1210,69,743,280,24,2,12,6,2346
"28087001100",195,13,891,642,27,8,0,0,1776
"28089030101",5901,230,659,101,165,23,79,0,7158
"28089030104",1964,83,433,0,242,34,0,0,2756
"28089030105",1107,435,730,383,302,25,269,4,3255
"28089030106",1617,217,1939,330,252,356,91,340,5142
"28089030107",2009,89,570,0,39,42,15,0,2764
"28089030108",1271,38,3415,229,259,22,281,0,5515
"28089030201",6520,180,1019,339,58,0,55,0,8171
"28089030202",3726,87,499,35,391,17,17,17,4789
"28089030203",2373,155,395,0,174,0,0,0,3097
"28089030204",3067,107,518,22,206,34,48,0,4002
"28089030205",1620,90,402,6,345,11,0,0,2474
"28089030206",1273,44,240,41,99,9,26,0,1732
"28089030301",4685,64,665,0,269,7,17,0,5707
"28089030302",3241,86,2310,1233,58,0,85,0,7013
"28089030400",10251,83,3048,615,393,0,231,0,14621
"28089030500",69,76,3389,3311,171,572,166,572,8326
"28089030600",268,96,1527,1450,99,23,99,58,3620
"28089030700",219,23,344,168,79,0,65,7,905
"28089030800",689,53,1054,256,63,46,57,46,2264
"28089030900",1691,140,3436,762,83,0,59,36,6207
"28089031000",259,70,1116,339,0,0,18,0,1802
"28091950100",2962,823,696,581,157,42,102,0,5363
"28091950200",1901,413,510,456,74,0,10,13,3377
"28091950300",792,603,990,883,7,0,46,0,3321
"28091950400",1974,403,396,440,39,0,56,0,3308
"28091950500",1673,512,1375,978,0,119,0,128,4785
"28091950600",4035,534,472,343,26,26,0,0,5436
"28093950100",3165,481,1986,252,27,11,0,59,5981
"28093950200",4592,779,1957,526,458,68,581,24,8985
"28093950300",3163,276,2544,521,125,156,113,156,7054
"28093950401",361,39,1465,1204,19,35,0,35,3158
"28093950402",548,39,1988,302,10,6,21,0,2914
"28093950500",2915,872,2402,878,131,68,67,114,7447
"28095950100",5090,319,125,40,54,4,62,0,5694
"28095950200",3714,562,1775,832,65,15,152,0,7115
"28095950300",2730,404,288,204,0,0,18,0,3644
"28095950400",1361,141,897,782,6,74,0,0,3261
"28095950501",3032,515,171,40,7,18,0,18,3801
"28095950502",3010,553,348,83,0,0,46,28,4068
"28095950600",1408,66,1039,516,0,65,52,0,3146
"28095950700",666,106,965,551,23,0,0,0,2311
"28095950800",595,80,1209,994,10,159,6,0,3053
"28097950100",1234,194,615,537,3,0,0,0,2583
"28097950200",1488,204,736,289,2,0,113,0,2832
"28097950300",2057,339,1019,1476,124,19,0,0,5034
"28099010100",4079,582,544,93,410,97,15,0,5820
"28099010200",1897,224,437,86,190,0,0,0,2834
"28099010400",1008,63,1441,991,96,75,35,0,3709
"28099010500",1198,295,631,730,74,4,0,0,2932
"28099010600",2667,922,53,173,482,253,33,65,4648
"28099010700",2956,700,574,551,122,211,7,0,5121
"28099940100",352,254,144,0,2703,653,14,17,4137
"28101050100",2365,369,141,0,22,0,0,0,2897
"28101050200",2377,304,352,371,36,113,0,13,3566
"28101050300",2651,459,605,603,428,691,32,75,5544
"28101050400",3084,599,1298,542,24,0,113,28,5688
"28101050500",940,159,1896,501,48,26,85,0,3655
"28103950100",1354,290,2259,1341,7,0,0,61,5312
"28103950200",860,72,1307,1212,7,0,8,0,3466
"28103950300",325,62,781,976,19,0,49,0,2212
"28105950100",2598,1646,1750,1217,19,568,38,115,7951
"28105950200",3524,964,1169,920,260,0,29,0,6866
"28105950300",814,332,1089,1146,123,0,0,0,3504
"28105950400",1759,1528,653,523,237,9,20,20,4749
"28105950500",1787,839,876,415,91,49,71,26,4154
"28105950601",2038,638,285,382,203,100,37,38,3721
"28105950602",2001,457,1445,1266,272,29,257,0,5727
"28105950700",3489,626,2444,1114,94,12,22,0,7801
"28107950100",1780,135,4094,1154,51,131,68,0,7413
"28107950200",677,57,1006,1128,3,4,2,0,2877
"28107950300",2682,333,976,986,12,32,45,59,5125
"28107950400",3114,721,824,355,57,0,77,0,5148
"28107950500",3075,585,2407,948,29,23,270,25,7362
"28107950600",3237,286,2385,915,0,0,0,0,6823
"28109950100",4295,1104,0,0,129,30,156,19,5733
"28109950200",3516,650,597,574,103,25,63,30,5558
"28109950300",1674,276,280,180,229,9,60,4,2712
"28109950401",4910,1180,237,273,161,0,138,101,7000
"28109950402",4832,1155,273,663,0,0,154,0,7077
"28109950501",5508,1331,142,3,107,188,169,188,7636
"28109950502",6875,619,89,35,206,0,207,0,8031
"28109950600",2767,403,480,423,22,8,213,0,4316
"28109950700",3042,1494,1692,967,51,0,150,0,7396
"28111950101",3375,429,344,126,12,5,0,0,4291
"28111950102",2512,483,521,225,80,19,0,0,3840
"28111950200",2205,369,727,631,32,0,33,0,3997
"28113950101",2853,563,1084,373,90,7,0,0,4970
"28113950102",3260,352,269,345,0,9,0,0,4235
"28113950200",1967,514,1470,982,88,0,157,0,5178
"28113950300",142,124,2302,2229,195,67,216,67,5342
"28113950400",1604,168,771,536,108,0,17,0,3204
"28113950500",2032,156,3122,1401,89,1,25,0,6826
"28113950600",1501,461,2294,1803,11,5,0,0,6075
"28113950700",1474,531,854,706,67,1,43,15,3691
"28115950101",2692,331,1091,248,52,0,32,0,4446
"28115950102",3988,577,786,148,235,85,558,81,6458
"28115950200",4071,871,274,55,388,128,461,111,6359
"28115950300",3188,577,584,258,492,159,393,141,5792
"28115950400",2935,641,574,200,57,0,34,25,4466
"28115950500",3640,536,261,85,11,4,9,8,4554
"28117950100",5140,726,174,96,0,34,0,34,6204
"28117950200",4229,877,325,7,106,0,87,26,5657
"28117950300",3173,1164,873,547,0,108,13,23,5901
"28117950400",3955,579,51,147,76,0,105,0,4913
"28117950500",640,158,331,659,94,10,0,7,1899
"28119950100",289,32,1052,850,23,12,44,14,2316
"28119950200",258,41,685,635,5,0,0,0,1624
"28119950300",1103,425,1147,964,0,23,0,0,3662
"28121020101",2901,339,740,284,144,0,67,0,4475
"28121020102",8434,224,1383,284,319,5,159,5,10813
"28121020206",7233,562,1286,124,304,0,73,0,9582
"28121020207",3942,361,1032,283,106,53,117,26,5920
"28121020208",5462,318,428,0,134,18,47,0,6407
"28121020209",3583,110,567,13,21,8,22,0,4324
"28121020210",3972,161,350,266,98,0,88,0,4935
"28121020211",6971,553,804,65,556,0,286,0,9235
"28121020212",2253,46,595,0,70,0,77,0,3041
"28121020213",1022,0,305,37,55,0,27,0,1446
"28121020301",2432,416,171,216,0,0,0,0,3235
"28121020302",5348,655,1306,0,488,62,287,93,8239
"28121020401",2852,403,587,269,306,25,483,4,4929
"28121020402",4165,373,1309,165,161,0,107,14,6294
"28121020500",38,133,13,85,0,0,0,0,269
"28121020600",4388,442,2916,613,432,328,166,193,9478
"28121020701",925,54,105,35,4,0,117,4,1244
"28121020703",1246,199,203,0,53,14,84,0,1799
"28121020704",4814,409,530,153,101,12,654,36,6709
"28121020801",1633,146,171,15,5,0,45,15,2030
"28121020802",7820,559,2979,663,413,0,0,374,12808
"28121020803",1403,485,70,0,2,18,11,33,2022
"28121020900",4711,762,1729,283,0,0,34,0,7519
"28121021001",4569,669,689,0,51,28,11,0,6017
"28121021002",4948,267,985,263,97,4,12,0,6576
"28121021003",3686,537,610,144,20,32,9,0,5038
"28121980000",107,9,15,5,0,3,0,0,139
"28123020100",2707,785,1617,1141,154,40,199,171,6814
"28123020200",1760,757,1665,702,0,10,16,35,4945
"28123020300",3410,524,741,363,17,0,203,0,5258
"28123020400",1222,540,725,517,69,11,728,250,4062
"28123020500",2244,567,854,741,277,130,786,549,6148
"28123020600",1897,339,862,497,24,79,47,54,3799
"28125950100",676,62,1016,664,12,7,0,0,2437
"28125950200",460,72,1155,575,6,0,31,0,2299
"28127950100",1942,699,1705,442,9,12,11,0,4820
"28127950200",1929,399,709,459,1,45,0,43,3585
"28127950300",3713,571,1057,657,16,17,0,0,6031
"28127950400",4343,973,1430,1216,80,99,21,0,8162
"28127950500",1642,652,1081,727,107,17,314,76,4616
"28129950100",2806,826,944,318,2,0,2,14,4912
"28129950200",4228,937,503,453,13,21,5,0,6160
"28129950300",3046,281,806,962,5,15,26,0,5141
"28131020100",1961,514,513,337,0,0,132,37,3494
"28131020201",5133,858,784,13,126,0,11,12,6937
"28131020202",4545,757,879,622,244,2,79,2,7130
"28133950100",860,213,1164,1185,13,0,11,0,3446
"28133950200",1080,266,1881,1152,15,0,47,13,4454
"28133950300",760,163,711,747,54,0,36,118,2589
"28133950401",1298,64,1207,586,113,0,91,0,3359
"28133950402",39,0,3414,2199,13,36,0,12,5713
"28133950500",384,18,800,1110,34,0,0,0,2346
"28133950600",711,109,795,610,15,0,20,4,2264
"28135950100",1978,402,381,234,7,2,0,0,3004
"28135950200",450,24,487,395,3,4,0,0,1363
"28135950300",1157,180,2157,1059,7,1,58,3,4622
"28135950400",794,58,465,236,3,14,0,14,1584
"28137950100",2890,612,1099,509,30,105,0,67,5312
"28137950200",5133,437,1021,151,23,12,228,0,7005
"28137950301",1618,166,1194,711,156,38,41,38,3962
"28137950302",4018,616,1081,158,27,0,35,0,5935
"28137950400",2573,225,871,903,166,13,244,26,5021
"28139950100",3028,1012,277,273,84,13,34,13,4734
"28139950200",3914,1683,550,257,97,58,60,197,6816
"28139950300",1494,201,475,468,116,143,42,12,2951
"28139950400",5594,805,742,366,36,32,438,262,8275
"28141950100",2485,311,0,0,9,0,14,0,2819
"28141950200",1570,546,59,15,90,29,0,0,2309
"28141950300",5250,869,0,5,110,0,0,0,6234
"28141950400",6052,1172,249,97,219,102,316,192,8399
"28143950100",949,317,3056,1023,185,0,0,0,5530
"28143950200",820,78,2491,1273,30,133,0,133,4958
"28143980000",0,0,0,0,0,0,0,0,0
"28145950100",3390,1038,108,0,57,84,72,112,4861
"28145950200",3521,1151,317,38,18,61,73,57,5236
"28145950300",2538,216,749,363,243,69,172,41,4391
"28145950400",2025,657,783,465,155,219,187,408,4899
"28145950500",4129,893,239,83,108,0,6,81,5539
"28145950600",2449,447,337,386,48,0,0,38,3705
"28147950100",2113,974,2244,1535,80,7,80,0,7033
"28147950200",657,199,328,261,81,0,38,0,1564
"28147950300",3436,347,1436,876,75,0,0,146,6316
"28149950100",2942,19,850,598,26,142,135,29,4741
"28149950200",568,96,1771,1166,222,0,0,0,3823
"28149950300",237,106,1420,1545,0,0,20,0,3328
"28149950400",884,25,1075,1137,13,0,46,0,3180
"28149950500",1016,188,997,254,69,205,52,330,3111
"28149950600",2895,277,1477,871,64,0,0,0,5584
"28149950700",592,97,1069,269,38,13,0,0,2078
"28149950800",1151,321,1869,490,135,0,74,85,4125
"28149950901",3506,304,897,167,11,0,128,0,5013
"28149950902",2287,441,1090,353,17,7,28,0,4223
"28149951101",2549,495,1246,426,8,0,10,0,4734
"28149951102",2241,337,1351,396,193,23,68,0,4609
"28151000100",834,121,278,248,0,0,44,14,1539
"28151000200",458,69,806,661,0,0,13,0,2007
"28151000300",97,49,1890,898,11,6,0,0,2951
"28151000400",8,0,1226,1520,6,0,0,0,2760
"28151000600",4,91,1062,1805,0,24,29,24,3039
"28151000701",937,179,1539,955,136,0,0,0,3746
"28151000702",1857,157,1146,254,198,7,31,46,3696
"28151000800",1228,289,1431,513,19,31,11,13,3535
"28151000900",909,68,925,1042,8,8,0,0,2960
"28151001000",7,8,468,423,5,22,15,0,948
"28151001100",0,0,671,807,0,4,0,0,1482
"28151001200",0,0,1135,1116,22,0,0,0,2273
"28151001300",185,70,1163,953,31,0,48,0,2450
"28151001400",558,204,2335,929,0,13,0,23,4062
"28151001500",2411,802,619,529,116,0,233,0,4710
"28151001600",530,93,622,540,124,0,97,0,2006
"28151001700",698,41,1177,790,10,6,10,0,2732
"28151002000",232,53,591,464,6,0,4,0,1350
"28151002100",44,0,525,721,0,3,0,0,1293
"28153950100",2275,128,1429,1106,47,14,0,0,4999
"28153950200",1341,442,1007,1571,166,41,89,41,4698
"28153950300",3665,407,641,445,48,0,124,0,5330
"28153950400",3277,502,827,831,55,22,17,22,5553
"28155950100",3592,520,190,246,40,64,85,4,4741
"28155950200",2534,345,475,290,36,0,33,0,3713
"28155950300",596,242,186,527,6,9,6,0,1572
"28157950100",1444,84,1254,1372,44,0,0,0,4198
"28157950200",876,123,2022,1108,0,0,0,0,4129
"28159950100",1611,515,520,375,27,0,0,9,3057
"28159950200",1711,142,1520,603,0,6,37,0,4019
"28159950300",809,67,1316,1559,83,0,55,0,3889
"28159950400",1621,160,634,1228,3,0,3,33,3682
"28159950500",2171,642,796,90,40,2,57,0,3798
"28161950100",1667,336,889,315,28,6,17,13,3271
"28161950200",1651,450,1045,530,34,0,24,45,3779
"28161950300",2743,369,1621,434,42,32,103,0,5344
"28163950100",1494,292,1418,734,81,0,0,0,4019
"28163950200",968,50,1346,833,0,0,0,5,3202
"28163950300",310,19,2075,2316,27,0,8,0,4755
"28163950400",1426,141,199,67,2,0,6,0,1841
"28163950500",294,94,1745,2181,13,55,0,0,4382
"28163950600",3209,1025,1517,210,51,0,0,0,6012
"29001950100",3097,485,0,0,52,14,4,4,3656
"29001950200",2264,480,0,0,116,0,43,0,2903
"29001950300",1671,1060,55,21,0,121,0,79,3007
"29001950400",3081,420,14,78,189,45,27,0,3854
"29001950500",4845,1684,126,0,39,328,99,198,7319
"29001950900",941,1266,25,5,56,36,0,122,2451
"29001951000",17,28,30,15,0,19,0,0,109
"29003010100",5024,291,141,15,163,0,194,24,5852
"29003010200",5837,657,25,3,18,0,120,0,6660
"29003010300",1589,239,27,0,55,0,2,8,1920
"29003010400",2489,326,0,0,88,0,18,0,2921
"29005950100",2419,493,10,4,52,6,26,1,3011
"29005950200",2138,172,0,0,23,18,32,6,2389
"29007950100",1973,477,256,85,104,69,23,29,3016
"29007950200",3482,560,24,8,145,9,118,0,4346
"29007950300",2894,748,84,0,36,0,0,0,3762
"29007950400",2058,437,15,101,51,149,104,0,2915
"29007950500",2527,353,94,156,60,36,178,37,3441
"29007950600",2188,330,368,19,73,0,13,0,2991
"29007950700",2625,753,203,2,126,109,79,111,4008
"29009960100",4773,1065,0,0,38,0,0,0,5876
"29009960200",5185,964,16,0,448,220,619,266,7718
"29009960300",3733,1213,0,2,627,342,661,629,7207
"29009960401",3225,798,2,0,175,25,46,30,4301
"29009960402",2324,647,0,0,152,148,246,41,3558
"29009960500",4807,930,29,0,224,110,290,137,6527
"29009960600",2317,605,3,0,89,3,17,15,3049
"29011960100",2179,333,12,3,90,114,66,121,2918
"29011960200",2822,723,0,0,142,55,14,0,3756
"29011960300",3731,1546,1,0,127,136,14,73,5628
"29013070100",4280,554,0,2,203,23,93,6,5161
"29013070200",3300,525,0,0,170,44,126,29,4194
"29013070300",2914,1234,26,18,70,65,14,73,4414
"29013070400",2197,509,0,0,70,22,2,0,2800
"29015460100",2948,564,0,0,17,0,131,14,3674
"29015460200",1732,642,4,4,34,4,25,18,2463
"29015460300",3518,779,35,10,38,20,111,7,4518
"29015460400",1485,245,0,0,61,0,0,0,1791
"29015460700",2043,449,0,0,60,62,0,0,2614
"29015460800",2961,646,15,0,54,115,27,0,3818
"29017950100",3662,965,0,11,34,16,45,4,4737
"29017950200",3305,992,0,0,166,0,48,18,4529
"29017950300",2424,658,0,0,10,12,0,0,3104
"29019000200",894,318,55,26,72,53,95,16,1529
"29019000300",783,1550,0,77,53,198,0,57,2718
"29019000500",415,740,47,25,174,287,14,41,1743
"29019000600",3822,554,0,0,411,171,356,0,5314
"29019000700",2283,530,445,116,149,281,80,207,4091
"29019000900",702,305,240,140,101,66,50,73,1677
"29019001001",2344,1869,167,98,273,264,71,28,5114
"29019001002",3865,599,120,235,848,30,174,0,5871
"29019001101",2770,3755,332,497,484,1148,127,171,9284
"29019001103",5264,1066,185,36,359,79,69,0,7058
"29019001104",7277,1674,1020,157,719,50,235,0,11132
"29019001201",4829,188,268,72,447,151,137,38,6130
"29019001202",4747,277,8,0,466,64,34,0,5596
"29019001300",1981,591,157,396,523,72,52,108,3880
"29019001400",9006,467,671,485,1244,161,509,4,12547
"29019001502",3221,954,704,242,412,488,75,234,6330
"29019001503",2059,646,516,283,251,168,208,25,4156
"29019001504",5815,1205,1169,621,442,182,416,28,9878
"29019001601",5770,717,1156,98,613,159,212,16,8741
"29019001602",3007,167,201,104,43,0,90,0,3612
"29019001701",6571,886,14,23,342,0,5,0,7841
"29019001702",4055,269,38,21,193,0,37,0,4613
"29019001803",3730,263,150,79,313,6,149,17,4707
"29019001805",7246,223,881,0,824,3,331,0,9508
"29019001901",4384,149,64,1,77,13,65,0,4753
"29019001902",7483,638,9,0,312,0,165,15,8622
"29019002000",4214,800,83,0,13,11,43,10,5174
"29019002100",1008,697,703,515,156,424,90,38,3631
"29019002200",212,555,0,62,158,234,22,10,1253
"29021000100",4705,391,46,69,350,18,535,18,6132
"29021000200",3864,281,9,0,57,46,84,46,4387
"29021000300",2546,686,0,0,75,75,138,73,3593
"29021000400",1123,492,20,3,144,0,84,0,1866
"29021000500",1867,520,59,0,277,0,175,30,2928
"29021000600",2903,246,18,4,94,120,134,119,3638
"29021000701",3084,81,0,169,73,0,82,0,3489
"29021000702",3061,854,560,213,105,111,34,113,5051
"29021000900",4128,552,57,19,55,0,243,48,5102
"29021001000",1075,1130,505,71,78,149,27,240,3275
"29021001100",1563,643,192,21,81,28,105,205,2838
"29021001200",726,469,46,85,44,164,8,35,1577
"29021001500",4140,586,156,13,196,176,132,0,5399
"29021001600",1679,181,187,95,104,0,18,0,2264
"29021001700",3375,497,14,37,63,156,347,0,4489
"29021001800",2172,567,30,166,174,44,182,49,3384
"29021002100",1769,298,162,57,243,62,125,46,2762
"29021002200",1749,132,28,0,0,8,50,8,1975
"29021002300",2271,348,10,0,40,0,237,0,2906
"29021002400",1487,389,120,8,43,161,136,127,2471
"29021002500",1475,521,45,12,110,50,116,136,2465
"29021002700",2658,194,9,75,96,246,104,11,3393
"29021002800",4893,315,43,0,168,68,154,0,5641
"29021002900",2453,408,0,0,43,0,44,0,2948
"29021003000",3723,1231,217,309,338,336,361,237,6752
"29023950100",4916,698,14,0,122,0,122,40,5912
"29023950201",4016,826,131,0,150,0,64,0,5187
"29023950202",4652,560,0,0,181,0,0,0,5393
"29023950300",5335,808,41,0,93,103,100,133,6613
"29023950400",1444,708,715,38,52,343,24,35,3359
"29023950500",1199,1237,114,19,114,21,67,0,2771
"29023950600",3331,724,78,0,87,10,0,19,4249
"29023950700",1530,829,215,259,40,11,6,5,2895
"29023950800",1758,570,211,173,8,44,57,52,2873
"29023950900",2226,785,136,107,93,69,8,0,3424
"29025950100",1946,420,26,0,55,31,21,14,2513
"29025950200",5488,698,5,15,130,22,113,1,6472
"29027070100",3925,740,68,14,107,63,187,98,5202
"29027070200",2974,359,0,1,48,19,8,0,3409
"29027070300",3713,744,325,63,158,210,0,90,5303
"29027070400",3003,657,167,28,146,202,161,0,4364
"29027070500",3896,565,128,14,152,0,58,0,4813
"29027070600",5447,1026,62,6,154,3,53,8,6759
"29027070700",5783,370,17,21,306,19,59,0,6575
"29027070800",4025,682,81,44,166,15,20,0,5033
"29029950100",3313,614,0,0,53,0,12,0,3992
"29029950200",4654,1003,1,0,193,273,80,510,6714
"29029950300",1851,134,0,0,4,0,0,0,1989
"29029950400",3261,317,0,0,47,56,28,66,3775
"29029950500",2610,772,3,4,34,164,73,76,3736
"29029950600",3459,640,0,0,84,12,21,20,4236
"29029950700",2906,659,17,7,26,96,9,39,3759
"29029950800",6012,1578,0,8,122,91,7,57,7875
"29029950900",3172,569,0,0,0,0,10,39,3790
"29029951100",2133,180,0,0,12,0,29,0,2354
"29029951200",1866,322,37,17,45,0,13,0,2300
"29031880100",4848,514,0,0,71,0,190,0,5623
"29031880200",3905,96,0,0,6,0,43,0,4050
"29031880300",3714,295,33,0,40,8,5,0,4095
"29031880400",5495,1081,143,0,166,19,214,24,7142
"29031880500",8550,1038,75,56,216,107,54,18,10114
"29031880600",4837,1012,144,80,144,97,0,83,6397
"29031880700",3837,682,117,93,238,0,126,0,5093
"29031880800",947,670,98,223,76,180,38,35,2267
"29031880900",1092,197,152,515,166,169,75,44,2410
"29031881000",997,676,95,301,46,63,27,17,2222
"29031881100",2762,667,228,2,22,100,73,81,3935
"29031881200",5440,446,201,91,60,0,136,0,6374
"29031881300",4268,557,452,337,205,28,62,0,5909
"29031881400",772,271,532,804,37,37,13,24,2490
"29031881500",3537,489,8,3,164,0,53,110,4364
"29031881600",1552,746,127,633,79,243,23,90,3493
"29033960100",2016,315,0,0,27,8,8,3,2377
"29033960200",2246,211,21,0,110,9,0,7,2604
"29033960300",3099,634,23,59,101,37,102,0,4055
"29035960100",2525,904,0,0,89,35,9,17,3579
"29035960200",2188,333,0,0,86,47,53,1,2708
"29037060001",3198,673,75,0,64,68,303,330,4711
"29037060003",2779,282,246,0,362,13,356,28,4066
"29037060004",4283,783,133,63,277,0,435,248,6222
"29037060100",952,217,87,37,31,5,60,0,1389
"29037060202",4670,219,33,83,140,109,198,148,5600
"29037060301",7338,280,1165,0,435,57,234,63,9572
"29037060302",6201,828,93,0,207,47,107,0,7483
"29037060305",4037,31,488,0,116,0,146,0,4818
"29037060400",4424,91,126,0,80,0,79,10,4810
"29037060500",2575,135,13,1,43,19,40,0,2826
"29037060600",6403,1023,0,16,446,0,174,209,8271
"29037060700",3003,354,28,0,95,38,35,8,3561
"29037060800",5460,302,0,0,81,0,57,0,5900
"29037060904",2564,342,28,92,78,6,0,2,3112
"29037061001",4127,236,151,0,257,30,105,0,4906
"29037061002",6108,543,2,2,123,245,171,0,7194
"29037061100",3728,248,8,0,89,8,45,2,4128
"29037061200",3412,396,121,0,148,15,73,11,4176
"29037061300",3686,839,261,227,307,0,204,111,5635
"29037061400",4203,745,4,23,39,34,149,33,5230
"29039870100",4755,715,0,2,53,11,70,7,5613
"29039870200",2767,1776,1,0,154,157,0,0,4855
"29039870300",2362,695,3,0,81,25,5,9,3180
"29041470100",1780,398,0,7,5,2,8,2,2202
"29041470200",1938,276,51,35,46,16,34,12,2408
"29041470300",2299,423,19,56,39,0,6,0,2842
"29043020101",2865,239,62,0,104,0,27,0,3297
"29043020102",4642,499,28,0,91,29,113,12,5414
"29043020201",4104,78,0,0,8,17,26,0,4233
"29043020202",5104,984,108,0,311,262,316,0,7085
"29043020203",5395,770,0,0,238,213,113,137,6866
"29043020204",3837,632,0,2,210,169,301,43,5194
"29043020205",5523,522,0,4,135,39,233,0,6456
"29043020302",4908,486,85,2,37,67,19,0,5604
"29043020303",4424,891,41,0,202,0,185,0,5743
"29043020304",2376,519,15,0,61,99,15,77,3162
"29043020305",5516,448,0,44,140,51,12,32,6243
"29043020306",7042,453,0,17,32,15,326,44,7929
"29043020400",6580,707,7,0,101,4,37,11,7447
"29043020500",6372,597,0,0,323,20,147,4,7463
"29045950100",1593,234,0,0,40,7,0,0,1874
"29045950200",1994,319,0,11,24,3,0,0,2351
"29045950300",2168,319,0,0,32,35,0,21,2575
"29047020201",2962,275,335,287,746,144,270,10,5029
"29047020202",3081,207,29,11,332,46,371,0,4077
"29047020300",3782,602,450,141,627,312,472,124,6510
"29047020400",1419,83,220,23,631,9,342,0,2727
"29047020500",3747,928,56,385,328,124,232,171,5971
"29047020602",2903,624,318,90,294,87,325,114,4755
"29047020603",2708,503,149,0,169,26,300,75,3930
"29047020604",3705,293,168,47,782,123,614,83,5815
"29047020801",5093,898,72,6,615,105,190,120,7099
"29047020901",4472,137,371,2,484,0,446,0,5912
"29047020902",1807,61,243,9,169,59,316,8,2672
"29047021001",2813,405,37,125,297,172,206,248,4303
"29047021003",3373,154,66,8,215,38,204,31,4089
"29047021004",2709,288,204,10,179,10,117,49,3566
"29047021101",3556,831,199,0,177,17,233,201,5214
"29047021102",5246,789,331,34,180,52,350,64,7046
"29047021103",3081,248,100,0,194,23,141,8,3795
"29047021204",3233,407,739,31,229,169,266,208,5282
"29047021205",5803,175,237,177,756,61,422,0,7631
"29047021206",5873,100,219,23,680,0,499,0,7394
"29047021207",2073,308,274,163,98,144,115,34,3209
"29047021208",4087,528,492,400,687,0,538,23,6755
"29047021303",3019,159,152,0,93,47,17,0,3487
"29047021305",6079,218,403,97,606,30,428,30,7891
"29047021306",6351,100,358,0,353,37,665,0,7864
"29047021307",4455,180,437,204,448,178,340,125,6367
"29047021309",4095,30,187,14,258,23,120,0,4727
"29047021310",6530,234,437,0,626,0,479,22,8328
"29047021401",2996,354,290,23,137,0,11,88,3899
"29047021403",2232,304,177,0,46,7,134,58,2958
"29047021404",3592,425,309,62,132,99,121,76,4816
"29047021600",7361,589,101,21,329,0,211,0,8612
"29047021701",5042,246,111,79,221,0,213,0,5912
"29047021702",4247,1278,356,114,322,92,134,35,6578
"29047021803",6865,29,213,0,843,0,479,0,8429
"29047021804",6376,48,0,0,102,0,21,6,6553
"29047021805",7927,154,20,0,520,0,376,16,9013
"29047021806",3601,315,0,0,76,9,29,0,4030
"29047021900",5831,164,0,0,379,0,143,0,6517
"29047022000",4241,348,0,0,296,23,287,2,5197
"29047022100",3379,332,277,0,402,51,360,108,4909
"29047022200",3114,236,72,148,197,0,303,0,4070
"29047022301",2447,201,60,0,95,19,41,61,2924
"29047022302",5251,273,133,6,173,0,561,0,6397
"29049960100",4002,663,52,17,106,46,44,12,4942
"29049960200",5946,301,19,41,141,41,117,7,6613
"29049960300",3699,289,102,28,169,18,174,0,4479
"29049960400",3684,403,69,0,72,9,21,14,4272
"29051010300",3691,272,137,531,191,2,39,0,4863
"29051010400",5031,535,169,353,231,32,249,0,6600
"29051010500",1956,522,936,442,286,40,39,134,4355
"29051010600",1873,534,250,385,357,199,180,0,3778
"29051010701",4133,373,437,37,369,0,224,0,5573
"29051010702",4130,344,450,123,150,174,10,0,5381
"29051010800",7323,576,356,26,198,231,189,221,9120
"29051010900",5341,295,376,60,193,43,10,0,6318
"29051020198",3958,79,4,14,47,0,13,0,4115
"29051020200",3896,179,23,0,26,35,6,0,4165
"29051020300",3186,332,0,0,80,19,0,0,3617
"29051020400",4605,363,604,21,255,35,189,101,6173
"29051020500",2205,398,0,0,37,2,29,0,2671
"29051020600",3467,331,6,194,211,0,171,0,4380
"29051020700",680,520,469,402,21,184,30,31,2337
"29053950100",2579,474,5,2,65,7,4,3,3139
"29053950200",1262,249,142,89,80,21,74,7,1924
"29053950300",2792,462,99,73,269,15,68,0,3778
"29053950400",1975,311,92,42,74,0,21,16,2531
"29053950500",4070,591,20,7,153,11,7,2,4861
"29055450101",1805,467,0,0,45,0,17,48,2382
"29055450102",4324,1165,10,15,158,0,77,0,5749
"29055450200",3629,734,0,2,179,2,13,7,4566
"29055450301",2054,366,0,0,0,17,61,0,2498
"29055450302",3131,1179,0,0,0,16,57,61,4444
"29055450400",3716,1091,7,0,69,39,81,0,5003
"29057480100",3440,870,1,0,89,64,95,28,4587
"29057480200",2296,483,5,13,105,43,0,11,2956
"29059480100",3365,1052,4,4,138,238,27,27,4855
"29059480200",4056,748,0,0,127,46,99,2,5078
"29059480300",4990,1412,0,0,101,77,137,10,6727
"29061470100",2685,504,6,0,27,8,22,9,3261
"29061470200",3896,803,3,1,69,24,39,13,4848
"29063080100",4133,1073,17,24,30,16,25,218,5536
"29063080200",3622,273,2,0,80,5,42,9,4033
"29065960100",3582,603,0,0,117,11,27,0,4340
"29065960200",4163,1029,0,0,88,73,0,101,5454
"29065960300",1097,1236,55,0,0,13,0,29,2430
"29065960400",2507,563,0,0,27,114,51,0,3262
"29067950100",2639,863,0,0,34,0,0,0,3536
"29067950200",4227,1017,0,0,66,2,32,20,5364
"29067950500",3242,1059,0,0,109,0,92,0,4502
"29069360100",933,410,877,137,32,120,0,0,2509
"29069360200",1859,316,226,119,88,57,155,25,2845
"29069360300",2818,1136,0,27,5,44,12,22,4064
"29069360400",3125,951,67,165,111,134,212,131,4896
"29069360500",1539,538,286,216,5,33,25,72,2714
"29069360600",2145,1637,342,134,196,35,27,223,4739
"29069360700",2446,566,216,83,119,3,53,0,3486
"29069360800",1506,470,0,0,50,220,334,366,2946
"29069360900",1712,255,48,12,113,7,55,28,2230
"29069361000",1341,697,0,0,26,14,39,116,2233
"29071800100",7824,917,22,27,265,91,156,0,9302
"29071800201",3970,575,66,231,139,209,0,209,5399
"29071800202",5515,132,0,0,130,0,75,0,5852
"29071800300",6608,653,66,40,222,84,39,97,7809
"29071800401",4839,331,0,0,111,25,248,12,5566
"29071800402",5726,736,0,0,46,0,99,0,6607
"29071800500",6707,437,0,0,61,0,82,0,7287
"29071800601",6090,855,0,0,113,0,92,0,7150
"29071800602",7334,590,44,0,207,0,56,13,8244
"29071800701",5430,1335,176,67,121,0,158,0,7287
"29071800702",2729,57,42,9,169,0,83,0,3089
"29071800800",5831,879,104,21,79,3,0,0,6917
"29071800901",2451,579,0,0,151,0,58,0,3239
"29071800902",5187,1027,25,5,183,58,0,0,6485
"29071801000",2962,666,0,0,79,19,16,0,3742
"29071801101",3354,866,58,0,12,106,12,99,4507
"29071801102",3383,311,0,0,39,0,0,12,3745
"29073960100",2179,371,37,0,30,0,0,10,2627
"29073960200",1738,146,0,0,17,8,5,0,1914
"29073960300",2609,246,0,0,49,77,23,0,3004
"29073960400",2256,693,0,11,34,0,6,0,3000
"29073960500",3271,751,8,0,40,13,25,125,4233
"29075960100",2554,476,39,23,32,15,7,0,3146
"29075960200",2781,595,0,1,45,9,53,0,3484
"29077000100",577,549,54,75,15,42,23,50,1385
"29077000200",139,629,17,36,56,218,13,15,1123
"29077000300",2251,621,0,0,121,33,111,61,3198
"29077000400",1802,1588,61,175,173,53,177,188,4217
"29077000501",1147,773,83,27,153,63,53,26,2325
"29077000502",1578,1184,218,211,120,294,202,41,3848
"29077000600",1547,721,138,115,80,4,111,21,2737
"29077000700",1494,746,191,255,127,58,26,14,2911
"29077000800",1400,426,100,98,60,33,55,25,2197
"29077000900",2698,1307,34,122,175,305,80,58,4779
"29077001000",1804,236,18,0,48,14,35,0,2155
"29077001100",2524,437,86,24,170,70,56,6,3373
"29077001200",2954,593,152,18,145,48,102,221,4233
"29077001301",1712,378,12,11,10,9,75,50,2257
"29077001302",1484,541,16,63,41,43,127,34,2349
"29077001400",2897,1114,70,51,284,197,255,128,4996
"29077001500",3429,1022,197,0,527,252,221,83,5731
"29077001700",1697,857,101,36,85,75,44,151,3046
"29077001800",2236,747,79,53,51,24,70,62,3322
"29077001900",1733,1023,49,151,37,65,153,148,3359
"29077002200",2888,803,110,0,214,373,22,335,4745
"29077002300",3323,1636,0,16,368,84,69,64,5560
"29077002402",2916,509,99,72,285,0,16,0,3897
"29077002502",3855,821,225,41,234,79,62,35,5352
"29077002600",4567,118,31,0,57,0,52,0,4825
"29077002700",1792,361,42,0,320,96,248,0,2859
"29077002800",1453,285,7,4,78,5,117,114,2063
"29077002900",3443,282,73,14,260,0,50,14,4136
"29077003002",3208,1134,217,134,512,245,44,112,5606
"29077003100",1602,667,148,0,33,0,6,0,2456
"29077003200",2663,968,60,126,242,181,264,22,4526
"29077003300",1937,1523,33,277,185,84,66,35,4140
"29077003600",1652,1039,140,78,56,8,23,8,3004
"29077003700",6197,744,28,0,264,0,157,19,7409
"29077003800",6801,422,0,0,359,0,33,0,7615
"29077003900",2345,244,86,0,52,0,22,9,2758
"29077004001",3994,696,130,0,233,39,57,27,5176
"29077004002",2971,224,42,1,310,0,36,0,3584
"29077004003",4518,265,90,0,167,29,78,0,5147
"29077004101",7079,410,178,27,349,186,234,128,8591
"29077004102",6308,496,164,0,245,0,86,0,7299
"29077004103",6138,702,126,0,539,23,81,0,7609
"29077004201",4466,367,33,0,173,37,73,23,5172
"29077004202",4498,826,220,0,516,237,128,130,6555
"29077004301",6240,586,151,152,321,105,241,0,7796
"29077004302",3051,585,54,0,164,35,0,0,3889
"29077004400",5088,1375,77,87,119,62,189,0,6997
"29077004500",2400,178,47,0,61,22,73,0,2781
"29077004600",6604,692,56,8,135,22,172,0,7689
"29077004700",4442,330,0,0,167,0,0,0,4939
"29077004801",5600,1071,0,0,370,0,177,15,7233
"29077004802",6378,652,0,0,177,0,222,0,7429
"29077004803",3294,1024,8,0,70,80,15,0,4491
"29077004900",5289,406,0,0,91,0,0,0,5786
"29077005001",2901,626,9,0,121,20,108,17,3802
"29077005002",5689,493,157,3,285,19,367,23,7036
"29077005100",2839,301,0,0,84,0,56,0,3280
"29077005200",5556,655,13,0,127,59,27,69,6506
"29077005500",2294,894,347,115,136,10,62,4,3862
"29077005600",2622,877,51,35,68,15,177,3,3848
"29077005700",2708,975,22,13,188,99,86,181,4272
"29077005800",2796,1709,72,55,247,137,243,27,5286
"29079960100",1748,265,4,0,14,27,3,0,2061
"29079960200",1718,383,0,0,23,10,2,0,2136
"29079960300",1746,446,0,20,171,23,0,20,2426
"29079960400",2455,802,8,14,40,30,3,66,3418
"29081950100",2855,623,1,1,33,11,6,6,3536
"29081950200",1789,335,18,2,4,0,7,0,2155
"29081950300",2242,467,0,16,76,30,118,30,2979
"29083950100",2130,512,164,0,10,30,0,0,2846
"29083950200",2781,731,0,0,33,15,56,0,3616
"29083950300",2915,415,0,0,14,33,58,11,3446
"29083950400",2343,490,5,7,62,5,154,0,3066
"29083950500",2740,711,56,8,58,23,38,0,3634
"29083950600",3760,1061,82,27,77,63,0,126,5196
"29085470100",2183,579,0,2,28,8,21,3,2824
"29085470300",2001,364,0,0,50,16,57,0,2488
"29085470500",2518,1267,0,0,27,158,38,10,4018
"29087960100",955,214,0,1,4,16,4,1,1195
"29087960200",1444,181,0,0,51,4,0,0,1680
"29087960300",1443,128,0,0,34,11,7,0,1623
"29089960100",2438,407,27,29,84,24,11,38,3058
"29089960200",2904,423,67,0,29,54,32,12,3521
"29089960300",1997,586,287,35,83,29,25,12,3054
"29091090100",4174,1404,0,16,69,10,85,0,5758
"29091090200",2848,981,0,0,62,22,48,16,3977
"29091090300",3247,1000,5,0,93,28,21,31,4425
"29091090400",3610,829,0,0,205,13,72,0,4729
"29091090500",3971,685,22,5,103,21,37,0,4844
"29091090600",3721,928,9,8,48,77,87,0,4878
"29091090700",3025,1730,0,0,149,184,4,239,5331
"29091090800",4650,1186,59,0,326,31,0,124,6376
"29093950100",2245,404,0,0,61,2,48,12,2772
"29093950200",1731,492,27,0,30,37,0,0,2317
"29093950300",1835,713,37,21,7,42,6,4,2665
"29093950400",1497,423,15,143,37,16,9,0,2140
"29095000300",596,147,114,491,159,60,30,21,1618
"29095000600",1182,864,11,118,737,677,1167,981,5737
"29095000700",1302,341,415,79,494,561,651,527,4370
"29095000800",1137,454,308,67,1304,256,1295,410,5231
"29095000900",687,302,86,105,625,421,581,417,3224
"29095001000",612,102,332,744,761,156,606,178,3491
"29095001100",933,204,284,90,108,60,87,64,1830
"29095001800",447,298,320,527,420,286,415,413,3126
"29095001900",907,343,209,274,593,327,929,197,3779
"29095002000",414,303,10,111,916,520,702,697,3673
"29095002100",933,788,507,609,794,621,1032,1043,6327
"29095002200",446,233,357,234,577,238,503,293,2881
"29095002300",546,185,377,356,167,315,444,302,2692
"29095003400",196,293,397,572,594,90,608,85,2835
"29095003700",42,29,399,399,1,0,40,20,930
"29095003800",41,20,1206,508,7,20,35,8,1845
"29095004300",1103,364,267,217,135,45,207,6,2344
"29095004400",735,87,52,27,47,76,57,0,1081
"29095004600",1710,342,107,62,237,75,325,26,2884
"29095005100",1054,67,146,116,107,305,182,302,2279
"29095005200",138,94,356,383,32,51,98,58,1210
"29095005300",278,17,642,169,42,29,22,7,1206
"29095005400",14,19,337,308,85,0,88,0,851
"29095005500",0,66,493,170,0,21,15,58,823
"29095005601",116,37,860,600,38,172,28,148,1999
"29095005602",8,2,938,563,25,35,47,33,1651
"29095005700",87,3,1506,547,96,71,0,0,2310
"29095005801",44,93,1147,414,83,64,62,99,2006
"29095006000",39,85,706,400,48,117,10,93,1498
"29095006100",148,129,1079,1098,234,9,24,27,2748
"29095006300",11,80,823,754,98,0,105,29,1900
"29095006500",1032,229,200,157,101,29,100,0,1848
"29095006600",1039,219,88,8,262,81,146,0,1843
"29095006700",878,370,262,118,169,66,102,90,2055
"29095006900",852,93,68,0,97,34,70,0,1214
"29095007100",1950,399,47,9,275,30,275,12,2997
"29095007200",1748,108,65,0,209,0,49,0,2179
"29095007300",2516,310,88,95,216,116,30,21,3392
"29095007400",2183,444,21,44,193,115,54,10,3064
"29095007500",437,491,703,399,108,84,38,83,2343
"29095007600",122,145,1170,549,33,37,0,0,2056
"29095007700",21,19,808,727,28,29,21,0,1653
"29095007802",97,29,1744,476,15,80,1,81,2523
"29095007900",135,36,2363,640,299,0,104,0,3577
"29095008000",55,115,1761,824,144,79,133,8,3119
"29095008100",231,61,1233,298,34,21,15,0,1893
"29095008200",2462,179,177,13,189,47,66,8,3141
"29095008300",2122,84,76,0,153,6,36,6,2483
"29095008400",2781,11,20,0,132,0,15,0,2959
"29095008500",3204,83,38,0,130,0,102,0,3557
"29095008600",4501,253,271,0,209,187,262,198,5881
"29095008700",229,70,1167,752,102,2,41,0,2363
"29095008800",126,59,2058,1132,154,29,151,11,3720
"29095008900",27,7,1127,834,18,3,27,0,2043
"29095009000",751,42,2789,915,315,0,162,10,4984
"29095009100",3009,217,346,45,255,0,143,0,4015
"29095009200",2508,122,119,39,211,7,301,7,3314
"29095009300",1993,196,59,0,116,0,95,11,2470
"29095009400",2558,645,780,321,385,39,95,48,4871
"29095009500",607,281,1287,731,135,24,8,12,3085
"29095009600",298,64,599,1033,33,77,32,85,2221
"29095009700",326,56,500,472,111,89,126,89,1769
"29095009800",2126,306,501,160,207,13,129,13,3455
"29095009900",1469,177,155,45,89,170,99,137,2341
"29095010001",1346,49,205,45,73,0,31,0,1749
"29095010002",1403,119,1452,114,188,96,61,24,3457
"29095010103",873,78,1061,129,243,0,105,0,2489
"29095010105",2714,123,309,1,166,121,100,0,3534
"29095010201",633,184,631,644,59,56,7,12,2226
"29095010203",2649,174,942,189,371,20,315,0,4660
"29095010204",2270,456,552,619,1000,235,563,62,5757
"29095010500",1594,527,1608,713,345,230,445,307,5769
"29095010600",2041,336,572,123,114,63,336,0,3585
"29095010702",1244,151,903,1040,173,19,190,18,3738
"29095011000",2514,1446,226,31,115,236,128,170,4866
"29095011100",2467,479,37,0,185,32,126,90,3416
"29095011200",2115,526,188,0,106,266,139,272,3612
"29095011300",3412,896,232,397,242,49,111,0,5339
"29095011401",5869,1285,400,314,427,143,607,443,9488
"29095011405",1212,1288,221,241,273,483,321,571,4610
"29095011406",4178,586,131,125,569,172,463,163,6387
"29095011500",3056,1226,709,195,473,93,484,189,6425
"29095011600",2953,1199,146,71,214,31,212,0,4826
"29095011700",2819,573,328,182,53,152,126,251,4484
"29095011800",2708,1004,330,308,103,140,265,70,4928
"29095011900",2220,484,75,35,529,134,562,68,4107
"29095012000",2085,538,145,95,254,65,247,19,3448
"29095012100",3622,782,295,80,501,121,614,188,6203
"29095012200",4644,419,257,0,422,59,374,0,6175
"29095012300",2822,225,107,5,67,8,8,10,3252
"29095012400",3012,283,299,75,611,111,303,111,4805
"29095012501",1661,603,827,134,69,159,102,134,3689
"29095012502",1834,122,486,30,141,6,195,0,2814
"29095012600",2876,365,1039,127,318,0,320,0,5045
"29095012701",4570,300,932,229,245,9,389,9,6683
"29095012802",2104,103,1254,29,70,5,112,0,3677
"29095012803",1163,68,417,90,61,8,62,0,1869
"29095012804",3081,205,1404,924,484,536,166,137,6937
"29095012903",974,366,1614,529,241,80,255,68,4127
"29095012904",990,160,1279,55,100,59,92,0,2735
"29095012906",1369,172,2460,486,359,52,243,17,5158
"29095013003",1217,240,3131,652,150,250,447,62,6149
"29095013100",721,162,1205,238,303,242,88,203,3162
"29095013203",746,330,1470,1282,224,312,151,167,4682
"29095013208",490,74,1197,905,75,33,106,46,2926
"29095013210",544,52,1508,249,108,47,103,40,2651
"29095013301",2289,297,528,107,315,294,167,206,4203
"29095013307",457,43,1793,148,236,12,158,0,2847
"29095013309",1519,297,2080,409,260,47,313,0,4925
"29095013313",2294,213,1136,524,598,94,568,126,5553
"29095013401",871,531,755,178,287,213,327,399,3561
"29095013405",1024,236,202,442,99,15,224,81,2323
"29095013407",2129,68,107,15,58,0,0,0,2377
"29095013408",3629,253,1023,3,514,0,510,0,5932
"29095013410",1894,579,474,280,151,78,186,39,3681
"29095013416",1004,56,1176,129,107,0,80,0,2552
"29095013502",4892,368,86,13,249,29,156,60,5853
"29095013504",2423,218,256,12,417,0,515,105,3946
"29095013606",1291,24,20,0,38,0,14,0,1387
"29095013608",4800,323,194,241,117,0,78,0,5753
"29095013612",4803,100,732,0,899,0,322,0,6856
"29095013703",3008,875,289,442,193,85,108,55,5055
"29095013704",5239,395,272,52,351,0,219,32,6560
"29095013801",3574,485,580,45,279,33,121,0,5117
"29095013802",7513,167,585,70,601,45,588,0,9569
"29095013901",6153,217,8,0,136,0,148,33,6695
"29095013902",1028,133,15,4,85,1,38,0,1304
"29095013904",5936,190,435,0,407,69,334,0,7371
"29095013916",4573,156,680,11,482,24,141,5,6072
"29095014002",1651,147,0,0,13,0,25,0,1836
"29095014004",2325,294,12,1,116,3,183,12,2946
"29095014005",4870,224,68,0,107,0,605,0,5874
"29095014006",4948,370,165,3,511,48,177,61,6283
"29095014007",4467,1084,71,56,113,0,144,0,5935
"29095014101",4866,858,681,13,329,8,193,70,7018
"29095014105",6267,522,453,0,423,0,175,0,7840
"29095014108",4257,1127,212,299,403,0,281,0,6579
"29095014111",2653,50,138,121,150,110,77,0,3299
"29095014112",751,15,14,23,31,0,19,0,853
"29095014114",5536,572,564,53,319,259,69,24,7396
"29095014120",2536,335,62,2,265,42,122,245,3609
"29095014203",3578,18,264,0,120,11,104,0,4095
"29095014204",6233,308,599,298,389,12,232,37,8108
"29095014300",3436,310,940,419,216,21,28,49,5419
"29095014400",1393,158,795,61,124,8,14,8,2561
"29095014501",3234,159,343,32,240,0,149,13,4170
"29095014502",3772,175,127,0,125,0,70,19,4288
"29095014601",4062,241,53,114,504,26,503,39,5542
"29095014603",2796,437,65,0,165,42,89,79,3673
"29095014604",3117,327,341,73,710,124,904,0,5596
"29095014701",2726,148,300,159,147,43,124,52,3699
"29095014702",4281,111,46,49,448,0,287,0,5222
"29095014804",2611,168,29,29,123,0,84,0,3044
"29095014806",3716,140,169,0,238,13,284,31,4591
"29095014902",1383,421,7,0,87,20,57,31,2006
"29095014903",4712,115,1,1,63,60,237,0,5189
"29095014904",4895,266,273,98,488,141,324,93,6578
"29095014905",4491,83,192,0,122,0,137,0,5025
"29095015000",3137,444,23,11,143,5,113,57,3933
"29095015100",4879,594,272,9,188,40,265,165,6412
"29095015200",1251,198,148,76,177,31,83,0,1964
"29095015300",1186,250,101,385,515,310,1060,465,4272
"29095015400",203,298,690,1838,154,689,77,442,4391
"29095015500",452,265,13,31,116,174,149,271,1471
"29095015600",991,359,47,108,207,369,452,369,2902
"29095015700",1615,126,280,73,165,27,90,0,2376
"29095015800",1067,119,58,40,48,7,104,21,1464
"29095015900",464,149,104,150,156,89,59,24,1195
"29095016000",135,83,457,222,437,154,332,100,1920
"29095016100",46,39,1328,426,50,33,19,20,1961
"29095016200",131,77,632,287,52,24,45,27,1275
"29095016300",502,447,572,314,160,100,194,90,2379
"29095016400",112,390,880,248,191,316,172,359,2668
"29095016500",25,37,1105,393,14,47,28,59,1708
"29095016600",66,5,715,461,75,55,84,0,1461
"29095016700",1865,165,370,132,445,64,367,21,3429
"29095016800",2691,994,25,93,388,21,481,101,4794
"29095016900",51,4,1341,647,66,52,27,68,2256
"29095017000",1104,330,546,134,258,113,149,191,2825
"29095017100",96,52,2634,659,51,21,13,12,3538
"29095017200",1446,133,2350,224,165,179,207,149,4853
"29095017300",2836,133,416,15,152,0,124,9,3685
"29095017400",352,259,1419,240,184,90,88,12,2644
"29095017500",791,148,542,226,136,48,72,0,1963
"29095017600",3151,202,1372,184,179,15,156,32,5291
"29095017700",4390,300,103,0,350,10,458,91,5702
"29095017800",1016,304,228,649,271,286,225,175,3154
"29095017900",3519,101,495,28,391,103,133,14,4784
"29095018000",2319,521,223,10,248,39,282,137,3779
"29095018100",5392,201,594,27,598,0,61,29,6902
"29095018200",2541,64,492,17,277,25,248,12,3676
"29095018500",2718,148,252,6,275,0,244,0,3643
"29095018600",2753,31,0,0,279,0,53,0,3116
"29095019300",4564,347,287,47,268,97,225,15,5850
"29095980101",0,0,0,0,0,0,0,0,0
"29095980802",0,0,0,0,0,0,0,0,0
"29095988300",42,0,0,0,0,0,0,0,42
"29095989100",8,0,5,0,0,0,0,0,13
"29095989200",0,0,0,0,0,0,0,0,0
"29097010100",2265,764,167,90,330,65,9,45,3735
"29097010200",4015,727,59,0,233,6,71,0,5111
"29097010300",4535,886,113,116,418,163,435,58,6724
"29097010400",3533,534,6,63,274,6,112,12,4540
"29097010500",3935,593,102,56,493,104,289,0,5572
"29097010600",2998,795,80,180,81,186,264,115,4699
"29097010700",2120,333,0,35,90,236,104,55,2973
"29097010800",2419,625,102,32,460,112,96,40,3886
"29097010900",5944,472,68,13,372,87,110,0,7066
"29097011000",2254,951,158,334,234,73,131,38,4173
"29097011100",1681,216,9,0,76,31,97,16,2126
"29097011200",5293,854,0,4,504,0,53,0,6708
"29097011300",7219,1098,51,0,426,0,199,0,8993
"29097011400",4728,536,0,72,62,23,48,0,5469
"29097011500",8311,1379,65,5,233,65,402,304,10764
"29097011600",2768,1366,33,53,385,319,914,1452,7290
"29097011700",5180,1136,64,24,23,131,503,690,7751
"29097011800",3028,1068,5,21,265,0,599,618,5604
"29097011900",2928,542,13,58,235,44,142,7,3969
"29097012000",3570,570,0,0,76,41,8,20,4285
"29097012100",3015,304,10,0,267,74,210,24,3904
"29097012200",6089,870,11,1,187,14,245,29,7446
"29099700107",2540,92,135,0,82,0,43,0,2892
"29099700109",11546,645,0,18,552,12,125,18,12916
"29099700110",7188,663,0,0,115,0,164,0,8130
"29099700111",3464,662,9,20,80,27,68,47,4377
"29099700113",3094,242,0,1,48,15,24,0,3424
"29099700114",3860,412,12,0,75,2,67,0,4428
"29099700115",3992,216,0,0,145,0,144,0,4497
"29099700116",2752,146,15,0,117,15,63,0,3108
"29099700117",6435,327,0,0,268,9,103,63,7205
"29099700118",5510,472,20,0,94,47,112,0,6255
"29099700119",1819,144,56,0,53,0,14,14,2100
"29099700203",4745,530,40,110,233,0,241,41,5940
"29099700206",4241,1105,0,35,45,0,73,19,5518
"29099700207",3089,526,32,0,42,0,178,0,3867
"29099700208",4845,968,83,38,235,0,46,0,6215
"29099700209",3325,85,0,6,100,0,116,0,3632
"29099700210",3252,380,11,0,252,26,249,26,4196
"29099700211",4439,648,28,3,166,0,17,23,5324
"29099700302",4870,544,0,0,165,7,50,0,5636
"29099700303",4147,361,0,0,166,37,242,11,4964
"29099700304",6299,721,3,0,135,100,39,0,7297
"29099700401",4020,282,0,0,0,0,0,10,4312
"29099700402",6017,404,0,2,112,83,126,72,6816
"29099700502",4950,471,0,0,71,16,129,1,5638
"29099700503",3158,408,0,0,21,5,0,23,3615
"29099700504",3932,680,0,0,39,9,12,0,4672
"29099700601",4834,761,96,0,248,29,76,0,6044
"29099700603",5306,604,0,14,28,0,72,0,6024
"29099700604",5327,543,0,9,57,9,27,14,5986
"29099700605",4908,782,129,217,105,0,52,190,6383
"29099700700",3508,687,72,36,179,137,7,0,4626
"29099700801",4918,380,75,74,167,14,140,0,5768
"29099700802",3362,420,59,133,196,142,0,0,4312
"29099700900",4451,441,216,17,86,0,0,0,5211
"29099701000",7202,633,5,0,186,21,276,7,8330
"29099701101",3545,293,59,0,31,0,0,0,3928
"29099701102",4655,1277,3,0,29,14,41,0,6019
"29099701200",4198,1087,82,0,96,83,0,98,5644
"29099701300",2761,558,84,0,19,40,8,15,3485
"29099701401",3430,559,13,0,0,0,0,0,4002
"29099701403",3744,346,0,0,33,0,6,0,4129
"29099701404",5222,738,0,0,160,62,0,0,6182
"29101960100",7524,673,207,34,200,6,98,0,8742
"29101960200",3881,703,40,0,126,38,62,36,4886
"29101960300",7156,772,113,17,467,10,440,24,8999
"29101960400",1665,1333,158,277,269,170,73,94,4039
"29101960500",5459,948,515,61,545,109,159,0,7796
"29101960600",1997,1119,139,173,88,32,105,36,3689
"29101960700",4201,937,128,20,526,110,277,71,6270
"29101960900",4010,751,7,0,69,18,72,8,4935
"29101980000",1165,87,197,0,293,9,193,0,1944
"29103960100",1556,286,0,0,16,13,11,0,1882
"29103960200",1485,489,8,9,58,26,28,6,2109
"29105960100",6434,1497,27,0,232,66,271,53,8580
"29105960298",4506,589,4,0,96,7,64,0,5266
"29105960300",6191,1092,0,0,142,41,89,0,7555
"29105960400",2773,743,18,9,26,28,0,19,3616
"29105960500",4198,983,0,51,246,42,157,63,5740
"29105960600",2988,1480,0,0,190,188,46,0,4892
"29107090100",4124,653,27,38,152,76,75,96,5241
"29107090200",4412,615,322,14,328,107,0,214,6012
"29107090300",1093,162,37,1,36,0,24,38,1391
"29107090400",5648,714,110,25,70,88,52,66,6773
"29107090500",3207,247,0,1,149,1,28,13,3646
"29107090601",5131,620,0,0,49,1,166,34,6001
"29107090602",3487,316,10,3,99,24,22,0,3961
"29109470100",3300,490,0,0,58,13,97,0,3958
"29109470200",6311,766,13,2,94,0,304,0,7490
"29109470300",4319,980,0,1,176,77,306,144,6003
"29109470400",4610,1379,8,0,460,374,605,544,7980
"29109470500",4822,1479,0,6,119,118,55,98,6697
"29109470601",4198,555,0,0,159,184,376,13,5485
"29109470602",1862,554,0,4,23,70,49,0,2562
"29111970100",2358,363,15,11,24,53,4,0,2828
"29111970200",1802,397,27,24,8,1,9,0,2268
"29111970300",2388,108,0,1,72,1,144,0,2714
"29111970400",1350,176,113,38,101,42,5,0,1825
"29113810100",3413,464,8,119,28,9,63,26,4130
"29113810201",5886,1174,9,11,180,56,101,127,7544
"29113810202",5483,577,17,0,50,0,28,0,6155
"29113810301",6465,1420,192,0,204,132,53,166,8632
"29113810303",7987,740,327,33,212,102,144,0,9545
"29113810304",7261,1680,185,68,73,173,14,0,9454
"29113810400",6669,1007,11,0,403,215,221,205,8731
"29115490100",1372,215,3,0,11,5,11,9,1626
"29115490200",1796,432,0,0,26,14,29,12,2309
"29115490300",2410,186,26,0,168,13,49,7,2859
"29115490400",1841,985,36,0,81,42,31,15,3031
"29115490500",2299,267,4,0,7,37,16,37,2667
"29117480100",2214,506,7,6,17,30,16,10,2806
"29117480200",2820,399,0,0,129,5,13,4,3370
"29117480300",2679,384,0,19,31,0,7,9,3129
"29117480400",2204,329,0,0,87,41,19,41,2721
"29117480500",1168,528,54,0,46,26,0,69,1891
"29119070100",5043,1137,0,0,343,86,189,0,6798
"29119070200",3542,749,0,0,224,73,114,33,4735
"29119070300",3095,1212,158,132,376,211,936,773,6893
"29119070400",4375,957,34,2,421,317,401,128,6635
"29121960100",1931,373,0,3,12,10,15,2,2346
"29121960200",2070,617,3,0,16,6,8,0,2720
"29121960300",2976,625,39,0,94,52,79,0,3865
"29121960400",2948,577,21,38,90,39,37,16,3766
"29121960500",1914,357,166,139,0,59,0,30,2665
"29123960100",2496,614,90,0,127,10,0,7,3344
"29123960200",3822,1410,95,0,155,28,37,0,5547
"29123960300",3171,176,0,0,0,0,8,0,3355
"29125880100",2089,785,0,20,0,39,19,31,2983
"29125880298",2173,367,0,0,118,0,0,0,2658
"29125880300",2753,462,0,18,94,30,0,0,3357
"29127960100",3742,384,49,17,140,0,0,0,4332
"29127960200",2745,406,7,1,51,22,15,0,3247
"29127960300",2800,537,10,6,57,50,2,0,3462
"29127960400",2715,743,86,287,49,138,10,44,4072
"29127960500",1737,747,278,104,92,0,22,0,2980
"29127960600",2634,327,126,1,132,18,20,1,3259
"29127960800",2103,443,257,9,72,30,228,12,3154
"29127960900",2182,717,249,33,83,0,45,0,3309
"29129470100",1275,255,5,3,23,0,0,0,1561
"29129470200",1701,322,4,4,47,0,28,9,2115
"29131962500",5628,527,0,0,82,84,27,3,6351
"29131962600",2856,568,0,0,45,0,35,0,3504
"29131962700",3404,534,56,0,50,13,14,0,4071
"29131962800",4670,627,3,3,75,173,17,168,5736
"29131962900",2718,2134,0,4,48,275,61,108,5348
"29133950100",1671,417,27,69,3,62,0,0,2249
"29133950200",1665,355,1330,979,34,0,10,20,4393
"29133950300",1425,385,30,80,20,2,13,0,1955
"29133950400",2490,1183,120,96,12,14,80,73,4068
"29135385100",3437,363,0,2,164,0,68,22,4056
"29135385200",3405,474,54,0,188,0,517,27,4665
"29135385300",2739,458,11,0,83,0,74,3,3368
"29135385400",2410,572,28,8,41,8,0,1,3068
"29137960100",2858,338,90,92,110,6,8,0,3502
"29137960200",1960,382,34,16,27,7,16,37,2479
"29137960300",2174,418,0,0,46,1,26,11,2676
"29139970100",1785,340,31,37,27,40,12,0,2272
"29139970200",2823,675,32,20,11,48,7,37,3653
"29139970300",2698,388,25,1,20,57,0,0,3189
"29139970400",1995,356,0,3,18,60,89,7,2528
"29141470100",5040,1308,48,0,233,3,69,2,6703
"29141470200",2770,912,0,1,96,5,74,0,3858
"29141470300",1898,732,88,25,28,98,71,30,2970
"29141470400",1765,343,0,0,0,0,74,0,2182
"29141470500",3096,1293,0,37,25,0,36,30,4517
"29143960100",3490,621,256,109,53,21,92,2,4644
"29143960200",1084,378,339,261,30,9,26,22,2149
"29143960300",1997,303,444,337,10,98,0,3,3192
"29143960400",1502,393,285,182,59,29,9,65,2524
"29143960500",1878,610,0,2,36,1,26,5,2558
"29143960600",2068,356,310,364,50,20,23,0,3191
"29145020100",3204,753,6,92,243,64,201,376,4939
"29145020200",3608,706,57,38,310,11,270,53,5053
"29145020300",2746,530,40,4,333,30,349,63,4095
"29145020400",6504,704,0,0,280,14,325,7,7834
"29145020501",3475,380,23,0,234,0,76,3,4191
"29145020502",4012,950,68,0,186,80,253,25,5574
"29145020601",4293,465,8,4,403,19,98,60,5350
"29145020602",3365,422,115,0,485,0,40,17,4444
"29145020700",3287,555,15,0,710,157,34,4,4762
"29145020800",4260,983,10,0,441,223,103,93,6113
"29145020900",3279,559,7,0,57,117,23,23,4065
"29145021000",3047,501,0,0,269,16,309,52,4194
"29147470100",1849,373,0,0,27,33,1,6,2289
"29147470200",2200,346,0,12,53,4,12,3,2630
"29147470300",3655,1976,22,32,79,55,6,27,5852
"29147470400",2381,1970,8,87,118,42,22,74,4702
"29147470500",3757,711,19,19,45,22,11,19,4603
"29149480100",2629,1081,0,0,121,96,17,0,3944
"29149480200",3349,905,0,0,141,51,109,0,4555
"29149480300",1632,646,0,0,28,45,34,0,2385
"29151490100",3393,175,0,0,7,0,9,0,3584
"29151490200",3617,466,49,0,44,47,25,0,4248
"29151490300",3147,235,0,28,1,0,14,48,3473
"29151490400",2072,188,29,0,5,0,0,3,2297
"29153470100",3574,891,2,0,70,159,9,133,4838
"29153470200",3417,1226,0,0,73,16,10,0,4742
"29155470100",1428,437,110,133,10,22,16,6,2162
"29155470200",1216,160,953,953,62,3,18,4,3369
"29155470300",1637,310,508,385,88,44,41,14,3027
"29155470400",1576,347,324,899,21,0,41,48,3256
"29155470500",2088,548,109,25,70,1,33,2,2876
"29155470600",2004,596,193,150,89,55,141,34,3262
"29157470100",2186,289,0,0,13,0,0,61,2549
"29157470200",4511,422,0,0,85,0,71,0,5089
"29157470300",3356,383,0,0,115,6,75,0,3935
"29157470400",3082,475,0,0,101,42,149,19,3868
"29157470500",3444,181,96,0,0,0,26,0,3747
"29159480100",3301,345,2,0,86,125,25,6,3890
"29159480200",4777,497,39,0,579,117,653,175,6837
"29159480300",3384,547,9,10,27,26,22,2,4027
"29159480400",3498,528,38,2,96,13,109,32,4316
"29159480500",2556,605,0,0,46,0,0,23,3230
"29159480600",734,663,190,66,221,240,82,277,2473
"29159480700",2629,665,19,6,95,43,190,37,3684
"29159480800",1876,622,268,132,86,46,165,8,3203
"29159480900",1694,646,73,12,42,60,162,25,2714
"29159481000",3117,683,34,46,479,35,414,0,4808
"29159481100",3422,669,131,9,335,26,698,277,5567
"29161890100",3839,472,0,5,14,69,0,16,4415
"29161890200",3583,628,8,0,247,133,54,31,4684
"29161890300",4915,1335,168,189,628,86,232,78,7631
"29161890400",1463,1228,64,166,454,436,90,39,3940
"29161890500",3009,734,26,0,96,24,6,22,3917
"29161890600",2465,404,5,0,87,0,0,24,2985
"29161890700",2608,588,0,5,154,6,1,1,3363
"29161890800",1731,495,83,0,73,1,0,0,2383
"29161890900",3703,381,17,84,251,23,138,23,4620
"29161891000",4104,497,0,148,65,0,269,0,5083
"29163460100",2410,370,111,0,274,66,118,57,3406
"29163460200",2576,466,28,8,31,0,38,0,3147
"29163460300",3609,316,1,4,46,6,15,0,3997
"29163460400",2595,647,203,27,107,39,27,14,3659
"29163460500",1639,497,76,32,25,4,14,8,2295
"29165030001",5418,779,938,505,342,0,378,297,8657
"29165030002",1592,337,314,29,203,218,42,115,2850
"29165030101",3061,181,105,20,321,14,226,49,3977
"29165030102",2139,142,374,14,307,52,114,48,3190
"29165030103",5028,239,186,19,166,14,316,61,6029
"29165030201",1865,26,108,23,108,0,92,0,2222
"29165030205",5283,230,550,224,563,10,345,0,7205
"29165030207",4637,534,227,0,192,0,340,48,5978
"29165030208",2610,91,3,4,115,0,78,16,2917
"29165030209",6317,305,475,0,595,121,619,58,8490
"29165030210",1645,34,112,0,205,5,26,6,2033
"29165030211",1856,38,280,280,220,145,416,0,3235
"29165030305",7163,698,254,0,655,153,324,30,9277
"29165030306",3416,154,72,0,90,14,41,14,3801
"29165030307",0,0,0,0,0,0,0,0,0
"29165030308",3788,105,118,20,567,37,299,37,4971
"29165030401",5279,104,99,6,89,0,154,39,5770
"29165030500",4694,577,365,98,261,0,272,61,6328
"29165030600",6483,331,57,3,221,33,119,26,7273
"29165030700",3150,131,0,3,74,6,23,2,3389
"29167960100",4237,1196,10,3,236,105,109,7,5903
"29167960200",5411,1403,37,8,36,5,99,0,6999
"29167960300",6691,1532,0,50,220,79,121,4,8697
"29167960400",7126,1020,4,70,311,44,105,176,8856
"29169470101",3052,523,4,30,147,22,71,49,3898
"29169470102",2034,562,42,0,147,18,83,14,2900
"29169470286",2615,213,209,0,443,69,215,56,3820
"29169470287",4782,564,759,616,1450,462,1020,238,9891
"29169470389",1102,193,283,4,336,0,240,3,2161
"29169470390",921,36,501,147,415,17,535,0,2572
"29169470400",8135,886,1026,182,809,100,431,240,11809
"29169470500",4325,706,246,33,141,66,182,54,5753
"29169470600",2532,305,1026,0,551,27,551,8,5000
"29171960100",2368,361,9,0,38,0,1,0,2777
"29171960200",1448,547,9,1,30,17,52,4,2108
"29173470100",2819,418,83,21,21,2,0,2,3366
"29173470200",3071,479,42,0,54,67,33,72,3818
"29173470300",2767,260,1,0,22,7,0,11,3068
"29175490100",3108,526,0,38,120,11,51,41,3895
"29175490200",2794,399,14,31,91,40,58,0,3427
"29175490300",2544,1237,109,68,151,86,44,0,4239
"29175490400",2697,255,249,0,136,7,190,0,3534
"29175490500",3094,750,47,236,178,174,0,42,4521
"29175490600",3236,512,3,3,58,22,16,0,3850
"29177080000",6129,753,12,7,162,61,127,13,7264
"29177080100",2951,552,7,5,45,33,43,17,3653
"29177080200",4288,1151,71,167,11,108,115,62,5973
"29177080300",5128,742,14,11,233,8,39,9,6184
"29179380100",2233,590,22,5,44,21,11,51,2977
"29179380200",2700,692,20,8,27,45,12,2,3506
"29181870100",3466,822,0,0,213,12,26,44,4583
"29181870200",1864,442,0,0,61,45,2,11,2425
"29181870300",3242,1187,0,6,52,24,42,28,4581
"29181870400",1786,575,27,0,4,54,15,0,2461
"29183310100",1920,300,12,0,41,6,16,0,2295
"29183310201",3263,67,159,0,152,0,111,0,3752
"29183310202",3048,594,63,23,6,0,67,0,3801
"29183310301",3727,136,116,110,57,78,54,0,4278
"29183310302",2281,366,220,152,142,0,77,0,3238
"29183310400",1617,265,121,27,104,21,38,10,2203
"29183310501",2054,1234,21,10,435,260,482,763,5259
"29183310502",1700,246,50,11,27,6,47,5,2092
"29183310601",1293,197,15,0,64,0,89,0,1658
"29183310602",4975,31,367,54,137,59,101,36,5760
"29183310700",3473,686,158,303,187,0,21,58,4886
"29183310801",1996,68,155,19,196,19,170,7,2630
"29183310802",4492,415,358,0,139,59,218,0,5681
"29183310901",1469,61,525,59,146,40,39,0,2339
"29183310902",4160,700,186,6,297,0,251,0,5600
"29183310903",3244,287,257,7,114,60,22,43,4034
"29183311001",3286,190,297,0,515,0,59,0,4347
"29183311003",1910,172,462,13,489,68,318,27,3459
"29183311004",4182,213,115,52,523,54,0,47,5186
"29183311103",6372,118,109,0,144,0,62,0,6805
"29183311114",4626,80,77,0,204,0,54,0,5041
"29183311122",5265,249,302,340,433,9,178,9,6785
"29183311124",5493,145,104,0,501,62,178,20,6503
"29183311132",3059,35,183,0,63,0,11,0,3351
"29183311145",4338,98,182,0,214,9,25,9,4875
"29183311146",3803,56,273,0,444,0,74,0,4650
"29183311147",3789,222,153,0,110,0,25,195,4494
"29183311148",3859,72,54,14,283,0,160,0,4442
"29183311149",3356,212,145,0,318,54,162,0,4247
"29183311150",4134,101,137,0,280,56,107,17,4832
"29183311151",5033,84,170,86,751,0,64,0,6188
"29183311152",4373,95,122,0,117,0,39,9,4755
"29183311153",5542,72,530,0,559,44,46,0,6793
"29183311154",4317,106,73,0,311,0,229,11,5047
"29183311203",5328,136,295,20,175,34,188,0,6176
"29183311211",3447,148,418,6,346,0,112,0,4477
"29183311212",3234,141,114,32,455,0,17,18,4011
"29183311221",3085,175,51,0,95,39,67,0,3512
"29183311294",3471,162,257,1,186,0,245,106,4428
"29183311296",4150,103,0,0,123,27,34,18,4455
"29183311311",5128,94,204,0,326,64,298,0,6114
"29183311312",5972,159,132,0,177,11,153,0,6604
"29183311322",5278,124,260,0,195,0,100,0,5957
"29183311331",3768,198,317,29,189,18,197,18,4734
"29183311391",4514,23,134,0,189,0,249,0,5109
"29183311422",5108,341,187,0,70,63,283,14,6066
"29183311500",1396,361,33,36,33,29,24,48,1960
"29183311601",5087,223,232,0,315,0,8,0,5865
"29183311602",5048,232,181,0,326,20,302,20,6129
"29183311712",3836,161,385,0,160,36,41,26,4645
"29183311721",3096,151,230,42,163,0,70,0,3752
"29183311722",6438,536,68,70,133,0,0,207,7452
"29183311732",6394,470,387,1,268,0,248,0,7768
"29183311733",1959,129,103,0,137,4,129,0,2461
"29183311734",3121,197,26,126,198,55,72,73,3868
"29183311735",5543,72,159,0,245,28,101,0,6148
"29183311736",5411,115,529,0,870,0,111,0,7036
"29183311801",4746,238,163,0,137,0,166,0,5450
"29183311802",4944,593,222,65,141,0,37,9,6011
"29183311903",5001,610,47,0,183,0,57,0,5898
"29183311904",5324,465,87,0,569,0,588,14,7047
"29183311907",5045,533,207,101,316,0,0,0,6202
"29183311908",2500,168,185,0,108,0,122,0,3083
"29183311909",4407,215,162,10,236,0,187,38,5255
"29183312001",2457,23,7,0,29,0,13,0,2529
"29183312094",3566,136,211,207,114,45,111,21,4411
"29183312095",3900,383,64,50,380,0,81,0,4858
"29183312096",5849,212,158,0,194,0,128,0,6541
"29183312097",7158,302,175,0,183,0,173,0,7991
"29183312192",3700,60,7,10,158,0,28,0,3963
"29183312193",6559,239,167,23,112,0,71,0,7171
"29183312194",2632,160,175,4,90,12,98,0,3171
"29183312195",2459,275,103,289,151,0,37,0,3314
"29183312204",4716,199,0,0,11,0,34,0,4960
"29183312205",6784,1132,203,52,245,0,375,0,8791
"29183312206",4048,95,0,3,58,0,24,0,4228
"29183312300",3069,19,9,0,0,0,11,0,3108
"29183312400",3643,575,236,32,78,22,60,0,4646
"29183980000",0,0,0,0,0,0,0,0,0
"29185480100",2599,904,0,32,86,38,67,22,3748
"29185480200",2140,469,0,0,44,12,73,0,2738
"29185480300",2176,694,0,0,57,7,29,0,2963
"29186960100",5445,735,24,0,18,20,81,0,6323
"29186960200",3486,1090,0,11,387,26,23,0,5023
"29186960300",3644,245,27,0,14,0,0,0,3930
"29186960400",2138,407,31,6,7,0,3,70,2662
"29187950101",3539,640,0,0,42,4,50,0,4275
"29187950102",3853,752,0,0,28,23,34,64,4754
"29187950300",3345,604,22,33,14,0,34,17,4069
"29187950400",4932,1593,0,15,63,166,49,175,6993
"29187950600",2496,584,0,0,13,4,22,12,3131
"29187950700",6649,1331,12,56,0,16,40,0,8104
"29187950800",5448,604,23,25,286,51,93,20,6550
"29187950901",1985,424,0,0,15,0,0,0,2424
"29187950902",3631,688,43,8,84,4,77,4,4539
"29187951000",4894,1589,42,26,68,0,42,0,6661
"29187951100",5098,1775,41,29,27,94,19,0,7083
"29189210100",1720,147,2792,1266,19,245,61,123,6373
"29189210200",759,61,3705,1770,0,96,16,0,6407
"29189210300",862,255,1423,774,96,141,66,99,3716
"29189210400",365,19,2876,840,62,56,12,0,4230
"29189210501",253,0,2188,838,164,126,0,0,3569
"29189210502",106,31,2277,825,51,31,0,0,3321
"29189210600",1141,183,3365,1278,165,73,90,0,6295
"29189210702",951,101,3804,1149,301,74,42,0,6422
"29189210703",521,146,2424,479,195,12,0,25,3802
"29189210704",355,20,1811,787,192,6,0,0,3171
"29189210803",1605,35,2748,111,245,4,14,0,4762
"29189210804",1068,110,6317,890,846,58,63,0,9352
"29189210805",701,110,4314,586,16,32,0,2,5761
"29189210806",577,68,4034,850,54,14,58,1,5656
"29189210912",2723,139,2985,221,353,13,57,25,6516
"29189210921",1844,99,1623,515,209,0,9,0,4299
"29189210923",2878,172,1680,330,246,37,64,152,5559
"29189210924",1668,69,2393,192,605,0,103,0,5030
"29189210925",2451,151,2541,71,146,0,57,0,5417
"29189210926",1714,161,838,70,95,7,71,0,2956
"29189210927",1874,25,2251,228,61,0,198,17,4654
"29189210928",1043,201,2377,311,318,44,148,0,4442
"29189211000",2881,613,2838,142,645,0,0,0,7119
"29189211101",3577,394,2169,115,253,28,169,0,6705
"29189211102",1607,118,2074,606,679,0,34,0,5118
"29189211201",2786,408,2086,347,179,123,73,54,6056
"29189211202",2569,168,250,49,176,8,67,22,3309
"29189211301",4855,97,558,425,298,13,45,26,6317
"29189211331",4110,334,1156,192,242,83,58,0,6175
"29189211332",4553,270,558,159,388,298,40,224,6490
"29189211333",2482,52,1601,200,207,71,15,11,4639
"29189211334",3206,270,432,39,105,69,125,0,4246
"29189211401",3538,345,877,253,416,0,68,201,5698
"29189211402",626,146,998,52,187,6,1,15,2031
"29189211500",117,45,2348,577,7,103,14,103,3314
"29189211600",1613,145,2848,978,153,339,0,4,6080
"29189211700",1629,84,2155,416,98,17,45,0,4444
"29189211801",640,44,2448,840,40,145,27,0,4184
"29189211802",369,0,2368,502,25,98,27,0,3389
"29189211900",388,13,2496,2273,122,57,17,0,5366
"29189212001",499,25,4754,2420,0,16,11,0,7725
"29189212002",175,38,1607,740,7,57,0,0,2624
"29189212101",112,31,2397,1334,130,185,84,209,4482
"29189212102",126,30,2124,838,40,9,0,0,3167
"29189212200",94,17,4487,2022,40,0,0,2,6662
"29189212300",715,117,2853,903,228,18,1,8,4843
"29189212400",319,25,1595,686,95,72,0,23,2815
"29189212500",1241,37,2595,1149,40,116,124,64,5366
"29189212600",2045,221,1697,809,166,114,17,0,5069
"29189212700",1332,86,3027,603,69,44,34,0,5195
"29189213101",2783,448,779,196,33,0,18,180,4437
"29189213102",235,52,8,9,14,0,10,0,328
"29189213202",3895,322,325,19,1495,97,233,0,6386
"29189213203",3581,274,287,253,146,18,33,29,4621
"29189213204",2031,198,543,283,642,103,546,140,4486
"29189213300",3437,559,2540,421,914,259,489,82,8701
"29189213400",3471,672,1208,497,572,63,343,158,6984
"29189213500",2987,278,1613,202,152,0,169,56,5457
"29189213600",420,141,2130,1189,192,65,54,0,4191
"29189213700",1100,167,2217,825,127,126,13,69,4644
"29189213800",136,23,3420,1440,79,56,55,3,5212
"29189213900",14,18,795,1008,9,20,4,0,1868
"29189214100",23,0,898,332,90,8,0,0,1351
"29189214200",153,64,2123,1062,45,9,0,0,3456
"29189214300",1056,257,1467,621,189,183,112,126,4011
"29189214400",2900,598,1069,56,199,70,444,40,5376
"29189214500",2095,423,356,231,196,55,217,18,3591
"29189214601",2526,448,648,62,148,69,62,2,3965
"29189214602",2474,536,788,176,25,13,142,138,4292
"29189214700",3370,1313,983,540,377,33,307,455,7378
"29189214800",3509,444,636,151,274,106,100,177,5397
"29189214900",3519,471,1447,276,743,63,617,175,7311
"29189215001",1497,48,162,234,756,153,66,0,2916
"29189215003",3579,169,203,144,253,0,113,0,4461
"29189215004",1792,287,403,30,285,94,76,24,2991
"29189215005",3772,446,633,44,949,119,43,0,6006
"29189215102",3449,270,414,28,749,103,390,0,5403
"29189215103",1776,25,276,0,389,0,58,0,2524
"29189215105",1829,108,52,26,354,60,253,0,2682
"29189215141",3512,59,170,10,436,0,49,9,4245
"29189215142",3693,280,1257,150,1279,139,477,37,7312
"29189215143",2854,148,63,42,47,0,10,5,3169
"29189215144",4157,358,550,14,773,55,229,86,6222
"29189215201",3818,403,611,53,967,175,185,70,6282
"29189215202",4748,338,620,0,831,14,121,0,6672
"29189215231",3867,244,52,11,356,9,135,0,4674
"29189215232",5677,285,363,24,1209,44,23,10,7635
"29189215301",3442,134,194,34,587,20,75,0,4486
"29189215302",2774,29,60,7,182,5,43,0,3100
"29189215400",4570,84,92,13,276,0,92,0,5127
"29189215500",3645,80,423,0,477,42,78,42,4787
"29189215600",1607,179,2018,229,868,148,288,181,5518
"29189215700",1257,123,3185,832,181,610,330,233,6751
"29189215800",5844,459,1459,145,206,92,173,34,8412
"29189215900",1573,122,3710,672,156,163,71,163,6630
"29189216000",162,37,789,188,75,0,13,0,1264
"29189216100",2193,749,531,707,425,369,119,101,5194
"29189216200",5963,579,606,48,402,236,296,13,8143
"29189216300",2276,164,38,2,158,86,99,0,2823
"29189216400",4070,211,256,21,565,261,57,0,5441
"29189216500",2961,170,18,18,352,25,89,0,3633
"29189216600",1605,72,172,0,104,0,44,0,1997
"29189216700",2155,157,610,112,233,73,48,1,3389
"29189216800",2518,226,170,13,194,45,150,14,3330
"29189216900",1383,241,332,81,0,65,21,0,2123
"29189217000",2685,593,363,216,124,18,50,0,4049
"29189217200",1087,177,202,76,225,92,47,17,1923
"29189217300",2553,151,78,2,378,116,88,0,3366
"29189217400",3943,140,79,0,210,12,125,0,4509
"29189217500",4875,48,88,2,329,0,99,0,5441
"29189217600",6337,268,28,15,276,0,70,4,6998
"29189217701",4302,140,114,0,504,24,147,0,5231
"29189217702",5890,63,119,16,752,59,122,0,7021
"29189217802",6372,22,93,2,803,0,160,0,7452
"29189217806",4713,452,164,4,211,112,303,0,5959
"29189217807",5285,197,196,13,286,24,124,0,6125
"29189217841",4301,150,155,48,657,191,394,0,5896
"29189217842",5602,199,179,12,710,120,151,29,7002
"29189217851",2827,24,119,0,144,0,48,0,3162
"29189217852",5552,92,52,0,366,0,103,0,6165
"29189217921",4318,77,10,14,247,0,103,0,4769
"29189217923",5852,340,262,2,767,13,154,22,7412
"29189217931",5752,104,169,0,405,0,258,3,6691
"29189217932",3764,110,52,0,741,14,41,0,4722
"29189217941",4553,197,213,13,573,0,98,13,5660
"29189217942",4624,146,157,0,411,42,11,0,5391
"29189217943",3172,92,15,7,377,0,53,0,3716
"29189217944",4919,99,52,0,487,0,39,0,5596
"29189218003",6514,221,138,0,457,33,148,33,7544
"29189218011",4928,662,182,152,1368,143,565,142,8142
"29189218012",4025,88,48,20,193,0,78,0,4452
"29189218102",2572,194,14,381,201,0,0,0,3362
"29189218103",4336,333,73,0,462,167,90,21,5482
"29189218201",2841,77,74,0,128,9,47,0,3176
"29189218300",3206,166,402,71,109,34,44,1,4033
"29189218401",3562,54,23,12,24,0,11,0,3686
"29189218402",4304,191,41,0,197,0,167,0,4900
"29189218500",4300,152,59,9,168,39,220,0,4947
"29189218600",1775,137,396,106,50,1,24,0,2489
"29189218800",5631,72,25,0,200,0,46,0,5974
"29189218900",4175,378,1239,166,528,0,143,0,6629
"29189219100",3685,152,8,9,129,0,93,7,4083
"29189219200",1924,160,112,50,83,13,24,8,2374
"29189219300",1603,85,93,12,97,28,44,0,1962
"29189219400",5994,28,55,21,165,0,185,0,6448
"29189219500",5898,130,0,55,32,0,264,0,6379
"29189219600",5011,537,118,15,624,13,136,64,6518
"29189219700",5134,465,142,19,37,109,122,29,6057
"29189219800",6146,667,192,227,534,59,146,161,8132
"29189219900",5191,502,9,2,788,2,245,0,6739
"29189220001",4215,187,38,0,101,38,0,0,4579
"29189220002",2878,154,44,7,145,7,46,0,3281
"29189220100",5767,1172,131,0,307,192,94,3,7666
"29189220200",4447,497,152,17,112,19,90,19,5353
"29189220300",1214,422,72,106,30,43,34,5,1926
"29189220431",7065,570,227,12,348,124,542,38,8926
"29189220432",7545,214,187,46,216,0,138,0,8346
"29189220441",5747,194,94,0,159,0,182,0,6376
"29189220442",4100,167,18,0,93,19,92,0,4489
"29189220443",3343,343,41,51,101,16,31,0,3926
"29189220444",7436,321,0,0,61,160,0,0,7978
"29189220445",4645,132,11,2,78,0,15,7,4890
"29189220446",4561,104,0,0,27,8,97,0,4797
"29189220501",5230,921,137,71,255,59,140,0,6813
"29189220502",5230,612,447,37,250,110,118,0,6804
"29189220601",5544,304,41,117,244,0,86,0,6336
"29189220602",4907,568,49,0,290,43,114,0,5971
"29189220701",2365,237,43,2,101,14,118,9,2889
"29189220702",3417,72,0,0,167,0,61,0,3717
"29189220703",2416,61,0,0,56,0,48,0,2581
"29189220801",4329,426,117,0,50,78,117,58,5175
"29189220802",4173,245,0,120,182,21,329,0,5070
"29189220803",4176,77,130,16,221,0,125,0,4745
"29189221000",2013,83,576,88,185,0,190,0,3135
"29189221100",1722,71,19,7,49,3,22,0,1893
"29189221201",2796,252,27,0,200,0,2,0,3277
"29189221202",5411,234,151,2,104,0,0,0,5902
"29189221301",7367,569,0,1,66,50,31,0,8084
"29189221302",5977,377,107,0,209,17,124,0,6811
"29189221332",4129,179,19,0,211,0,57,0,4595
"29189221335",5439,144,199,1,125,0,121,0,6029
"29189221421",6579,133,48,0,316,0,135,0,7211
"29189221422",7557,663,0,2,213,80,200,0,8715
"29189221423",3640,234,20,0,85,5,32,0,4016
"29189221424",4609,225,17,0,188,10,83,0,5132
"29189221502",5517,172,0,1,217,1,117,0,6025
"29189221503",5177,334,31,0,387,73,100,0,6102
"29189221506",4209,7,44,9,459,0,152,0,4880
"29189221621",3859,198,30,0,101,118,40,0,4346
"29189221624",2940,102,68,0,316,0,54,0,3480
"29189221625",5968,621,59,53,291,29,273,0,7294
"29189221626",5954,296,120,8,308,0,243,0,6929
"29189221627",5700,173,166,0,333,0,164,12,6548
"29189221628",4973,449,171,2,1105,48,58,0,6806
"29189221629",4533,160,20,5,545,0,99,10,5372
"29189221800",331,76,2154,810,8,118,6,0,3503
"29189221900",2945,132,105,0,278,0,113,8,3581
"29189222000",3178,80,64,5,8,23,63,1,3422
"29189222100",4554,62,52,0,169,7,80,0,4924
"29195090100",1708,412,103,17,297,0,102,7,2646
"29195090200",1980,220,30,2,31,17,40,14,2334
"29195090300",1897,408,127,0,241,451,400,216,3740
"29195090400",1651,435,148,191,359,0,310,0,3094
"29195090500",2619,406,34,15,117,0,169,0,3360
"29195090600",1708,402,136,0,398,75,455,104,3278
"29195090700",2152,310,69,11,55,2,8,6,2613
"29195090800",2234,395,23,6,58,33,34,160,2943
"29197470100",1513,536,8,4,22,0,24,2,2109
"29197470200",1809,372,2,0,38,2,0,0,2223
"29199480100",2382,273,26,0,9,1,44,2,2737
"29199480200",1538,443,0,13,3,0,9,0,2006
"29201780100",2377,714,24,1,120,28,114,0,3378
"29201780200",3101,630,0,0,65,27,20,27,3870
"29201780300",2233,468,0,17,13,32,63,38,2864
"29201780400",3936,877,108,57,130,49,44,17,5218
"29201780600",3466,502,369,42,86,13,43,5,4526
"29201780700",1101,221,1231,402,90,0,0,64,3109
"29201781000",3116,604,1,3,24,9,38,149,3944
"29201781100",2732,597,1,0,28,38,19,52,3467
"29201781200",3027,813,921,673,103,191,101,0,5829
"29201781300",2221,324,169,153,10,7,25,7,2916
"29203470100",2682,580,9,0,19,155,0,6,3451
"29203470200",3413,1165,0,6,133,32,122,20,4891
"29205450100",1600,245,6,15,6,2,5,2,1881
"29205450200",2004,377,2,0,7,7,0,26,2423
"29205450300",1223,432,0,12,1,2,25,21,1716
"29207470100",2983,741,8,3,11,20,15,0,3781
"29207470200",3692,571,0,12,3,2,98,8,4386
"29207470300",3761,496,0,1,1,2,31,0,4292
"29207470400",2741,312,47,62,32,31,64,27,3316
"29207470500",2435,829,0,0,124,36,60,0,3484
"29207470600",3897,649,65,0,25,29,22,0,4687
"29207470700",1805,515,69,141,64,0,49,19,2662
"29207470800",2838,131,12,0,4,0,71,0,3056
"29209090100",6384,1202,0,0,108,84,46,112,7936
"29209090200",3784,935,0,0,125,84,71,49,5048
"29209090400",4075,524,0,2,106,18,38,20,4783
"29209090500",4707,661,2,2,95,0,58,3,5528
"29209090601",3023,133,2,0,121,0,23,0,3302
"29209090602",3228,1352,0,9,116,141,174,14,5034
"29211480100",1938,189,0,0,20,11,35,12,2205
"29211480200",1104,173,3,3,65,2,27,6,1383
"29211480300",2004,638,37,8,192,42,747,352,4020
"29213480105",4998,719,46,11,397,139,179,93,6582
"29213480106",1530,275,12,53,237,102,264,102,2575
"29213480201",7724,1455,93,33,411,141,339,283,10479
"29213480202",4606,1742,3,7,380,303,249,295,7585
"29213480301",4375,263,76,10,321,16,93,6,5160
"29213480302",3665,504,0,0,154,0,136,72,4531
"29213480401",4079,1538,0,0,87,11,104,28,5847
"29213480402",1913,519,4,14,59,88,0,7,2604
"29213480501",1495,133,0,0,0,53,0,0,1681
"29213480502",5126,1602,0,0,160,94,422,94,7498
"29215480100",5018,929,16,0,86,69,146,39,6303
"29215480200",3796,1172,17,2,178,82,14,0,5261
"29215480300",5208,1143,15,0,283,140,95,98,6982
"29215480400",4191,1594,0,0,32,83,79,26,6005
"29217950100",2335,622,2,0,81,18,10,17,3085
"29217950200",2056,355,0,0,41,0,0,0,2452
"29217950300",3929,1060,14,25,230,0,0,309,5567
"29217950400",2198,1079,31,0,67,34,0,9,3418
"29217950500",2714,196,8,0,99,0,11,0,3028
"29217950600",2462,375,11,0,8,0,8,0,2864
"29219820101",5244,1055,30,207,205,25,153,467,7386
"29219820102",6147,1143,103,32,237,158,31,36,7887
"29219820103",6901,859,187,125,234,0,71,0,8377
"29219820201",2072,148,3,11,70,159,52,159,2674
"29219820202",6679,581,0,2,74,2,64,6,7408
"29221460100",4241,1875,13,1,181,70,2,10,6393
"29221460200",4058,860,0,0,162,13,24,7,5124
"29221460300",2691,860,13,51,30,23,15,0,3683
"29221460400",3472,828,0,0,75,2,0,0,4377
"29221460500",3605,423,0,0,140,24,0,0,4192
"29223690100",2604,554,0,0,15,47,0,19,3239
"29223690200",2760,593,0,4,98,5,60,2,3522
"29223690300",2905,1158,20,0,82,10,30,34,4239
"29223690400",1665,568,20,0,30,21,24,4,2332
"29225470101",3611,444,0,0,35,103,28,81,4302
"29225470102",4619,651,48,0,147,19,149,0,5633
"29225470201",4445,651,66,0,99,114,70,93,5538
"29225470202",2758,790,0,20,232,36,123,10,3969
"29225470301",4520,504,5,29,160,12,47,0,5277
"29225470302",3361,1913,15,15,43,16,0,0,5363
"29225470401",2692,882,8,0,74,54,29,15,3754
"29225470402",1871,473,3,5,50,2,3,6,2413
"29227960100",1720,250,0,0,10,44,25,4,2053
"29229490100",2720,779,0,0,60,34,83,0,3676
"29229490200",2802,1247,0,0,95,20,3,22,4189
"29229490300",3953,1008,31,5,88,61,47,58,5251
"29229490400",3571,1355,96,1,98,84,98,0,5303
"29510101100",2008,105,143,0,200,135,106,135,2832
"29510101200",2588,428,87,0,154,8,60,8,3333
"29510101300",3218,146,290,114,272,0,112,0,4152
"29510101400",1462,243,500,197,216,132,72,30,2852
"29510101500",1834,302,600,728,173,89,370,4,4100
"29510101800",1541,619,740,337,127,88,109,228,3789
"29510102100",2056,232,281,28,189,0,144,0,2930
"29510102200",5850,266,55,4,96,84,435,30,6820
"29510102300",1502,320,4,31,112,0,12,38,2019
"29510102400",1839,548,143,81,24,13,123,27,2798
"29510102500",1545,187,82,12,168,17,97,17,2125
"29510103100",2549,225,307,39,100,0,51,0,3271
"29510103400",1628,170,23,19,32,1,53,0,1926
"29510103600",914,211,25,21,247,30,29,0,1477
"29510103700",1912,237,156,0,86,17,101,4,2513
"29510103800",3248,184,329,11,118,0,35,0,3925
"29510104200",2711,269,118,55,146,79,119,100,3597
"29510104500",1138,159,135,12,132,20,54,0,1650
"29510105198",1991,647,392,59,257,125,71,22,3564
"29510105200",1171,107,1257,175,176,86,12,22,3006
"29510105300",208,26,1420,658,100,14,63,0,2489
"29510105400",132,86,1292,622,101,94,104,40,2471
"29510105500",126,0,1846,942,67,0,0,0,2981
"29510106100",0,12,1008,671,7,26,0,5,1729
"29510106200",0,0,640,1167,0,9,0,0,1816
"29510106300",16,0,979,427,28,5,3,5,1463
"29510106400",18,0,1678,719,12,18,12,0,2457
"29510106500",0,14,1787,628,35,4,7,0,2475
"29510106600",0,0,792,874,5,4,0,0,1675
"29510106700",1,1,1661,1233,0,44,1,0,2941
"29510107200",6,0,671,452,22,0,0,0,1151
"29510107300",72,0,3168,1353,22,9,22,6,4652
"29510107400",22,0,1503,1416,0,0,0,0,2941
"29510107500",29,0,1770,576,27,18,0,0,2420
"29510107600",35,7,1380,744,5,0,0,0,2171
"29510108100",107,0,2335,652,16,0,1,0,3111
"29510108200",39,7,1587,620,34,24,19,0,2330
"29510108300",91,28,1368,473,20,0,0,4,1984
"29510109600",42,3,2295,842,24,0,13,0,3219
"29510109700",54,208,949,988,0,16,0,37,2252
"29510110100",38,1,1922,856,23,30,12,30,2912
"29510110200",6,0,1332,949,22,0,0,0,2309
"29510110300",8,44,1447,469,0,0,0,21,1989
"29510110400",2,4,1493,622,26,0,0,0,2147
"29510110500",0,5,633,362,13,0,0,0,1013
"29510111100",15,19,774,865,0,17,0,0,1690
"29510111200",8,16,432,482,4,9,0,0,951
"29510111300",0,0,910,426,0,0,0,0,1336
"29510111400",2,4,840,517,0,28,0,0,1391
"29510111500",0,1,247,349,22,0,0,0,619
"29510112100",2515,308,1041,199,259,35,66,0,4423
"29510112200",85,5,894,607,0,0,30,0,1621
"29510112300",23,0,1067,920,28,0,0,0,2038
"29510112400",2073,396,758,192,434,68,132,35,4088
"29510113500",1912,254,0,37,15,13,7,8,2246
"29510114101",2614,502,695,175,234,92,92,0,4404
"29510114102",3643,228,55,61,0,0,0,0,3987
"29510114200",3487,226,407,115,152,323,132,0,4842
"29510114300",4525,130,95,68,427,36,195,0,5476
"29510115100",2610,703,212,143,221,127,341,84,4441
"29510115200",1178,293,704,690,344,101,112,69,3491
"29510115300",2243,567,1225,455,647,111,216,103,5567
"29510115400",1532,467,512,294,253,127,76,31,3292
"29510115500",1987,1240,2010,1533,271,28,535,237,7841
"29510115600",1461,516,1025,1162,244,81,236,152,4877
"29510115700",1065,646,755,901,135,167,275,367,4311
"29510116100",1450,188,535,294,406,274,307,39,3493
"29510116200",2750,227,561,290,424,15,206,0,4473
"29510116301",2346,186,477,206,288,94,274,38,3909
"29510116302",550,223,663,334,355,352,286,148,2911
"29510116400",864,461,1645,1226,529,163,484,57,5429
"29510116500",1725,366,1026,589,570,203,210,114,4803
"29510117100",944,108,259,5,108,45,31,0,1500
"29510117200",2328,375,1699,744,170,207,45,9,5577
"29510117400",2133,351,1038,215,314,49,60,9,4169
"29510118100",359,55,454,269,23,0,84,0,1244
"29510118400",55,90,156,147,0,30,7,8,493
"29510118600",1056,354,839,403,104,157,113,19,3045
"29510119101",949,316,556,331,273,141,50,28,2644
"29510119102",1440,487,389,171,283,300,16,25,3111
"29510119200",508,98,808,197,116,19,31,0,1777
"29510119300",376,741,672,249,227,327,59,62,2713
"29510120200",109,15,425,659,9,63,0,0,1280
"29510121100",59,149,639,709,8,31,0,0,1595
"29510121200",30,5,850,1596,22,5,38,0,2546
"29510123100",874,96,2077,479,71,23,116,8,3744
"29510123200",1360,87,315,325,110,13,10,0,2220
"29510123300",1864,144,596,221,68,0,33,24,2950
"29510124100",1038,425,1541,1669,291,304,299,202,5769
"29510124200",774,137,934,1062,239,176,190,99,3611
"29510124300",1886,280,473,217,99,9,63,0,3027
"29510124600",451,189,265,878,26,130,0,95,2034
"29510125500",1530,319,623,107,197,47,35,0,2858
"29510125600",1616,176,1195,282,238,37,63,52,3659
"29510125700",15,23,1280,2427,7,0,0,0,3752
"29510126600",334,120,1246,1363,0,0,45,0,3108
"29510126700",261,171,303,328,19,7,0,5,1094
"29510126800",2728,288,173,21,230,40,110,35,3625
"29510126900",54,87,2528,1644,76,12,10,4,4415
"29510127000",129,47,666,284,9,0,9,7,1151
"29510127100",35,14,1066,833,5,0,7,9,1969
"29510127200",2766,435,756,144,327,47,29,0,4504
"29510127300",932,318,1268,723,105,51,52,117,3566
"29510127400",1508,269,1247,2196,47,59,76,0,5402
"29510127500",439,33,1175,786,40,0,43,0,2516
"29510127600",2285,184,432,115,105,8,25,0,3154
"30001000100",1052,179,2,5,17,0,25,8,1288
"30001000200",2831,413,0,5,109,21,53,23,3455
"30001000300",3160,823,0,0,229,0,190,27,4429
"30003000100",2807,139,0,0,1070,728,388,35,5167
"30003940400",137,19,0,0,784,752,50,4,1746
"30003940500",335,91,0,12,470,277,40,2,1227
"30003940600",487,40,0,0,1763,1180,101,49,3620
"30003940700",246,30,0,0,1077,520,11,4,1888
"30005000100",674,148,0,0,321,160,5,6,1314
"30005000200",1888,291,11,0,91,34,43,12,2370
"30005940100",27,0,5,0,768,581,41,39,1461
"30005940200",31,7,0,0,865,574,1,0,1478
"30007000100",1663,294,0,0,100,39,48,11,2155
"30007000200",3226,188,0,35,97,0,30,0,3576
"30009000100",2145,157,0,0,57,0,55,0,2414
"30009000200",1777,215,0,0,109,16,68,30,2215
"30009000300",1733,442,0,0,62,10,0,74,2321
"30009000400",1936,75,0,0,37,11,6,0,2065
"30009000500",1149,206,0,0,55,5,11,1,1427
"30011000300",1035,141,0,0,17,0,6,2,1201
"30013000100",1991,320,0,0,149,25,133,29,2647
"30013000200",3196,218,57,0,275,16,77,0,3839
"30013000300",2329,513,0,0,283,258,105,115,3603
"30013000400",1110,470,5,0,194,212,73,77,2141
"30013000700",1054,387,85,35,262,320,152,106,2401
"30013000800",1264,225,14,0,104,130,71,68,1876
"30013000900",1957,761,41,38,76,330,46,59,3308
"30013001000",2706,241,13,3,122,14,9,0,3108
"30013001100",3285,737,71,3,165,82,73,31,4447
"30013001200",2313,70,339,0,319,4,497,9,3551
"30013001600",2827,1320,3,0,348,166,69,130,4863
"30013001700",1921,138,0,0,157,0,87,0,2303
"30013001800",3005,152,8,2,330,140,114,53,3804
"30013001900",5469,193,0,0,460,0,17,0,6139
"30013002100",3151,772,0,0,179,194,58,0,4354
"30013002200",5435,234,37,0,573,70,355,19,6723
"30013002300",6688,309,57,0,375,56,145,0,7630
"30013010100",2647,690,0,0,290,26,0,0,3653
"30013010400",1582,163,0,0,38,15,9,0,1807
"30013010600",3070,316,7,0,164,35,57,0,3649
"30013010700",3233,533,15,0,177,48,57,0,4063
"30013010800",1431,711,53,0,144,517,44,136,3036
"30015010200",1678,175,0,0,52,0,11,0,1916
"30015010300",2150,379,4,0,551,787,27,84,3982
"30017961300",1842,159,0,0,38,18,11,0,2068
"30017961500",1335,246,0,0,80,15,53,15,1744
"30017961600",1923,157,0,0,76,11,110,0,2277
"30017961800",1417,62,0,0,34,12,5,0,1530
"30017961900",1713,154,0,0,83,13,52,0,2015
"30017962000",1577,362,0,34,77,55,75,0,2180
"30019020300",1601,97,0,0,23,3,44,0,1768
"30021000100",1229,170,0,0,27,2,11,0,1439
"30021000200",2401,340,0,0,15,4,16,11,2787
"30021000300",3782,651,15,43,192,0,176,0,4859
"30023000300",2044,394,74,10,69,71,6,42,2710
"30023000400",2494,380,0,0,26,22,65,0,2987
"30023000500",2285,567,0,3,194,52,53,49,3203
"30025000100",2711,198,40,0,62,0,29,0,3040
"30027030100",3632,748,15,5,122,28,26,9,4585
"30027030200",5802,504,0,0,360,2,7,47,6722
"30029000100",2088,668,0,28,173,108,51,12,3128
"30029000201",3773,1028,0,0,39,77,62,4,4983
"30029000202",2239,116,0,0,296,0,124,0,2775
"30029000203",3558,489,0,0,189,12,53,12,4313
"30029000300",4295,285,0,0,108,0,113,0,4801
"30029000401",4334,415,0,0,5,0,16,0,4770
"30029000402",2286,393,0,0,14,0,59,0,2752
"30029000601",3712,304,43,0,205,11,79,19,4373
"30029000602",3222,436,33,0,66,14,29,54,3854
"30029000700",4509,696,0,0,593,56,632,0,6486
"30029000800",6397,544,0,0,86,97,56,0,7180
"30029000900",6019,1072,32,0,306,353,195,144,8121
"30029001000",1550,364,0,0,88,21,16,16,2055
"30029001100",4807,1144,0,0,103,48,0,70,6172
"30029001200",5715,583,66,0,362,19,73,19,6837
"30029001301",2905,270,0,0,142,80,110,22,3529
"30029001302",4278,572,0,25,76,12,100,8,5071
"30029001400",4191,894,52,0,127,49,19,26,5358
"30029001700",6520,985,4,0,297,39,155,28,8028
"30031000101",4459,357,0,0,161,5,62,0,5044
"30031000102",1714,65,0,0,73,0,10,0,1862
"30031000103",6611,700,0,0,202,67,462,53,8095
"30031000200",8334,1222,27,0,309,0,233,171,10296
"30031000300",2713,203,0,0,126,17,50,0,3109
"30031000400",4181,272,22,0,85,2,57,47,4666
"30031000501",1757,81,4,0,55,4,37,1,1939
"30031000502",4652,194,10,0,279,0,102,1,5238
"30031000503",9469,1001,0,0,339,179,282,110,11380
"30031000504",2026,136,0,0,25,0,34,0,2221
"30031000600",1754,388,0,0,209,117,201,50,2719
"30031000701",2710,547,13,18,176,50,41,25,3580
"30031000702",4283,938,59,0,220,105,118,52,5775
"30031000800",1703,397,0,0,23,73,7,22,2225
"30031000900",2135,1201,46,0,124,161,88,51,3806
"30031001001",3148,372,32,0,28,15,20,3,3618
"30031001002",3796,474,9,0,176,35,63,6,4559
"30031001101",478,1017,29,55,321,280,15,36,2231
"30031001102",1768,541,0,0,113,30,33,11,2496
"30031001200",4644,307,7,0,58,28,28,2,5074
"30031001500",1536,213,0,11,40,0,37,37,1874
"30031001600",2378,247,6,0,16,0,115,12,2774
"30033000100",944,78,0,0,7,18,5,1,1053
"30035940200",161,56,11,0,2659,2552,10,0,5449
"30035940400",1181,400,35,0,2077,797,87,43,4620
"30035976000",2416,223,0,0,369,385,125,21,3539
"30035980000",26,26,0,0,1,8,0,16,77
"30037000100",539,193,0,0,16,8,4,12,772
"30039961700",2621,452,0,2,32,12,13,47,3179
"30041040100",910,149,0,0,34,0,9,1,1103
"30041040200",1390,285,0,0,165,15,49,5,1909
"30041040300",1680,877,0,0,340,455,17,102,3471
"30041040400",3319,520,0,0,292,53,68,48,4300
"30041040500",2324,153,0,0,324,0,88,0,2889
"30041940300",67,38,0,0,1817,855,65,38,2880
"30043962201",3633,53,6,0,100,0,37,0,3829
"30043962202",3339,544,0,0,231,45,91,45,4295
"30043962300",2799,388,0,0,96,38,58,11,3390
"30045000100",1689,277,0,0,27,4,27,0,2024
"30047000100",1210,202,5,0,5,14,26,40,1502
"30047000200",1379,229,0,0,35,10,36,22,1711
"30047940301",3135,581,0,0,814,590,88,82,5290
"30047940303",3685,912,18,0,1156,161,192,51,6175
"30047940400",1491,484,15,0,947,1113,64,109,4223
"30047940500",2465,439,6,0,1332,619,301,37,5199
"30047940600",2037,367,16,0,952,355,34,31,3792
"30047940700",933,233,0,10,640,190,12,48,2066
"30049000100",1400,267,0,0,111,12,78,30,1898
"30049000200",4816,179,0,0,95,36,82,42,5250
"30049000300",2061,188,0,3,226,15,47,3,2543
"30049000400",4413,1089,0,0,159,156,91,1,5909
"30049000501",3308,288,80,0,328,0,22,0,4026
"30049000502",5548,990,104,15,230,43,51,0,6981
"30049000600",2046,95,0,0,70,7,17,0,2235
"30049000700",5836,978,0,0,471,81,148,337,7851
"30049000800",2594,651,0,27,117,123,54,61,3627
"30049000900",2755,597,48,18,93,215,61,70,3857
"30049001000",3772,295,0,0,189,19,34,0,4309
"30049001100",4273,676,28,0,66,0,38,47,5128
"30049001201",5676,482,5,0,458,16,270,31,6938
"30049001202",4520,193,0,0,313,49,162,4,5241
"30051050100",1867,375,0,0,49,41,5,14,2351
"30053000100",2837,471,0,0,107,37,84,0,3536
"30053000200",1704,620,0,0,58,6,8,19,2415
"30053000300",2872,675,0,0,135,24,185,8,3899
"30053000400",4858,1104,0,7,212,6,91,28,6306
"30053000500",2698,547,3,0,86,57,68,0,3459
"30055954000",1463,151,0,0,71,0,26,0,1711
"30057000100",2761,260,0,48,58,9,36,0,3172
"30057000200",2158,278,0,12,30,10,34,29,2551
"30057000300",1715,202,0,0,149,1,129,4,2200
"30059000100",1580,265,0,0,28,0,2,25,1900
"30061964500",1831,287,0,0,24,7,11,6,2166
"30061964600",1593,419,0,0,17,8,47,0,2084
"30063000100",5045,649,0,0,286,127,25,0,6132
"30063000201",5231,2045,0,10,381,333,279,71,8350
"30063000202",9962,686,0,0,781,133,369,16,11947
"30063000300",1083,778,45,0,139,48,0,0,2093
"30063000400",2368,557,11,0,99,56,47,0,3138
"30063000500",2748,1101,0,17,735,180,0,53,4834
"30063000700",1614,856,24,12,46,33,89,50,2724
"30063000800",4235,1514,0,0,382,42,211,232,6616
"30063000901",4787,728,0,0,81,258,100,13,5967
"30063000902",2142,95,0,0,42,6,51,0,2336
"30063001000",3915,1113,0,17,195,115,85,32,5472
"30063001100",2415,535,0,0,170,104,19,0,3243
"30063001200",3734,967,52,0,354,17,132,131,5387
"30063001302",5055,532,0,201,196,121,74,0,6179
"30063001303",3868,785,0,2,241,32,55,52,5035
"30063001304",6167,321,43,0,682,14,449,0,7676
"30063001400",5923,626,20,0,177,121,205,22,7094
"30063001500",5580,336,0,0,178,16,95,0,6205
"30063001600",6470,441,0,28,174,130,92,49,7384
"30063001800",3089,546,0,0,466,30,101,24,4256
"30065000100",2199,389,6,0,118,14,47,4,2777
"30065000200",1573,371,3,0,55,0,41,66,2109
"30067000100",1574,149,0,0,59,9,7,6,1804
"30067000200",3591,336,0,0,132,30,19,0,4108
"30067000300",2446,634,0,14,98,69,76,97,3434
"30067000400",4359,364,28,44,23,0,79,0,4897
"30067000500",1301,269,0,0,68,0,73,60,1771
"30067980600",0,0,0,0,0,0,0,0,0
"30069000100",413,30,0,0,0,0,6,0,449
"30071060200",3101,502,0,0,349,149,75,13,4189
"30073977000",3146,584,21,0,110,47,19,38,3965
"30073977200",1017,284,0,0,548,368,47,10,2274
"30075000100",1447,148,0,0,61,7,26,2,1691
"30077000100",1259,165,5,0,32,5,17,0,1483
"30077000200",3193,553,0,0,106,12,41,0,3905
"30079000100",1080,231,0,0,27,8,11,0,1357
"30081000100",3309,424,0,0,113,16,71,0,3933
"30081000201",2897,828,0,6,73,132,34,36,4006
"30081000202",5716,615,68,0,341,12,167,0,6919
"30081000300",2338,680,0,0,57,11,86,0,3172
"30081000401",2269,563,0,0,4,5,25,99,2965
"30081000402",4062,852,0,0,71,53,105,58,5201
"30081000500",4041,1231,49,0,274,52,40,24,5711
"30081000600",4960,1222,0,0,168,124,248,279,7001
"30081000700",1440,328,0,0,107,24,7,11,1917
"30081000800",874,127,0,0,24,3,25,0,1053
"30083070100",1212,168,0,41,39,6,41,8,1515
"30083070200",1549,234,0,0,217,5,53,12,2070
"30083070300",3668,694,0,0,128,7,138,7,4642
"30083070400",2898,109,0,0,149,0,233,0,3389
"30085080100",1506,112,0,0,179,28,60,2,1887
"30085940001",1452,150,5,4,1997,1076,13,19,4716
"30085940002",668,60,0,0,2021,1577,22,0,4348
"30087000100",2175,140,0,0,45,0,10,32,2402
"30087000200",1149,136,0,0,112,27,47,23,1494
"30087000300",1679,54,0,0,387,139,165,0,2424
"30087940400",232,30,19,0,1495,1367,49,59,3251
"30089000100",2425,688,0,0,109,39,41,55,3357
"30089000200",4530,1189,6,0,187,10,78,6,6006
"30089940300",1040,357,4,7,354,207,39,36,2044
"30091090200",2126,189,0,0,83,102,59,0,2559
"30091090400",910,67,0,2,61,13,4,0,1057
"30093000100",2882,1569,30,24,276,122,94,20,5017
"30093000200",2885,1340,17,57,178,34,142,252,4905
"30093000300",2015,496,0,0,43,25,52,3,2634
"30093000400",3132,540,10,0,179,0,277,16,4154
"30093000500",3612,452,0,0,75,21,63,66,4289
"30093000600",3399,889,0,16,50,84,97,7,4542
"30093000700",2986,317,0,0,136,32,120,44,3635
"30093000800",4842,556,0,0,116,197,75,43,5829
"30095966400",3540,339,15,0,72,55,159,41,4221
"30095966500",1891,174,2,0,46,0,53,2,2168
"30095966600",2744,136,0,0,188,17,24,2,3111
"30097967000",2997,458,7,0,140,0,32,34,3668
"30099000100",1574,212,0,0,55,21,7,1,1870
"30099000200",1655,147,0,0,50,24,16,36,1928
"30099000300",1797,297,0,0,108,22,30,0,2254
"30101000100",839,156,0,0,35,0,10,0,1040
"30101000200",2589,600,0,0,177,110,76,52,3604
"30101980000",0,0,0,0,0,0,0,0,0
"30103963500",590,139,0,0,44,39,30,26,868
"30105100100",1268,100,0,0,26,0,2,14,1410
"30105100500",2166,298,0,0,119,147,16,27,2773
"30105940600",2409,224,10,0,508,116,72,12,3351
"30107000100",1620,391,0,0,52,19,40,4,2126
"30109000100",801,145,0,0,0,0,13,0,959
"30111000200",2065,589,35,20,249,222,212,48,3440
"30111000300",2390,670,9,34,569,232,629,92,4625
"30111000401",2706,388,0,17,198,53,72,96,3530
"30111000402",2156,554,0,0,264,156,164,79,3373
"30111000500",3347,837,0,0,44,2,143,0,4373
"30111000600",2114,199,33,0,76,2,11,0,2435
"30111000701",3871,353,0,0,418,140,102,0,4884
"30111000702",6278,488,0,25,710,266,441,57,8265
"30111000704",3334,245,109,0,351,123,126,89,4377
"30111000705",3415,277,17,0,256,65,237,54,4321
"30111000706",2725,1040,0,0,360,42,152,40,4359
"30111000800",3879,350,0,0,417,118,185,11,4960
"30111000901",2725,265,0,0,185,182,121,226,3704
"30111000902",2757,768,145,0,662,448,518,99,5397
"30111001000",3265,479,0,0,621,177,354,60,4956
"30111001100",4778,249,69,0,252,30,239,0,5617
"30111001200",2081,486,40,9,117,56,26,0,2815
"30111001300",5522,406,0,0,78,125,100,157,6388
"30111001401",10065,456,76,0,301,59,288,8,11253
"30111001402",5289,302,51,0,154,101,258,43,6198
"30111001501",4014,483,0,16,138,12,146,18,4827
"30111001502",3315,535,2,0,114,22,68,48,4104
"30111001702",3971,177,160,0,136,50,201,12,4707
"30111001703",4206,914,0,0,383,184,136,13,5836
"30111001704",3551,459,31,42,171,122,74,0,4450
"30111001801",5287,109,0,0,522,0,268,0,6186
"30111001802",5106,520,0,0,391,17,389,0,6423
"30111001803",1701,113,41,0,137,0,104,0,2096
"30111001804",2590,187,0,26,57,5,76,31,2972
"30111001901",4225,202,0,0,79,10,127,0,4643
"30111001902",3371,356,0,0,48,116,24,118,4033
"30111940000",6309,399,17,0,945,69,318,19,8076
"31001965400",3839,293,0,39,71,5,50,13,4310
"31001965500",3565,305,41,11,36,18,107,10,4093
"31001965600",3902,368,0,0,203,26,226,22,4747
"31001965700",966,288,0,0,16,92,215,127,1704
"31001965800",1710,221,0,0,222,34,299,8,2494
"31001965900",3844,287,30,0,120,12,428,23,4744
"31001966000",3412,822,50,0,253,34,322,0,4893
"31001966100",1486,522,0,13,7,0,555,150,2733
"31001966200",2270,108,40,0,45,1,38,3,2505
"31003979600",1744,265,0,0,30,4,91,15,2149
"31003979700",1348,250,0,0,12,4,25,7,1646
"31003979800",2389,279,4,0,51,9,30,18,2780
"31005958300",407,36,0,0,5,0,0,0,448
"31007954000",706,92,10,0,8,4,15,16,851
"31009972400",441,103,0,0,4,3,0,0,551
"31011960100",3129,334,6,0,11,3,50,20,3553
"31011960200",1581,191,0,0,12,5,11,7,1807
"31013951100",1776,255,0,0,16,7,50,18,2122
"31013951200",4261,377,0,3,134,76,542,0,5393
"31013951300",2817,804,6,0,207,364,277,416,4891
"31015975800",1726,215,15,2,41,3,5,5,2012
"31017975000",2463,476,0,0,54,23,14,1,3031
"31019968900",3044,314,0,0,103,4,97,28,3590
"31019969000",3950,165,0,0,38,0,115,0,4268
"31019969100",3712,496,40,0,501,28,790,137,5704
"31019969202",2937,573,15,68,138,12,196,104,4043
"31019969203",5294,408,0,19,73,6,163,6,5969
"31019969204",4466,176,94,0,191,24,138,31,5120
"31019969300",1737,256,0,14,167,46,195,68,2483
"31019969400",3287,364,18,0,251,50,255,28,4253
"31019969500",1645,407,75,14,38,6,216,70,2471
"31019969600",2376,1356,46,74,54,155,154,67,4282
"31019969700",4797,794,10,9,404,140,666,177,6997
"31021963200",1885,221,17,4,80,4,3,0,2214
"31021963300",2181,121,0,36,52,18,103,0,2511
"31021963400",1636,205,3,0,58,11,61,8,1982
"31023967600",2839,182,3,0,81,13,71,7,3196
"31023967700",2552,324,0,0,72,9,119,8,3084
"31023967800",1783,153,29,0,24,1,15,4,2009
"31025965600",3286,218,88,0,33,0,114,0,3739
"31025965700",4481,133,0,0,17,0,50,0,4681
"31025965800",3041,149,21,0,31,22,13,10,3287
"31025965900",4166,482,10,0,82,0,39,0,4779
"31025966000",3767,117,36,0,222,27,215,11,4395
"31025966100",4057,342,31,33,90,33,218,21,4825
"31027977100",3929,459,0,3,23,10,65,13,4502
"31027977200",3635,367,3,0,48,25,27,25,4130
"31029961900",3398,327,0,0,59,10,331,83,4208
"31031955800",3286,377,0,0,367,93,5,82,4210
"31031955900",1359,178,0,0,20,0,54,0,1611
"31033954800",2443,238,16,0,182,5,99,32,3015
"31033954900",3720,496,0,3,69,14,202,153,4657
"31033955000",2302,359,0,0,54,35,43,101,2894
"31035962100",3214,272,25,2,49,48,359,101,4070
"31035962200",2334,248,0,0,63,10,72,17,2744
"31037964600",2085,178,14,0,56,13,23,12,2381
"31037964700",1456,146,60,0,75,23,97,7,1864
"31037964800",4605,939,84,66,521,9,3517,790,10531
"31039972700",2367,201,0,0,58,0,63,6,2695
"31039972800",3363,683,0,0,157,22,392,304,4921
"31039972900",1798,140,3,0,98,25,37,28,2129
"31041971700",2382,302,19,0,65,5,39,0,2812
"31041971800",2423,289,0,0,9,13,15,55,2804
"31041971900",3137,480,45,0,20,19,104,19,3824
"31041972000",1273,80,4,12,54,0,20,0,1443
"31043010100",3073,474,245,581,1387,800,2281,773,9614
"31043010200",3532,634,7,5,2059,365,2569,658,9829
"31043010300",2950,392,14,0,656,15,943,183,5153
"31043010400",2754,243,5,0,342,19,271,4,3638
"31045950600",2357,493,0,0,73,12,24,20,2979
"31045950700",3649,662,0,9,496,252,237,31,5336
"31047968000",2225,193,17,0,195,1,341,7,2979
"31047968100",1223,142,0,0,34,0,89,43,1531
"31047968200",3310,374,5,0,30,45,79,55,3898
"31047968300",3111,583,78,19,114,9,536,51,4501
"31047968400",3489,986,81,266,532,47,2819,927,9147
"31047968500",3391,719,598,27,260,133,2200,602,7930
"31047968600",1249,65,0,0,24,9,51,13,1411
"31049955400",1611,231,0,0,46,15,80,72,2055
"31051977600",2216,220,0,0,37,1,63,12,2549
"31051977800",2655,416,12,10,157,36,402,199,3887
"31053963600",4147,401,20,7,172,32,188,25,4992
"31053963700",2508,145,0,0,16,0,0,0,2669
"31053963800",3969,461,0,0,132,72,307,98,5039
"31053963900",3504,662,50,0,4,36,490,291,5037
"31053964000",2525,432,0,0,196,21,369,98,3641
"31053964100",4061,298,0,0,60,0,95,0,4514
"31053964200",3123,316,42,7,192,42,483,159,4364
"31053964300",4348,398,0,0,120,55,478,55,5454
"31053964400",2247,629,0,25,132,22,648,208,3911
"31055000200",1739,497,790,30,225,20,91,12,3404
"31055000300",533,222,872,354,142,86,229,85,2523
"31055000400",882,642,135,48,275,169,327,284,2762
"31055000500",654,272,180,15,49,49,58,22,1299
"31055000600",325,156,285,256,94,107,59,6,1288
"31055000700",98,40,526,531,47,24,68,9,1343
"31055000800",178,138,508,788,229,81,150,91,2163
"31055001100",239,237,794,1256,126,174,99,170,3095
"31055001200",258,274,1372,594,145,123,195,13,2974
"31055001600",96,27,0,7,27,32,0,4,193
"31055001800",1850,383,73,55,176,26,114,83,2760
"31055001900",603,279,148,107,138,156,184,28,1643
"31055002000",1873,1019,0,0,389,298,1400,1000,5979
"31055002100",1275,835,70,59,256,124,697,596,3912
"31055002200",751,90,0,0,220,20,197,16,1294
"31055002300",1726,710,0,29,69,62,546,260,3402
"31055002400",2319,812,22,1,259,266,1532,771,5982
"31055002500",1517,606,104,26,301,158,880,476,4068
"31055002600",1437,528,6,34,259,166,1227,578,4235
"31055002700",1430,464,156,5,463,270,1502,542,4832
"31055002800",2305,691,57,24,559,156,2133,599,6524
"31055002900",2064,990,504,1252,573,291,1814,926,8414
"31055003000",4111,1223,194,26,1579,1124,2088,2194,12539
"31055003100",2446,563,73,116,623,137,1559,287,5804
"31055003200",1399,540,5,91,445,155,1427,510,4572
"31055003300",1105,551,165,17,242,368,568,645,3661
"31055003401",2438,671,68,21,798,5,868,107,4976
"31055003402",2233,320,32,0,93,10,436,125,3249
"31055003500",3200,251,37,0,302,190,428,158,4566
"31055003600",3570,292,67,0,101,96,84,0,4210
"31055003700",2048,68,16,0,145,0,81,0,2358
"31055003800",2307,534,136,294,270,253,823,236,4853
"31055003900",906,961,55,18,518,357,735,948,4498
"31055004000",1155,1326,125,186,193,95,222,899,4201
"31055004200",842,403,82,37,185,75,173,266,2063
"31055004300",1489,619,162,23,215,48,101,128,2785
"31055004400",1113,103,1,5,59,9,35,10,1335
"31055004500",2636,201,78,0,35,0,100,10,3060
"31055004600",1963,295,0,0,188,53,58,0,2557
"31055004700",1887,55,18,0,63,0,38,0,2061
"31055004800",3294,580,164,48,504,11,263,0,4864
"31055004900",2448,349,619,227,501,400,340,95,4979
"31055005000",2124,765,369,91,494,257,768,358,5226
"31055005100",992,578,519,336,125,53,122,236,2961
"31055005200",171,264,368,343,478,236,58,228,2146
"31055005300",432,190,711,436,212,135,117,142,2375
"31055005400",545,559,1042,280,301,407,287,265,3686
"31055005500",3988,327,208,59,294,0,140,0,5016
"31055005600",2375,437,900,2,333,87,58,53,4245
"31055005700",2342,447,758,238,254,130,170,135,4474
"31055005800",1822,194,1071,277,215,379,105,54,4117
"31055005901",501,236,767,460,164,16,46,26,2216
"31055005902",123,248,799,418,101,103,82,134,2008
"31055006000",446,129,1590,1059,238,164,180,237,4043
"31055006101",296,108,1117,330,175,213,77,137,2453
"31055006102",800,259,1287,717,366,188,297,195,4109
"31055006202",2448,206,679,462,205,71,259,44,4374
"31055006301",811,108,1286,148,164,126,178,94,2915
"31055006302",765,155,1971,329,342,875,149,225,4811
"31055006303",1452,101,676,316,122,88,324,12,3091
"31055006400",3184,878,185,241,354,106,477,82,5507
"31055006503",2185,91,217,40,153,113,94,0,2893
"31055006504",2502,218,285,326,154,19,74,6,3584
"31055006505",984,75,392,126,129,0,66,0,1772
"31055006506",1312,343,1219,230,113,315,142,10,3684
"31055006602",4174,798,509,0,319,70,209,0,6079
"31055006603",1526,405,357,533,16,34,127,51,3049
"31055006604",3062,218,228,46,298,42,288,20,4202
"31055006701",3052,217,151,15,214,76,57,37,3819
"31055006703",2611,158,217,46,140,29,168,0,3369
"31055006704",1351,135,0,0,59,7,0,0,1552
"31055006803",1669,114,63,42,81,0,5,0,1974
"31055006804",1348,19,0,0,68,0,34,0,1469
"31055006805",3107,143,0,3,122,10,64,10,3459
"31055006806",1365,430,225,249,147,176,0,61,2653
"31055006903",2216,87,69,80,130,0,185,5,2772
"31055006904",3706,167,0,0,108,0,165,0,4146
"31055006905",1420,127,53,7,236,0,37,31,1911
"31055006906",2616,219,59,56,83,9,133,0,3175
"31055007001",2126,632,275,38,185,165,303,119,3843
"31055007002",2451,254,180,172,326,42,426,0,3851
"31055007003",2258,254,4,15,115,17,773,94,3530
"31055007101",2005,356,140,2,378,190,639,293,4003
"31055007102",3250,175,0,110,251,108,1008,0,4902
"31055007303",2571,231,52,0,105,0,6,0,2965
"31055007304",1168,57,102,15,107,0,105,0,1554
"31055007309",2978,375,508,92,403,77,72,11,4516
"31055007310",2085,140,283,0,156,18,112,34,2828
"31055007311",1969,144,420,604,105,43,152,0,3437
"31055007312",1169,141,248,138,231,19,58,20,2024
"31055007313",5264,353,1709,296,433,0,504,0,8559
"31055007314",3460,25,119,0,153,0,78,0,3835
"31055007315",2993,168,278,0,72,57,23,0,3591
"31055007316",2739,0,72,61,187,0,153,0,3212
"31055007317",3500,113,222,216,106,12,62,0,4231
"31055007318",4279,101,172,0,261,0,45,0,4858
"31055007405",1307,306,24,3,196,8,54,4,1902
"31055007406",4231,411,54,0,290,0,238,0,5224
"31055007407",2364,221,9,0,119,48,127,0,2888
"31055007408",3544,264,164,21,271,182,264,150,4860
"31055007409",1959,173,30,0,83,0,52,22,2319
"31055007424",2334,248,115,32,59,0,216,95,3099
"31055007429",3248,38,11,0,85,0,167,0,3549
"31055007431",3794,234,176,25,293,0,61,0,4583
"31055007432",2472,286,164,130,157,0,152,88,3449
"31055007433",3381,317,300,73,189,24,190,147,4621
"31055007434",1878,364,601,198,277,72,193,53,3636
"31055007435",2640,332,229,125,264,171,287,39,4087
"31055007436",2816,328,512,185,179,31,57,25,4133
"31055007438",1813,70,12,0,50,0,133,0,2078
"31055007439",3915,149,268,0,144,12,122,14,4624
"31055007440",1002,223,303,154,154,13,63,41,1953
"31055007441",2225,62,100,12,165,0,86,0,2650
"31055007442",4557,172,8,9,163,13,191,8,5121
"31055007443",2709,82,149,86,299,0,229,0,3554
"31055007444",2595,325,329,97,939,21,120,0,4426
"31055007445",2080,58,314,79,97,0,130,0,2758
"31055007446",3500,102,11,0,133,13,135,13,3907
"31055007447",2544,152,0,0,18,0,118,9,2841
"31055007448",2405,104,29,0,86,0,8,31,2663
"31055007449",2872,143,0,0,226,0,101,0,3342
"31055007450",2925,150,50,0,103,0,63,0,3291
"31055007451",4401,525,0,29,457,142,148,0,5702
"31055007452",4505,98,16,0,229,13,125,0,4986
"31055007453",2973,71,33,0,195,0,17,0,3289
"31055007454",3896,224,24,0,278,23,202,0,4647
"31055007455",1208,191,0,0,49,131,124,180,1883
"31055007456",1969,156,73,30,101,74,172,52,2627
"31055007457",2230,124,100,9,198,52,211,34,2958
"31055007458",2161,299,109,11,477,8,427,19,3511
"31055007459",2456,184,0,0,61,31,298,34,3064
"31055007460",4033,10,0,0,393,0,172,0,4608
"31055007461",5262,132,17,0,645,0,266,0,6322
"31055007462",4202,385,138,0,146,49,223,168,5311
"31055007463",3819,265,72,0,308,20,216,0,4700
"31055007464",2353,105,51,189,83,0,91,0,2872
"31055007465",3459,161,98,0,599,56,256,0,4629
"31055007466",3957,530,166,14,329,101,342,396,5835
"31055007467",3925,368,205,0,460,90,324,153,5525
"31055007468",2212,92,8,0,152,0,456,23,2943
"31055007469",3477,87,7,38,386,32,188,14,4229
"31055007470",4889,331,402,113,562,70,328,40,6735
"31055007471",2795,101,175,0,558,35,94,8,3766
"31055007472",4188,67,97,0,345,36,278,36,5047
"31055007504",2477,387,26,37,70,39,20,35,3091
"31055007505",2808,101,0,0,83,5,7,0,3004
"31055007506",2320,100,21,0,85,0,111,0,2637
"31055007508",2673,148,0,2,40,14,40,3,2920
"31055007509",4201,37,0,0,78,0,42,0,4358
"31055007511",4833,324,326,0,445,42,154,0,6124
"31055007512",6408,246,0,0,386,61,203,0,7304
"31055007513",5233,72,46,12,205,0,19,0,5587
"31055007514",3564,44,26,0,185,0,72,0,3891
"31055007515",3766,0,218,0,376,0,148,0,4508
"31055007516",3680,60,46,0,203,0,20,0,4009
"31055007517",4783,243,84,0,217,16,111,13,5467
"31057962300",1797,151,0,0,27,0,194,5,2174
"31059091600",2022,193,0,0,30,0,127,8,2380
"31059091700",2857,289,19,0,23,32,6,40,3266
"31061964600",1157,139,0,2,3,16,29,1,1347
"31061964700",1450,234,0,0,19,5,12,7,1727
"31063961100",2099,289,0,0,17,16,7,3,2431
"31065963900",3856,763,6,0,86,57,63,92,4923
"31067964600",2440,145,0,0,26,0,22,0,2633
"31067964700",3370,172,2,0,32,12,41,28,3657
"31067964800",3188,312,39,0,117,0,46,0,3702
"31067964900",3288,466,10,0,70,18,52,18,3922
"31067965000",2818,275,11,0,64,19,40,23,3250
"31067965100",1537,207,0,0,87,44,106,33,2014
"31067965200",2184,355,16,4,43,51,19,0,2672
"31069952100",1555,172,0,3,38,6,13,0,1787
"31071973200",1672,181,0,12,27,0,20,4,1916
"31073967600",1773,106,0,0,46,4,33,7,1969
"31075956300",639,98,0,0,0,0,29,12,778
"31077970900",2170,232,9,5,18,6,29,21,2490
"31079000100",2352,170,21,0,79,5,226,34,2887
"31079000200",3634,827,46,17,476,104,2246,724,8074
"31079000300",4606,1146,47,79,194,21,1969,730,8792
"31079000400",4053,781,0,0,136,26,653,224,5873
"31079000500",4402,109,49,0,187,0,15,0,4762
"31079000600",4569,289,5,152,151,22,577,102,5867
"31079000700",3494,664,74,5,104,15,1199,34,5589
"31079000800",2545,369,40,0,68,0,346,17,3385
"31079000900",3618,1058,134,148,247,102,1202,580,7089
"31079001000",3000,831,315,18,200,202,637,742,5945
"31079001100",3243,1067,12,77,309,105,1372,948,7133
"31079001200",3282,260,14,11,92,7,299,2,3967
"31079001300",2730,216,7,4,36,5,68,45,3111
"31079001400",1812,155,34,0,63,25,250,54,2393
"31081969100",1732,114,31,0,73,2,72,0,2024
"31081969200",2225,152,0,0,67,6,85,14,2549
"31081969300",3913,506,15,0,100,0,67,11,4612
"31083964200",2877,435,5,0,67,15,84,15,3498
"31085961500",1005,68,2,0,9,0,58,18,1160
"31087962700",2317,485,0,0,11,5,65,5,2888
"31089974000",1343,191,0,0,5,0,22,0,1561
"31089974100",2048,435,0,0,30,22,27,8,2570
"31089974200",1797,185,7,0,35,0,45,0,2069
"31089974300",3648,299,0,0,84,77,222,52,4382
"31091956700",518,117,0,6,11,0,27,0,679
"31093970500",1557,144,0,0,26,0,60,0,1787
"31093970600",3996,498,0,7,81,9,65,19,4675
"31095963600",2749,195,0,0,79,50,68,46,3187
"31095963700",2452,339,0,0,8,10,111,0,2920
"31095963800",1050,303,0,0,50,12,0,26,1441
"31097967500",1655,143,1,0,16,2,25,0,1842
"31097967600",1708,308,10,0,143,18,156,101,2444
"31099966600",3110,200,0,0,56,9,173,0,3548
"31099966700",2813,199,0,0,48,0,158,0,3218
"31101000100",1082,236,0,0,73,13,27,27,1458
"31101000200",2734,375,0,0,61,0,203,14,3387
"31101000300",3062,254,41,1,40,52,160,71,3681
"31103975400",598,99,0,1,6,6,0,0,710
"31105954500",3026,496,10,0,120,0,159,127,3938
"31107976200",2461,304,0,0,32,10,26,0,2833
"31107976300",2023,258,0,1,34,30,33,11,2390
"31107976400",2049,158,1,0,580,356,117,24,3285
"31109000100",2639,662,18,12,349,98,320,23,4121
"31109000201",3762,504,25,0,145,0,48,15,4499
"31109000202",1833,1083,115,47,260,77,241,61,3717
"31109000300",2346,824,120,39,153,121,256,143,4002
"31109000400",2179,1256,414,467,806,194,346,106,5768
"31109000500",862,700,63,33,34,87,157,95,2031
"31109000600",0,0,0,0,0,0,0,0,0
"31109000700",766,474,220,146,603,419,72,0,2700
"31109000800",1742,645,395,13,433,431,307,549,4515
"31109000900",1955,632,115,54,410,218,82,42,3508
"31109001001",2052,520,90,0,177,95,102,67,3103
"31109001002",842,560,41,21,97,33,12,0,1606
"31109001003",2651,575,103,87,377,56,193,141,4183
"31109001101",4133,158,7,0,156,59,86,10,4609
"31109001102",3107,461,42,0,50,0,37,0,3697
"31109001200",5218,597,36,0,335,65,17,13,6281
"31109001301",3401,189,49,0,128,0,51,26,3844
"31109001302",2663,105,18,0,145,10,83,5,3029
"31109001400",3534,638,93,0,349,64,61,0,4739
"31109001500",3739,277,72,10,101,40,212,25,4476
"31109001600",4558,685,87,34,327,46,188,140,6065
"31109001700",2459,1115,271,242,882,642,602,462,6675
"31109001800",703,383,146,140,176,234,153,207,2142
"31109001900",317,242,77,4,34,4,5,1,684
"31109002001",907,769,99,171,293,44,157,112,2552
"31109002002",1135,468,217,349,65,187,159,53,2633
"31109002100",1287,566,62,16,187,87,443,208,2856
"31109002200",3076,1093,442,29,247,326,602,432,6247
"31109002300",4044,1048,43,175,427,70,222,79,6108
"31109002400",2870,117,0,0,49,0,61,0,3097
"31109002500",4995,291,11,13,297,61,245,9,5922
"31109002701",2001,416,39,0,355,11,187,11,3020
"31109002702",4628,246,81,0,351,0,359,0,5665
"31109002800",4575,325,206,42,201,0,211,0,5560
"31109002900",3188,828,385,156,559,26,245,38,5425
"31109003001",4624,797,87,316,822,371,104,104,7225
"31109003002",2085,708,163,19,130,132,171,83,3491
"31109003003",3290,1055,108,92,255,244,298,237,5579
"31109003102",4749,293,354,29,426,70,241,92,6254
"31109003103",1417,652,15,48,474,99,447,242,3394
"31109003104",3375,991,33,95,1020,319,621,161,6615
"31109003202",1845,710,271,32,151,18,292,181,3500
"31109003301",2528,1318,33,174,459,122,84,228,4946
"31109003302",3442,219,129,1,218,9,479,49,4546
"31109003401",4070,551,0,0,501,0,381,115,5618
"31109003402",4601,545,504,343,570,65,489,347,7464
"31109003500",0,0,0,0,0,0,0,0,0
"31109003601",0,0,0,0,0,0,0,0,0
"31109003604",2717,77,28,0,83,0,9,17,2931
"31109003605",3059,245,73,0,220,171,185,0,3953
"31109003607",3242,191,22,53,433,82,37,27,4087
"31109003608",1082,52,0,0,24,0,80,0,1238
"31109003609",2186,24,14,4,153,0,39,0,2420
"31109003704",4061,772,241,0,222,18,305,88,5707
"31109003706",5463,172,72,0,306,80,156,0,6249
"31109003707",6783,157,66,1,198,0,134,1,7340
"31109003708",3897,176,0,0,230,0,156,0,4459
"31109003709",4628,219,25,0,75,63,89,46,5145
"31109003713",2164,15,58,0,141,0,15,0,2393
"31109003714",2222,29,0,0,95,0,192,0,2538
"31109003715",2292,19,37,0,161,0,6,0,2515
"31109003716",4404,125,39,0,414,0,181,0,5163
"31109003717",2702,434,93,20,61,0,118,0,3428
"31109003718",2241,50,26,0,49,0,32,3,2401
"31109003719",3880,120,109,0,156,7,61,0,4333
"31109003720",1649,0,0,0,78,31,7,0,1765
"31109003801",4294,229,99,28,202,120,32,0,5004
"31109003802",2843,229,9,0,24,0,191,0,3296
"31109010100",6090,271,0,0,136,5,85,0,6587
"31109010201",3260,852,193,18,292,41,339,0,4995
"31109010202",4233,107,20,0,39,22,14,14,4449
"31109010300",3632,132,14,16,38,0,10,0,3842
"31109010400",7970,314,9,4,104,7,184,35,8627
"31109983200",0,0,0,0,0,0,0,0,0
"31111959700",3214,196,2,1,78,11,37,4,3543
"31111959800",2682,224,2,4,185,14,203,47,3361
"31111959900",3762,1049,9,37,19,29,209,120,5234
"31111960200",3642,820,40,23,70,35,164,393,5187
"31111960300",3880,586,29,8,190,30,389,184,5296
"31111960400",4950,400,0,0,144,15,310,154,5973
"31111960500",3664,696,107,0,109,46,307,79,5008
"31111960600",3620,237,2,0,218,27,115,25,4244
"31113957500",724,83,2,0,13,8,9,7,846
"31115972800",458,60,0,0,22,8,0,0,548
"31117957900",362,64,0,0,7,0,4,0,437
"31119960600",3900,349,0,0,377,0,241,98,4965
"31119960700",2021,784,115,10,174,56,258,212,3630
"31119960801",3901,250,0,0,132,222,243,179,4927
"31119960802",2763,310,17,0,30,51,20,60,3251
"31119960900",3413,710,0,43,280,293,398,573,5710
"31119961000",2327,618,91,45,218,14,413,118,3844
"31119961100",1821,155,44,0,130,133,465,185,2933
"31119961200",3155,309,4,0,20,5,58,27,3578
"31119961300",3816,761,9,0,160,1,1003,295,6045
"31121966600",1717,198,15,0,19,0,34,31,2014
"31121966700",2206,140,0,12,48,4,114,8,2532
"31121966800",2666,313,0,0,167,0,62,19,3227
"31123952500",4007,530,33,1,119,19,622,84,5415
"31125966100",3040,490,0,0,12,0,87,4,3633
"31127968100",2931,235,14,14,35,26,19,35,3309
"31127968200",3038,268,13,4,65,27,19,0,3434
"31129960000",2033,200,0,0,0,19,38,41,2331
"31129960100",1714,224,0,0,10,58,7,15,2028
"31131966600",1769,162,0,0,31,5,18,5,1990
"31131966700",2799,262,2,0,24,21,16,0,3124
"31131966800",2745,172,1,0,61,0,19,28,3026
"31131966900",3625,530,0,0,244,48,285,84,4816
"31131967000",2441,475,14,1,78,20,449,192,3670
"31133967800",2219,444,0,0,23,2,49,0,2737
"31135959300",2649,196,4,0,21,2,75,22,2969
"31137967000",2019,253,0,0,106,28,130,8,2544
"31137967100",2961,214,0,0,56,0,170,0,3401
"31137967200",3019,201,3,3,31,7,134,12,3410
"31139979100",3668,142,0,0,52,10,47,0,3919
"31139979200",2808,263,9,0,53,2,45,5,3185
"31141965100",3630,217,0,1,41,4,38,10,3941
"31141965298",2978,210,4,0,42,11,10,11,3266
"31141965300",6363,482,8,0,176,68,739,185,8021
"31141965400",4182,456,0,30,75,73,768,495,6079
"31141965500",4816,354,0,0,266,0,949,27,6412
"31141965600",3584,414,0,11,346,43,1032,263,5693
"31141965700",2682,337,8,0,167,17,363,216,3790
"31143960000",1871,109,0,0,65,0,3,0,2048
"31143960100",2717,264,13,0,92,16,134,63,3299
"31145963100",2247,274,0,67,16,0,6,2,2612
"31145963200",4523,169,0,0,38,0,401,5,5136
"31145963300",2504,608,25,0,82,0,57,2,3278
"31147964500",1502,118,2,0,99,16,15,5,1757
"31147968500",1433,287,0,0,38,20,4,7,1789
"31147968600",3220,941,0,0,189,175,22,85,4632
"31149974600",1140,154,0,0,39,8,7,0,1348
"31151960600",5287,882,0,59,801,110,2318,508,9965
"31151960700",1961,93,0,0,35,0,77,0,2166
"31151960800",1307,76,5,0,36,2,51,0,1477
"31151960900",2346,252,0,0,28,18,170,49,2863
"31153010103",4038,292,75,7,266,0,331,8,5017
"31153010104",1358,178,106,0,190,40,271,107,2250
"31153010105",2057,266,62,25,161,85,63,47,2766
"31153010106",3249,726,81,53,175,191,174,124,4773
"31153010107",2461,246,255,0,447,228,720,379,4736
"31153010108",2782,180,146,386,502,8,590,38,4632
"31153010203",4204,77,245,35,266,0,184,0,5011
"31153010204",3116,367,262,0,79,7,121,40,3992
"31153010205",4852,59,288,0,434,32,361,0,6026
"31153010206",3326,60,518,0,489,26,631,7,5057
"31153010207",2105,130,74,3,309,0,154,0,2775
"31153010208",2705,154,216,12,237,12,179,7,3522
"31153010302",314,30,77,0,47,0,58,0,526
"31153010305",1261,105,198,12,118,10,277,12,1993
"31153010306",1908,34,198,0,318,5,193,0,2656
"31153010401",2269,331,98,26,162,65,687,114,3752
"31153010402",3456,733,171,7,211,25,323,112,5038
"31153010501",5878,233,386,50,714,40,1413,156,8870
"31153010502",3063,697,81,0,381,44,471,94,4831
"31153010503",2948,186,245,0,149,49,552,90,4219
"31153010614",4120,356,212,155,477,141,462,13,5936
"31153010615",1589,89,8,0,222,0,238,21,2167
"31153010616",3183,55,162,0,137,0,208,0,3745
"31153010617",5009,116,184,2,270,0,274,26,5881
"31153010618",5452,18,318,39,555,0,521,0,6903
"31153010619",3481,323,318,9,210,5,151,0,4497
"31153010620",3607,134,67,0,156,20,149,0,4133
"31153010621",5011,101,122,249,153,30,206,253,6125
"31153010622",2783,103,68,0,284,0,9,7,3254
"31153010623",4247,107,43,8,113,8,105,0,4631
"31153010624",5104,335,37,2,238,0,241,0,5957
"31153010625",4409,256,348,48,248,100,463,48,5920
"31153010626",4703,232,11,0,412,0,41,0,5399
"31153010627",2667,45,0,0,95,17,102,11,2937
"31153010628",5113,15,25,0,95,3,119,0,5370
"31153010629",1573,98,8,0,114,0,36,0,1829
"31153010630",2823,22,11,0,145,0,157,0,3158
"31153010631",4147,206,54,55,32,0,99,0,4593
"31153010632",3891,140,0,0,214,0,205,0,4450
"31153010633",2797,144,30,0,163,9,100,66,3309
"31153010634",2279,98,42,0,272,9,139,9,2848
"31153010701",2045,41,0,0,85,0,10,0,2181
"31153010702",3081,174,28,0,130,0,23,0,3436
"31155968100",3038,140,0,0,29,3,26,7,3243
"31155968200",4789,563,4,50,89,11,77,0,5583
"31155968300",3971,650,4,0,67,5,144,0,4841
"31155968400",3844,278,66,0,72,16,95,0,4371
"31155968500",2510,285,0,0,121,0,45,28,2989
"31157952900",2528,164,4,0,92,5,220,80,3093
"31157953000",2752,283,0,0,195,114,471,165,3980
"31157953100",1825,335,0,6,101,8,232,185,2692
"31157953200",1358,94,0,0,28,16,116,18,1630
"31157953300",3145,164,76,6,246,29,604,8,4278
"31157953400",2480,58,10,0,81,0,214,3,2846
"31157953500",2037,828,29,28,75,57,585,392,4031
"31157953600",2471,368,12,5,52,0,470,154,3532
"31157953700",2424,1164,13,2,256,273,1767,771,6670
"31157953800",3411,473,6,30,289,0,692,18,4919
"31157953900",4693,320,35,1,67,46,843,147,6152
"31159960100",3899,378,12,2,35,21,21,4,4372
"31159960200",2027,284,13,0,43,0,37,0,2404
"31159960300",3500,324,9,0,126,56,129,0,4144
"31159960400",4280,320,10,3,122,79,68,73,4955
"31161951600",1354,316,0,6,162,240,25,72,2175
"31161951700",2492,220,15,0,311,75,123,0,3236
"31163970100",2610,377,0,34,26,0,53,0,3100
"31165950100",1025,154,0,0,68,2,37,10,1296
"31167962100",1407,187,0,0,9,0,4,0,1607
"31167962200",3810,492,27,7,113,15,301,0,4765
"31169963100",2193,220,0,0,4,13,13,0,2443
"31169963200",2120,348,0,1,108,22,35,8,2642
"31171957100",594,52,0,0,25,3,0,4,678
"31173940100",1725,348,2,3,1047,1029,77,139,4370
"31173940200",704,44,0,2,1262,664,63,16,2755
"31175971300",1634,169,0,0,7,16,56,3,1885
"31175971400",1995,309,0,1,0,45,0,0,2350
"31177050101",2669,270,0,0,39,0,65,113,3156
"31177050102",4158,893,38,43,182,39,87,0,5440
"31177050201",3868,169,0,0,10,1,26,1,4075
"31177050202",3016,41,19,0,21,0,70,0,3167
"31177050300",3878,423,22,0,79,1,67,0,4470
"31179978600",3161,138,44,0,95,0,72,6,3516
"31179978700",3700,800,69,177,0,0,320,68,5134
"31181965000",1711,97,0,0,41,37,60,6,1952
"31181965100",1297,305,0,0,64,20,82,9,1777
"31183973600",786,59,0,0,0,2,0,0,847
"31185969600",2602,129,0,0,41,4,23,3,2802
"31185969700",3072,326,4,0,201,29,152,83,3867
"31185969800",3432,652,0,2,89,0,94,66,4335
"31185969900",2078,202,14,25,30,24,108,3,2484
"32001950100",1897,239,6,27,220,18,228,34,2669
"32001950301",1939,941,20,7,539,338,151,287,4222
"32001950302",3160,803,288,73,680,37,668,124,5833
"32001950400",559,17,76,0,111,6,138,0,907
"32001950500",630,128,0,0,454,306,40,54,1612
"32001950600",4019,198,18,0,444,109,512,262,5562
"32001950700",4543,540,0,0,468,15,640,0,6206
"32003000101",3294,527,278,126,2010,501,3446,817,10999
"32003000103",2207,560,566,52,1741,542,2876,713,9257
"32003000105",2014,574,39,62,1335,19,2095,268,6406
"32003000106",1858,1198,352,37,598,327,833,785,5988
"32003000107",1868,399,294,27,1007,71,1065,108,4839
"32003000108",1911,331,96,54,1078,452,2173,618,6713
"32003000109",1918,376,77,179,1174,63,1787,163,5737
"32003000201",1148,363,1179,469,817,367,1395,480,6218
"32003000203",1347,827,361,306,962,284,833,728,5648
"32003000204",562,117,0,12,252,33,232,65,1273
"32003000301",345,404,837,442,438,160,669,282,3577
"32003000302",438,579,1177,1655,550,421,839,660,6319
"32003000401",389,525,201,354,295,234,272,272,2542
"32003000402",564,750,142,282,844,375,1033,872,4862
"32003000403",502,469,286,295,525,220,627,309,3233
"32003000510",1782,367,317,46,1485,476,2856,802,8131
"32003000513",1550,1245,73,197,574,385,1337,1487,6848
"32003000514",2139,731,310,62,1912,1181,2827,1657,10819
"32003000515",1984,861,152,120,1376,372,2650,1075,8590
"32003000516",1942,655,31,223,847,866,1932,1139,7635
"32003000517",2684,349,265,284,1350,460,3196,662,9250
"32003000518",2402,828,380,356,1033,527,2454,954,8934
"32003000519",1605,928,47,71,1566,498,2570,1230,8515
"32003000520",1025,279,14,29,524,302,1343,511,4027
"32003000521",974,716,215,119,783,656,1426,1080,5969
"32003000522",712,503,53,161,651,571,1112,963,4726
"32003000523",468,483,92,439,536,266,539,627,3450
"32003000524",459,434,63,72,506,247,735,595,3111
"32003000525",1066,179,243,117,792,221,1662,356,4636
"32003000526",1006,515,44,86,1031,323,1501,833,5339
"32003000527",1592,528,294,155,1115,175,2254,700,6813
"32003000528",1224,504,182,214,524,330,1494,753,5225
"32003000600",664,477,300,160,598,218,767,296,3480
"32003000700",533,238,91,174,228,7,190,24,1485
"32003000800",771,430,166,107,268,216,351,225,2534
"32003000900",618,144,101,58,173,7,81,0,1182
"32003001003",2203,328,311,56,847,324,1584,375,6028
"32003001004",3301,663,496,181,1911,430,2002,723,9707
"32003001005",1273,56,57,2,176,0,171,24,1759
"32003001006",2836,208,321,48,564,62,652,23,4714
"32003001100",657,486,137,197,444,296,569,549,3335
"32003001200",1819,715,129,107,802,249,997,599,5417
"32003001300",2726,628,47,73,1434,438,2917,737,9000
"32003001401",945,1098,58,22,696,66,897,614,4396
"32003001402",2125,750,6,257,785,212,2198,633,6966
"32003001501",1055,496,301,319,420,186,621,340,3738
"32003001502",2062,448,146,161,734,202,1241,383,5377
"32003001607",2291,924,191,218,796,315,1010,363,6108
"32003001608",787,186,51,2,455,138,624,217,2460
"32003001609",1996,1028,203,59,1165,317,2037,1039,7844
"32003001610",1361,474,34,4,1143,97,1523,429,5065
"32003001611",2011,530,37,161,1395,179,2227,549,7089
"32003001612",3461,168,707,615,944,1095,2161,777,9928
"32003001613",1824,651,248,31,971,131,1574,441,5871
"32003001706",1801,311,95,60,621,50,466,32,3436
"32003001707",1002,158,120,0,175,47,172,131,1805
"32003001708",1844,137,159,51,602,159,668,121,3741
"32003001709",875,273,110,18,232,34,367,115,2024
"32003001710",1749,226,233,100,1204,245,1412,274,5443
"32003001711",2144,433,213,34,699,177,706,312,4718
"32003001712",2000,461,528,58,521,428,638,467,5101
"32003001713",1997,152,84,43,719,75,1177,120,4367
"32003001714",2213,297,66,0,675,36,1437,174,4898
"32003001715",1403,200,61,31,885,384,1466,370,4800
"32003001716",866,286,33,0,530,49,832,222,2818
"32003001717",993,81,19,1,314,4,279,8,1699
"32003001718",1112,388,129,122,507,208,966,387,3819
"32003001801",3489,801,184,308,1253,570,2237,1162,10004
"32003001803",1425,198,182,27,729,64,1266,105,3996
"32003001804",1168,685,132,151,1078,501,1411,926,6052
"32003001901",2576,957,267,77,1420,522,2496,1283,9598
"32003001902",2060,743,48,160,676,150,1403,591,5831
"32003002000",2187,631,291,173,622,189,547,300,4940
"32003002201",2085,573,235,262,650,400,1084,537,5826
"32003002203",1425,636,235,253,2222,548,2328,1080,8727
"32003002204",1594,946,88,235,760,561,1731,1347,7262
"32003002206",1396,432,209,36,1180,351,1668,512,5784
"32003002207",706,583,320,162,824,1625,1331,1891,7442
"32003002302",662,51,15,6,159,6,143,6,1048
"32003002303",398,13,10,0,133,8,25,0,587
"32003002403",1570,381,366,473,638,273,1022,253,4976
"32003002404",815,1442,604,753,768,306,1166,1401,7255
"32003002405",1844,1166,236,361,793,248,1564,1046,7258
"32003002406",1115,727,344,136,496,167,546,317,3848
"32003002501",3096,1346,373,58,1480,394,2393,1019,10159
"32003002504",2219,369,351,169,418,237,931,192,4886
"32003002505",875,158,118,32,267,284,512,246,2492
"32003002506",1588,449,268,134,941,304,1097,465,5246
"32003002603",1317,468,193,60,462,284,381,268,3433
"32003002604",1037,400,230,45,270,67,634,193,2876
"32003002605",271,204,117,14,92,26,67,26,817
"32003002706",1835,540,157,143,526,181,1239,487,5108
"32003002707",2251,452,208,41,548,40,1309,338,5187
"32003002708",719,316,531,509,462,102,615,289,3543
"32003002808",1355,151,142,33,290,17,212,22,2222
"32003002810",1903,346,358,129,538,206,860,5,4345
"32003002811",2905,187,184,2,643,32,542,28,4523
"32003002814",3068,250,397,20,1124,220,487,95,5661
"32003002821",2451,558,224,283,1065,155,1031,209,5976
"32003002822",2343,364,146,110,901,120,1951,348,6283
"32003002823",1750,301,382,101,880,101,749,110,4374
"32003002824",1311,62,13,6,332,28,276,15,2043
"32003002825",1777,531,215,34,462,113,492,113,3737
"32003002826",1927,224,204,0,577,28,970,53,3983
"32003002827",1317,336,281,25,601,25,681,63,3329
"32003002828",2159,317,169,90,691,163,430,135,4154
"32003002829",2898,92,117,28,893,29,1028,73,5158
"32003002830",3948,526,186,11,1479,14,1501,48,7713
"32003002831",2179,364,198,76,811,219,962,172,4981
"32003002832",3682,399,397,33,1021,299,1200,155,7186
"32003002833",3508,440,84,49,1510,43,930,158,6722
"32003002834",4508,290,607,0,1336,0,1446,0,8187
"32003002835",1487,231,225,24,615,46,360,76,3064
"32003002836",2235,130,247,19,1103,76,1226,69,5105
"32003002837",4365,260,108,7,1114,32,1824,48,7758
"32003002838",3443,388,167,94,765,60,939,45,5901
"32003002841",2087,55,87,14,453,24,246,6,2972
"32003002842",2875,226,93,110,2399,68,1447,47,7265
"32003002843",4781,409,798,0,2910,275,1826,23,11022
"32003002844",3752,164,667,22,1714,85,948,0,7352
"32003002845",2917,604,417,59,654,244,1139,524,6558
"32003002846",4533,160,900,0,1979,184,1533,14,9303
"32003002847",2090,353,216,299,752,16,1197,24,4947
"32003002848",2139,206,281,15,711,59,877,61,4349
"32003002905",2100,507,311,108,934,527,789,134,5410
"32003002915",3208,142,319,100,905,72,722,28,5496
"32003002916",1739,176,326,50,374,78,316,26,3085
"32003002919",1989,444,158,87,772,308,546,270,4574
"32003002935",899,43,86,73,421,18,299,10,1849
"32003002936",1357,123,498,222,956,198,656,31,4041
"32003002937",1948,416,474,243,1465,583,1517,665,7311
"32003002938",791,151,132,35,299,29,121,33,1591
"32003002939",1267,92,67,5,281,28,126,14,1880
"32003002940",1561,142,459,86,1370,148,536,0,4302
"32003002941",2625,600,253,220,881,103,1356,512,6550
"32003002942",2517,285,360,44,1016,300,718,217,5457
"32003002944",1752,313,184,31,1215,153,363,186,4197
"32003002946",1106,250,130,0,566,115,284,118,2569
"32003002947",1974,240,23,0,672,35,297,29,3270
"32003002948",1818,448,64,86,935,48,1496,310,5205
"32003002949",1797,268,191,0,899,113,1072,124,4464
"32003002950",2112,304,485,160,1505,115,735,218,5634
"32003002951",3581,432,289,168,2395,495,1137,68,8565
"32003002952",1673,144,418,12,431,42,160,63,2943
"32003002953",2750,334,252,74,1160,62,949,100,5681
"32003002954",1824,604,130,63,952,140,802,348,4863
"32003002956",1165,77,422,98,721,48,592,48,3171
"32003002957",1616,11,109,0,166,0,234,0,2136
"32003002958",2388,445,596,135,1986,207,1123,333,7213
"32003002961",1392,206,175,35,336,46,150,100,2440
"32003002962",720,140,75,62,115,30,124,67,1333
"32003002964",1781,683,792,121,1106,246,1123,428,6280
"32003002965",2791,704,177,85,366,68,1270,543,6004
"32003002966",1606,567,1029,329,637,510,622,429,5729
"32003002967",1358,397,825,52,749,131,571,185,4268
"32003002968",1253,239,383,12,864,57,343,68,3219
"32003002969",721,33,235,73,382,22,383,15,1864
"32003002970",1340,258,582,21,1300,346,671,384,4902
"32003002974",2565,704,441,172,1385,137,732,178,6314
"32003002975",2425,378,490,349,2248,229,1209,206,7534
"32003002976",2498,144,76,132,1331,216,423,35,4855
"32003002977",1917,79,148,4,922,99,662,3,3834
"32003002978",1708,184,262,78,1062,68,622,68,4052
"32003002979",1465,146,48,115,441,112,439,96,2862
"32003002980",2379,162,604,43,3348,240,617,69,7462
"32003002981",2097,315,427,0,1899,112,1169,163,6182
"32003002982",2900,244,511,55,3151,189,1647,36,8733
"32003002983",1137,106,560,35,1085,151,484,29,3587
"32003002984",2355,12,419,0,2427,142,1038,0,6393
"32003002985",1972,190,536,0,1676,98,740,144,5356
"32003002995",1070,255,148,68,750,380,1000,316,3987
"32003002996",2210,581,238,40,1648,369,1928,678,7692
"32003003001",2491,384,48,50,912,105,1346,132,5468
"32003003003",3486,229,332,0,1003,458,1243,418,7169
"32003003004",1419,197,353,96,161,40,496,91,2853
"32003003005",2594,179,156,20,353,135,1014,88,4539
"32003003006",2304,881,119,43,374,146,1096,681,5644
"32003003102",2345,905,324,127,1064,684,1651,991,8091
"32003003103",2057,355,123,116,634,111,1122,223,4741
"32003003104",1682,708,483,251,690,107,1102,360,5383
"32003003204",4483,53,190,43,819,35,574,0,6197
"32003003208",2184,109,168,0,488,10,200,28,3187
"32003003210",2174,188,43,0,156,0,101,10,2672
"32003003211",3026,105,46,0,121,0,142,0,3440
"32003003213",1771,83,74,0,91,22,63,22,2126
"32003003214",1346,56,96,5,71,0,29,0,1603
"32003003215",2608,637,482,33,454,228,568,203,5213
"32003003218",3983,42,292,0,1072,11,838,0,6238
"32003003219",3699,288,836,29,1085,213,1004,62,7216
"32003003220",3083,779,523,341,1652,101,1921,521,8921
"32003003222",3187,126,402,0,804,43,676,14,5252
"32003003223",2160,88,118,0,573,30,127,62,3158
"32003003226",1810,79,42,0,498,45,163,0,2637
"32003003227",1978,182,324,50,682,59,261,0,3536
"32003003228",2279,912,516,50,713,31,435,394,5330
"32003003229",1353,211,334,37,597,108,521,59,3220
"32003003230",5336,501,735,115,1234,141,1540,182,9784
"32003003231",4854,760,532,0,1610,173,1228,0,9157
"32003003232",4470,178,383,1,612,237,482,48,6411
"32003003233",1839,154,569,0,1560,0,435,104,4661
"32003003234",3027,233,857,15,516,36,1035,45,5764
"32003003235",1733,146,712,43,397,116,549,57,3753
"32003003236",1756,24,174,0,253,0,142,15,2364
"32003003237",2728,166,105,206,844,98,760,18,4925
"32003003238",4157,436,1191,139,879,134,1198,106,8240
"32003003239",2327,122,212,33,764,37,385,75,3955
"32003003240",2471,371,80,8,761,144,556,6,4397
"32003003241",2664,138,519,25,510,200,807,207,5070
"32003003242",1254,82,22,2,339,39,102,42,1882
"32003003243",2765,181,313,19,1209,29,671,14,5201
"32003003244",2615,148,236,12,687,42,837,68,4645
"32003003245",3091,313,298,61,920,90,822,216,5811
"32003003246",2667,74,122,49,1005,26,611,6,4560
"32003003247",2831,131,186,64,681,27,494,10,4424
"32003003248",1922,247,265,57,878,120,605,62,4156
"32003003249",2371,160,313,110,705,67,653,20,4399
"32003003250",3477,186,202,62,1036,620,655,23,6261
"32003003251",1865,51,39,0,261,164,210,9,2599
"32003003252",3404,213,290,0,785,123,654,135,5604
"32003003253",2337,131,42,2,1098,308,989,67,4974
"32003003254",2370,563,440,0,472,29,711,237,4822
"32003003260",2398,228,215,9,589,88,645,84,4256
"32003003261",2077,204,62,0,142,109,436,203,3233
"32003003262",2442,144,42,0,225,0,44,9,2906
"32003003303",3424,241,546,197,809,187,1450,165,7019
"32003003305",3502,408,638,1,1069,18,881,130,6647
"32003003306",3028,325,307,114,397,12,538,11,4732
"32003003307",3455,373,834,133,1485,43,882,219,7424
"32003003308",2059,105,394,6,413,43,543,12,3575
"32003003309",2885,176,361,147,494,11,486,18,4578
"32003003310",3494,222,314,0,667,87,384,26,5194
"32003003311",2449,157,229,147,658,76,595,23,4334
"32003003312",2639,106,264,21,672,73,363,120,4258
"32003003313",2515,119,136,0,391,17,685,54,3917
"32003003314",5899,101,209,0,1004,0,819,0,8032
"32003003315",2668,199,442,12,721,214,555,284,5095
"32003003316",4218,164,304,267,744,70,1002,70,6839
"32003003317",2203,73,87,0,183,0,405,0,2951
"32003003318",3304,275,390,142,853,19,497,24,5504
"32003003319",4563,256,424,195,927,22,1107,0,7494
"32003003320",3708,135,415,0,544,18,1128,27,5975
"32003003321",1579,124,203,31,428,12,179,26,2582
"32003003408",3234,398,272,20,782,52,919,144,5821
"32003003409",4048,715,474,124,808,205,1309,106,7789
"32003003410",3915,170,334,185,816,65,1222,0,6707
"32003003411",1674,490,423,125,968,90,528,75,4373
"32003003412",2473,363,420,32,870,160,1287,130,5735
"32003003413",2706,351,488,169,1085,150,1414,167,6530
"32003003414",1479,144,232,3,268,40,356,69,2591
"32003003415",2773,1027,618,673,1186,491,1507,978,9253
"32003003416",2144,179,250,14,366,54,1035,62,4104
"32003003418",1293,699,781,403,1080,198,998,427,5879
"32003003419",2914,1194,1521,251,818,219,1706,764,9387
"32003003420",2164,919,382,161,699,517,1556,1128,7526
"32003003421",1486,278,323,74,696,478,423,493,4251
"32003003422",2783,753,316,147,870,257,1523,592,7241
"32003003423",2123,699,937,604,1962,94,2057,361,8837
"32003003426",1617,461,633,122,571,112,602,303,4421
"32003003427",2105,263,432,133,496,223,1217,256,5125
"32003003428",1133,297,143,47,123,247,570,332,2892
"32003003429",1991,898,776,343,1089,346,1596,733,7772
"32003003430",839,250,600,267,685,114,959,204,3918
"32003003431",884,779,347,339,531,398,907,1022,5207
"32003003500",600,287,1158,544,248,185,504,401,3927
"32003003607",4115,403,830,66,1998,157,2385,218,10172
"32003003609",2431,138,911,172,1010,180,1084,111,6037
"32003003610",2945,149,826,72,1647,203,2132,162,8136
"32003003612",3213,112,1602,259,2181,40,2523,26,9956
"32003003613",2646,736,1319,333,2378,231,2659,748,11050
"32003003615",1295,178,418,142,656,131,870,191,3881
"32003003616",1388,66,922,741,1195,249,2054,287,6902
"32003003617",422,92,389,123,249,64,450,87,1876
"32003003618",5065,495,749,195,1522,122,1098,230,9476
"32003003619",1901,61,484,0,864,51,842,24,4227
"32003003620",2789,103,808,152,1512,6,1074,35,6479
"32003003621",2605,116,140,0,253,0,55,3,3172
"32003003622",3460,55,1078,50,1314,140,1040,55,7192
"32003003623",2903,371,1154,171,926,148,1345,488,7506
"32003003624",2644,237,1951,61,1441,175,1349,52,7910
"32003003625",4978,964,976,398,974,42,2415,638,11385
"32003003626",1972,355,527,22,903,157,801,75,4812
"32003003627",1901,168,1322,43,897,116,1070,221,5738
"32003003628",3307,124,1645,1083,2227,270,1662,313,10631
"32003003629",3735,83,850,244,1272,61,1810,0,8055
"32003003630",3564,444,800,72,1171,234,1499,195,7979
"32003003631",1653,305,762,52,755,231,932,276,4966
"32003003632",1691,104,561,109,693,141,1126,234,4659
"32003003633",2147,535,702,86,430,53,956,553,5462
"32003003634",2400,79,790,254,830,73,1402,61,5889
"32003003635",2893,119,620,96,2112,63,2158,45,8106
"32003003636",1733,123,346,9,226,264,341,103,3145
"32003003637",2711,371,877,24,667,94,998,312,6054
"32003003638",952,339,608,233,751,191,555,350,3979
"32003003639",2091,126,388,203,834,164,1488,149,5443
"32003003640",2838,124,744,230,1178,0,2176,93,7383
"32003003641",2106,185,2098,448,1123,94,1540,231,7825
"32003003642",1762,124,926,134,1303,227,1771,214,6461
"32003003643",1836,326,821,239,1609,370,1860,469,7530
"32003003644",1062,231,1130,560,1345,36,1327,229,5920
"32003003700",336,90,1313,337,536,334,743,404,4093
"32003003800",1380,582,313,437,473,680,1345,979,6189
"32003004000",1329,656,68,0,843,503,1769,1119,6287
"32003004100",1793,888,100,0,1821,1000,2955,1783,10340
"32003004200",1767,1271,89,28,1223,265,2376,1402,8421
"32003004301",370,341,10,88,279,463,631,762,2944
"32003004302",912,795,239,175,645,564,1508,1250,6088
"32003004401",913,634,41,7,575,463,1194,1009,4836
"32003004402",1026,928,266,229,680,751,1616,1504,7000
"32003004500",1730,474,272,149,1341,631,2802,736,8135
"32003004601",677,566,471,827,1491,491,2008,1076,7607
"32003004602",688,431,409,174,610,293,1098,671,4374
"32003004703",2138,816,1046,519,689,87,1731,739,7765
"32003004707",1173,615,132,69,627,263,1487,794,5160
"32003004709",2092,882,612,535,1282,921,2807,1607,10738
"32003004710",2406,1867,334,514,1459,654,3295,2290,12819
"32003004712",1384,1008,450,745,799,556,845,795,6582
"32003004713",1409,1022,390,513,474,230,1434,918,6390
"32003004714",2320,957,856,347,834,123,2235,865,8537
"32003004715",2572,433,958,703,606,721,1240,917,8150
"32003004716",1299,561,414,105,685,109,1398,576,5147
"32003004717",1285,484,77,11,1445,74,2014,499,5889
"32003004907",1947,150,244,73,1135,43,1033,124,4749
"32003004910",920,163,167,15,1629,148,1632,134,4808
"32003004911",1423,539,277,102,1026,350,1205,654,5576
"32003004912",1800,723,355,165,1986,585,2316,978,8908
"32003004914",1397,304,146,49,498,159,1079,348,3980
"32003004915",1600,343,222,8,995,166,1408,293,5035
"32003004916",1307,292,275,6,529,292,1179,397,4277
"32003004917",1106,228,394,24,1182,189,1340,196,4659
"32003004918",2014,332,504,28,1193,35,1650,89,5845
"32003004919",2893,232,236,22,894,159,1726,131,6293
"32003004920",2352,741,389,351,1397,352,2759,734,9075
"32003004921",2845,821,493,177,1006,349,2301,737,8729
"32003004923",1839,82,322,360,1479,61,1577,59,5779
"32003004924",1171,540,295,254,1336,237,1580,501,5914
"32003004925",2931,168,433,67,1705,839,2499,587,9229
"32003004926",1636,72,110,78,1526,122,1444,182,5170
"32003005005",2175,671,245,349,374,221,355,283,4673
"32003005006",2587,337,728,31,953,491,1280,446,6853
"32003005007",1489,133,218,25,711,48,383,63,3070
"32003005010",2310,671,159,251,1460,198,1688,638,7375
"32003005011",1721,316,178,173,409,346,1180,526,4849
"32003005012",1714,333,147,35,725,7,1004,291,4256
"32003005013",1383,63,278,261,1794,269,1731,49,5828
"32003005014",1790,305,879,78,2053,630,1650,484,7869
"32003005015",2203,75,258,94,1582,87,1100,41,5440
"32003005016",3386,142,328,0,1964,16,2861,56,8753
"32003005017",1998,420,543,228,1804,82,1316,430,6821
"32003005101",5751,174,204,4,1412,453,1753,135,9886
"32003005102",3686,392,127,119,413,131,512,40,5420
"32003005103",3166,397,332,93,1072,101,1286,128,6575
"32003005104",2234,349,129,0,533,90,320,22,3677
"32003005105",5454,934,553,381,1082,178,1849,338,10769
"32003005106",1983,112,342,30,735,0,656,0,3858
"32003005107",2984,225,92,47,717,90,767,142,5064
"32003005108",2564,208,487,0,441,153,487,210,4550
"32003005109",4613,560,324,86,1525,90,1044,70,8312
"32003005200",2155,722,91,60,169,96,523,284,4100
"32003005311",1810,239,184,9,704,33,537,0,3516
"32003005312",1618,368,172,0,367,15,167,258,2965
"32003005313",4613,130,247,79,918,0,1006,76,7069
"32003005314",2178,29,107,0,308,72,312,11,3017
"32003005315",3786,249,225,14,748,0,699,0,5721
"32003005316",3316,250,231,178,952,105,1032,365,6429
"32003005317",3768,218,210,10,867,53,610,1,5737
"32003005318",2241,280,75,0,508,169,329,0,3602
"32003005319",1614,170,117,20,589,114,575,124,3323
"32003005320",2078,176,84,5,309,15,440,15,3122
"32003005321",2927,278,237,29,552,102,652,151,4928
"32003005322",985,47,13,24,266,30,104,33,1502
"32003005333",1777,114,53,0,431,93,156,74,2698
"32003005335",3943,163,18,24,399,37,329,17,4930
"32003005336",2869,515,114,42,328,14,404,48,4334
"32003005337",2382,150,90,0,486,65,262,65,3500
"32003005338",1703,69,7,13,86,19,163,11,2071
"32003005341",1813,241,54,0,167,66,325,46,2712
"32003005342",2958,97,49,0,292,41,507,43,3987
"32003005343",3499,406,74,0,505,31,448,12,4975
"32003005346",3373,412,224,63,1157,282,804,127,6442
"32003005347",3703,321,26,0,1033,194,670,0,5947
"32003005348",3776,167,90,72,1075,131,720,32,6063
"32003005349",2783,333,166,19,868,94,697,89,5049
"32003005350",2775,171,51,0,576,0,346,15,3934
"32003005351",2773,419,198,35,908,165,352,306,5156
"32003005352",2619,284,67,10,216,54,287,24,3561
"32003005353",2775,104,269,9,667,36,475,0,4335
"32003005354",3718,512,549,0,735,78,643,274,6509
"32003005355",3704,651,89,32,628,13,282,96,5495
"32003005356",2142,59,87,26,255,24,396,28,3017
"32003005357",4734,286,438,110,835,101,717,83,7304
"32003005358",2490,65,24,0,367,7,536,21,3510
"32003005359",6005,277,473,99,1042,93,947,0,8936
"32003005360",3470,537,114,0,588,30,584,151,5474
"32003005421",1521,814,332,663,110,30,196,312,3978
"32003005422",2712,512,298,141,271,249,721,337,5241
"32003005423",2614,579,241,525,469,106,824,71,5429
"32003005432",4688,96,396,0,666,0,785,0,6631
"32003005433",4085,150,24,0,238,162,598,105,5362
"32003005434",4047,252,60,12,499,39,756,2,5667
"32003005435",2823,329,72,1,108,57,358,36,3784
"32003005436",5703,279,864,161,1079,0,1565,32,9683
"32003005437",2117,208,148,0,125,12,70,0,2680
"32003005438",1549,119,5,119,308,55,239,86,2480
"32003005439",1906,652,116,75,835,20,1096,139,4839
"32003005501",3183,461,0,0,360,16,164,16,4200
"32003005502",3868,367,9,3,167,2,540,30,4986
"32003005503",2663,208,0,0,131,121,91,56,3270
"32003005504",2794,328,0,13,173,11,304,34,3657
"32003005607",2307,422,66,8,559,220,1062,313,4957
"32003005612",1148,144,0,20,61,8,115,0,1496
"32003005613",4172,223,182,0,203,9,319,37,5145
"32003005614",1097,550,5,4,440,292,690,615,3693
"32003005615",1436,124,0,0,147,99,316,83,2205
"32003005702",1973,716,72,46,249,203,308,121,3688
"32003005703",528,204,50,22,109,18,73,23,1027
"32003005704",1307,456,100,5,59,0,297,104,2328
"32003005705",1948,322,75,11,251,12,143,30,2792
"32003005711",3632,109,73,0,783,148,366,15,5126
"32003005712",7214,256,307,141,950,52,991,0,9911
"32003005713",4348,113,221,24,1083,146,351,0,6286
"32003005714",4625,131,224,24,516,5,192,52,5769
"32003005715",3293,201,294,0,558,20,297,18,4681
"32003005716",2743,127,212,10,699,49,46,0,3886
"32003005803",2599,524,133,70,769,177,600,28,4900
"32003005804",2796,43,203,17,619,131,317,0,4126
"32003005805",2289,118,101,0,326,102,285,59,3280
"32003005806",2489,403,226,67,384,88,435,110,4202
"32003005807",2676,218,390,195,750,75,504,37,4845
"32003005808",2068,166,177,16,624,64,443,0,3558
"32003005809",2460,366,339,0,590,147,740,50,4692
"32003005811",4193,186,1085,0,2789,441,1299,301,10294
"32003005813",2054,80,499,279,1475,43,951,1,5382
"32003005818",830,138,0,0,82,0,187,0,1237
"32003005822",4581,165,134,0,1425,167,953,96,7521
"32003005823",3094,70,371,0,1017,48,433,15,5048
"32003005824",2277,111,64,0,571,87,190,10,3310
"32003005825",2876,530,472,94,1483,330,1308,344,7437
"32003005826",1991,161,471,9,1093,114,477,125,4441
"32003005827",4286,275,75,39,1748,211,742,0,7376
"32003005828",4261,100,559,86,2553,101,816,62,8538
"32003005829",3848,613,400,51,2010,100,1391,411,8824
"32003005830",1762,83,529,31,1284,124,487,0,4300
"32003005831",2420,98,126,185,1687,43,489,25,5073
"32003005832",2552,266,88,80,1309,133,429,24,4881
"32003005833",3874,309,434,91,2295,128,1512,117,8760
"32003005834",1518,114,262,20,330,32,605,0,2881
"32003005835",2875,52,1138,34,983,0,991,0,6073
"32003005836",2963,147,103,0,982,94,671,0,4960
"32003005837",2998,273,245,0,1141,34,562,51,5304
"32003005838",3978,102,312,0,1485,192,807,41,6917
"32003005839",2824,13,262,22,826,163,554,140,4804
"32003005840",4686,530,684,223,3640,0,1810,65,11638
"32003005841",3606,282,216,0,891,6,453,180,5634
"32003005842",1513,73,132,114,211,95,38,6,2182
"32003005843",1865,297,48,0,436,25,161,19,2851
"32003005844",4541,154,353,24,1026,16,587,0,6701
"32003005845",2571,319,306,0,730,138,491,108,4663
"32003005846",3974,159,47,0,921,38,495,24,5658
"32003005847",908,81,220,49,515,76,140,0,1989
"32003005848",1901,280,354,191,664,549,520,321,4780
"32003005849",1849,193,671,8,887,74,609,12,4303
"32003005850",1717,90,397,50,1636,133,539,32,4594
"32003005851",2920,381,298,12,2352,94,1242,207,7506
"32003005852",2483,207,32,0,1593,6,656,60,5037
"32003005853",3904,688,564,3,2375,270,1295,384,9483
"32003005854",4635,470,1315,478,2765,358,1342,20,11383
"32003005855",3135,416,301,95,2330,212,627,58,7174
"32003005856",2166,144,205,34,1746,160,429,54,4938
"32003005902",1049,57,0,1,332,137,282,73,1931
"32003005903",2140,97,4,0,85,0,310,10,2646
"32003005904",2043,98,5,0,139,0,193,5,2483
"32003005905",1880,244,0,0,260,30,211,1,2626
"32003006001",2318,583,1141,341,634,412,843,629,6901
"32003006103",1818,173,138,225,354,401,718,426,4253
"32003006104",1979,251,259,86,1244,101,684,175,4779
"32003006201",1270,986,359,119,650,194,1046,663,5287
"32003006202",1651,818,616,0,565,247,1041,673,5611
"32003006203",1497,530,100,92,735,119,1157,329,4559
"32003006204",2420,572,155,192,1149,179,2012,229,6908
"32003006700",552,79,29,0,122,16,53,8,859
"32003006800",2486,670,273,267,565,405,1677,717,7060
"32003006900",1213,62,43,18,466,21,311,14,2148
"32003007100",1482,662,24,23,562,575,1533,966,5827
"32003007200",1607,584,448,455,1343,389,1789,417,7032
"32003007500",902,104,0,1,134,70,67,6,1284
"32003007600",2861,236,0,0,720,23,854,74,4768
"32003007800",697,521,57,36,208,45,233,79,1876
"32005001000",2267,112,15,0,229,0,249,0,2872
"32005001100",3551,851,33,0,699,271,732,293,6430
"32005001200",2344,359,0,0,62,39,150,104,3058
"32005001300",1405,80,0,0,16,16,48,48,1613
"32005001400",2334,313,0,4,275,99,230,38,3293
"32005001500",3981,721,43,11,585,152,692,301,6486
"32005001600",1046,76,3,0,48,0,19,8,1200
"32005001700",1373,115,93,0,380,48,405,59,2473
"32005001800",1670,73,0,0,186,41,189,0,2159
"32005001900",1469,32,0,0,52,0,52,4,1609
"32005002000",2891,363,0,0,382,20,683,0,4339
"32005002100",1716,174,11,0,144,0,230,74,2349
"32005002200",6104,267,0,0,168,0,441,0,6980
"32005002300",3153,180,0,0,133,2,100,0,3568
"32005002400",864,96,14,2,390,230,177,75,1848
"32005002500",1635,208,9,0,149,29,126,47,2203
"32005990000",0,0,0,0,0,0,0,0,0
"32007950200",1621,48,0,0,80,58,325,9,2141
"32007950701",5162,540,117,58,320,71,1119,315,7702
"32007950702",3973,218,27,0,705,367,629,101,6020
"32007950800",1411,58,25,0,182,27,163,15,1881
"32007950900",1578,170,172,0,168,86,251,50,2475
"32007951000",1257,76,36,0,132,0,622,26,2149
"32007951201",4495,38,0,0,337,6,125,0,5001
"32007951202",2538,434,16,0,298,61,1093,373,4813
"32007951300",1895,350,30,0,216,67,1204,93,3855
"32007951401",3988,173,20,0,455,0,1343,0,5979
"32007951402",5934,389,0,0,177,0,256,85,6841
"32007951500",3240,1110,22,0,65,219,1865,801,7322
"32007951600",2109,69,0,4,0,0,192,4,2378
"32007951700",1410,624,0,0,1001,253,865,293,4446
"32009950100",881,109,0,0,58,85,126,56,1315
"32011000100",1444,152,0,0,58,10,32,10,1706
"32013010500",4529,396,27,1,914,316,1467,32,7682
"32013010600",2142,216,0,0,77,3,453,22,2913
"32013010701",3703,560,0,1,375,52,1265,332,6288
"32013010702",3026,116,4,0,266,101,750,0,4263
"32015000300",4642,583,0,5,574,88,1548,65,7505
"32017950100",1860,270,0,0,110,120,0,15,2375
"32017950200",2159,241,0,0,59,0,155,92,2706
"32019960101",7752,702,145,0,1445,0,849,109,11002
"32019960102",5772,950,17,50,839,187,1419,277,9511
"32019960103",932,209,0,0,137,24,157,92,1551
"32019960201",2821,715,8,0,663,87,545,106,4945
"32019960202",1940,777,67,0,210,86,104,61,3245
"32019960301",1275,570,0,0,55,155,362,225,2642
"32019960302",6804,1550,71,0,737,72,887,438,10559
"32019960303",3048,761,6,0,427,55,451,256,5004
"32019960800",3072,248,48,2,258,4,448,13,4093
"32019960900",3142,1005,3,14,1130,259,970,264,6787
"32021970700",2036,395,12,34,519,73,320,72,3461
"32021970800",438,133,0,0,570,272,126,27,1566
"32023960100",1948,236,0,2,470,102,193,3,2954
"32023960200",1823,312,19,0,127,44,205,9,2539
"32023960300",1393,383,0,0,583,32,868,148,3407
"32023960401",4024,573,207,114,301,224,470,279,6192
"32023960402",3203,924,47,11,541,126,595,130,5577
"32023960403",3465,987,135,268,32,120,358,120,5485
"32023960404",5874,799,101,0,449,806,447,685,9161
"32023960405",2281,882,44,5,144,12,324,170,3862
"32023960406",6378,653,63,0,791,43,763,199,8890
"32023980500",0,0,0,0,0,0,0,0,0
"32027960100",3644,723,0,6,273,103,628,278,5655
"32029970200",3431,269,2,10,189,14,136,8,4059
"32031000101",1553,559,97,60,259,335,203,188,3254
"32031000102",976,991,55,297,212,163,223,160,3077
"32031000201",1841,437,5,56,391,165,1385,196,4476
"32031000202",1471,729,10,0,286,75,542,207,3320
"32031000300",2829,370,9,0,317,77,374,2,3978
"32031000400",3832,1055,51,4,223,113,187,161,5626
"32031000700",2657,835,169,0,1310,206,1151,216,6544
"32031000900",1994,1424,53,133,397,155,1735,1250,7141
"32031001005",2089,324,0,1,199,110,277,113,3113
"32031001008",2396,709,126,31,631,482,1643,427,6445
"32031001009",1325,486,25,10,537,69,521,324,3297
"32031001010",2375,181,18,0,241,14,66,18,2913
"32031001011",3285,67,19,0,199,15,106,0,3691
"32031001012",2643,147,70,34,206,72,83,17,3272
"32031001013",5907,227,0,0,574,67,123,46,6944
"32031001014",1866,118,0,0,427,31,89,0,2531
"32031001015",3543,118,58,78,277,13,144,7,4238
"32031001101",2509,167,0,0,170,42,177,18,3083
"32031001103",3930,329,173,0,435,0,61,32,4960
"32031001104",3879,122,0,0,487,3,157,0,4648
"32031001105",3537,149,0,5,186,7,267,28,4179
"32031001201",1616,333,23,111,178,35,92,197,2585
"32031001202",2653,694,151,67,714,155,586,86,5106
"32031001300",2108,601,40,9,452,294,385,255,4144
"32031001400",1506,938,68,6,518,210,276,138,3660
"32031001501",2343,716,86,9,1197,51,848,212,5462
"32031001502",1759,1225,150,47,406,370,654,508,5119
"32031001701",1351,839,49,165,741,682,1266,785,5878
"32031001702",2868,1080,112,91,891,385,1292,775,7494
"32031001801",1255,700,94,44,1148,351,1494,490,5576
"32031001802",1247,585,58,0,1208,301,1502,571,5472
"32031001901",2406,1156,103,131,791,431,1715,1043,7776
"32031001902",2373,941,71,2,648,406,811,562,5814
"32031002103",2454,141,6,0,374,0,663,56,3694
"32031002104",2648,142,26,9,242,70,428,52,3617
"32031002105",3371,545,44,15,559,43,1349,138,6064
"32031002106",2153,410,45,0,708,36,1141,11,4504
"32031002107",781,336,10,24,413,223,436,302,2525
"32031002204",3082,737,208,0,1031,478,2133,865,8534
"32031002205",3274,566,24,30,755,113,1016,258,6036
"32031002206",4749,635,51,0,1044,0,1043,348,7870
"32031002207",3463,65,131,0,783,33,552,11,5038
"32031002208",2563,101,52,0,461,57,340,22,3596
"32031002209",4685,198,46,0,1424,0,651,0,7004
"32031002210",2189,64,17,0,134,51,42,0,2497
"32031002211",2091,976,27,0,653,292,1673,981,6693
"32031002212",1767,1868,39,327,224,562,1188,2026,8001
"32031002301",4690,132,61,0,454,12,318,0,5667
"32031002302",1877,105,0,0,233,0,139,20,2374
"32031002401",2433,318,0,1,519,189,233,71,3764
"32031002406",3335,927,45,0,757,161,580,168,5973
"32031002407",2708,553,57,1,586,73,334,204,4516
"32031002408",2424,238,13,76,403,92,275,23,3544
"32031002409",3635,224,111,0,252,0,310,0,4532
"32031002410",2771,369,54,0,918,37,1236,8,5393
"32031002411",2998,385,189,0,588,70,506,21,4757
"32031002412",2144,60,9,0,497,90,370,29,3199
"32031002500",3282,813,86,90,585,22,666,72,5616
"32031002603",1311,98,0,0,104,30,105,10,1658
"32031002610",4246,257,14,246,715,65,1365,43,6951
"32031002611",3285,1440,94,263,958,605,1327,485,8457
"32031002612",2635,745,0,6,238,50,376,86,4136
"32031002613",4504,184,150,0,738,0,619,0,6195
"32031002614",2435,298,134,0,998,383,1417,507,6172
"32031002615",2092,207,73,47,940,95,704,112,4270
"32031002616",2985,360,60,0,988,134,1385,139,6051
"32031002617",3907,446,88,10,1384,168,2215,126,8344
"32031002618",5524,280,0,3,573,1,986,21,7388
"32031002619",4152,1091,115,93,651,78,1482,413,8075
"32031002703",1454,369,100,114,432,22,784,112,3387
"32031002704",2540,593,165,42,610,394,1209,521,6074
"32031002705",2988,998,65,113,699,23,956,371,6213
"32031002706",3103,652,75,0,610,250,1010,438,6138
"32031002707",3043,921,8,0,798,26,1498,582,6876
"32031002801",2509,536,269,40,1088,205,1568,255,6470
"32031002802",3098,716,87,14,1330,298,2221,692,8456
"32031002901",2634,289,44,29,139,117,654,44,3950
"32031002902",2584,797,129,73,835,291,1139,701,6549
"32031003000",3851,890,53,0,1822,130,2075,616,9437
"32031003101",2499,491,298,119,390,148,667,232,4844
"32031003105",1787,171,39,0,332,4,501,14,2848
"32031003106",5253,897,137,0,920,228,1754,439,9628
"32031003108",2637,103,0,0,454,15,572,17,3798
"32031003109",2454,126,0,0,577,10,133,8,3308
"32031003110",3605,494,48,0,1009,0,891,0,6047
"32031003202",5726,326,0,0,190,0,284,0,6526
"32031003203",4450,256,35,9,266,9,266,28,5319
"32031003204",2216,79,44,0,70,0,75,11,2495
"32031003305",955,166,0,0,200,0,267,0,1588
"32031003306",1148,166,0,0,112,120,326,190,2062
"32031003307",985,178,0,0,19,0,166,14,1362
"32031003308",1854,142,0,0,176,13,79,0,2264
"32031003309",2246,194,0,0,118,0,86,0,2644
"32031003501",2838,154,76,7,485,244,356,30,4190
"32031003503",3977,126,78,1,345,26,1269,1,5823
"32031003504",6440,268,62,0,515,21,625,0,7931
"32031003507",3370,45,112,0,463,6,485,0,4481
"32031003508",2526,117,7,0,314,24,554,11,3553
"32031003509",3699,108,375,0,1273,25,1316,29,6825
"32031003510",1980,247,33,0,637,387,579,460,4323
"32031003511",4294,215,224,0,406,0,585,33,5757
"32031003512",3963,159,117,20,372,20,436,57,5144
"32031003513",1921,66,47,0,336,46,518,10,2944
"32031003514",2320,215,64,0,170,26,305,0,3100
"32031003515",5509,183,79,54,806,19,1248,80,7978
"32031940200",280,80,8,3,736,434,77,32,1650
"32031980000",0,0,0,0,0,0,0,0,0
"32031980100",0,0,0,0,0,0,0,0,0
"32031980200",0,0,0,0,0,0,0,0,0
"32031980300",0,0,0,0,0,0,0,0,0
"32031990000",0,0,0,0,0,0,0,0,0
"32031990100",0,0,0,0,0,0,0,0,0
"32033970100",1430,162,0,0,76,5,36,11,1720
"32033970200",3634,415,23,0,295,168,623,23,5181
"32033970300",1878,211,0,1,268,25,352,39,2774
"32510000100",2498,228,79,4,261,52,367,54,3543
"32510000200",3007,543,1,0,232,9,200,145,4137
"32510000300",2915,135,0,0,421,52,239,7,3769
"32510000400",3031,292,0,0,395,217,550,187,4672
"32510000501",3603,973,44,0,1039,482,1170,968,8279
"32510000502",2035,728,16,0,153,146,371,152,3601
"32510000600",3400,898,0,0,802,262,1372,312,7046
"32510000701",3099,427,0,0,293,78,458,121,4476
"32510000702",2662,245,32,0,240,30,250,141,3600
"32510000800",2470,251,0,0,247,75,401,2,3446
"32510000900",2986,928,0,0,1166,55,952,196,6283
"32510001001",2255,731,13,0,760,647,1763,886,7055
"32510001002",3027,264,29,0,416,35,705,0,4476
"32510990000",0,0,0,0,0,0,0,0,0
"33001965100",2820,225,31,34,146,15,5,9,3285
"33001965200",2386,460,0,0,75,89,33,131,3174
"33001965300",2918,233,92,0,50,0,24,0,3317
"33001965400",2883,82,2,0,5,0,73,0,3045
"33001965598",3025,207,0,0,54,73,0,73,3432
"33001965600",3161,392,0,0,166,12,50,0,3781
"33001965700",4406,178,0,0,18,0,0,0,4602
"33001965800",6445,533,0,0,216,40,271,0,7505
"33001965900",3136,602,0,0,29,0,121,12,3900
"33001966000",3780,1159,0,0,128,37,0,0,5104
"33001966100",3285,250,0,0,87,36,76,7,3741
"33001966200",2194,610,91,3,43,22,0,0,2963
"33001966401",1067,103,0,0,20,0,49,0,1239
"33001966402",5356,446,0,0,141,7,0,0,5950
"33001966500",4572,366,75,0,270,0,0,0,5283
"33003955100",3448,327,3,1,78,3,0,13,3873
"33003955300",5240,660,52,0,163,61,12,69,6257
"33003955400",3275,490,0,0,278,1,5,13,4062
"33003955500",2554,204,20,7,43,0,1,5,2834
"33003955600",4488,574,33,9,47,46,9,0,5206
"33003955800",2231,389,4,0,17,7,4,0,2652
"33003955900",3232,729,37,0,66,0,92,0,4156
"33003956000",5532,197,3,0,78,3,121,0,5934
"33003956100",5614,455,0,0,68,0,255,0,6392
"33003956300",3784,153,0,1,43,43,25,1,4050
"33003956400",2053,124,0,0,5,0,14,0,2196
"33005970100",3709,413,5,19,58,0,83,0,4287
"33005970200",3377,191,0,0,110,25,47,12,3762
"33005970400",4691,311,47,0,62,3,62,8,5184
"33005970500",4281,778,0,0,178,6,15,0,5258
"33005970600",4299,294,46,0,99,109,25,0,4872
"33005970700",3197,222,4,0,144,0,32,0,3599
"33005970800",3572,342,58,0,101,35,42,0,4150
"33005970900",5953,879,0,0,194,142,176,75,7419
"33005971000",4684,510,47,0,364,40,128,0,5773
"33005971100",4006,1039,29,27,142,92,88,4,5427
"33005971300",2203,603,23,0,136,0,110,0,3075
"33005971401",1534,792,31,0,64,11,0,34,2466
"33005971402",3277,244,0,0,205,71,86,0,3883
"33005971500",5008,286,6,0,35,0,0,37,5372
"33005971600",3510,401,0,0,27,0,72,0,4010
"33005971700",3560,541,0,0,54,41,26,0,4222
"33007950100",1491,244,0,3,19,26,7,7,1797
"33007950200",2355,495,5,0,62,3,30,10,2960
"33007950300",1877,154,2,0,25,2,20,9,2089
"33007950400",2854,520,16,8,108,0,11,0,3517
"33007950500",2939,273,8,2,28,0,5,0,3255
"33007950600",2115,901,0,0,45,61,9,23,3154
"33007950700",2574,344,0,0,41,7,44,31,3041
"33007950800",1787,374,9,0,94,7,3,14,2288
"33007950900",2782,238,0,0,90,0,53,0,3163
"33007951000",2002,206,5,20,16,1,4,1,2255
"33007951100",2554,342,13,1,114,25,24,20,3093
"33009960100",4881,904,0,28,93,0,58,48,6012
"33009960200",3578,440,8,0,44,150,45,0,4265
"33009960300",4191,462,13,0,105,14,27,15,4827
"33009960400",3142,358,17,0,105,0,25,0,3647
"33009960500",1941,269,3,0,37,15,18,16,2299
"33009960600",3546,650,17,0,113,3,24,15,4368
"33009960700",2813,286,4,0,85,1,30,6,3225
"33009960800",4409,297,0,0,232,11,0,0,4949
"33009960900",2859,317,7,0,105,0,77,8,3373
"33009961000",3844,1136,72,1,192,49,219,2,5515
"33009961100",3800,407,57,10,55,0,16,17,4362
"33009961200",3737,318,0,0,111,0,26,0,4192
"33009961300",2889,339,76,0,58,5,30,7,3404
"33009961400",3257,507,7,0,114,13,39,0,3937
"33009961500",4388,115,15,0,20,0,71,0,4609
"33009961601",2693,80,0,0,215,0,46,0,3034
"33009961602",3220,567,0,29,270,192,24,0,4302
"33009961700",4962,1187,66,34,884,158,178,169,7638
"33009961800",5246,199,0,0,538,58,387,0,6428
"33011000101",2381,184,43,18,125,78,12,96,2937
"33011000102",3362,252,91,53,256,281,101,0,4396
"33011000202",1760,361,91,0,64,52,41,27,2396
"33011000203",2437,325,133,0,204,34,53,0,3186
"33011000204",3211,473,242,120,835,64,252,110,5307
"33011000300",2383,290,0,0,68,12,75,68,2896
"33011000600",1542,228,54,13,63,0,69,0,1969
"33011000700",2785,109,8,30,73,0,55,14,3074
"33011000800",1745,321,88,53,138,75,115,46,2581
"33011000901",3009,165,201,0,0,0,104,0,3479
"33011000902",4587,396,382,109,554,37,232,155,6452
"33011001000",4842,254,0,0,385,0,107,0,5588
"33011001100",4714,124,348,0,87,57,192,0,5522
"33011001200",1500,171,9,0,31,0,105,91,1907
"33011001300",1786,655,137,72,179,97,563,104,3593
"33011001400",1026,485,103,231,194,137,203,203,2582
"33011001500",1179,768,175,209,302,180,397,405,3615
"33011001600",2337,1116,310,14,612,328,663,337,5717
"33011001700",1919,253,34,0,0,45,585,168,3004
"33011001800",4020,775,187,30,598,40,319,254,6223
"33011001900",1289,709,53,104,370,38,293,202,3058
"33011002000",1002,443,82,107,338,99,184,89,2344
"33011002100",3165,1063,202,73,332,132,459,194,5620
"33011002200",2903,380,10,0,50,27,199,43,3612
"33011002300",2930,169,162,38,186,9,125,0,3619
"33011002400",5183,926,572,270,314,64,412,53,7794
"33011002500",4484,301,113,0,244,56,192,24,5414
"33011002600",5067,176,0,1,541,0,317,0,6102
"33011002701",3403,171,0,0,99,0,32,0,3705
"33011002702",5685,271,30,0,53,0,76,53,6168
"33011002800",5041,505,137,0,70,18,182,18,5971
"33011002901",6318,299,190,0,362,0,92,0,7261
"33011002902",5454,129,96,0,60,0,52,29,5820
"33011002903",7962,15,0,0,215,0,126,0,8318
"33011010100",4452,221,110,0,379,23,320,105,5610
"33011010200",5484,447,165,21,1012,25,620,0,7774
"33011010301",3684,59,0,0,437,16,113,0,4309
"33011010302",3803,227,21,0,195,0,370,9,4625
"33011010400",3950,489,134,0,314,24,181,150,5242
"33011010500",2310,1112,190,18,328,172,714,645,5489
"33011010600",3779,566,389,223,312,175,661,442,6547
"33011010700",706,342,120,6,147,56,183,118,1678
"33011010800",4053,2196,254,155,697,281,1690,1068,10394
"33011010900",5160,756,171,16,708,31,443,16,7301
"33011011000",4070,195,69,0,301,0,246,0,4881
"33011011101",2374,196,47,20,845,10,123,13,3628
"33011011102",1874,198,110,7,691,321,234,3,3438
"33011011200",4799,25,155,0,1223,0,295,0,6497
"33011011300",3677,123,30,0,330,21,102,0,4283
"33011011401",4302,167,13,19,843,24,479,0,5847
"33011011402",3630,295,195,0,886,0,360,31,5397
"33011011500",1923,88,0,0,204,13,172,13,2413
"33011012100",7580,256,108,0,289,0,0,0,8233
"33011012200",6316,520,157,0,274,79,457,21,7824
"33011012300",8237,213,42,0,450,0,101,0,9043
"33011013100",7841,352,14,0,159,0,222,0,8588
"33011014100",4621,265,0,0,148,10,65,0,5109
"33011014201",5495,102,13,25,325,67,309,0,6336
"33011014202",5660,182,47,0,124,0,33,0,6046
"33011014300",7396,355,0,0,491,0,267,1,8510
"33011015100",4668,148,59,0,316,0,147,0,5338
"33011015200",5629,93,0,0,219,83,76,83,6183
"33011016100",2638,77,25,0,391,0,171,0,3302
"33011016201",5693,571,66,0,346,66,123,0,6865
"33011016202",4916,162,0,0,100,0,135,0,5313
"33011017100",7196,151,41,0,337,8,114,0,7847
"33011018000",4876,58,0,0,166,0,7,0,5107
"33011018501",1749,287,0,0,70,3,6,0,2115
"33011018502",1197,147,0,0,13,30,53,0,1440
"33011019000",3462,156,16,1,46,0,21,1,3703
"33011019501",1559,94,7,0,44,3,19,8,1734
"33011019502",2362,237,0,0,12,9,38,0,2658
"33011020000",5301,109,0,0,8,0,40,0,5458
"33011021000",8309,253,17,0,197,107,107,0,8990
"33011021500",4193,291,27,0,166,20,78,0,4775
"33011022000",1354,119,1,0,83,5,22,0,1584
"33011022500",6648,224,0,0,121,0,86,17,7096
"33011023000",5824,331,19,8,31,20,56,1,6290
"33011024000",1601,80,3,0,58,0,26,0,1768
"33011025000",2297,270,10,0,38,19,6,0,2640
"33011025500",5621,430,3,0,158,3,11,2,6228
"33011200100",4327,256,29,0,121,6,0,59,4798
"33011200200",4027,72,0,0,130,13,129,0,4371
"33011200300",3603,305,32,13,77,43,86,0,4159
"33011200400",1581,593,160,12,98,123,189,173,2929
"33011980101",0,0,0,0,0,0,0,0,0
"33013003001",3463,80,85,0,103,4,218,0,3953
"33013003006",3180,190,6,0,52,0,317,0,3745
"33013003100",3722,435,30,0,60,0,30,19,4296
"33013003200",6424,461,0,0,165,70,204,0,7324
"33013030000",2508,161,10,0,108,0,16,0,2803
"33013031001",3474,152,0,0,79,75,64,75,3919
"33013031002",3503,145,0,0,217,0,0,0,3865
"33013032100",3461,222,25,0,41,0,0,5,3754
"33013032200",2507,487,20,0,44,0,81,0,3139
"33013032300",1221,204,10,5,97,59,21,16,1633
"33013032400",2578,434,64,8,61,17,61,17,3240
"33013032500",2947,423,5,6,145,0,0,0,3526
"33013032600",1864,129,39,9,60,6,0,0,2107
"33013032701",1468,95,0,0,196,0,153,0,1912
"33013032706",3553,343,54,52,21,19,138,0,4180
"33013032800",4482,57,0,0,337,0,24,0,4900
"33013032900",2215,658,97,33,527,153,10,8,3701
"33013033000",2272,200,2,0,59,0,43,0,2576
"33013034000",4257,165,0,0,73,10,0,0,4505
"33013035000",3218,588,23,46,147,25,35,0,4082
"33013036000",4548,571,0,0,172,61,0,11,5363
"33013037000",2109,79,16,3,16,0,57,0,2280
"33013038000",2910,453,0,0,36,7,17,16,3439
"33013038500",4066,342,0,0,98,13,32,0,4551
"33013039000",5198,249,34,0,121,0,11,0,5613
"33013040000",3809,438,14,0,12,0,52,32,4357
"33013040500",5069,322,11,0,139,2,47,0,5590
"33013041000",3141,306,0,0,72,46,69,0,3634
"33013041500",3541,247,11,0,24,0,0,0,3823
"33013042500",3436,274,5,0,149,0,26,0,3890
"33013043001",2970,992,7,0,27,62,69,40,4167
"33013043002",3332,664,44,0,142,30,23,45,4280
"33013044000",4239,319,62,0,134,0,63,0,4817
"33013044100",2495,562,334,59,237,48,0,0,3735
"33013044200",5462,100,26,0,325,0,189,0,6102
"33013044300",3801,338,210,1,202,26,66,0,4644
"33015003301",4140,243,0,0,185,1,101,0,4670
"33015003302",4466,264,22,0,204,27,178,0,5161
"33015003400",4797,505,128,0,72,38,99,30,5669
"33015003500",4723,568,35,0,105,0,192,0,5623
"33015003601",5807,824,147,0,200,0,49,44,7071
"33015003602",5209,128,0,0,113,0,47,0,5497
"33015003701",2970,155,69,0,113,0,184,9,3500
"33015003703",5079,91,122,0,100,0,60,0,5452
"33015003801",3720,77,0,0,131,0,125,0,4053
"33015003802",4311,70,66,0,56,11,452,0,4966
"33015003901",3707,161,0,0,143,10,87,10,4118
"33015003902",3255,57,14,0,24,0,4,0,3354
"33015004000",4876,127,0,0,137,0,96,0,5236
"33015050000",3586,209,0,0,112,0,9,0,3916
"33015051000",4296,231,23,13,163,0,77,23,4826
"33015052000",5713,386,20,0,43,14,38,0,6214
"33015053000",4089,136,9,0,192,1,86,0,4513
"33015054000",4169,72,54,0,81,8,68,8,4460
"33015055001",5346,266,132,0,76,0,196,0,6016
"33015055002",3622,442,36,0,278,0,109,92,4579
"33015056000",4147,151,27,0,15,0,33,0,4373
"33015057000",3772,364,0,0,127,8,53,38,4362
"33015058000",4664,103,22,0,56,0,24,0,4869
"33015059000",6115,311,26,0,98,106,12,0,6668
"33015060000",3812,364,0,12,105,10,12,20,4335
"33015061001",5646,363,0,0,242,0,63,0,6314
"33015062000",2475,81,0,0,19,0,24,0,2599
"33015062500",2655,95,11,0,46,20,50,6,2883
"33015063001",2924,269,6,0,152,106,98,106,3661
"33015063002",4538,643,0,0,126,7,0,0,5314
"33015064000",2071,101,7,0,127,7,0,0,2313
"33015065001",7067,437,70,0,529,9,32,9,8153
"33015065005",2422,43,0,0,42,0,0,0,2507
"33015065006",1418,65,0,0,47,0,0,0,1530
"33015065007",1309,47,15,0,26,0,27,0,1424
"33015065008",1150,280,6,0,24,0,21,24,1505
"33015066000",3905,153,50,0,209,44,103,15,4479
"33015067000",7013,39,0,3,247,0,66,1,7369
"33015067501",5960,527,3,2,646,78,255,56,7527
"33015067502",2567,286,65,36,223,57,27,31,3292
"33015069100",3510,118,16,0,41,18,56,2,3761
"33015069200",2515,180,6,17,205,0,8,0,2931
"33015069300",1916,142,15,10,48,0,49,14,2194
"33015069700",2776,65,40,0,285,7,96,7,3276
"33015071000",4991,257,18,0,33,0,44,12,5355
"33015100100",6205,167,18,0,243,0,138,0,6771
"33015100200",4794,307,84,0,195,0,78,0,5458
"33015100301",4218,156,25,0,194,32,270,0,4895
"33015100302",3580,303,22,0,436,47,611,167,5166
"33015100400",6784,266,95,15,445,55,240,0,7900
"33015101100",7047,256,19,0,259,0,91,0,7672
"33015102100",4386,267,48,8,27,16,128,99,4979
"33015103100",6360,216,0,0,220,0,212,0,7008
"33015104101",4392,310,16,0,89,0,153,0,4960
"33015104102",3371,152,0,0,174,9,95,0,3801
"33015105100",5629,291,0,0,124,0,86,0,6130
"33015106101",6581,227,0,0,548,96,140,0,7592
"33015106102",6046,210,54,0,311,0,63,0,6684
"33015106200",3351,362,55,73,81,27,0,73,4022
"33015106400",3905,138,0,0,25,43,101,0,4212
"33015107100",1960,229,71,8,271,95,112,22,2768
"33015107200",4561,398,181,5,650,0,224,42,6061
"33015107400",969,74,8,0,157,0,41,0,1249
"33015107500",4205,156,5,0,85,2,63,0,4516
"33015980011",0,0,0,0,0,0,0,0,0
"33015990000",0,0,0,0,0,0,0,0,0
"33017080100",2861,0,0,0,226,0,70,0,3157
"33017080202",1629,800,0,0,141,34,54,1,2659
"33017080203",800,422,0,0,164,79,6,0,1471
"33017080204",474,717,0,0,45,2,7,0,1245
"33017080500",5625,194,3,0,333,1,57,0,6213
"33017081100",5826,536,168,92,477,120,24,61,7304
"33017081200",4108,125,0,0,135,0,65,0,4433
"33017081300",3248,696,0,0,134,37,47,32,4194
"33017081400",1391,285,44,0,265,34,62,0,2081
"33017081500",4223,537,8,17,686,38,164,0,5673
"33017081600",5363,434,46,0,554,14,66,0,6477
"33017082000",2245,136,62,0,82,0,63,10,2598
"33017083001",5229,587,75,0,483,269,165,129,6937
"33017083002",3674,639,253,0,433,98,112,0,5209
"33017084100",4434,208,0,0,248,40,19,0,4949
"33017084200",6823,799,38,0,228,0,17,0,7905
"33017084300",4499,1035,86,0,275,17,271,2,6185
"33017084400",3068,895,41,42,70,65,135,28,4344
"33017084500",3492,620,13,0,67,42,56,1,4291
"33017084600",2416,154,0,0,0,0,23,0,2593
"33017085000",8100,464,0,0,151,0,231,0,8946
"33017086000",3782,105,48,0,82,1,226,0,4244
"33017087000",5848,892,0,0,68,0,0,97,6905
"33017088000",4140,403,10,1,28,0,9,0,4591
"33017088500",4079,243,6,0,16,28,26,0,4398
"33019975100",3494,179,25,0,203,5,51,0,3957
"33019975200",4669,159,17,0,124,35,63,0,5067
"33019975300",3138,176,0,0,55,0,30,0,3399
"33019975400",5248,554,0,0,405,44,67,2,6320
"33019975500",2577,178,11,0,44,33,51,15,2909
"33019975600",2731,232,4,0,59,12,35,0,3073
"33019975700",4184,654,63,0,120,8,22,0,5051
"33019975800",4731,478,22,0,112,0,142,1,5486
"33019975901",3638,583,11,0,0,0,0,0,4232
"33019975902",2512,769,68,0,23,0,87,0,3459
"34001000100",768,231,157,380,370,307,490,191,2894
"34001000200",1877,238,315,27,591,282,583,19,3932
"34001000300",1393,553,361,124,1200,770,1051,615,6067
"34001000400",1185,559,177,172,522,146,609,379,3749
"34001000500",737,649,111,123,1189,374,414,679,4276
"34001001100",58,120,930,527,49,75,43,110,1912
"34001001200",204,181,1764,794,166,254,326,335,4024
"34001001300",77,60,1235,229,207,4,114,100,2026
"34001001400",375,346,1371,1379,32,545,303,859,5210
"34001001500",104,90,725,478,72,104,63,86,1722
"34001001900",602,172,446,207,226,104,571,213,2541
"34001002300",668,600,46,172,752,419,590,460,3707
"34001002400",702,427,237,641,287,119,345,289,3047
"34001002500",640,302,1382,775,446,394,365,173,4477
"34001010101",3065,131,0,11,67,0,85,20,3379
"34001010102",1555,178,17,0,60,3,53,20,1886
"34001010104",1214,255,0,0,66,0,97,43,1675
"34001010105",1792,267,83,184,263,78,188,320,3175
"34001010200",5186,253,54,7,281,0,482,0,6263
"34001010300",1234,27,310,26,772,95,417,13,2894
"34001010401",4698,98,154,70,435,0,239,26,5720
"34001010403",2904,441,373,90,2493,423,1171,180,8075
"34001010501",6154,304,312,34,399,56,659,60,7978
"34001010503",4074,324,1937,381,1323,105,1597,111,9852
"34001010505",2056,124,38,18,149,4,162,0,2551
"34001010506",3645,249,310,46,936,75,425,0,5686
"34001010600",2095,225,779,87,673,348,929,369,5505
"34001010700",4839,319,217,209,469,87,909,88,7137
"34001010800",2311,330,0,29,305,70,389,119,3553
"34001010900",4525,427,292,27,520,9,830,194,6824
"34001011000",1970,123,8,31,321,16,409,38,2916
"34001011100",2193,404,41,20,450,27,521,257,3913
"34001011201",1544,113,164,4,62,4,147,3,2041
"34001011202",4972,743,804,2,442,574,522,502,8561
"34001011300",3137,297,135,22,771,177,1193,169,5901
"34001011401",3807,233,147,5,337,10,530,22,5091
"34001011403",2196,205,1664,173,1209,288,1138,67,6940
"34001011404",5342,567,974,314,1172,889,868,498,10624
"34001011500",3880,235,1395,116,610,16,757,119,7128
"34001011600",4277,315,56,77,175,4,175,53,5132
"34001011701",3679,216,892,305,3875,462,1788,349,11566
"34001011702",1284,328,670,50,871,312,695,228,4438
"34001011802",10910,492,1321,179,3203,188,2288,216,18797
"34001011803",2869,383,360,64,634,338,1002,270,5920
"34001011804",5682,447,44,0,682,19,411,0,7285
"34001011805",1725,110,63,34,78,180,118,58,2366
"34001011900",2271,966,2620,452,858,883,2171,939,11160
"34001012000",1834,686,1071,150,666,268,1205,720,6600
"34001012100",1353,382,558,256,260,130,978,493,4410
"34001012200",1856,179,2014,627,333,64,1481,371,6925
"34001012302",2739,230,20,0,352,5,306,69,3721
"34001012401",2246,366,11,0,200,189,88,134,3234
"34001012402",1691,213,9,24,142,18,159,37,2293
"34001012501",2305,45,12,0,238,0,226,0,2826
"34001012502",1411,22,0,0,94,0,78,0,1605
"34001012602",1291,73,0,1,27,12,0,0,1404
"34001012701",2208,242,375,34,368,27,327,11,3592
"34001012702",1218,53,122,292,94,8,157,1,1945
"34001012801",2851,234,301,259,366,45,503,80,4639
"34001012802",1446,131,6,7,35,43,167,27,1862
"34001013000",2935,288,41,0,96,12,49,25,3446
"34001013101",1258,10,3,2,4,0,22,1,1300
"34001013102",1262,265,80,0,29,0,6,25,1667
"34001013201",1198,699,34,8,1003,93,507,269,3811
"34001013202",1721,265,30,10,140,62,433,40,2701
"34001013301",2012,135,33,0,245,62,369,62,2918
"34001013302",2036,156,204,0,403,7,485,41,3332
"34001013500",2422,85,66,1,82,0,117,0,2773
"34001983400",32,4,8,0,3,0,0,0,47
"34001990000",0,0,0,0,0,0,0,0,0
"34003001000",5344,208,82,0,915,57,335,0,6941
"34003002100",877,94,67,48,446,27,65,26,1650
"34003002200",3152,313,59,0,1345,131,354,36,5390
"34003002300",3822,117,84,0,1441,149,437,23,6073
"34003003100",2167,109,288,131,2108,63,1227,59,6152
"34003003200",1411,169,285,0,2557,438,1414,274,6548
"34003003300",2664,88,412,32,3163,95,1817,64,8335
"34003003401",1774,101,111,2,1004,59,579,37,3667
"34003003402",2071,58,73,2,1748,10,959,2,4923
"34003003500",1340,212,467,85,1618,419,1153,406,5700
"34003004001",2134,211,120,2,638,221,1125,170,4621
"34003004002",2679,461,340,1,1467,37,1940,284,7209
"34003005000",4818,223,0,20,1148,16,1679,41,7945
"34003006100",5039,491,122,36,1573,163,1852,261,9537
"34003006201",2931,593,62,0,737,329,1051,521,6224
"34003006202",2568,301,269,0,1413,135,258,52,4996
"34003006300",4638,776,251,0,1833,233,2602,645,10978
"34003007001",2220,14,260,19,1311,0,342,0,4166
"34003007002",2618,119,83,0,1826,57,69,0,4772
"34003008000",5997,110,23,15,2366,179,891,0,9581
"34003009100",3452,38,11,0,1440,63,356,0,5360
"34003009200",2762,30,32,2,620,0,64,0,3510
"34003010100",4451,75,71,15,1394,47,785,29,6867
"34003010200",3096,78,0,201,975,0,867,1,5218
"34003010300",5095,91,469,1,1671,90,1472,0,8889
"34003011100",2691,154,206,0,948,162,1147,150,5458
"34003011200",3067,550,299,94,1011,88,1140,494,6743
"34003011300",3257,307,149,1,722,31,903,132,5502
"34003011400",4576,306,356,3,730,195,1428,195,7789
"34003012001",3382,449,455,15,1292,293,1138,499,7523
"34003012002",2175,144,49,4,803,15,354,1,3545
"34003013001",2399,318,379,12,3208,164,613,36,7129
"34003013002",3386,159,88,304,1249,200,738,205,6329
"34003014000",5743,489,139,1,937,83,771,154,8317
"34003015100",2083,18,151,0,275,0,160,0,2687
"34003015200",1839,359,1794,129,1117,605,1022,646,7511
"34003015300",1140,66,3673,689,916,120,1591,129,8324
"34003015400",2317,246,985,438,2598,441,1514,424,8963
"34003015500",3732,98,831,0,1147,0,549,1,6358
"34003016000",2776,159,78,8,2325,23,217,10,5596
"34003017100",5835,312,0,1,868,0,565,54,7635
"34003017200",4523,343,194,0,890,53,912,91,7006
"34003017300",4939,72,69,1,1224,194,958,194,7651
"34003017400",4275,82,38,5,939,91,408,33,5871
"34003017500",5568,403,126,42,1812,97,1555,59,9662
"34003018100",4141,730,65,41,1159,685,3279,882,10982
"34003018200",3825,700,226,84,2376,201,2946,630,10988
"34003019102",1674,118,40,0,1272,229,170,0,3503
"34003019103",1587,111,116,45,2053,84,449,7,4452
"34003019104",1484,105,187,0,1971,340,593,0,4680
"34003019202",673,89,8,0,690,169,329,63,2021
"34003019203",1954,222,36,0,916,25,237,21,3411
"34003019204",1639,159,67,43,1372,194,620,12,4106
"34003019303",1990,43,57,0,2558,758,771,18,6195
"34003019304",1686,177,0,4,758,134,747,68,3574
"34003019305",3657,359,17,0,2230,50,445,125,6883
"34003019306",1375,55,93,0,539,39,146,0,2247
"34003020100",3324,101,104,0,560,0,263,0,4352
"34003020200",5741,238,12,0,690,0,432,0,7113
"34003021100",5140,831,153,0,472,117,1359,132,8204
"34003021200",4463,650,160,95,297,114,1321,448,7548
"34003021300",3026,507,177,8,567,103,850,203,5441
"34003021400",3845,339,210,20,375,110,1472,182,6553
"34003021500",3056,715,350,226,355,141,1771,465,7079
"34003021600",2725,759,283,78,469,284,1815,712,7125
"34003022100",3524,30,124,0,356,58,164,0,4256
"34003022200",6659,95,15,3,942,48,568,20,8350
"34003023100",800,640,607,104,764,183,769,573,4440
"34003023200",3718,317,1325,155,1341,187,1633,227,8903
"34003023301",1599,22,599,16,762,70,775,70,3913
"34003023302",2422,184,702,192,1249,104,804,58,5715
"34003023401",1006,222,746,43,1661,144,530,154,4506
"34003023402",1714,529,963,71,2105,815,1690,831,8718
"34003023501",479,56,1408,349,645,96,809,127,3969
"34003023502",1210,245,1045,38,1406,358,1493,459,6254
"34003023601",1409,323,463,211,643,104,907,373,4433
"34003023602",909,150,253,219,2028,594,2306,622,7081
"34003024100",4183,114,200,0,1308,117,256,0,6178
"34003024200",3699,74,0,40,833,118,320,12,5096
"34003025100",4545,342,112,21,1217,165,709,123,7234
"34003025200",4942,187,42,2,460,0,403,0,6036
"34003026100",3983,165,21,3,352,275,202,249,5250
"34003026200",4659,311,90,3,462,94,437,131,6187
"34003027000",3758,9,0,0,365,0,367,0,4499
"34003028001",1938,348,169,0,2763,284,681,316,6499
"34003028002",1752,268,37,0,1405,158,313,163,4096
"34003029100",2202,222,211,96,2172,130,806,15,5854
"34003029200",3266,477,83,2,1840,135,1185,379,7367
"34003030100",3010,554,334,383,814,72,1151,720,7038
"34003030200",4207,904,537,130,1295,53,2225,385,9736
"34003030300",2512,291,336,57,789,35,1473,123,5616
"34003030400",5006,975,403,104,1399,45,1927,937,10796
"34003031100",3841,427,144,15,1145,0,1495,229,7296
"34003031200",3985,373,73,0,291,69,772,92,5655
"34003031300",4304,429,0,33,488,14,754,45,6067
"34003031400",4710,454,45,0,406,72,834,287,6808
"34003032102",4636,87,347,0,619,0,143,0,5832
"34003032103",3770,127,87,0,891,123,344,0,5342
"34003032104",1619,38,123,0,356,57,373,42,2608
"34003032201",4424,66,13,0,1011,0,314,19,5847
"34003032202",3987,57,53,1,661,31,190,18,4998
"34003033100",2845,68,95,0,437,55,668,0,4168
"34003033200",2119,164,104,0,298,0,457,35,3177
"34003033300",2012,135,284,19,935,106,600,53,4144
"34003034000",6512,346,29,4,328,50,460,293,8022
"34003035100",6459,272,43,0,1061,364,648,254,9101
"34003035200",4944,96,33,0,659,0,212,0,5944
"34003036100",1580,232,224,10,620,54,976,143,3839
"34003036200",1929,103,0,16,539,152,639,139,3517
"34003037100",3693,265,104,1,1162,169,596,162,6152
"34003037201",2773,364,63,0,870,72,521,30,4693
"34003037202",3598,232,1004,32,1995,8,1198,8,8075
"34003038100",4469,437,178,0,372,198,1180,336,7170
"34003038200",3047,274,123,1,838,28,990,91,5392
"34003038300",4471,165,44,0,938,151,1524,28,7321
"34003039100",3825,86,0,0,377,0,379,8,4675
"34003039200",5402,181,42,0,257,0,320,1,6203
"34003039300",2374,47,28,0,183,5,80,7,2724
"34003040001",2848,10,0,2,495,0,247,1,3603
"34003040002",3461,39,182,0,939,0,86,0,4707
"34003041100",1701,142,138,9,3174,519,1531,360,7574
"34003041200",1328,34,6,0,3182,251,471,56,5328
"34003041301",1411,193,129,22,3196,281,903,189,6324
"34003041302",1328,198,0,54,2748,320,432,44,5124
"34003042100",5244,34,99,3,1543,111,561,2,7597
"34003042301",2862,135,71,0,1473,24,402,57,5024
"34003042302",3228,76,62,0,1394,0,453,0,5213
"34003042400",3155,74,0,0,1189,35,297,13,4763
"34003042500",2343,185,192,0,1801,98,599,177,5395
"34003043001",3521,27,42,3,396,9,539,0,4537
"34003043002",3722,125,147,25,508,91,554,91,5263
"34003044100",5561,151,0,0,485,0,154,0,6351
"34003044201",3286,47,34,0,380,1,406,1,4155
"34003044202",4172,108,0,0,664,0,223,5,5172
"34003045100",4559,598,65,1,3334,74,1556,284,10471
"34003045200",1405,84,33,0,1095,8,515,37,3177
"34003046100",2277,284,284,0,1329,40,1339,160,5713
"34003046200",2915,40,40,25,1186,76,1600,71,5953
"34003046300",2748,253,318,26,1034,94,1662,142,6277
"34003047100",4491,8,36,0,1163,81,589,0,6368
"34003047200",3424,77,128,19,504,44,205,0,4401
"34003047300",2588,85,50,0,329,10,78,0,3140
"34003047400",3525,213,131,96,1082,47,474,109,5677
"34003047500",5757,107,15,0,1050,97,338,0,7364
"34003048100",2367,165,115,0,1397,210,371,63,4688
"34003048200",5918,46,0,0,1348,0,729,0,8041
"34003049001",3788,131,0,0,571,0,302,0,4792
"34003049002",4496,101,153,2,593,48,177,2,5572
"34003050000",4148,179,16,0,1042,0,1090,0,6475
"34003051100",4429,109,123,0,1447,0,668,37,6813
"34003051200",2187,67,20,0,387,13,578,17,3269
"34003051300",3247,156,133,15,786,256,727,23,5343
"34003051400",3845,208,33,0,747,10,822,0,5665
"34003052100",6444,684,86,2,488,186,854,216,8960
"34003052200",4812,170,172,3,892,1,561,3,6614
"34003053100",2798,43,82,0,306,0,292,0,3521
"34003053200",6592,180,305,0,1258,0,520,0,8855
"34003054100",1721,70,5123,867,995,0,1225,31,10032
"34003054200",1472,174,1490,159,744,24,836,41,4940
"34003054300",5783,25,358,0,242,1,139,1,6549
"34003054400",3037,226,1295,159,2144,293,1932,248,9334
"34003054500",2822,59,613,0,1133,0,1051,21,5699
"34003054600",3477,62,1365,0,3542,244,2405,72,11167
"34003055100",5007,181,15,2,1385,110,470,20,7190
"34003055200",4676,274,31,54,2705,284,752,190,8966
"34003056100",4258,74,51,0,305,0,241,0,4929
"34003056200",4007,583,112,0,512,0,305,122,5641
"34003057101",2936,469,259,60,610,31,353,156,4874
"34003057102",3301,167,27,1,317,64,353,34,4264
"34003057200",2712,467,50,0,100,13,436,117,3895
"34003058100",3579,109,43,0,115,0,167,0,4013
"34003058200",4922,70,6,0,416,0,412,0,5826
"34003059100",3779,253,410,7,679,54,810,225,6217
"34003059200",4406,406,304,16,706,69,579,99,6585
"34003060000",6411,357,104,0,1041,79,716,73,8781
"34003061100",4139,52,10,0,354,1,298,0,4854
"34003061200",3361,65,0,0,102,42,64,37,3671
"34003061300",3016,249,4,11,139,3,149,6,3577
"34003061400",4745,63,0,0,412,0,242,0,5462
"34005700102",2214,65,77,0,315,32,123,21,2847
"34005700103",2211,142,118,0,219,29,141,0,2860
"34005700104",868,124,478,140,245,63,188,49,2155
"34005700200",2443,90,50,12,45,29,118,40,2827
"34005700303",2578,85,398,253,176,0,292,7,3789
"34005700304",2011,229,42,0,133,12,158,8,2593
"34005700305",4620,137,137,1,194,31,265,0,5385
"34005700306",2363,49,32,4,75,0,141,0,2664
"34005700307",2449,28,55,0,166,39,53,0,2790
"34005700401",1853,65,4,0,163,0,111,0,2196
"34005700402",2990,134,0,0,221,0,82,19,3446
"34005700403",3858,246,0,0,100,26,152,25,4407
"34005700405",1363,156,0,0,144,0,130,0,1793
"34005700407",2347,581,1013,47,1212,164,713,268,6345
"34005700408",905,146,335,46,537,58,159,24,2210
"34005700501",4541,143,510,78,320,46,180,0,5818
"34005700502",1935,219,42,0,59,18,51,0,2324
"34005700503",2784,48,488,62,324,11,124,0,3841
"34005700504",2598,29,126,0,0,0,21,0,2774
"34005700505",4383,125,65,0,1293,0,0,0,5866
"34005700602",4813,237,407,49,716,36,0,0,6258
"34005700603",4040,385,668,12,848,17,486,89,6545
"34005700605",3905,87,448,8,179,1,35,9,4672
"34005700701",2572,232,239,11,277,0,228,1,3560
"34005700702",1752,114,414,19,129,197,198,126,2949
"34005700703",1422,254,151,40,90,58,174,28,2217
"34005700800",3423,157,538,47,371,0,196,0,4732
"34005700900",1448,168,519,128,242,64,67,37,2673
"34005701001",2915,159,1069,182,527,77,515,53,5497
"34005701002",1998,167,1052,65,534,103,638,26,4583
"34005701102",3025,262,1164,39,623,10,508,35,5666
"34005701103",3517,68,1423,190,976,0,511,26,6711
"34005701104",2320,150,1073,216,768,64,525,10,5126
"34005701105",2721,52,2112,225,665,301,497,124,6697
"34005701201",1743,49,777,97,552,0,59,28,3305
"34005701203",1108,49,478,12,188,38,143,0,2016
"34005701204",492,78,879,374,578,65,136,58,2660
"34005701205",1517,48,459,41,55,126,86,89,2421
"34005701301",3166,130,705,192,198,0,90,32,4513
"34005701302",2332,81,135,0,160,0,96,0,2804
"34005701303",3673,128,740,39,859,16,505,0,5960
"34005701401",4867,93,666,0,821,0,265,0,6712
"34005701402",1683,47,20,0,374,0,34,0,2158
"34005701502",3275,202,237,0,216,49,465,31,4475
"34005701700",3031,158,308,43,344,1,219,12,4116
"34005702101",2344,76,677,0,887,11,534,4,4533
"34005702203",1495,132,1041,42,543,23,405,39,3720
"34005702204",1028,160,383,13,359,141,336,124,2544
"34005702206",1382,64,86,8,381,53,165,35,2174
"34005702207",1701,283,417,98,283,272,310,130,3494
"34005702208",4884,486,1002,131,495,50,849,43,7940
"34005702209",2035,354,350,123,357,24,197,6,3446
"34005702210",2489,391,949,110,637,146,379,159,5260
"34005702300",945,80,101,54,212,93,243,99,1827
"34005702400",2942,93,78,58,163,56,291,0,3681
"34005702500",4124,75,736,14,1006,76,193,0,6224
"34005702601",2772,196,871,0,348,10,277,0,4474
"34005702603",1374,255,387,40,132,34,201,101,2524
"34005702700",4992,111,2019,31,1470,145,1003,19,9790
"34005702801",294,0,1546,122,105,0,126,44,2237
"34005702802",736,78,2329,72,224,0,193,31,3663
"34005702803",614,74,2696,60,333,20,297,6,4100
"34005702804",399,16,1746,87,336,0,351,0,2935
"34005702805",664,37,2283,602,429,48,252,18,4333
"34005702806",575,9,1916,236,478,140,327,95,3776
"34005702807",583,186,1738,403,419,56,265,12,3662
"34005702808",614,235,2043,234,185,19,153,139,3622
"34005702809",204,119,1230,100,31,7,103,99,1893
"34005702810",186,6,808,37,121,0,51,4,1213
"34005702811",288,8,1747,125,191,9,205,9,2582
"34005702905",3288,144,171,8,477,7,154,0,4249
"34005702906",1677,13,36,3,178,0,92,0,1999
"34005702907",2644,29,0,0,172,25,83,0,2953
"34005702908",3563,129,157,6,306,0,9,48,4218
"34005702909",4327,13,564,1,1010,61,327,0,6303
"34005702910",4167,168,151,19,742,246,388,0,5881
"34005702913",2406,387,852,32,548,77,209,1,4512
"34005702914",3551,227,419,12,437,0,278,0,4924
"34005702915",2622,328,968,54,610,17,232,17,4848
"34005702917",1504,48,43,7,257,10,35,0,1904
"34005702918",1218,14,193,16,272,10,186,0,1909
"34005703000",4651,272,570,28,488,27,274,0,6310
"34005703102",2266,23,242,0,227,0,140,0,2898
"34005703103",2545,251,868,122,560,339,241,352,5278
"34005703104",3409,144,668,9,518,0,406,39,5193
"34005703201",3493,222,51,0,54,0,198,0,4018
"34005703202",2538,53,37,2,51,0,90,0,2771
"34005703203",3392,307,145,0,54,0,31,0,3929
"34005703600",6376,225,51,22,289,0,589,0,7552
"34005703700",5900,300,16,0,196,0,212,0,6624
"34005703801",6020,275,204,2,385,20,159,0,7065
"34005703802",3545,263,110,13,192,15,172,114,4424
"34005703803",4337,102,34,0,243,0,130,0,4846
"34005703804",6689,6,179,3,470,3,337,0,7687
"34005703900",4007,23,28,0,66,0,43,0,4167
"34005704004",2918,211,116,6,482,51,250,0,4034
"34005704005",3403,90,166,10,202,94,100,0,4065
"34005704006",1580,89,171,28,420,48,35,0,2371
"34005704007",3144,251,22,11,118,12,211,51,3820
"34005704008",4579,253,229,2,212,41,43,0,5359
"34005704009",3690,253,303,0,308,0,210,0,4764
"34005704011",2781,97,63,0,86,0,80,0,3107
"34005704012",4790,220,389,0,316,0,362,0,6077
"34005704013",4395,105,137,8,650,0,358,0,5653
"34005704014",5865,252,500,164,968,100,237,186,8272
"34005704200",5394,280,712,22,1443,5,487,0,8343
"34005704302",4575,32,222,23,1144,0,511,0,6507
"34005704500",3028,268,740,62,238,45,464,115,4960
"34005704600",1177,283,506,37,211,64,235,95,2608
"34005704700",3123,280,19,9,179,0,236,5,3851
"34005704801",1968,142,293,15,396,35,404,72,3325
"34005704802",543,23,48,0,104,0,100,7,825
"34005981802",90,0,0,0,0,0,0,0,90
"34005982111",337,33,49,14,172,25,37,25,692
"34007600200",84,43,776,310,412,226,437,260,2548
"34007600400",184,102,798,848,714,525,917,861,4949
"34007600700",97,57,299,194,345,388,464,428,2272
"34007600800",242,435,747,606,1093,1767,1456,2101,8447
"34007600900",503,182,563,771,1014,1195,1337,1606,7171
"34007601000",1382,168,828,413,2423,1085,3589,1276,11164
"34007601101",329,166,383,120,1318,929,1251,866,5362
"34007601102",715,406,941,387,2378,951,2288,947,9013
"34007601200",1151,204,1653,396,2109,780,2881,912,10086
"34007601300",385,258,1131,781,920,1298,1298,1469,7540
"34007601400",67,60,2633,1080,375,435,491,491,5632
"34007601500",526,103,2588,1252,588,654,1276,803,7790
"34007601600",162,11,1061,798,230,87,306,153,2808
"34007601700",161,49,1028,1245,257,440,463,569,4212
"34007601800",148,47,580,420,90,86,131,208,1710
"34007601900",113,80,1061,1297,376,248,482,864,4521
"34007602000",548,525,2887,1327,621,450,1106,1023,8487
"34007602503",638,76,919,98,654,106,633,153,3277
"34007602601",1399,102,391,0,931,32,682,66,3603
"34007602602",1035,109,785,46,808,40,863,122,3808
"34007602901",3045,136,595,45,831,0,858,12,5522
"34007602902",2010,115,214,96,606,268,934,304,4547
"34007603001",2549,85,597,0,580,133,610,120,4674
"34007603002",1418,75,1143,84,1628,186,1572,137,6243
"34007603100",2342,171,473,24,783,0,726,134,4653
"34007603200",4647,194,692,17,847,92,579,92,7160
"34007603301",2877,255,491,3,1239,422,197,336,5820
"34007603302",4113,404,518,57,1468,37,709,32,7338
"34007603303",1541,425,69,59,327,78,57,131,2687
"34007603400",4695,257,505,44,1592,93,855,12,8053
"34007603501",4050,55,568,12,1445,66,195,1,6392
"34007603503",3821,35,69,0,526,29,47,0,4527
"34007603504",2038,46,78,0,506,0,144,0,2812
"34007603505",2489,21,183,13,681,67,93,0,3547
"34007603506",4614,46,273,0,1327,0,267,0,6527
"34007603507",5049,124,262,26,1248,192,165,127,7193
"34007603601",2893,161,117,39,307,11,188,5,3721
"34007603602",2113,98,59,0,257,0,215,0,2742
"34007603603",2044,53,21,0,129,0,49,0,2296
"34007603700",2614,47,333,18,675,18,397,0,4102
"34007603800",4652,180,209,0,126,48,74,15,5304
"34007603901",4615,232,0,0,150,17,84,17,5115
"34007603902",2427,101,226,0,110,0,63,13,2940
"34007604100",531,308,622,228,1076,202,1121,378,4466
"34007604200",2680,218,377,0,228,45,247,91,3886
"34007604300",3305,139,160,0,250,0,149,0,4003
"34007604400",2767,30,104,67,180,121,210,90,3569
"34007604600",1576,99,150,20,118,42,129,12,2146
"34007604700",1822,39,37,0,78,16,37,0,2029
"34007605100",2082,177,0,10,55,0,19,5,2348
"34007605200",2216,169,49,0,272,129,67,144,3046
"34007605300",1424,176,66,14,161,103,79,74,2097
"34007605400",2201,200,0,77,0,1,61,11,2551
"34007605602",2671,138,32,0,21,0,36,57,2955
"34007605700",3163,216,7,23,25,22,14,49,3519
"34007605800",2403,79,216,1,53,56,25,56,2889
"34007605900",2443,57,12,6,84,0,48,6,2656
"34007606000",1889,53,23,1,93,7,73,7,2146
"34007606100",1903,85,0,0,115,5,40,0,2148
"34007606200",3699,134,0,1,156,0,97,0,4087
"34007606300",2088,79,66,0,91,4,88,0,2416
"34007606400",2903,2,18,1,120,12,133,0,3189
"34007606500",78,2,2161,448,223,14,110,0,3036
"34007606600",1826,160,87,0,46,0,73,0,2192
"34007606700",4148,245,52,19,146,6,242,7,4865
"34007606800",3023,158,15,27,414,305,153,32,4127
"34007607000",3384,671,37,1,237,85,431,228,5074
"34007607100",3356,137,0,1,259,0,406,21,4180
"34007607200",2959,387,645,143,365,128,319,181,5127
"34007607300",2835,342,511,73,384,133,204,147,4629
"34007607401",1709,319,475,60,234,40,149,38,3024
"34007607402",1317,50,651,31,351,45,177,35,2657
"34007607502",3883,146,404,26,669,19,216,0,5363
"34007607503",3744,197,435,0,1851,77,55,0,6359
"34007607504",2791,57,138,0,473,0,93,37,3589
"34007607505",3523,80,316,10,785,32,142,6,4894
"34007607506",1493,381,288,9,871,107,103,18,3270
"34007607507",2769,327,835,43,1245,334,264,20,5837
"34007607600",2042,71,37,8,32,23,24,28,2265
"34007607701",1391,179,1610,607,1225,468,1479,429,7388
"34007607702",2055,161,640,159,671,187,594,152,4619
"34007607801",1864,340,1904,167,797,659,679,526,6936
"34007607802",1575,119,417,14,246,13,197,18,2599
"34007607900",1650,109,51,14,69,17,62,0,1972
"34007608001",2262,269,570,52,321,52,61,94,3681
"34007608202",2932,105,665,13,333,6,108,0,4162
"34007608205",3681,207,145,0,204,27,80,27,4371
"34007608206",3219,108,175,72,103,8,126,39,3850
"34007608209",1873,396,723,17,345,12,100,226,3692
"34007608210",2014,237,1161,91,262,69,240,12,4086
"34007608211",2609,225,1994,32,684,238,453,0,6235
"34007608302",3254,347,571,49,340,55,271,10,4897
"34007608303",2328,244,106,47,123,149,82,184,3263
"34007608304",4832,434,439,175,485,28,470,31,6894
"34007608401",3197,84,398,20,105,99,154,9,4066
"34007608402",2527,246,711,6,276,33,24,0,3823
"34007608403",4168,178,1458,39,893,231,495,14,7476
"34007608404",3884,571,1173,158,238,17,0,0,6041
"34007608503",1136,172,1168,131,389,42,251,17,3306
"34007608504",1546,345,559,216,311,195,441,290,3903
"34007608600",2926,652,974,239,131,29,346,111,5408
"34007608700",6220,297,103,307,559,0,371,30,7887
"34007608800",3956,341,501,97,371,105,166,123,5660
"34007608901",4565,533,286,24,471,37,162,206,6284
"34007608903",3005,135,58,1,126,1,0,44,3370
"34007608904",1350,48,31,0,16,1,55,0,1501
"34007609000",512,182,606,83,256,18,290,32,1979
"34007609103",3284,176,915,118,714,28,305,39,5579
"34007609201",2123,259,1552,153,232,9,342,39,4709
"34007609202",1028,63,2291,848,480,36,300,38,5084
"34007609203",4427,77,3504,167,1218,152,599,107,10251
"34007609204",612,55,2008,523,246,202,322,220,4188
"34007609205",4422,323,879,34,916,22,717,49,7362
"34007610300",287,261,667,371,87,128,147,129,2077
"34007610400",362,332,734,1283,568,635,969,1005,5888
"34007610500",1473,256,2362,165,1846,878,1735,969,9684
"34007610600",450,73,173,2,203,91,131,64,1187
"34007610800",1051,279,671,97,613,134,842,93,3780
"34007610900",3213,148,8,27,37,0,25,11,3469
"34007611000",4066,423,219,75,1249,106,820,157,7115
"34007611100",2387,242,43,15,306,133,124,99,3349
"34007611200",3570,246,115,19,250,27,123,11,4361
"34007611300",3324,428,144,40,156,0,97,0,4189
"34007611400",3190,217,437,138,175,34,177,71,4439
"34007611500",3755,209,103,72,70,26,387,27,4649
"34007611600",2433,180,901,28,167,0,124,92,3925
"34007611700",2473,285,190,8,53,63,83,24,3179
"34009020101",2661,304,170,44,269,263,333,106,4150
"34009020102",1851,127,0,0,241,121,255,101,2696
"34009020201",1407,27,0,0,0,0,0,0,1434
"34009020203",2083,58,0,0,0,0,0,0,2141
"34009020205",821,37,0,9,0,0,12,0,879
"34009020206",791,72,0,0,0,0,36,0,899
"34009020301",4152,40,33,0,60,17,72,0,4374
"34009020302",4326,158,2,0,150,2,98,2,4738
"34009020400",2890,217,57,0,33,20,125,0,3342
"34009020500",1160,402,539,218,219,160,499,230,3427
"34009020600",1958,101,13,0,11,0,41,0,2124
"34009020700",3389,700,2,0,96,0,52,241,4480
"34009020800",1626,137,0,1,4,20,23,0,1811
"34009020901",796,58,14,3,4,0,0,0,875
"34009020902",1504,73,0,0,19,0,14,1,1611
"34009021001",1741,53,42,2,87,0,114,2,2041
"34009021002",3114,143,156,0,117,24,104,18,3676
"34009021100",4117,446,435,9,167,0,283,0,5457
"34009021300",3534,373,31,0,0,0,0,0,3938
"34009021400",2514,1091,0,163,107,32,128,816,4851
"34009021500",1194,196,262,13,57,53,252,25,2052
"34009021600",3023,128,0,0,62,14,200,23,3450
"34009021701",2087,242,21,1,233,0,225,0,2809
"34009021702",2215,182,28,1,148,14,10,0,2598
"34009021803",2766,502,13,0,0,14,77,47,3419
"34009021804",4610,818,118,21,152,15,637,54,6425
"34009021805",3651,369,90,0,136,9,281,18,4554
"34009021806",2673,129,94,0,0,0,0,2,2898
"34009021900",1796,154,65,8,63,11,32,71,2200
"34009022000",2168,221,16,33,173,95,179,22,2907
"34009022101",1243,400,0,37,6,13,136,0,1835
"34009022102",3142,246,1400,80,538,0,449,0,5855
"34009990100",0,0,0,0,0,0,0,0,0
"34011010101",2459,152,7,0,281,7,78,30,3014
"34011010103",0,0,0,0,0,0,0,0,0
"34011010200",3482,557,308,248,198,320,184,349,5646
"34011010301",2288,297,258,139,152,92,194,165,3585
"34011010302",1244,134,22,21,72,0,61,4,1558
"34011010401",1787,297,1905,306,738,103,512,85,5733
"34011010402",0,0,0,0,0,0,0,0,0
"34011010500",1922,108,75,14,171,22,52,10,2374
"34011010600",3757,313,200,18,433,21,139,48,4929
"34011010700",5140,377,1127,70,704,147,472,203,8240
"34011010800",2023,246,362,16,407,0,490,14,3558
"34011020100",121,331,168,114,233,111,329,406,1813
"34011020200",767,259,361,290,679,370,1193,640,4559
"34011020300",1605,893,712,709,1784,884,3314,1592,11493
"34011020400",829,253,637,96,958,168,1025,311,4277
"34011020502",0,0,0,0,0,0,0,0,0
"34011020503",595,168,1253,875,163,594,684,703,5035
"34011020600",1844,227,1057,233,558,152,992,171,5234
"34011030100",517,193,149,54,23,8,92,53,1089
"34011030200",2155,615,1285,563,651,278,1137,426,7110
"34011030300",1690,203,758,367,271,108,509,72,3978
"34011030400",5768,475,675,212,378,56,553,369,8486
"34011030501",5409,395,424,1,133,94,566,94,7116
"34011030502",2233,620,415,416,242,266,344,731,5267
"34011040300",2481,251,336,61,364,106,1512,261,5372
"34011040400",3276,307,1094,85,1170,46,2666,244,8888
"34011040500",3425,732,1015,83,1033,455,2783,1099,10625
"34011040600",3018,1000,1096,510,1182,226,2270,520,9822
"34011040700",5167,1066,454,420,604,193,1181,196,9281
"34011040800",3888,162,530,47,513,43,656,95,5934
"34011040901",1458,108,451,37,560,134,699,179,3626
"34011040902",3664,714,556,0,966,80,1196,466,7642
"34011041000",5873,818,596,143,595,124,1324,383,9856
"34011041100",1884,461,862,293,1410,1379,3329,1687,11305
"34011990000",0,0,0,0,0,0,0,0,0
"34013000100",1910,897,1176,133,1839,249,2772,1018,9994
"34013000200",951,134,385,151,1343,494,1919,566,5943
"34013000300",975,361,470,727,983,168,1601,516,5801
"34013000400",1005,118,58,16,1007,158,1522,199,4083
"34013000500",511,201,117,45,831,314,1137,478,3634
"34013000600",1450,197,700,103,1474,404,2601,483,7412
"34013000700",1056,189,2192,1251,1548,364,2470,545,9615
"34013000800",768,465,874,344,1666,687,2062,1138,8004
"34013000900",527,219,792,783,663,491,968,785,5228
"34013001000",364,142,947,468,375,342,592,427,3657
"34013001100",120,149,902,190,92,186,118,274,2031
"34013001300",85,63,1023,323,85,50,140,85,1854
"34013001400",115,258,979,1014,226,185,359,449,3585
"34013001500",38,25,740,720,78,211,80,252,2144
"34013001600",138,123,802,283,242,89,386,229,2292
"34013001700",29,74,1173,622,225,89,225,203,2640
"34013001800",8,13,1199,651,65,4,115,66,2121
"34013001900",0,9,950,764,34,18,63,67,1905
"34013002000",126,47,3114,713,90,126,179,115,4510
"34013002100",17,10,2443,535,84,50,178,30,3347
"34013002201",505,96,4067,637,1772,1413,991,956,10437
"34013002202",81,79,2278,604,347,26,10,0,3425
"34013002300",156,20,2740,772,109,295,195,218,4505
"34013002400",22,9,1643,860,19,136,31,5,2725
"34013002500",0,0,1733,994,227,32,48,22,3056
"34013002600",72,30,970,647,117,99,144,192,2271
"34013002800",28,9,813,418,185,83,166,106,1808
"34013003100",44,1,1238,499,99,77,163,78,2199
"34013003500",20,23,1357,480,24,135,44,138,2221
"34013003700",46,19,918,548,9,0,55,14,1609
"34013003800",24,93,1287,335,114,87,120,180,2240
"34013003900",0,0,453,406,58,13,46,28,1004
"34013004100",111,0,1710,543,37,19,140,0,2560
"34013004200",6,11,1386,1161,131,145,115,229,3184
"34013004300",0,0,1349,1018,45,87,45,43,2587
"34013004400",12,13,1186,510,65,48,65,52,1951
"34013004500",7,22,2696,246,58,22,38,12,3101
"34013004600",0,0,1947,725,36,25,0,0,2733
"34013004700",16,24,4489,525,166,9,63,14,5306
"34013004801",62,4,1036,947,326,122,297,135,2929
"34013004802",323,103,987,1577,235,166,467,273,4131
"34013004900",27,8,2615,591,277,50,281,0,3849
"34013005000",106,77,1645,757,197,31,181,155,3149
"34013005100",13,75,1548,509,0,0,13,28,2186
"34013005200",12,0,883,346,0,20,0,20,1281
"34013005300",0,146,1267,582,6,0,0,104,2105
"34013005400",8,5,1758,1306,228,166,138,155,3764
"34013005700",746,141,782,421,382,235,716,255,3678
"34013006200",79,16,512,679,6,217,102,233,1844
"34013006400",91,24,666,85,91,91,42,22,1112
"34013006600",38,48,926,173,95,81,115,104,1580
"34013006700",278,262,838,1155,561,337,587,371,4389
"34013006800",1850,363,642,581,1984,570,2523,615,9128
"34013006900",2071,368,16,32,2105,524,2674,448,8238
"34013007000",1937,284,0,0,1361,332,1416,325,5655
"34013007100",2328,513,100,0,805,182,1022,319,5269
"34013007200",2470,360,35,0,1109,194,1609,282,6059
"34013007300",2436,600,141,185,2330,452,2174,673,8991
"34013007400",1329,317,14,67,999,253,911,312,4202
"34013007501",1601,384,352,391,1059,566,1360,676,6389
"34013007502",833,370,191,248,890,404,1009,686,4631
"34013007600",1392,259,94,0,1038,324,1207,389,4703
"34013007700",1106,344,143,0,994,431,1242,604,4864
"34013007800",1334,151,65,50,1543,419,1846,470,5878
"34013007900",1644,290,39,195,1352,642,1594,752,6508
"34013008000",590,185,550,157,559,414,518,423,3396
"34013008100",190,176,1647,916,298,69,212,222,3730
"34013008200",0,18,814,696,107,116,45,72,1868
"34013008700",1375,654,578,293,1042,504,2286,1072,7804
"34013008800",507,235,309,129,631,62,1112,299,3284
"34013008900",509,282,376,179,497,166,1010,553,3572
"34013009000",155,144,794,302,377,156,429,243,2600
"34013009100",905,549,279,14,661,564,1570,1062,5604
"34013009200",338,200,673,709,453,269,679,539,3860
"34013009300",1212,498,840,357,1732,523,2593,1059,8814
"34013009400",1811,863,905,171,946,565,2039,1067,8367
"34013009500",1689,672,454,321,2334,253,3458,910,10091
"34013009600",1068,490,869,742,1127,647,2191,1155,8289
"34013009700",1792,586,585,291,1497,520,3263,929,9463
"34013009900",33,8,1347,290,63,0,18,28,1787
"34013010000",55,26,2256,277,115,0,47,0,2776
"34013010100",108,25,2455,331,187,59,191,84,3440
"34013010200",103,92,3519,491,170,12,172,29,4588
"34013010300",30,0,2433,807,339,18,245,10,3882
"34013010400",180,57,4008,652,91,49,160,14,5211
"34013010500",196,19,2723,1032,269,175,270,182,4866
"34013010600",102,82,2504,1034,301,138,344,134,4639
"34013010700",4,32,2460,408,47,62,68,61,3142
"34013010800",31,7,1707,366,294,0,377,6,2788
"34013010900",33,2,1813,627,123,44,85,46,2773
"34013011100",90,142,2249,984,182,263,115,338,4363
"34013011200",22,16,2055,639,181,1,103,82,3099
"34013011300",129,0,2079,678,253,93,325,72,3629
"34013011400",178,62,3481,657,228,137,139,137,5019
"34013011500",222,5,1682,407,45,47,162,17,2587
"34013011600",12,0,2169,816,72,14,69,15,3167
"34013011700",26,0,2548,751,85,46,101,0,3557
"34013011800",0,0,1820,407,103,0,60,46,2436
"34013011900",121,27,1060,328,84,43,118,67,1848
"34013012000",312,2,4351,780,340,185,426,158,6554
"34013012100",327,147,2390,492,525,238,561,376,5056
"34013012200",128,30,3545,1018,250,372,106,372,5821
"34013012300",253,31,3543,697,278,141,400,219,5562
"34013012400",295,319,2984,768,87,21,287,292,5053
"34013012500",98,23,2684,736,55,105,69,34,3804
"34013012600",83,13,2089,639,24,37,57,37,2979
"34013012700",51,9,3845,331,186,67,157,0,4646
"34013012800",164,16,2512,400,283,98,125,0,3598
"34013012900",21,202,1842,851,264,228,308,391,4107
"34013013000",55,8,1285,185,210,103,24,43,1913
"34013013100",68,16,978,493,87,48,131,107,1928
"34013013200",112,26,1608,612,79,144,103,99,2783
"34013013300",235,42,1397,1680,51,35,318,107,3865
"34013013400",3133,150,0,10,419,13,341,0,4066
"34013013500",3503,399,265,0,664,0,753,106,5690
"34013013600",4195,93,319,39,1393,36,988,0,7063
"34013013700",3673,471,83,77,400,26,851,48,5629
"34013013800",3485,229,0,0,521,0,503,46,4784
"34013013900",3387,98,143,2,1343,0,819,14,5806
"34013014000",2395,141,98,0,1394,14,1038,0,5080
"34013014100",1927,175,262,0,1442,294,1476,390,5966
"34013014200",2299,136,152,0,1520,87,1703,184,6081
"34013014300",3122,411,262,48,1484,126,2666,138,8257
"34013014400",1770,297,450,72,958,116,1244,334,5241
"34013014500",1893,259,553,41,1248,269,1780,383,6426
"34013014600",2150,107,553,51,1284,65,1995,105,6310
"34013014700",2609,414,918,189,1778,268,2335,424,8935
"34013014800",2596,29,83,0,657,18,587,0,3970
"34013014900",3617,255,252,0,604,44,511,172,5455
"34013015000",2239,181,283,78,695,0,620,2,4098
"34013015100",2907,158,773,190,640,51,1343,82,6144
"34013015200",3209,192,420,3,355,0,1146,8,5333
"34013015300",1238,249,491,142,635,82,620,128,3585
"34013015400",2798,140,540,42,519,182,486,67,4774
"34013015500",2124,189,1221,111,450,12,956,35,5098
"34013015600",1620,206,720,11,1187,0,904,84,4732
"34013015700",779,135,699,106,387,6,708,93,2913
"34013015800",2321,144,567,221,841,78,1192,132,5496
"34013015900",1958,131,1254,136,1784,256,2577,271,8367
"34013016000",6414,42,472,34,641,4,864,0,8471
"34013016100",2807,65,28,0,244,7,185,7,3343
"34013016200",2935,114,145,0,327,0,192,1,3714
"34013016300",3159,144,227,12,264,49,142,31,4028
"34013016400",2912,80,386,0,199,0,277,14,3868
"34013016500",2747,144,412,51,462,41,357,33,4247
"34013016600",1596,126,702,41,306,51,250,29,3101
"34013016700",1260,104,803,121,258,156,399,225,3326
"34013016800",1667,114,888,181,379,0,147,0,3376
"34013016900",1834,43,798,10,408,7,161,0,3261
"34013017000",1627,70,983,34,206,42,311,1,3274
"34013017100",320,52,1300,390,281,68,341,73,2825
"34013017200",644,24,1288,185,405,0,199,0,2745
"34013017301",3868,128,622,63,844,38,462,50,6075
"34013017302",4367,191,1131,80,1108,35,717,3,7632
"34013017400",3526,34,695,37,1011,1,466,6,5776
"34013017500",3615,69,1407,129,695,25,915,50,6905
"34013017600",1914,266,1830,53,586,145,1455,231,6480
"34013017700",1626,307,1756,173,703,130,1718,228,6641
"34013017800",1764,288,925,99,532,71,1427,167,5273
"34013017900",1855,74,1120,37,258,0,247,0,3591
"34013018000",3630,86,1537,1,625,12,407,0,6298
"34013018100",119,49,1096,476,169,185,204,199,2497
"34013018200",108,107,2376,887,807,375,830,444,5934
"34013018300",240,32,2429,773,1022,217,1099,378,6190
"34013018400",43,11,1196,443,240,50,223,45,2251
"34013018600",632,263,1192,306,742,247,1328,499,5209
"34013018700",90,172,3095,1240,228,58,158,165,5206
"34013018800",272,45,3195,776,522,0,253,0,5063
"34013018900",96,125,2100,601,297,180,278,268,3945
"34013019000",3233,184,578,100,418,8,145,0,4666
"34013019100",1599,165,1502,105,247,23,162,40,3843
"34013019200",1632,521,686,110,130,61,119,76,3335
"34013019300",1924,187,827,20,245,56,133,0,3392
"34013019400",2992,38,166,0,283,5,274,8,3766
"34013019500",3211,44,395,8,419,0,208,22,4307
"34013019600",2161,325,2486,192,260,0,183,0,5607
"34013019700",1809,89,3404,228,390,19,711,103,6753
"34013019800",1743,55,530,26,194,66,147,13,2774
"34013019900",2323,134,39,17,228,0,90,108,2939
"34013020000",4608,123,27,0,1137,20,195,0,6110
"34013020100",3758,78,0,0,797,0,104,0,4737
"34013020200",3810,13,325,3,906,7,586,7,5657
"34013020300",3076,161,245,13,950,123,120,19,4707
"34013020400",3949,71,0,1,947,12,276,2,5258
"34013020500",5799,68,152,2,1748,18,336,3,8126
"34013020600",3195,38,15,0,1330,8,52,1,4639
"34013020700",3116,124,46,6,1002,101,160,99,4654
"34013020800",5387,343,159,2,1689,30,421,0,8031
"34013020901",1963,34,7,0,149,0,102,0,2255
"34013020902",5090,98,34,0,587,44,578,0,6431
"34013021000",4393,106,102,0,411,0,173,0,5185
"34013021100",3925,149,112,8,241,60,357,60,4912
"34013021200",3518,141,43,2,196,12,319,1,4232
"34013021300",4405,172,151,0,741,89,181,0,5739
"34013021400",5249,193,304,1,316,127,305,63,6558
"34013021601",7352,24,0,0,180,0,282,0,7838
"34013021602",5816,147,0,0,452,0,291,0,6706
"34013021701",3056,120,52,1,355,71,138,71,3864
"34013021702",3122,126,174,37,319,0,241,0,4019
"34013021801",2481,53,52,2,133,0,73,18,2812
"34013021802",2638,126,1,3,610,5,190,5,3578
"34013021803",4361,122,0,0,147,0,427,0,5057
"34013022700",157,96,1099,1131,306,310,401,399,3899
"34013022800",40,9,1213,847,176,50,192,52,2579
"34013022900",507,274,1184,824,296,194,375,219,3873
"34013023000",26,31,1512,980,346,175,165,174,3409
"34013023100",93,43,1265,724,105,117,209,137,2693
"34013023200",257,250,1325,1265,125,82,215,334,3853
"34013980100",0,0,0,0,0,0,0,0,0
"34013980200",0,0,0,0,0,0,0,0,0
"34015500100",3434,395,61,29,182,135,145,126,4507
"34015500201",2099,118,0,0,183,0,178,0,2578
"34015500202",3853,216,371,44,117,10,72,30,4713
"34015500203",4073,219,126,96,182,10,57,0,4763
"34015500204",4441,145,954,51,451,144,286,57,6529
"34015500205",3024,165,180,15,28,7,45,0,3464
"34015500300",2593,267,22,15,104,4,42,8,3055
"34015500400",2514,775,1385,883,89,379,261,364,6650
"34015500500",4252,328,77,52,160,0,108,0,4977
"34015500600",7941,417,477,290,851,0,309,0,10285
"34015500701",6668,420,363,124,335,0,334,25,8269
"34015500702",5260,185,250,3,38,0,16,0,5752
"34015500703",1296,59,23,0,23,16,62,16,1495
"34015500800",2043,50,4,7,95,0,26,1,2226
"34015500900",2823,73,36,4,68,0,121,9,3134
"34015501001",1250,176,149,279,106,113,162,187,2422
"34015501002",1633,210,949,576,322,322,268,198,4478
"34015501003",2752,229,242,199,328,71,231,0,4052
"34015501101",2442,436,830,236,245,88,254,258,4789
"34015501102",4861,256,918,0,698,154,404,27,7318
"34015501103",3629,266,241,55,639,56,325,56,5267
"34015501104",2180,156,113,11,337,0,115,53,2965
"34015501105",2220,190,134,19,144,364,192,31,3294
"34015501106",2051,135,815,228,495,28,160,45,3957
"34015501107",3868,208,55,27,180,49,122,32,4541
"34015501201",5551,71,247,1,307,22,62,0,6261
"34015501202",4333,127,67,1,311,0,59,0,4898
"34015501203",3078,76,7,0,48,0,5,0,3214
"34015501204",3459,61,212,4,136,11,91,0,3974
"34015501205",2428,117,157,0,203,0,89,12,3006
"34015501206",2777,223,305,33,289,36,249,29,3941
"34015501208",3445,164,44,0,323,118,72,86,4252
"34015501209",5581,185,600,148,575,12,671,15,7787
"34015501210",3473,32,49,8,123,0,43,0,3728
"34015501212",2612,130,375,2,385,23,218,75,3820
"34015501213",3974,50,247,115,353,0,234,0,4973
"34015501301",3347,169,9,0,85,26,29,26,3691
"34015501302",2615,161,8,0,80,0,49,0,2913
"34015501303",2083,44,41,2,178,9,11,0,2368
"34015501402",1009,768,713,34,305,11,317,32,3189
"34015501403",2337,224,405,197,295,1,243,8,3710
"34015501404",597,292,62,30,3,101,9,32,1126
"34015501405",3481,131,312,11,151,34,19,6,4145
"34015501406",2625,645,400,296,592,450,474,348,5830
"34015501500",5347,602,1175,52,1016,100,433,156,8881
"34015501603",5101,379,335,143,505,0,741,21,7225
"34015501604",5249,718,1075,80,411,0,297,1,7831
"34015501605",3041,233,754,38,446,161,193,125,4991
"34015501606",4718,67,1263,28,593,43,400,56,7168
"34015501608",3614,395,654,39,351,51,297,29,5430
"34015501609",3985,111,999,86,675,0,180,15,6051
"34015501701",4319,200,425,10,291,24,186,24,5479
"34015501702",2275,83,46,13,81,0,130,0,2628
"34015501703",3350,353,204,56,265,102,322,28,4680
"34015501704",3117,262,536,0,483,192,388,152,5130
"34015501800",1408,102,29,12,59,3,72,1,1686
"34015501900",3184,200,503,112,171,0,135,0,4305
"34015502001",5020,84,137,6,130,45,193,45,5660
"34015502002",6230,202,432,22,434,0,166,0,7486
"34015502100",2796,40,287,0,33,0,183,0,3339
"34015502200",9130,299,789,142,1093,84,401,26,11964
"34015502300",1739,98,434,6,272,63,308,85,3005
"34015502400",4641,277,482,64,486,25,263,0,6238
"34017000100",2359,162,242,16,3962,312,3213,457,10723
"34017000200",1626,434,198,53,2478,738,2240,887,8654
"34017000300",1708,221,310,13,1571,555,2118,568,7064
"34017000400",857,377,226,16,1650,406,630,404,4566
"34017000500",1550,209,517,11,1738,520,1666,389,6600
"34017000600",1865,348,420,103,2290,389,2229,636,8280
"34017000700",1581,185,98,15,884,581,1098,514,4956
"34017000800",1607,225,195,14,1711,609,1912,576,6849
"34017000902",1666,726,323,74,2761,456,764,221,6991
"34017001000",1049,149,28,0,700,237,683,41,2887
"34017001100",2495,268,290,25,1702,364,2134,321,7599
"34017001201",696,94,67,9,1131,122,354,71,2544
"34017001202",304,108,183,117,468,292,253,125,1850
"34017001300",982,46,189,30,799,677,979,464,4166
"34017001400",1413,330,444,24,1422,117,1198,298,5246
"34017001701",1327,319,404,557,1490,659,839,202,5797
"34017001800",1246,474,206,269,1555,365,758,270,5143
"34017001900",249,19,64,46,806,249,79,9,1521
"34017002000",1257,709,359,57,1418,391,443,281,4915
"34017002200",1102,162,61,8,237,15,345,68,1998
"34017002300",1323,75,63,16,570,181,434,209,2871
"34017002400",1928,84,221,10,453,11,383,2,3092
"34017002700",1352,641,866,886,1693,194,947,378,6957
"34017002800",2866,546,1224,308,1160,238,1658,262,8262
"34017002900",1409,341,354,116,1345,316,805,73,4759
"34017003000",1106,149,401,169,865,39,854,124,3707
"34017003100",1428,527,513,103,1414,314,883,432,5614
"34017003500",1136,270,159,58,311,18,429,243,2624
"34017004000",906,127,924,134,2948,380,739,306,6464
"34017004101",1950,609,1593,474,1294,660,813,826,8219
"34017004102",591,259,897,685,562,156,755,336,4241
"34017004200",744,497,1806,686,1304,73,1206,391,6707
"34017004300",446,23,1029,318,240,124,360,120,2660
"34017004400",105,9,888,927,365,107,329,97,2827
"34017004500",310,163,2408,1099,453,120,567,268,5388
"34017004600",392,64,885,128,391,398,608,476,3342
"34017004700",694,143,701,247,786,174,851,266,3862
"34017004800",1049,190,917,142,1937,175,589,108,5107
"34017004900",562,206,1500,441,845,289,728,496,5067
"34017005200",526,201,1812,1056,717,43,264,291,4910
"34017005300",339,195,1546,343,104,241,395,414,3577
"34017005400",1196,0,2510,433,2920,45,1097,16,8217
"34017005500",207,70,1481,498,138,57,334,176,2961
"34017005600",709,166,1170,405,806,286,518,258,4318
"34017005801",190,25,3166,1174,442,341,966,452,6756
"34017005802",1139,73,60,0,292,0,98,16,1678
"34017005900",1471,308,1590,196,3357,604,1036,169,8731
"34017006000",560,145,2715,720,732,241,939,423,6475
"34017006100",1308,458,1291,773,2257,423,922,961,8393
"34017006200",631,228,903,667,1083,233,1113,247,5105
"34017006300",933,67,979,636,1448,213,1502,255,6033
"34017006400",1975,89,231,0,677,29,709,66,3776
"34017006500",1086,282,241,54,414,99,433,359,2968
"34017006600",328,44,45,0,1081,158,58,0,1714
"34017006700",432,395,1054,631,400,91,729,478,4210
"34017006800",58,98,1950,1081,203,145,158,85,3778
"34017006900",4,0,11,0,0,9,0,0,24
"34017007000",2047,135,204,11,1262,99,1079,117,4954
"34017007100",1347,197,372,62,1433,186,732,138,4467
"34017007200",911,15,158,0,788,54,234,3,2163
"34017007300",1012,14,69,0,696,0,190,0,1981
"34017007400",2846,82,133,0,1912,62,365,13,5413
"34017007500",2439,429,311,43,2400,116,615,208,6561
"34017007600",2533,44,145,47,3359,304,460,31,6923
"34017007700",1962,28,383,183,5968,1331,395,83,10333
"34017007800",499,268,59,143,362,69,357,199,1956
"34017010100",2981,535,924,224,1046,162,1058,275,7205
"34017010200",2082,267,80,0,391,89,328,107,3344
"34017010300",1461,203,545,98,489,88,625,118,3627
"34017010400",2908,417,650,8,890,77,1020,118,6088
"34017010500",3712,248,366,19,540,139,743,108,5875
"34017010600",3366,731,552,110,1353,433,1272,198,8015
"34017010700",2096,616,335,54,561,52,998,179,4891
"34017010800",2332,215,115,81,461,20,898,81,4203
"34017010900",1205,409,73,52,300,39,369,89,2536
"34017011000",872,342,206,0,519,183,438,138,2698
"34017011100",2546,926,482,27,603,96,960,308,5948
"34017011200",4930,483,444,0,743,83,1228,95,8006
"34017011300",1557,318,348,76,223,288,590,426,3826
"34017011400",2801,99,84,55,728,16,803,20,4606
"34017011500",2259,261,243,134,647,18,688,237,4487
"34017011600",2557,480,480,228,574,153,599,234,5305
"34017012300",1559,148,29,13,641,95,863,128,3476
"34017012400",2646,257,0,0,323,10,634,179,4049
"34017012500",2451,193,215,0,1492,69,1302,124,5846
"34017012600",2418,356,11,1,438,163,849,216,4452
"34017012700",3286,359,326,34,1146,153,1833,328,7465
"34017012800",2616,199,142,0,1017,48,1705,35,5762
"34017012900",2573,486,0,0,859,284,1849,723,6774
"34017013000",1727,197,102,1,1223,230,1755,214,5449
"34017013100",1440,129,86,14,378,187,736,267,3237
"34017013200",2251,537,112,0,1403,350,2244,531,7428
"34017013300",1712,151,90,0,1302,245,1700,339,5539
"34017013400",1207,168,81,0,723,331,1322,384,4216
"34017013500",2328,454,14,0,1642,568,1861,670,7537
"34017013600",859,145,46,12,945,195,982,262,3446
"34017013700",1130,31,70,5,1094,186,1512,112,4140
"34017013800",805,85,4,0,1079,135,508,143,2759
"34017013900",1393,81,55,10,1135,111,682,39,3506
"34017014000",3101,435,282,0,1151,155,3553,449,9126
"34017014101",1848,55,104,44,962,57,732,61,3863
"34017014102",3395,174,231,38,984,103,2831,86,7842
"34017014200",3424,1102,132,0,1302,615,3899,1335,11809
"34017014300",3956,738,57,11,1099,329,3971,923,11084
"34017014400",4706,814,238,4,1871,131,4806,806,13376
"34017014501",4931,878,116,1,1451,154,5157,814,13502
"34017014502",1523,922,54,0,226,227,1279,866,5097
"34017014600",2186,383,90,22,927,149,2430,491,6678
"34017014700",2932,550,136,16,1217,322,3539,753,9465
"34017014800",3081,807,306,3,1439,141,3594,813,10184
"34017014900",1536,221,96,0,1068,214,2072,360,5567
"34017015001",1150,20,126,0,755,44,537,0,2632
"34017015002",2393,786,415,76,1764,241,3499,881,10055
"34017015100",1784,414,50,77,1285,105,2679,253,6647
"34017015201",1541,95,162,0,1011,0,371,19,3199
"34017015202",2985,499,220,0,1614,818,3174,801,10111
"34017015300",2289,735,74,66,1005,118,2945,726,7958
"34017015500",2538,603,193,31,1667,427,3866,1061,10386
"34017015600",2065,756,53,57,1043,303,2841,1033,8151
"34017015700",1794,486,124,38,1008,274,2603,778,7105
"34017015801",1751,109,95,8,857,83,408,35,3346
"34017015802",3121,1100,177,80,1451,64,4034,1229,11256
"34017015900",2123,701,8,101,1979,842,3762,1395,10911
"34017016000",1432,495,26,0,931,452,2068,922,6326
"34017016100",1162,371,232,0,1531,385,2712,725,7118
"34017016200",2418,782,53,19,1186,352,3293,1134,9237
"34017016300",2897,848,128,67,551,394,3186,1178,9249
"34017016400",1885,933,62,42,720,392,2307,1222,7563
"34017016500",2180,794,155,33,1016,100,2666,546,7490
"34017016600",2091,915,141,12,798,468,2551,1106,8082
"34017016700",990,128,0,14,390,94,1011,236,2863
"34017016800",2027,482,85,17,469,403,2236,889,6608
"34017016900",1756,1140,12,7,452,304,1857,1328,6856
"34017017000",2178,1010,401,58,744,250,2741,1235,8617
"34017017100",3221,613,194,11,944,281,3698,870,9832
"34017017200",1549,575,146,22,598,124,1963,566,5543
"34017017300",1448,369,25,0,592,151,1372,472,4429
"34017017400",1287,531,59,91,606,151,1745,647,5117
"34017017500",1565,722,338,0,1382,48,2698,667,7420
"34017017600",1579,420,204,2,750,239,2215,515,5924
"34017017700",1006,204,99,50,416,121,1216,308,3420
"34017017800",2908,1110,354,34,1306,301,3548,1286,10847
"34017017900",1193,31,47,0,690,7,140,13,2121
"34017018000",3231,358,151,6,509,86,1761,320,6422
"34017018100",1832,212,141,19,352,170,1154,337,4217
"34017018200",2921,247,345,0,411,241,1101,327,5593
"34017018301",1838,27,0,9,440,22,151,0,2487
"34017018302",2727,60,43,0,749,28,198,16,3821
"34017018400",4097,692,51,0,468,135,730,255,6428
"34017018500",5529,158,92,44,378,65,711,13,6990
"34017018600",1959,74,0,6,330,37,352,16,2774
"34017018701",1290,37,1,0,98,44,55,1,1526
"34017018702",3188,580,61,0,417,121,505,414,5286
"34017018800",2648,175,0,53,318,40,198,28,3460
"34017018900",2981,210,14,0,461,137,233,178,4214
"34017019000",2613,962,532,274,257,215,1112,916,6881
"34017019100",2449,458,68,0,488,20,293,356,4132
"34017019200",3169,28,14,0,895,0,231,0,4337
"34017019300",2240,243,27,18,287,30,351,64,3260
"34017019400",2040,460,29,0,266,42,269,127,3233
"34017019800",3644,329,26,0,1884,19,664,270,6836
"34017019900",2872,180,50,7,1831,40,623,77,5680
"34017020000",2650,407,198,86,1918,22,1045,148,6474
"34017020100",442,194,52,0,842,45,245,76,1896
"34017032400",2755,1220,53,1,2129,884,4488,2030,13560
"34017980100",0,0,0,0,0,0,0,0,0
"34019010100",5533,69,132,0,187,0,340,0,6261
"34019010200",7156,189,0,21,263,22,101,7,7759
"34019010300",2322,156,51,18,198,0,128,9,2882
"34019010400",4356,217,16,0,53,0,120,130,4892
"34019010500",4985,145,10,0,39,0,116,0,5295
"34019010600",5667,124,20,6,133,9,104,1,6064
"34019010701",4315,142,26,3,243,40,273,57,5099
"34019010702",3078,93,3,1,33,1,111,2,3322
"34019010801",2267,188,1,0,201,6,162,107,2932
"34019010802",1588,107,22,8,104,6,120,1,1956
"34019010900",3309,62,64,36,110,0,176,0,3757
"34019011001",4272,49,47,10,229,0,178,8,4793
"34019011002",5308,249,35,0,613,0,520,60,6785
"34019011100",4720,470,36,0,74,0,178,53,5531
"34019011201",6509,68,26,1,549,18,284,0,7455
"34019011202",3029,109,72,46,241,0,123,0,3620
"34019011301",5719,148,7,23,389,0,291,5,6582
"34019011302",5882,512,115,0,702,12,223,35,7481
"34019011303",4159,194,32,23,324,116,201,111,5160
"34019011304",3087,126,37,0,159,0,43,0,3452
"34019011400",2441,387,113,73,1214,338,811,463,5840
"34019011500",4853,146,25,5,160,16,62,20,5287
"34019011600",4949,132,5,0,47,4,127,74,5338
"34019011700",3580,177,15,11,130,12,233,11,4169
"34019011800",2550,47,12,0,132,17,61,8,2827
"34019011900",3339,165,92,6,232,0,320,0,4154
"34021000100",1478,430,352,146,526,317,1396,634,5279
"34021000200",1485,283,691,378,344,170,1204,385,4940
"34021000300",1599,335,569,137,1114,281,1777,447,6259
"34021000400",2022,881,543,251,1022,278,2562,977,8536
"34021000500",2001,728,447,418,611,182,2021,904,7312
"34021000600",1904,699,1158,70,617,219,1783,769,7219
"34021000700",934,333,544,29,568,63,1148,317,3936
"34021000800",976,339,449,118,497,110,1287,427,4203
"34021000900",668,555,814,520,286,210,649,600,4302
"34021001000",443,407,817,567,369,0,748,316,3667
"34021001101",77,56,1262,618,117,113,35,32,2310
"34021001102",65,34,2292,1256,10,42,28,19,3746
"34021001200",713,7,2662,345,225,52,241,16,4261
"34021001300",537,67,1991,342,205,22,208,33,3405
"34021001401",142,33,2308,1551,26,90,61,33,4244
"34021001402",14,76,1358,739,34,36,21,213,2491
"34021001500",189,262,1709,741,0,18,163,280,3362
"34021001600",119,130,475,245,105,123,222,39,1458
"34021001700",550,63,2234,836,60,65,467,0,4275
"34021001800",1891,868,618,216,140,71,620,718,5142
"34021001900",210,541,614,179,0,254,235,770,2803
"34021002000",152,77,499,251,32,9,98,11,1129
"34021002100",760,731,2074,601,529,272,1139,777,6883
"34021002200",1466,493,2722,404,249,261,1371,575,7541
"34021002400",0,0,0,0,0,0,0,0,0
"34021002500",5165,286,608,0,452,0,1691,33,8235
"34021002601",1857,311,1166,170,554,48,1203,211,5520
"34021002602",2476,248,871,165,392,140,697,43,5032
"34021002701",2260,258,850,104,334,89,634,194,4723
"34021002702",4540,656,719,138,399,0,940,179,7571
"34021002800",2406,998,1924,796,889,112,1217,994,9336
"34021002902",2443,124,1054,148,789,108,664,134,5464
"34021002903",2158,160,16,105,412,74,201,214,3340
"34021002904",4622,58,290,0,465,39,129,28,5631
"34021003001",5555,180,260,2,217,0,166,0,6380
"34021003002",5060,52,151,12,253,0,306,0,5834
"34021003003",5667,167,67,21,268,0,195,0,6385
"34021003004",4989,50,31,1,167,0,452,0,5690
"34021003006",5017,33,323,3,649,2,252,0,6279
"34021003007",3431,94,39,0,77,0,102,0,3743
"34021003008",4273,48,310,1,451,12,375,38,5508
"34021003009",3931,121,475,17,442,0,216,0,5202
"34021003100",3336,168,409,94,381,143,863,126,5520
"34021003201",3565,275,1014,122,503,75,267,41,5862
"34021003202",3914,289,567,88,925,15,412,74,6284
"34021003301",5525,225,220,122,712,0,142,0,6946
"34021003302",3586,98,923,89,3517,65,544,1,8823
"34021003400",808,17,1227,257,116,60,286,51,2822
"34021003500",2769,766,2721,185,580,59,732,96,7908
"34021003601",1157,204,1460,191,474,11,369,160,4026
"34021003602",1713,406,1031,314,164,57,215,0,3900
"34021003703",2637,239,570,10,225,12,225,1,3919
"34021003704",1838,101,175,1,204,40,45,0,2404
"34021003705",3870,366,1277,115,153,8,193,144,6126
"34021003706",2523,201,714,32,226,0,179,40,3915
"34021003800",5874,171,351,1,504,1,55,1,6958
"34021003902",1735,32,30,0,48,0,31,7,1883
"34021003903",2337,84,42,14,63,59,45,52,2696
"34021003904",4334,102,294,0,1252,0,365,24,6371
"34021003905",4418,61,169,2,252,0,149,0,5051
"34021004000",3627,72,565,18,280,96,628,3,5289
"34021004201",5260,103,501,44,785,166,265,0,7124
"34021004203",2384,103,96,39,1362,110,141,13,4248
"34021004204",3697,209,96,9,1308,159,317,77,5872
"34021004301",3242,227,173,2,4925,28,352,12,8961
"34021004304",3970,106,265,0,3535,61,284,24,8245
"34021004306",2573,73,59,0,2647,90,251,0,5693
"34021004307",3199,256,48,40,2049,92,404,0,6088
"34021004309",3920,43,35,1,559,5,191,0,4754
"34021004310",7213,118,299,1,1869,2,359,1,9862
"34021004403",3588,177,246,72,1312,108,1951,86,7540
"34021004404",4173,367,621,160,1511,318,2044,160,9354
"34021004405",4144,221,351,0,2744,443,1023,177,9103
"34021004406",2949,173,291,36,1179,126,1289,141,6184
"34021004407",4867,610,273,111,1537,29,1092,148,8667
"34021004501",1256,73,16,8,153,7,18,5,1536
"34021004502",838,135,11,0,67,65,38,35,1189
"34023000100",6869,97,153,6,451,0,614,0,8190
"34023000200",3945,192,824,31,1241,22,1471,0,7726
"34023000300",4342,294,1061,253,1360,42,1860,153,9365
"34023000401",2069,55,699,0,761,91,745,0,4420
"34023000403",1738,68,1102,64,2463,17,546,23,6021
"34023000404",1880,298,689,10,1789,206,422,280,5574
"34023000501",1466,147,2059,197,942,94,1134,136,6175
"34023000502",1662,44,1338,111,3791,426,753,32,8157
"34023000603",971,45,130,8,1076,60,223,0,2513
"34023000606",1606,271,1573,5,3428,290,373,0,7546
"34023000608",448,123,168,4,816,150,113,34,1856
"34023000701",1507,65,393,146,1208,10,431,0,3760
"34023000702",2729,48,1311,11,1167,57,571,57,5951
"34023000801",2313,249,733,34,613,0,828,108,4878
"34023000802",1980,230,101,0,508,10,465,0,3294
"34023000901",1969,51,65,0,379,5,565,10,3044
"34023000902",3348,194,262,20,864,6,751,36,5481
"34023001001",1993,4,146,0,433,0,228,0,2804
"34023001002",2784,129,943,0,3071,193,513,49,7682
"34023001100",3008,243,156,53,900,113,271,13,4757
"34023001200",3114,484,437,20,1201,101,890,160,6407
"34023001300",3011,255,250,18,545,288,289,272,4928
"34023001409",1455,50,34,4,1775,51,74,0,3443
"34023001410",886,99,331,35,2954,55,101,12,4473
"34023001411",1157,14,132,0,2157,69,130,0,3659
"34023001412",1458,50,84,0,1752,112,198,0,3654
"34023001413",847,48,417,85,3857,117,95,0,5466
"34023001414",1296,20,234,22,3969,178,123,13,5855
"34023001415",2676,33,0,0,2669,11,382,0,5771
"34023001416",952,53,228,126,7088,561,598,19,9625
"34023001417",1095,40,68,21,874,0,28,0,2126
"34023001502",3765,236,316,221,1298,41,303,50,6230
"34023001504",1167,100,284,114,4119,87,360,30,6261
"34023001505",156,3,333,13,1638,0,79,0,2222
"34023001506",509,153,99,61,4592,244,175,84,5917
"34023001600",2355,141,143,20,2127,96,1258,8,6148
"34023001701",3243,96,215,0,1348,63,578,56,5599
"34023001702",2128,25,209,15,1135,22,455,0,3989
"34023001803",1538,3,350,1,966,10,440,0,3308
"34023001804",1840,381,280,0,1679,168,348,213,4909
"34023001805",2345,227,596,17,1790,88,614,39,5716
"34023001901",2130,198,484,14,1542,14,715,135,5232
"34023001902",1396,45,86,0,522,0,354,5,2408
"34023001903",2298,154,83,0,596,0,487,83,3701
"34023002000",2296,127,427,6,1054,0,374,0,4284
"34023002101",1898,96,29,0,341,12,194,1,2571
"34023002102",3016,22,129,0,726,0,205,0,4098
"34023002200",2775,124,125,0,543,0,274,0,3841
"34023002301",3196,55,202,0,447,8,337,32,4277
"34023002302",2965,38,15,27,561,21,479,24,4130
"34023002401",3815,144,334,20,955,0,573,80,5921
"34023002402",1096,77,0,0,370,0,165,0,1708
"34023002500",2101,109,623,38,4446,196,627,34,8174
"34023002603",1872,60,425,155,2638,123,168,0,5441
"34023002604",3213,188,494,70,2014,258,429,0,6666
"34023002605",1892,49,106,0,652,0,275,0,2974
"34023002701",2036,431,379,8,2693,87,703,137,6474
"34023002703",3338,285,746,1,1394,0,1129,78,6971
"34023002805",2146,18,225,0,293,12,405,16,3115
"34023002901",1957,148,385,16,869,0,705,83,4163
"34023002902",1825,221,182,99,346,238,763,330,4004
"34023003001",3062,357,239,123,673,64,1104,302,5924
"34023003002",1559,56,555,0,4053,0,456,31,6710
"34023003101",1374,63,328,0,959,13,251,49,3037
"34023003102",1976,171,507,226,1835,157,482,92,5446
"34023003201",2229,79,437,0,507,4,612,0,3868
"34023003203",2240,298,121,20,665,66,833,230,4473
"34023003300",3234,370,440,142,988,147,2092,371,7784
"34023003401",2761,48,449,7,423,0,822,3,4513
"34023003500",2018,169,406,1,663,92,774,33,4156
"34023003600",3714,1151,670,328,1650,409,2147,702,10771
"34023003700",2154,77,204,53,1336,72,783,30,4709
"34023003800",3434,628,1141,333,2074,232,1708,557,10107
"34023004000",2338,612,292,16,388,130,2095,704,6575
"34023004100",1989,473,196,28,233,0,1753,444,5116
"34023004200",2205,387,153,21,483,69,2200,441,5959
"34023004300",2944,514,370,14,289,174,2762,674,7741
"34023004400",3152,507,371,6,524,20,3386,513,8479
"34023004500",4028,1872,831,80,643,95,4163,1852,13564
"34023004600",2776,1461,219,87,593,78,3063,1474,9751
"34023004700",2751,512,230,86,696,107,2887,492,7761
"34023004800",3185,1780,310,16,281,221,3239,1906,10938
"34023004900",2862,920,238,216,737,183,3092,1024,9272
"34023005000",2855,899,138,113,509,61,3092,917,8584
"34023005100",1200,1459,99,30,470,362,211,67,3898
"34023005200",2026,2306,266,112,362,796,1600,1158,8626
"34023005300",1790,807,139,85,94,34,1785,771,5505
"34023005500",1267,759,1273,107,306,154,1391,904,6161
"34023005601",1433,723,258,141,137,71,1521,710,4994
"34023005602",3436,2008,480,170,1300,351,4488,2342,14575
"34023005700",2622,844,630,297,908,209,3023,855,9388
"34023005800",2591,1586,367,465,176,320,2557,1650,9712
"34023006001",1333,32,437,0,380,19,468,9,2678
"34023006002",1609,299,403,165,436,141,1584,201,4838
"34023006101",3158,211,303,0,781,99,2349,154,7055
"34023006103",2810,112,522,33,1552,135,1622,163,6949
"34023006104",2190,127,674,116,1243,12,745,0,5107
"34023006203",3163,250,1224,376,3949,275,711,18,9966
"34023006204",603,54,273,0,803,8,70,0,1811
"34023006205",3102,36,950,81,2764,193,770,74,7970
"34023006206",1432,32,98,0,296,6,67,0,1931
"34023006207",2809,352,1666,265,1078,123,772,181,7246
"34023006300",5744,647,228,0,370,0,441,161,7591
"34023006403",1571,82,177,0,934,63,327,5,3159
"34023006500",4847,232,363,0,1832,85,478,0,7837
"34023006601",1920,47,6,0,538,8,205,8,2732
"34023006604",3545,327,227,19,2467,144,255,174,7158
"34023006605",2936,75,196,0,566,0,120,0,3893
"34023006606",2003,193,10,0,787,24,70,0,3087
"34023006607",2287,68,52,0,536,0,136,0,3079
"34023006608",2173,117,90,21,1107,42,98,14,3662
"34023006701",2713,108,177,48,1063,47,450,0,4606
"34023006703",3070,484,347,129,1935,146,537,299,6947
"34023006800",3695,478,64,0,186,56,685,291,5455
"34023006900",2020,390,357,99,514,223,1141,577,5321
"34023007000",5653,347,693,0,1206,255,962,202,9318
"34023007101",2966,99,276,0,403,161,473,36,4414
"34023007102",3241,169,360,30,832,0,342,40,5014
"34023007103",1520,273,2044,134,932,128,533,77,5641
"34023007202",2988,46,239,89,1695,44,324,0,5425
"34023007203",2726,245,431,301,982,225,578,231,5719
"34023007301",2691,65,123,12,112,0,360,15,3378
"34023007303",1431,83,136,2,117,0,230,0,1999
"34023007304",3215,246,1111,0,2044,146,778,43,7583
"34023007402",3363,191,347,25,466,59,556,0,5007
"34023007500",2537,173,159,0,378,0,256,95,3598
"34023007600",4700,391,145,46,248,0,779,2,6311
"34023007702",3739,208,415,26,1423,0,692,0,6503
"34023007703",2908,63,90,0,298,0,405,34,3798
"34023007704",2306,63,127,0,274,0,345,35,3150
"34023007801",2112,80,381,26,612,0,292,0,3503
"34023007804",3816,215,149,0,820,11,383,0,5394
"34023007805",4215,61,41,0,494,0,215,0,5026
"34023007806",3197,209,221,1,282,0,282,9,4201
"34023007905",1714,44,101,3,381,5,296,0,2544
"34023007906",953,86,301,0,330,75,310,51,2106
"34023007907",2502,47,85,0,373,0,391,0,3398
"34023007908",1804,35,748,28,1592,235,1059,42,5543
"34023007909",3308,89,51,13,693,0,388,13,4555
"34023007910",2408,115,69,0,621,57,302,30,3602
"34023007911",2491,9,214,0,1164,14,665,0,4557
"34023007912",4941,195,284,11,1796,44,742,20,8033
"34023008001",5676,174,477,79,787,25,862,16,8096
"34023008101",4014,202,113,72,132,9,181,48,4771
"34023008102",3291,192,90,10,288,0,431,11,4313
"34023008103",1864,69,85,31,287,14,258,6,2614
"34023008202",8037,393,372,7,2876,112,368,0,12165
"34023008204",3337,119,209,19,164,0,109,0,3957
"34023008205",2857,169,66,0,135,0,68,40,3335
"34023008206",2644,389,318,105,99,0,103,170,3828
"34023008207",2422,48,16,21,63,0,64,0,2634
"34023008208",8171,262,428,36,3986,20,526,35,13464
"34023008209",2963,133,20,3,503,15,12,15,3664
"34023008300",4458,583,530,37,329,41,799,426,7203
"34023008403",3280,45,668,227,2971,331,281,9,7812
"34023008404",2776,111,132,0,1049,40,356,72,4536
"34023008405",2571,115,166,1,2330,0,293,29,5505
"34023008406",1269,101,96,0,644,0,188,56,2354
"34023008501",1784,196,1004,47,2529,91,179,21,5851
"34023008502",2496,24,121,0,2403,29,318,12,5403
"34023008503",3212,129,992,36,4446,112,539,50,9516
"34023008504",3448,18,320,0,2373,62,155,0,6376
"34023008601",2451,128,73,0,2603,10,148,10,5423
"34023008602",2031,65,433,0,2900,64,149,0,5642
"34023008604",2219,109,207,17,3201,105,353,0,6211
"34023008605",736,38,378,0,1268,66,105,0,2591
"34023008606",1138,128,431,0,2272,207,145,97,4418
"34023008700",2758,35,198,2,685,0,162,0,3840
"34023008800",1267,80,79,58,591,75,163,0,2313
"34023008900",1403,75,443,45,1897,141,738,57,4799
"34023009000",1161,182,941,39,688,0,354,1,3366
"34023009100",2137,237,572,0,574,0,666,190,4376
"34023009200",3202,118,416,0,526,7,618,13,4900
"34023009300",1913,1456,500,355,1188,215,1874,1198,8699
"34023009400",2810,342,470,0,1353,218,517,70,5780
"34025800100",3947,568,94,0,286,28,343,0,5266
"34025800200",3740,212,124,25,188,38,99,66,4492
"34025800400",3266,205,0,0,98,15,280,0,3864
"34025800500",3805,149,11,1,174,15,475,15,4645
"34025800601",4589,402,75,3,209,15,565,22,5880
"34025800602",3184,258,28,11,139,24,168,16,3828
"34025800701",4817,110,23,2,192,0,330,5,5479
"34025800702",2920,301,34,0,169,55,197,9,3685
"34025800800",5610,42,16,0,569,0,446,0,6683
"34025800900",5229,257,205,0,96,0,374,42,6203
"34025801000",3379,292,73,23,267,0,341,0,4375
"34025801100",3926,130,21,10,271,0,305,0,4663
"34025801200",3495,42,0,0,173,0,110,0,3820
"34025801300",5855,234,11,0,237,20,118,0,6475
"34025801400",3596,28,0,0,203,137,102,100,4166
"34025801500",5505,191,118,0,580,7,227,7,6635
"34025801600",4129,650,221,143,491,9,822,41,6506
"34025801700",2691,524,243,54,432,204,434,173,4755
"34025801800",4851,232,82,349,235,24,599,0,6372
"34025801900",2267,95,119,31,671,29,580,6,3798
"34025802000",2579,301,173,19,625,258,806,268,5029
"34025802100",5556,215,221,10,143,59,443,10,6657
"34025802200",3179,285,72,0,160,0,261,0,3957
"34025802300",3957,194,25,0,268,51,356,62,4913
"34025802400",4421,329,183,0,666,0,364,0,5963
"34025802500",2257,128,385,28,339,5,269,34,3445
"34025802600",2607,286,1017,131,884,25,572,8,5530
"34025802700",2899,96,236,44,565,15,344,28,4227
"34025802800",3393,255,216,0,391,47,265,36,4603
"34025802900",1700,90,32,66,125,1,90,0,2104
"34025803000",3867,263,334,65,532,106,415,56,5638
"34025803100",2683,165,240,2,442,73,312,1,3918
"34025803201",2382,87,23,0,1261,112,316,11,4192
"34025803202",4666,169,62,0,1286,0,353,0,6536
"34025803300",4482,169,160,0,1341,0,276,0,6428
"34025803400",1430,311,1308,381,1403,568,2102,845,8348
"34025803500",1585,182,178,0,329,103,365,94,2836
"34025803600",3539,166,40,70,445,19,543,33,4855
"34025803700",5732,57,147,0,110,0,193,0,6239
"34025803800",2925,45,17,7,96,0,148,1,3239
"34025803900",3616,152,25,0,109,1,73,0,3976
"34025804100",2874,182,0,0,202,0,168,0,3426
"34025804200",5539,209,25,0,164,0,141,0,6078
"34025804500",4243,157,639,36,430,0,654,15,6174
"34025804600",2425,76,97,0,217,0,143,0,2958
"34025804700",0,0,0,0,0,0,0,0,0
"34025804800",7364,331,282,89,856,441,289,98,9750
"34025805001",2293,467,1189,86,730,101,597,315,5778
"34025805100",3300,256,104,2,295,38,371,51,4417
"34025805300",4732,628,50,0,155,0,141,0,5706
"34025805400",2735,269,568,69,171,85,364,68,4329
"34025805500",1652,344,916,146,610,22,1082,72,4844
"34025805600",316,447,840,413,487,176,614,586,3879
"34025805700",2123,310,97,8,797,154,1248,258,4995
"34025805800",1755,529,422,67,461,328,917,451,4930
"34025805900",3445,771,374,78,638,95,1563,589,7553
"34025806000",2651,615,157,46,629,2,947,276,5323
"34025806100",2919,348,44,58,46,329,143,178,4065
"34025806201",1977,98,44,0,90,13,44,0,2266
"34025806202",4076,139,55,0,210,0,301,9,4790
"34025806300",2042,189,0,0,89,36,87,10,2453
"34025806400",4130,323,50,1,410,3,131,14,5062
"34025806501",2221,407,663,59,688,396,1213,201,5848
"34025806502",1982,331,550,21,467,47,327,96,3821
"34025806503",3229,103,91,0,351,9,136,0,3919
"34025806504",1439,124,670,25,270,101,175,72,2876
"34025806600",4731,277,183,0,362,50,560,125,6288
"34025807003",1792,530,1166,531,606,315,1710,809,7459
"34025807004",1647,314,327,237,178,322,444,445,3914
"34025807100",1021,42,918,470,46,164,156,190,3007
"34025807200",281,84,765,772,92,99,198,238,2529
"34025807300",330,85,1365,903,299,218,595,325,4120
"34025807400",2584,188,47,15,79,0,193,48,3154
"34025807500",769,160,1083,18,300,95,472,146,3043
"34025807600",185,119,1528,516,435,172,312,120,3387
"34025807700",821,82,2165,665,429,91,317,91,4661
"34025807800",1592,90,2138,156,567,7,316,7,4873
"34025807900",1798,37,1059,102,291,10,287,0,3584
"34025808001",3895,270,6,0,128,0,142,14,4455
"34025808002",2012,44,147,22,173,5,210,2,2615
"34025808100",2918,339,701,342,367,14,212,236,5129
"34025808200",3513,339,50,58,323,14,463,14,4774
"34025808300",1703,58,0,1,46,1,39,11,1859
"34025808401",1982,161,27,2,22,17,212,17,2440
"34025808402",2863,329,104,29,182,17,544,184,4252
"34025808500",5675,539,19,4,199,44,197,0,6677
"34025808600",5106,405,474,223,66,3,218,0,6495
"34025808701",4232,275,17,0,181,0,53,0,4758
"34025808702",3959,58,21,0,43,0,27,0,4108
"34025808800",3890,116,8,0,128,13,53,32,4240
"34025808900",4287,165,28,0,193,10,192,17,4892
"34025809000",1061,164,118,0,100,46,147,92,1728
"34025809100",2812,126,17,0,34,0,103,0,3092
"34025809200",1626,48,0,0,8,0,21,0,1703
"34025809301",2763,59,0,53,263,54,215,52,3459
"34025809302",2461,177,0,0,0,0,165,10,2813
"34025809400",4404,120,127,0,118,0,225,9,5003
"34025809501",5697,112,155,0,2587,0,346,16,8913
"34025809502",6361,25,318,0,1775,0,155,0,8634
"34025809600",6572,58,147,0,547,0,402,0,7726
"34025809701",4276,62,95,10,1089,3,317,0,5852
"34025809703",3967,83,60,0,362,0,141,0,4613
"34025809704",4572,242,102,0,1265,19,189,0,6389
"34025809901",4592,335,45,0,144,24,188,13,5341
"34025809902",4184,218,32,0,221,17,94,91,4857
"34025809903",158,0,16,0,28,0,42,0,244
"34025810001",4828,276,128,20,517,30,386,9,6194
"34025810002",3072,195,48,0,66,27,165,10,3583
"34025810003",4744,163,32,7,117,17,169,11,5260
"34025810004",3469,113,0,2,368,0,112,0,4064
"34025810101",3779,170,55,0,366,0,186,0,4556
"34025810102",3614,129,48,0,276,0,293,0,4360
"34025810200",10203,276,521,11,1889,70,772,0,13742
"34025810300",1692,76,18,0,281,23,175,35,2300
"34025810401",2785,134,37,5,394,0,173,46,3574
"34025810402",6741,306,433,19,1043,18,485,22,9067
"34025810501",3629,172,408,78,235,1,568,128,5219
"34025810502",6467,128,171,2,809,149,675,113,8514
"34025810503",3399,162,193,16,268,0,391,0,4429
"34025810600",5517,345,159,21,413,43,255,1,6754
"34025810700",1345,86,198,13,274,0,530,39,2485
"34025810800",1681,287,567,241,156,279,1022,453,4686
"34025810900",2208,349,148,21,303,23,1031,258,4341
"34025811000",2501,477,291,51,382,35,1488,471,5696
"34025811101",4348,314,214,0,680,0,343,24,5923
"34025811102",5761,266,106,0,391,0,445,64,7033
"34025811200",5033,161,149,13,254,0,463,6,6079
"34025811301",3888,620,401,22,766,115,440,280,6532
"34025811303",4123,53,134,17,193,26,229,0,4775
"34025811304",2656,59,87,0,468,10,396,29,3705
"34025811401",5478,73,212,0,274,0,475,28,6540
"34025811402",3488,93,193,25,515,0,578,1,4893
"34025811501",5638,44,0,20,461,42,478,0,6683
"34025811502",3169,222,45,0,161,35,77,55,3764
"34025811600",1017,159,104,16,93,35,44,44,1512
"34025811900",6197,180,75,0,438,0,167,0,7057
"34025812000",1682,50,63,0,93,0,53,0,1941
"34025812100",1185,150,8,4,39,4,135,5,1530
"34025812200",2670,80,49,17,493,83,506,29,3927
"34025812300",4432,195,122,52,201,17,333,106,5458
"34025812400",2074,65,5,9,56,18,68,21,2316
"34025812501",4849,338,286,13,317,0,206,0,6009
"34025812502",4456,146,270,5,615,14,194,2,5702
"34025990000",0,0,0,0,0,0,0,0,0
"34027040101",3769,56,2,0,399,11,266,43,4546
"34027040102",4833,216,140,39,414,14,318,133,6107
"34027040200",6244,283,0,8,625,22,881,22,8085
"34027040300",8004,159,15,1,181,0,340,0,8700
"34027040400",3717,176,0,0,228,0,186,150,4457
"34027040500",2967,259,8,0,427,59,605,199,4524
"34027040600",3730,13,0,0,193,0,339,0,4275
"34027040701",5350,152,0,0,424,0,349,0,6275
"34027040702",3926,118,46,0,345,11,408,19,4873
"34027040801",4083,288,8,0,625,15,147,25,5191
"34027040803",4839,205,56,0,1967,88,617,49,7821
"34027040804",2610,106,82,0,793,0,237,2,3830
"34027040805",4678,78,0,0,1076,0,512,0,6344
"34027040900",3835,81,58,0,253,0,107,0,4334
"34027041000",3764,142,278,52,546,39,557,37,5415
"34027041100",3085,156,101,2,111,73,349,113,3990
"34027041200",3537,76,12,0,578,59,46,38,4346
"34027041300",3994,101,0,0,368,0,133,0,4596
"34027041400",5153,205,192,0,532,0,373,56,6511
"34027041500",5348,0,191,0,598,0,479,0,6616
"34027041601",3730,345,88,44,2687,12,223,14,7143
"34027041602",1936,53,93,0,759,66,92,66,3065
"34027041603",2416,41,395,0,1537,322,534,10,5255
"34027041604",3430,89,60,0,871,18,215,0,4683
"34027041701",3695,190,125,0,1998,199,679,34,6920
"34027041702",2120,130,163,0,1096,0,331,82,3922
"34027041704",2530,60,274,5,1840,37,355,44,5145
"34027041705",822,145,0,0,389,85,44,13,1498
"34027041706",2305,327,346,13,2169,11,456,56,5683
"34027041801",1311,42,179,8,1250,87,175,8,3060
"34027041802",3199,27,83,0,1871,38,481,3,5702
"34027041803",2200,69,93,37,2094,97,159,54,4803
"34027041901",5047,247,44,0,493,190,498,224,6743
"34027041902",3946,260,22,0,979,19,362,20,5608
"34027042000",3512,78,73,0,907,28,58,25,4681
"34027042100",3827,32,9,0,434,0,428,1,4731
"34027042200",4044,245,115,0,843,7,145,0,5399
"34027042301",2345,52,19,0,98,0,279,0,2793
"34027042302",2543,63,142,2,311,0,251,23,3335
"34027042500",3082,24,60,0,135,10,190,0,3501
"34027042600",4967,559,399,3,1023,0,530,55,7536
"34027042700",3554,63,34,4,377,31,361,8,4432
"34027042800",4518,82,26,16,254,16,435,16,5363
"34027042900",2816,240,193,4,342,54,303,59,4011
"34027043000",3748,205,131,0,351,12,445,123,5015
"34027043100",3267,134,43,17,147,0,39,12,3659
"34027043200",2544,170,51,0,206,0,179,32,3182
"34027043301",1839,56,368,43,221,7,334,7,2875
"34027043302",2743,211,28,13,205,0,64,0,3264
"34027043303",3395,8,27,0,283,0,206,0,3919
"34027043401",5695,304,78,32,653,18,416,0,7196
"34027043402",4526,252,62,213,382,7,249,43,5734
"34027043500",1668,609,693,83,564,21,1969,519,6126
"34027043600",3371,206,737,20,820,56,969,118,6297
"34027043700",2582,257,253,0,202,0,310,131,3735
"34027043800",4097,567,299,94,859,26,1937,350,8229
"34027043900",4207,60,47,18,301,0,144,0,4777
"34027044000",4979,137,116,0,599,10,210,0,6051
"34027044101",2627,25,0,1,249,0,96,0,2998
"34027044102",4881,211,126,0,641,9,599,20,6487
"34027044200",3351,100,11,0,403,30,107,0,4002
"34027044300",5522,89,316,60,503,0,1273,0,7763
"34027044401",4030,157,17,0,302,0,145,51,4702
"34027044403",4203,64,171,34,394,0,517,0,5383
"34027044404",3167,46,83,0,781,0,474,6,4557
"34027044501",4920,214,284,14,1134,0,387,70,7023
"34027044502",3154,114,78,3,1135,47,1299,39,5869
"34027044601",4351,250,0,1,154,39,279,2,5076
"34027044602",5380,326,28,11,21,0,325,0,6091
"34027044701",4314,342,13,0,113,50,272,0,5104
"34027044702",4852,410,60,4,667,16,552,1,6562
"34027044800",2567,600,413,40,3430,144,4451,436,12081
"34027044900",3002,209,347,0,2532,21,4095,162,10368
"34027045000",2280,163,95,7,2028,186,2860,300,7919
"34027045100",3237,175,232,1,2620,336,2539,422,9562
"34027045200",2841,166,41,11,485,0,672,42,4258
"34027045300",3520,159,132,0,429,108,457,112,4917
"34027045401",4723,33,205,1,225,0,337,17,5541
"34027045402",4187,263,77,29,849,0,756,15,6176
"34027045501",4617,63,123,1,245,0,287,51,5387
"34027045502",7250,232,206,27,668,145,641,12,9181
"34027045602",622,225,155,55,414,122,700,298,2591
"34027045603",3520,37,332,0,1459,0,1227,0,6575
"34027045701",5297,48,96,12,557,33,236,23,6302
"34027045703",3174,84,196,0,294,45,245,36,4074
"34027045704",4595,150,65,0,496,0,294,44,5644
"34027045804",5006,343,35,3,498,0,345,0,6230
"34027045901",1388,61,0,0,163,0,209,0,1821
"34027045902",7022,192,43,0,640,38,298,67,8300
"34027046000",2606,341,54,8,197,45,703,119,4073
"34027046103",4535,312,443,51,537,0,370,14,6262
"34027046104",5832,340,323,55,1117,0,1465,241,9373
"34027046105",5210,261,474,3,1054,89,831,105,8027
"34027046106",6141,217,413,0,1172,0,1161,86,9190
"34027046201",5416,122,89,131,436,21,385,0,6600
"34027046202",3645,162,0,0,58,0,186,51,4102
"34027046297",3341,56,83,0,77,0,145,0,3702
"34027046298",4209,65,143,0,515,0,231,0,5163
"34027046300",4311,114,134,51,707,87,454,8,5866
"34027046400",4460,141,0,6,164,0,138,0,4909
"34029710100",4089,383,28,0,97,7,241,148,4993
"34029711100",3704,186,38,12,48,73,124,110,4295
"34029711200",4024,356,0,0,44,0,41,0,4465
"34029711300",3616,331,0,0,140,0,168,0,4255
"34029711400",5342,286,0,19,94,0,123,19,5883
"34029712000",1151,91,0,0,72,1,21,0,1336
"34029713000",3875,220,15,2,282,25,302,56,4777
"34029713100",5726,239,51,0,362,3,340,0,6721
"34029713201",2456,94,31,0,19,0,37,5,2642
"34029713202",3795,42,42,0,207,0,335,0,4421
"34029713203",4007,173,303,109,210,0,431,0,5233
"34029713300",3664,314,0,2,146,0,143,0,4269
"34029713401",4040,308,100,78,404,34,700,59,5723
"34029713402",2925,562,36,3,310,56,361,143,4396
"34029713500",2801,119,0,0,28,0,121,0,3069
"34029713600",3486,146,0,1,177,14,199,8,4031
"34029713700",2347,123,0,0,55,0,125,0,2650
"34029713800",2963,288,23,16,46,73,227,13,3649
"34029713900",4772,412,411,27,668,307,565,367,7529
"34029714000",5071,247,0,2,661,110,594,57,6742
"34029714100",2686,198,124,57,72,0,165,0,3302
"34029714200",6124,262,48,47,195,32,433,1,7142
"34029714300",3132,86,0,0,28,13,40,44,3343
"34029714400",549,20,1,0,0,0,6,0,576
"34029715000",6096,1659,623,2,1179,188,2809,875,13431
"34029715200",7205,4403,275,202,763,300,2209,1320,16677
"34029715301",5553,2630,662,0,150,52,743,502,10292
"34029715302",2253,3717,76,53,144,46,334,522,7145
"34029715401",3855,1443,0,0,137,5,217,6,5663
"34029715402",2647,3150,0,0,0,0,92,25,5914
"34029715500",7571,3888,137,0,11,85,410,324,12426
"34029715600",3493,2008,177,285,364,215,879,581,8002
"34029715700",6111,3012,342,32,138,0,905,384,10924
"34029715800",4390,1769,292,24,347,113,881,324,8140
"34029715901",1392,156,259,98,214,25,247,58,2449
"34029715902",3497,340,172,139,118,23,860,124,5273
"34029716000",3335,283,52,0,51,0,79,0,3800
"34029717001",2383,36,132,6,157,0,280,29,3023
"34029717002",3182,101,365,64,672,0,684,7,5075
"34029717101",6822,137,508,0,773,96,933,172,9441
"34029717102",3942,121,141,176,134,7,304,7,4832
"34029717200",8019,311,315,38,348,11,492,10,9544
"34029717300",5199,178,417,81,158,14,263,0,6310
"34029717400",4449,267,405,32,212,28,569,0,5962
"34029717501",6510,372,491,57,289,87,801,122,8729
"34029717502",6385,179,195,14,416,0,331,17,7537
"34029718000",7471,402,320,0,190,2,401,2,8788
"34029720001",3522,308,126,0,243,2,80,2,4283
"34029720101",4696,1023,545,136,120,0,427,0,6947
"34029720102",2688,355,174,16,59,0,80,0,3372
"34029720103",4100,279,26,10,101,88,170,26,4800
"34029720202",3191,129,398,52,71,38,229,38,4146
"34029720203",3501,216,166,1,108,10,444,17,4463
"34029720204",4285,381,322,0,864,18,500,25,6395
"34029720205",2423,129,25,0,244,0,110,20,2951
"34029720206",5071,186,276,0,395,0,176,7,6111
"34029721000",2058,194,201,22,96,95,263,65,2994
"34029722001",4457,205,53,0,423,26,410,18,5592
"34029722002",7149,279,182,0,641,0,843,0,9094
"34029722100",5023,148,35,13,712,0,428,0,6359
"34029722200",1949,225,29,0,37,0,62,0,2302
"34029722300",3299,72,245,0,258,0,334,7,4215
"34029722401",4923,266,19,0,160,0,397,0,5765
"34029722402",3382,108,5,2,223,0,127,0,3847
"34029722500",1013,144,0,0,0,0,17,16,1190
"34029722600",2891,188,56,0,0,19,208,1,3363
"34029722701",4029,233,0,0,308,0,167,14,4751
"34029722702",3636,268,25,9,117,139,269,9,4472
"34029722800",3730,205,496,43,729,42,1311,86,6642
"34029722900",3598,430,268,77,677,94,715,32,5891
"34029723000",4352,445,62,20,530,45,321,97,5872
"34029723100",3310,109,34,18,101,61,212,27,3872
"34029723200",5752,325,0,0,395,0,314,84,6870
"34029723300",5954,607,7,17,216,42,394,224,7461
"34029723400",2871,87,0,0,134,0,117,0,3209
"34029723500",1757,241,106,0,130,24,31,0,2289
"34029723600",2163,151,6,30,11,28,79,6,2474
"34029724000",2059,217,614,196,506,92,704,77,4465
"34029725001",2571,204,16,3,146,69,98,73,3180
"34029725002",5208,607,44,3,242,10,483,28,6625
"34029725100",1776,78,89,0,45,0,104,44,2136
"34029726000",1387,105,18,0,100,30,25,30,1695
"34029727001",1941,148,0,0,6,3,19,26,2143
"34029727002",1049,119,4,0,13,0,25,4,1214
"34029728000",4363,633,1,31,189,186,675,441,6519
"34029729000",1791,270,34,0,5,0,66,28,2194
"34029730000",2025,78,8,2,42,0,71,0,2226
"34029731001",2917,72,24,0,72,15,127,9,3236
"34029731002",3363,256,9,88,9,20,154,20,3919
"34029731101",2210,589,63,50,241,31,244,90,3518
"34029731102",4989,327,203,40,406,1,607,4,6577
"34029731103",4115,133,39,0,110,0,137,12,4546
"34029731201",3716,291,65,66,104,11,271,0,4524
"34029731202",3815,352,14,0,53,0,55,0,4289
"34029731203",1528,158,0,0,5,0,0,0,1691
"34029731204",3489,114,33,0,36,11,389,0,4072
"34029731205",2550,238,540,69,75,0,111,112,3695
"34029731206",1855,152,0,0,151,0,131,0,2289
"34029732001",6183,67,42,3,25,11,76,2,6409
"34029732002",7817,947,53,5,13,0,344,122,9301
"34029732101",5436,896,1,1,64,0,315,347,7060
"34029732103",2192,144,0,1,143,0,242,1,2723
"34029732104",3348,398,23,0,116,0,45,0,3930
"34029733000",8094,348,0,2,92,15,259,0,8810
"34029734001",6437,285,198,0,317,16,208,31,7492
"34029734002",5886,859,91,0,89,172,396,410,7903
"34029734003",5389,810,416,0,405,111,680,55,7866
"34029735001",6001,386,0,0,145,0,533,90,7155
"34029735002",8031,309,101,310,82,0,326,0,9159
"34029735101",2040,143,18,0,63,150,54,0,2468
"34029735103",3900,244,0,0,126,86,119,86,4561
"34029735104",3666,373,18,0,259,1,838,220,5375
"34029736001",3019,110,0,0,58,0,31,0,3218
"34029736002",1435,27,0,0,90,0,32,0,1584
"34029736101",4650,635,26,14,504,97,203,380,6509
"34029736102",6927,630,0,34,195,9,167,18,7980
"34029736105",2884,102,61,11,55,4,144,8,3269
"34029737000",2953,226,29,19,122,15,133,22,3519
"34029738001",1878,224,0,0,28,0,15,0,2145
"34029738002",1128,71,16,0,8,1,6,0,1230
"34029738100",1546,74,1,0,30,3,20,0,1674
"34029739000",1866,127,15,0,27,9,32,13,2089
"34029739100",1258,132,17,0,51,16,0,16,1490
"34029980000",0,0,0,0,0,0,0,0,0
"34029980100",0,0,0,0,46,0,0,0,46
"34029990000",0,0,0,0,0,0,0,0,0
"34031116500",7227,239,67,5,280,0,1002,95,8915
"34031124200",4851,125,301,42,1759,133,1258,0,8469
"34031124311",3122,178,47,4,1132,9,639,9,5140
"34031124312",3037,42,378,2,530,44,539,1,4573
"34031124321",3919,142,426,8,1301,233,1479,233,7741
"34031124322",3285,51,17,3,885,8,549,3,4801
"34031124323",1578,115,296,213,589,22,472,24,3309
"34031124401",5301,249,309,3,886,0,1080,19,7847
"34031124402",3138,229,426,27,1346,49,966,49,6230
"34031124500",4079,746,373,2,1078,140,2373,212,9003
"34031124601",2867,482,38,72,1131,169,1575,249,6583
"34031124602",3229,408,587,0,882,55,1586,170,6917
"34031124700",3967,515,216,1,1074,255,2504,220,8752
"34031124800",2748,376,156,35,1241,123,2078,296,7053
"34031124900",2857,406,304,0,1611,140,2848,422,8588
"34031125000",3957,830,580,0,1433,337,4392,733,12262
"34031125100",2127,314,399,33,1026,328,2582,513,7322
"34031133701",2679,818,628,18,1128,61,2163,304,7799
"34031133702",2510,147,106,21,264,17,964,123,4152
"34031143200",5653,179,24,2,188,8,631,22,6707
"34031143300",5034,216,0,6,217,0,1150,70,6693
"34031143400",6131,585,195,1,550,0,1317,29,8808
"34031154001",4067,130,294,0,796,74,293,33,5687
"34031154002",6234,514,101,1,1120,147,1370,63,9550
"34031163500",7456,351,0,0,652,0,699,14,9172
"34031175200",1674,649,321,136,1151,1096,2793,1772,9592
"34031175301",928,433,37,34,1036,838,1835,1248,6389
"34031175302",1471,710,259,127,1037,1354,2477,1989,9424
"34031175401",1994,399,518,77,1388,993,3285,1361,10015
"34031175402",969,386,418,347,1577,1645,2576,2061,9979
"34031175500",1814,842,679,585,2235,1289,3678,2291,13413
"34031175601",2193,83,0,0,68,0,71,0,2415
"34031175602",2299,653,808,176,1796,948,3175,1318,11173
"34031175701",2940,365,341,353,969,243,2245,354,7810
"34031175703",2080,248,347,206,1613,476,1469,683,7122
"34031175704",3428,229,256,39,328,17,1136,112,5545
"34031175801",1224,593,330,12,1604,691,1981,1174,7609
"34031175802",1744,1548,345,200,1362,1692,3134,3220,13245
"34031175900",941,426,378,140,995,834,1773,1201,6688
"34031180100",3752,727,1947,28,1807,420,4317,673,13671
"34031180201",1182,248,657,110,828,179,1425,375,5004
"34031180202",2347,534,402,26,1614,1735,2867,1374,10899
"34031180300",1549,308,1565,673,1283,754,2563,683,9378
"34031180600",932,522,1361,555,455,355,1205,697,6082
"34031180700",528,265,697,498,216,236,658,501,3599
"34031180800",382,339,608,651,480,509,892,846,4707
"34031180900",889,650,405,438,872,276,1641,906,6077
"34031181000",1739,513,598,172,1128,372,2820,841,8183
"34031181100",1699,380,2218,744,1619,455,2963,716,10794
"34031181200",661,275,1532,769,800,357,1589,657,6640
"34031181300",766,252,1885,1217,706,130,1469,321,6746
"34031181400",263,127,1176,680,233,213,431,312,3435
"34031181500",146,137,1029,897,378,103,554,267,3511
"34031181702",664,372,306,355,845,490,1474,854,5360
"34031181800",302,488,147,289,497,584,614,835,3756
"34031181900",1689,354,357,166,1968,526,2408,467,7935
"34031182000",358,108,78,0,747,228,1001,310,2830
"34031182100",1423,741,157,249,993,439,1928,909,6839
"34031182200",683,467,254,616,834,501,1449,862,5666
"34031182301",446,325,105,36,371,527,752,852,3414
"34031182302",840,559,973,435,1901,1659,2747,2162,11276
"34031182400",1278,145,1552,374,1025,402,2526,547,7849
"34031182500",2277,500,3609,1130,1127,176,3861,745,13425
"34031182600",982,249,2575,248,714,42,1616,284,6710
"34031182700",2258,636,954,220,2276,422,4568,909,12243
"34031182800",882,133,438,84,1181,696,2067,830,6311
"34031182900",626,354,86,58,620,511,1194,855,4304
"34031183000",4062,1301,9,77,1719,493,2546,767,10974
"34031183101",1767,165,180,13,879,320,1781,356,5461
"34031183102",1618,575,436,48,1391,565,2952,943,8528
"34031183200",666,236,980,590,202,170,848,313,4005
"34031196401",3726,33,37,0,286,19,411,33,4545
"34031196402",5651,821,0,0,540,0,952,501,8465
"34031203600",2997,381,844,401,1051,250,2660,559,9143
"34031216701",6082,171,69,15,399,27,120,18,6901
"34031216702",4971,248,2,12,310,0,387,13,5943
"34031223801",1960,147,59,0,386,25,523,25,3125
"34031223802",6255,149,16,76,982,55,1259,55,8847
"34031223900",215,274,16,101,0,0,0,49,655
"34031236601",3185,214,108,6,639,2,640,78,4872
"34031236602",6149,215,65,65,576,5,832,60,7967
"34031246001",3319,161,0,0,871,107,459,46,4963
"34031246002",2741,55,0,0,223,0,175,0,3194
"34031246003",4383,174,146,2,706,1,324,25,5761
"34031246101",5641,280,198,14,837,3,690,53,7716
"34031246102",1925,97,100,0,685,7,414,0,3228
"34031246103",5472,217,0,2,763,0,433,205,7092
"34031246104",2669,91,0,0,263,66,232,1,3322
"34031246201",5504,13,23,3,445,0,345,0,6333
"34031246202",4906,157,170,5,266,0,488,63,6055
"34031246203",3657,84,9,12,263,22,392,49,4488
"34031246300",3750,408,72,90,354,3,494,271,5442
"34031256801",4744,190,36,0,196,193,309,24,5692
"34031256802",3785,130,5,5,132,0,344,0,4401
"34031256803",4813,51,25,10,59,28,371,11,5368
"34031256804",6234,183,24,2,305,0,490,0,7238
"34031256805",4828,267,37,4,140,11,418,30,5735
"34031264101",3943,322,341,0,741,83,1803,253,7486
"34031264102",5333,266,216,34,933,0,972,47,7801
"34031264200",381,610,1565,996,519,406,809,1059,6345
"34033020100",1552,89,58,21,42,21,39,16,1838
"34033020200",569,137,870,95,304,32,634,99,2740
"34033020300",606,676,785,355,302,205,466,543,3938
"34033020400",1505,494,549,66,122,11,414,186,3347
"34033020500",1778,82,370,37,114,36,8,0,2425
"34033020600",1749,143,173,47,252,22,389,46,2821
"34033020700",3286,338,261,33,110,4,38,121,4191
"34033020800",2691,331,458,72,7,3,110,3,3675
"34033020900",3052,121,10,37,103,85,113,83,3604
"34033021000",1158,121,52,14,73,35,26,10,1489
"34033021101",4343,137,57,6,138,0,153,0,4834
"34033021102",3376,309,339,131,206,0,114,0,4475
"34033021201",2898,175,81,0,105,5,51,5,3320
"34033021202",1981,150,284,27,156,7,86,7,2698
"34033021300",993,138,197,8,56,15,79,49,1535
"34033021400",2551,295,71,10,187,32,53,20,3219
"34033021500",1515,186,79,0,204,12,108,0,2104
"34033021600",4973,857,0,0,99,0,91,0,6020
"34033021700",1798,102,54,0,16,0,34,14,2018
"34033021900",448,92,704,249,20,50,82,12,1657
"34033022000",175,309,752,793,45,41,76,118,2309
"34033022100",494,111,344,159,33,169,65,110,1485
"34033022201",1363,91,32,58,101,4,47,1,1697
"34033022202",870,74,44,26,10,11,34,12,1081
"34033990000",0,0,0,0,0,0,0,0,0
"34035050100",2656,97,66,59,187,21,664,39,3789
"34035050200",1244,86,282,1,752,0,381,24,2770
"34035050300",3025,46,140,10,644,0,530,9,4404
"34035050400",1293,103,382,260,508,86,958,166,3756
"34035050500",2282,293,156,11,590,36,780,133,4281
"34035050600",2845,78,113,0,899,0,378,0,4313
"34035050701",2902,103,18,0,862,29,340,0,4254
"34035050703",2476,174,43,90,2387,40,615,2,5827
"34035050704",3238,234,193,0,2850,113,636,65,7329
"34035050801",3161,30,9,17,417,6,171,9,3820
"34035050802",3185,60,137,0,940,0,287,0,4609
"34035050901",3893,55,168,0,507,7,235,0,4865
"34035050902",2788,58,151,2,378,0,263,0,3640
"34035050903",4424,188,150,1,960,41,271,137,6172
"34035051000",4096,266,454,9,2160,71,1410,5,8471
"34035051100",2690,226,75,14,308,74,1269,166,4822
"34035051200",2838,405,348,22,838,257,1990,579,7277
"34035051300",2133,68,90,8,119,0,474,0,2892
"34035051400",3506,176,250,9,463,0,1166,0,5570
"34035051500",2182,567,65,87,323,13,349,271,3857
"34035051600",2508,138,0,38,115,1,405,28,3233
"34035051700",1993,103,501,62,2191,338,3232,405,8825
"34035051800",1750,19,485,59,1632,327,2086,217,6575
"34035051900",1791,52,962,87,531,171,628,172,4394
"34035052001",1832,187,1059,49,694,146,736,219,4922
"34035052002",2041,424,431,72,1802,251,2481,362,7864
"34035052100",4462,363,140,51,1975,0,438,128,7557
"34035052201",3945,226,36,2,1239,0,539,103,6090
"34035052203",3968,92,42,0,1004,0,200,0,5306
"34035052204",4140,69,35,1,945,65,385,65,5705
"34035052300",4642,170,89,0,904,7,639,0,6451
"34035052400",4481,216,46,22,392,96,234,14,5501
"34035052601",6535,119,35,65,2567,159,426,14,9920
"34035052603",3531,168,69,0,453,0,95,0,4316
"34035052700",6538,95,22,2,1127,2,1087,0,8873
"34035052800",2244,18,41,9,66,30,292,25,2725
"34035052901",871,45,39,0,97,0,140,0,1192
"34035052903",4929,209,123,1,697,31,405,24,6419
"34035052904",1978,76,0,3,110,7,88,13,2275
"34035053000",3004,343,432,12,783,38,1260,244,6116
"34035053102",1552,40,1141,241,1351,10,627,11,4973
"34035053103",2338,52,1918,65,766,127,599,126,5991
"34035053105",3275,261,1906,1,2108,17,451,0,8019
"34035053200",2809,123,2232,183,1090,50,1764,57,8308
"34035053300",1459,186,1606,418,681,0,1266,172,5788
"34035053402",2530,74,1099,0,3259,47,611,0,7620
"34035053403",1463,55,955,65,2041,62,318,0,4959
"34035053404",3540,442,3422,258,3563,212,1387,238,13062
"34035053501",2516,108,293,9,673,0,102,0,3701
"34035053602",4979,109,428,197,614,68,235,0,6630
"34035053603",4026,88,191,0,398,40,279,26,5048
"34035053604",2937,50,87,0,461,0,136,9,3680
"34035053703",2651,153,44,2,1061,1,108,10,4030
"34035053704",2754,19,66,6,360,0,375,0,3580
"34035053705",4465,491,705,2,1112,35,743,44,7597
"34035053706",3500,191,340,0,1024,11,381,117,5564
"34035053707",2999,20,25,58,671,0,193,0,3966
"34035053801",435,9,2,4,36,0,24,3,513
"34035053803",6644,130,108,10,1189,0,178,0,8259
"34035053804",3071,78,359,15,951,90,529,64,5157
"34035053805",2863,89,214,0,615,26,230,0,4037
"34035053901",566,26,11,0,12,0,24,0,639
"34035053904",2661,11,0,0,760,0,132,0,3564
"34035053905",3719,24,350,0,3009,28,241,0,7371
"34035054100",5773,72,96,56,1222,22,324,14,7579
"34035054201",4362,389,67,24,2044,189,150,30,7255
"34035054202",3466,196,29,6,1188,0,182,51,5118
"34035054300",5608,211,965,44,2366,40,614,5,9853
"34037371000",3161,386,43,6,187,17,183,20,4003
"34037371100",3755,84,63,11,156,0,118,0,4187
"34037371200",1396,360,11,12,181,6,139,11,2116
"34037371300",3273,115,48,0,191,9,227,62,3925
"34037371400",2648,76,36,0,141,0,219,21,3141
"34037371502",4479,392,96,4,165,4,496,6,5642
"34037371503",2423,41,45,8,114,0,61,0,2692
"34037371600",2571,357,49,8,101,27,461,172,3746
"34037371700",4763,318,217,8,184,20,529,22,6061
"34037371800",6322,372,68,5,329,16,365,4,7481
"34037371900",1647,125,56,6,100,7,145,0,2086
"34037372000",2881,95,0,0,138,0,327,0,3441
"34037372100",1758,108,27,0,39,0,104,5,2041
"34037372200",2015,120,0,0,11,0,254,21,2421
"34037372300",3895,109,13,24,49,14,98,0,4202
"34037372400",2158,112,6,9,55,0,188,0,2528
"34037372500",2766,99,23,0,154,0,158,11,3211
"34037372600",4807,101,37,3,104,0,80,4,5136
"34037372700",2757,210,89,1,152,0,202,48,3459
"34037372800",1317,123,109,1,26,4,109,23,1712
"34037372900",2923,239,9,72,96,0,275,29,3643
"34037373000",2202,107,5,0,110,0,172,0,2596
"34037373100",5536,133,228,11,262,58,395,0,6623
"34037373200",3208,59,19,0,278,9,223,0,3796
"34037373300",2455,42,133,14,239,6,154,5,3048
"34037373400",6245,219,65,0,162,0,151,0,6842
"34037373500",2965,170,44,25,128,1,134,16,3483
"34037373600",2539,47,61,0,138,0,217,0,3002
"34037373700",2547,427,230,198,299,47,587,107,4442
"34037373800",3116,368,112,26,214,20,398,125,4379
"34037373900",3542,250,0,0,151,0,71,0,4014
"34037374000",2968,197,0,35,107,0,22,2,3331
"34037374100",3352,68,6,0,110,3,233,0,3772
"34037374200",2343,92,0,0,105,0,81,11,2632
"34037374300",3100,56,16,0,59,0,112,0,3343
"34037374400",2327,22,0,0,45,0,117,0,2511
"34037374500",1821,85,0,0,133,12,112,0,2163
"34037374600",2889,229,33,22,280,51,154,12,3670
"34037374700",3680,94,151,17,102,16,214,38,4312
"34037374800",3491,169,71,6,279,0,393,0,4409
"34037374900",3819,328,102,0,123,254,533,221,5380
"34039030200",790,241,686,171,1186,209,1818,425,5526
"34039030400",1443,440,1192,751,1177,806,2278,1172,9259
"34039030500",2011,236,559,228,1740,611,3382,842,9609
"34039030600",1221,199,478,487,627,282,1280,391,4965
"34039030701",868,177,16,0,630,118,908,230,2947
"34039030702",3387,631,738,151,3437,445,5158,977,14924
"34039030802",1407,80,314,142,729,276,1685,328,4961
"34039030900",2985,574,194,34,2167,350,4377,837,11518
"34039031000",1356,215,295,310,1532,682,2865,856,8111
"34039031100",2286,657,363,141,1604,571,3604,1162,10388
"34039031200",1228,597,1443,323,1467,340,2478,837,8713
"34039031300",2590,121,1737,414,1206,593,3218,521,10400
"34039031400",1452,525,1822,499,786,0,2015,439,7538
"34039031500",3663,225,470,10,1279,266,3116,428,9457
"34039031601",1639,144,900,125,842,158,2321,287,6416
"34039031602",2678,678,1069,13,1089,346,3210,867,9950
"34039031700",1628,621,1477,658,1203,254,1954,764,8559
"34039031801",2908,265,586,107,848,584,2940,716,8954
"34039031802",1052,271,547,31,453,245,1081,487,4167
"34039031903",2339,803,629,214,1143,213,2662,904,8907
"34039031904",690,439,519,345,983,207,1493,549,5225
"34039032001",3085,513,204,55,2034,650,3950,810,11301
"34039032002",2444,201,476,172,786,34,2330,125,6568
"34039032100",5699,152,403,2,701,0,3478,2,10437
"34039032200",358,0,4781,682,70,50,221,18,6180
"34039032300",422,13,1511,171,217,0,359,6,2699
"34039032400",2042,297,2999,555,1855,25,1402,97,9272
"34039032500",2823,293,1369,346,675,57,1352,81,6996
"34039032600",1244,167,2624,169,454,62,326,0,5046
"34039032700",2522,428,2685,103,1607,188,1125,135,8793
"34039032800",520,48,3036,750,289,34,365,116,5158
"34039032901",2042,83,1022,0,660,195,789,178,4969
"34039032902",3695,160,355,305,1092,140,977,42,6766
"34039033000",2448,140,617,46,766,28,599,8,4652
"34039033100",2557,77,1836,2,1535,57,783,49,6896
"34039033200",2429,76,1197,109,1168,50,1053,66,6148
"34039033300",2244,93,560,39,1007,42,774,0,4759
"34039033400",2491,54,295,0,508,258,566,260,4432
"34039033500",4535,352,767,10,747,236,1369,24,8040
"34039033600",6758,173,421,4,748,0,1170,0,9274
"34039033700",3636,172,157,204,890,93,1312,145,6609
"34039033800",3343,180,31,73,1603,48,1435,48,6761
"34039033900",1653,92,469,10,541,309,807,280,4161
"34039034000",1710,179,2708,118,992,943,1527,1004,9181
"34039034100",798,32,1410,277,511,345,923,339,4635
"34039034200",1044,75,1721,154,446,217,787,238,4682
"34039034300",1195,95,2043,189,370,33,566,23,4514
"34039034400",470,82,2300,307,507,79,517,110,4372
"34039034500",2590,290,1215,192,458,14,1865,201,6825
"34039034600",589,60,2504,356,636,111,1139,49,5444
"34039034700",1742,137,1406,263,506,18,987,100,5159
"34039034800",3043,87,586,20,804,35,857,24,5456
"34039034900",4511,378,1091,0,585,0,1813,218,8596
"34039035000",1831,85,157,0,582,0,941,26,3622
"34039035100",1582,307,1321,302,170,44,439,228,4393
"34039035200",1143,76,338,38,856,43,1402,74,3970
"34039035300",2731,431,1290,197,428,166,1200,302,6745
"34039035400",1734,123,319,10,376,81,719,52,3414
"34039035500",3880,430,1394,18,1506,308,1923,303,9762
"34039035600",2569,167,670,39,397,10,720,30,4602
"34039035700",2621,236,664,111,1156,34,1375,28,6225
"34039035800",1164,120,1860,249,228,36,788,136,4581
"34039035900",1703,125,1118,123,318,21,800,81,4289
"34039036000",1184,51,2495,346,1136,0,1414,25,6651
"34039036100",1319,149,32,0,61,5,92,7,1665
"34039036200",5962,130,1,0,148,1,665,0,6907
"34039036301",4255,136,107,0,258,46,418,0,5220
"34039036302",3550,245,33,0,102,0,544,10,4484
"34039036400",6550,86,95,0,601,0,561,0,7893
"34039036500",4673,82,64,4,822,0,351,0,5996
"34039036600",2796,90,654,91,519,38,474,65,4727
"34039036700",5053,241,91,0,313,19,236,0,5953
"34039036800",6381,113,36,215,713,10,511,1,7980
"34039036900",3923,101,17,0,265,0,723,22,5051
"34039037000",5805,117,194,0,103,0,571,52,6842
"34039037100",4220,44,0,0,101,0,173,0,4538
"34039037200",2818,131,196,23,347,42,315,75,3947
"34039037300",4116,66,217,2,220,0,272,0,4893
"34039037400",3865,62,59,4,336,1,398,8,4733
"34039037500",4114,79,239,122,1380,0,683,123,6740
"34039037601",4125,126,177,0,318,27,270,37,5080
"34039037602",4743,336,449,34,718,103,258,1,6642
"34039037700",4146,138,53,75,439,25,418,1,5295
"34039037800",4576,121,122,0,812,79,497,78,6285
"34039037900",4638,93,230,0,688,83,97,44,5873
"34039038000",3603,231,359,1,1211,64,1647,93,7209
"34039038101",3351,96,14,15,477,103,191,10,4257
"34039038102",6507,196,17,0,1338,138,485,41,8722
"34039038201",4932,246,18,0,937,0,172,110,6415
"34039038202",5955,149,38,5,600,36,540,1,7324
"34039038300",5737,302,8,4,566,0,190,0,6807
"34039038400",3984,69,1018,0,943,0,567,24,6605
"34039038500",4904,65,538,12,445,0,363,0,6327
"34039038601",5903,113,757,268,987,0,577,7,8612
"34039038602",3072,30,182,0,493,0,196,0,3973
"34039038700",5872,58,551,0,912,0,762,0,8155
"34039038800",448,113,2769,413,780,224,801,195,5743
"34039038900",524,306,1814,898,1736,619,1645,609,8151
"34039039000",479,67,927,233,1320,606,1135,503,5270
"34039039100",1318,64,1296,59,453,15,339,9,3553
"34039039200",677,192,1686,367,1400,827,1238,667,7054
"34039039300",500,245,961,442,2886,1732,3029,1354,11149
"34039039400",412,0,1331,338,1879,728,1535,589,6812
"34039039500",528,110,1966,366,2837,1340,2515,1076,10738
"34039039600",684,92,2047,217,847,181,1022,192,5282
"34039039700",642,44,2887,200,491,464,521,324,5573
"34039039800",1806,363,652,381,945,136,1927,406,6616
"34039039900",449,118,138,113,158,96,421,158,1651
"34041030600",2709,388,347,44,193,115,400,108,4304
"34041030700",3099,712,65,144,307,53,423,113,4916
"34041030800",2773,335,17,82,154,19,210,8,3598
"34041030900",1264,404,387,293,413,153,244,289,3447
"34041031101",5566,146,10,27,47,0,561,17,6374
"34041031102",3438,158,79,1,136,13,175,13,4013
"34041031200",6859,401,23,5,380,10,264,40,7982
"34041031301",4848,205,101,6,338,1,139,0,5638
"34041031302",4024,182,48,0,245,0,213,0,4712
"34041031401",3226,139,132,1,743,99,833,123,5296
"34041031402",3522,568,29,54,235,99,415,511,5433
"34041031500",5620,448,267,0,1011,37,625,107,8115
"34041031601",4294,193,0,6,72,18,215,9,4807
"34041031602",2329,70,36,28,15,0,140,14,2632
"34041031700",2292,206,21,12,100,3,62,7,2703
"34041031800",2414,125,10,0,35,0,31,0,2615
"34041031900",5821,78,432,29,150,0,157,0,6667
"34041032000",4759,556,340,41,527,230,507,321,7281
"34041032101",2933,70,0,1,114,0,95,1,3214
"34041032102",4660,148,306,4,437,25,200,3,5783
"34041032200",6529,421,336,184,376,61,522,59,8488
"34041032300",2772,321,51,0,115,6,140,37,3442
"34041032400",1945,182,66,34,28,0,88,15,2358
"35001000107",2186,127,0,32,90,6,429,52,2922
"35001000108",2031,284,31,0,474,67,627,94,3608
"35001000109",1859,30,86,0,376,149,546,7,3053
"35001000110",2597,714,39,22,346,418,757,615,5508
"35001000111",1956,315,26,0,478,18,637,48,3478
"35001000112",1585,157,54,8,198,18,309,66,2395
"35001000113",2047,393,258,22,536,246,897,121,4520
"35001000114",2462,198,2,118,368,62,1142,220,4572
"35001000115",1716,703,68,170,473,220,605,369,4324
"35001000116",2357,352,49,0,303,4,569,244,3878
"35001000117",1721,119,56,0,413,23,607,83,3022
"35001000118",1939,278,0,10,246,135,538,87,3233
"35001000119",1508,114,68,0,140,9,449,48,2336
"35001000120",1832,159,51,112,369,108,796,140,3567
"35001000121",3657,833,237,175,692,261,1480,580,7915
"35001000122",3010,405,136,11,353,117,1258,145,5435
"35001000123",3144,197,47,69,774,173,1445,303,6152
"35001000124",2020,448,93,202,535,177,855,479,4809
"35001000125",3182,100,32,0,477,31,922,50,4794
"35001000126",1856,385,98,7,346,39,663,121,3515
"35001000127",2038,395,51,0,592,10,997,188,4271
"35001000128",1579,450,115,50,345,666,522,604,4331
"35001000129",2348,588,269,135,565,339,1007,685,5936
"35001000203",1212,160,62,16,296,145,421,162,2474
"35001000204",1761,395,58,24,459,207,828,162,3894
"35001000205",2138,299,44,64,195,92,1479,158,4469
"35001000206",2067,232,123,48,286,203,848,220,4027
"35001000207",2048,277,65,116,461,126,1046,257,4396
"35001000208",1727,272,46,0,566,79,1298,226,4214
"35001000300",3599,632,76,19,806,352,823,314,6621
"35001000401",3085,406,76,24,713,208,1015,199,5726
"35001000402",2825,182,111,12,293,36,733,103,4295
"35001000501",1400,544,10,28,617,471,742,499,4311
"35001000502",2796,873,99,68,654,56,608,167,5321
"35001000601",2109,502,274,27,612,120,910,82,4636
"35001000603",1764,1749,73,22,920,1031,1988,2120,9667
"35001000604",1478,754,35,34,829,887,1353,1247,6617
"35001000704",2251,461,32,47,783,0,1217,229,5020
"35001000707",2675,1479,420,44,1413,269,2922,1330,10552
"35001000708",2833,900,88,87,1228,498,1729,775,8138
"35001000710",5201,194,111,56,1200,68,2180,94,9104
"35001000711",3263,479,56,0,727,201,822,287,5835
"35001000712",2041,858,205,35,754,401,1043,605,5942
"35001000713",2396,1476,479,236,1395,592,1929,1054,9557
"35001000714",2607,559,136,26,1109,218,1298,406,6359
"35001000801",2267,181,286,0,524,75,538,17,3888
"35001000901",1862,1867,207,70,1749,1436,2669,2301,12161
"35001000903",2195,1387,154,228,786,612,1295,866,7523
"35001000904",2148,443,58,24,1026,473,1383,622,6177
"35001001101",2863,472,89,0,855,68,815,235,5397
"35001001102",1715,548,78,79,218,451,652,737,4478
"35001001200",2753,1810,302,47,1230,1053,1883,1870,10948
"35001001300",1692,337,77,6,1204,1099,2777,1396,8588
"35001001400",1124,458,5,6,356,833,1211,1079,5072
"35001001500",950,643,38,33,537,194,738,584,3717
"35001001600",1255,480,13,14,437,281,348,181,3009
"35001001700",2509,982,0,75,744,387,889,403,5989
"35001001800",228,175,0,0,95,106,121,102,827
"35001001900",738,149,29,0,120,0,227,29,1292
"35001002000",716,608,50,24,397,310,757,490,3352
"35001002100",588,201,38,48,158,150,227,163,1573
"35001002200",2029,270,31,0,577,238,1026,342,4513
"35001002300",3723,852,16,117,1866,1370,4938,2175,15057
"35001002401",2547,540,133,32,1589,267,3346,740,9194
"35001002402",2712,1034,99,236,1947,1110,4188,2038,13364
"35001002500",1282,588,0,28,309,393,902,889,4391
"35001002600",583,237,0,0,142,60,324,211,1557
"35001002700",2297,525,23,0,561,341,1358,492,5597
"35001002900",2027,700,12,28,690,423,1618,842,6340
"35001003001",2657,418,96,62,755,810,1787,1111,7696
"35001003002",2839,511,61,0,555,126,1840,394,6326
"35001003100",1986,293,28,14,370,9,947,210,3857
"35001003201",1820,399,58,0,393,67,1276,304,4317
"35001003202",2908,614,11,0,2122,599,3551,1111,10916
"35001003400",1247,1405,199,33,847,540,1092,1576,6939
"35001003501",3664,801,39,0,463,340,2219,783,8309
"35001003502",4190,521,0,0,697,104,1737,253,7502
"35001003600",4337,1086,18,0,928,226,2603,1049,10247
"35001003707",2748,682,30,0,778,108,1190,239,5775
"35001003712",4123,256,316,38,446,80,1354,186,6799
"35001003714",4098,1588,301,82,964,693,2231,1211,11168
"35001003715",3298,69,12,17,519,16,888,35,4854
"35001003717",3257,449,38,0,1189,190,1332,96,6551
"35001003718",1814,131,101,53,424,82,625,29,3259
"35001003719",3928,455,48,164,1140,169,1650,287,7841
"35001003721",5216,161,64,0,805,19,869,0,7134
"35001003722",4847,153,103,10,1231,235,2004,17,8600
"35001003723",3759,716,561,20,621,76,1380,318,7451
"35001003724",2665,89,221,0,397,55,821,8,4256
"35001003725",3293,453,93,10,389,171,1232,312,5953
"35001003726",2055,30,8,0,370,39,454,39,2995
"35001003728",2940,376,99,0,698,115,1255,37,5520
"35001003729",1611,49,0,2,212,2,217,13,2106
"35001003730",3672,144,132,0,726,0,799,69,5542
"35001003731",3292,160,0,0,228,96,666,117,4559
"35001003732",5808,424,42,40,1222,39,1466,217,9258
"35001003733",1190,1110,204,88,601,530,1027,1107,5857
"35001003735",4110,835,111,0,1376,141,2907,508,9988
"35001003736",1175,233,38,14,399,175,810,152,2996
"35001003737",2211,116,0,0,345,59,566,17,3314
"35001003738",3694,614,0,0,685,157,718,304,6172
"35001003803",2669,213,10,0,129,0,555,0,3576
"35001003804",4854,276,37,0,672,0,1195,36,7070
"35001003805",1645,455,0,0,133,25,575,332,3165
"35001003806",2982,284,0,0,196,34,736,19,4251
"35001003807",3290,451,8,0,181,117,983,213,5243
"35001004001",2603,1146,48,79,816,402,2659,1320,9073
"35001004300",2240,1110,17,12,1121,732,2442,1665,9339
"35001004401",1413,543,0,0,606,393,1825,886,5666
"35001004402",2560,917,0,47,824,376,2592,1072,8388
"35001004501",1895,666,29,0,882,484,2280,1071,7307
"35001004502",1046,575,32,36,1495,1046,2194,1477,7901
"35001004602",2789,281,24,0,817,431,2668,603,7613
"35001004603",2157,276,36,16,750,261,2355,469,6320
"35001004604",3129,956,22,47,1106,575,3226,1248,10309
"35001004712",4048,633,84,0,1890,588,4751,985,12979
"35001004713",3950,780,140,12,1608,268,4770,950,12478
"35001004715",2232,586,123,0,1168,1195,2782,1572,9658
"35001004716",1568,97,12,50,279,210,685,196,3097
"35001004717",6050,503,107,49,1581,223,3763,365,12641
"35001004720",2662,248,21,0,382,345,961,339,4958
"35001004722",3161,357,41,50,857,69,1634,49,6218
"35001004723",5570,304,56,0,1023,0,2886,101,9940
"35001004724",2514,133,27,0,367,0,1346,102,4489
"35001004725",3084,118,0,0,620,12,2036,98,5968
"35001004726",1687,126,13,42,400,99,937,135,3439
"35001004727",1553,73,19,6,274,29,907,50,2911
"35001004728",3591,218,164,100,1035,2,2023,25,7158
"35001004729",2638,330,105,13,570,70,1831,196,5753
"35001004733",3434,997,190,26,1862,1314,4684,2151,14658
"35001004734",3811,896,67,0,2090,755,5056,1485,14160
"35001004735",696,353,46,37,724,213,1316,554,3939
"35001004736",419,377,22,0,592,234,804,611,3059
"35001004737",3281,517,183,44,1805,522,4016,1033,11401
"35001004738",2288,446,169,98,1589,649,3003,1071,9313
"35001004739",2398,1630,497,0,1802,717,3708,2112,12864
"35001004740",3100,845,197,99,2149,936,4773,1499,13598
"35001004741",2945,977,67,137,2331,905,4312,1495,13169
"35001004742",4068,753,62,0,1641,509,3156,628,10817
"35001004743",2528,118,100,0,814,20,1698,116,5394
"35001004744",4228,69,181,0,1214,0,3196,62,8950
"35001004745",4825,198,332,0,1152,35,2708,93,9343
"35001004746",5655,531,89,262,2034,213,4079,514,13377
"35001004747",3617,659,66,335,669,11,2076,216,7649
"35001004748",7936,518,251,0,1065,169,3800,257,13996
"35001004749",1913,595,112,10,1134,547,1681,878,6870
"35001004750",4171,300,244,112,1192,339,3250,432,10040
"35001004751",2009,163,8,0,305,93,807,52,3437
"35001004752",2285,304,65,74,707,624,1239,580,5878
"35001004753",2687,143,123,0,830,32,1465,115,5395
"35001940500",2675,118,0,0,229,47,219,40,3328
"35001940600",4302,934,106,36,2172,778,2989,677,11994
"35001940700",129,7,0,0,1843,810,316,96,3201
"35003976400",2889,561,0,23,70,31,464,162,4200
"35005000201",2451,468,35,11,814,114,1823,387,6103
"35005000202",2183,332,184,25,685,141,1581,277,5408
"35005000300",3571,710,15,18,799,543,2182,852,8690
"35005000400",1947,976,37,42,907,222,1860,879,6870
"35005000500",915,443,27,27,260,357,735,672,3436
"35005000600",2490,1263,31,0,663,373,2641,1378,8839
"35005000700",2676,710,284,0,654,221,1902,637,7084
"35005000800",3347,1091,132,50,848,244,2261,1051,9024
"35005000900",2382,169,0,0,292,172,1222,320,4557
"35005001001",3997,387,0,0,804,76,1387,197,6848
"35005001002",2934,990,13,0,264,73,562,705,5541
"35005001101",3384,1777,16,34,666,273,2842,1459,10451
"35005001102",3045,475,0,0,350,61,533,206,4670
"35005001200",1245,91,5,0,111,17,564,58,2091
"35005001300",1783,424,2,2,316,120,1508,451,4606
"35005001400",2071,282,0,0,318,209,1355,392,4627
"35006941500",18,27,0,0,2060,914,57,24,3100
"35006945800",164,36,18,0,1048,789,75,48,2178
"35006946100",55,5,0,0,2478,1287,140,28,3993
"35006974201",1578,516,36,27,1069,1192,1778,830,7026
"35006974202",1767,88,51,0,959,360,1475,156,4856
"35006974400",1531,638,30,0,939,561,1517,790,6006
"35006974700",3336,787,51,0,863,262,1843,261,7403
"35007950500",3079,716,0,32,218,98,1751,528,6422
"35007950600",2289,353,0,0,477,136,1726,267,5248
"35007950700",3379,1052,0,0,596,103,1305,484,6919
"35009000100",1272,910,272,346,1219,910,2114,1484,8527
"35009000201",2522,358,214,31,751,420,1156,594,6046
"35009000202",1502,610,215,69,1025,597,1337,924,6279
"35009000301",3879,355,324,314,874,427,1884,517,8574
"35009000303",2683,395,237,31,435,150,523,329,4783
"35009000304",5189,582,242,0,707,51,682,0,7453
"35009000400",2160,950,102,205,806,531,1756,1035,7545
"35009000500",890,336,103,0,636,217,1018,421,3621
"35009000601",1002,156,2,0,36,31,42,10,1279
"35009000602",3826,125,100,8,474,5,986,20,5544
"35009000603",2517,627,114,56,796,335,1636,736,6817
"35009000900",1376,109,145,0,361,91,291,115,2488
"35011960100",1336,262,0,0,205,192,700,195,2890
"35013000102",2822,831,48,24,344,66,2081,589,6805
"35013000103",2976,1733,38,0,284,75,2066,1477,8649
"35013000104",4039,961,115,0,367,42,1909,715,8148
"35013000201",2949,1578,72,107,263,131,2029,1554,8683
"35013000202",4181,1160,129,17,313,54,2839,1088,9781
"35013000300",2421,1040,42,0,393,68,1580,721,6265
"35013000401",1764,963,0,0,251,133,1666,760,5537
"35013000402",3859,1372,74,32,518,104,3402,1181,10542
"35013000500",1427,681,8,10,210,56,1031,400,3823
"35013000600",1212,971,9,0,283,49,1086,896,4506
"35013000700",3585,1335,39,45,188,175,2611,1174,9152
"35013000800",1811,973,0,176,212,96,1069,554,4891
"35013000900",2928,3054,116,124,375,282,1542,1891,10312
"35013001000",215,683,27,48,170,269,114,455,1981
"35013001102",2384,779,33,0,150,22,1450,598,5416
"35013001103",3550,439,11,9,201,73,2294,428,7005
"35013001104",3164,1802,0,48,207,186,2319,1836,9562
"35013001201",11197,961,704,0,1890,768,5342,1301,22163
"35013001203",3020,1032,116,61,556,143,1379,768,7075
"35013001204",3665,354,36,0,76,0,717,331,5179
"35013001205",2993,501,49,0,532,71,1086,239,5471
"35013001303",5110,1530,93,0,439,97,2455,1406,11130
"35013001304",4770,1463,45,64,819,376,3655,1668,12860
"35013001305",3691,1344,59,26,303,10,2860,787,9080
"35013001306",8229,1222,0,105,762,105,5228,708,16359
"35013001307",4551,1598,88,0,108,191,2912,1489,10937
"35013001400",2670,1865,0,0,85,175,2076,1944,8815
"35013001500",4109,363,0,0,646,24,1770,165,7077
"35013001600",1872,683,0,0,361,52,1844,670,5482
"35013001701",4828,1822,97,0,454,192,3816,1880,13089
"35013001702",1194,418,0,0,104,6,1049,366,3137
"35013001703",2694,764,20,0,153,118,1951,845,6545
"35013001705",1821,1413,0,0,63,72,1840,1485,6694
"35013001706",2337,1095,0,0,145,155,2456,1250,7438
"35013001707",3256,2248,0,0,107,199,3305,2440,11555
"35013001801",3476,1986,0,0,173,68,2748,1935,10386
"35013001802",3960,3004,26,24,119,103,3790,3131,14157
"35013001804",4001,2024,0,0,241,495,3035,2212,12008
"35013001805",1904,1116,0,0,123,217,1982,1333,6675
"35013001806",2704,2846,0,0,442,312,3096,3087,12487
"35013001900",816,89,322,0,76,0,130,0,1433
"35015000100",1081,358,32,0,38,6,485,76,2076
"35015000200",4363,299,158,0,284,39,839,39,6021
"35015000300",4638,721,0,0,287,103,1954,246,7949
"35015000401",3105,286,13,0,256,2,972,225,4859
"35015000402",3251,927,109,0,335,9,2140,594,7365
"35015000500",2112,369,170,0,260,99,1662,411,5083
"35015000600",4174,533,86,30,507,8,2583,347,8268
"35015000700",4926,280,0,0,330,103,1827,267,7733
"35015000800",1747,263,0,0,91,77,1217,244,3639
"35015000900",3504,335,46,0,632,0,1761,202,6480
"35015001000",5270,586,45,25,565,289,3939,551,11270
"35015001100",5831,388,0,0,559,102,2469,243,9592
"35017964100",1908,205,0,0,191,56,370,54,2784
"35017964200",1476,189,0,0,42,75,186,106,2074
"35017964300",4613,1267,0,20,370,23,2455,807,9555
"35017964400",2194,1160,0,0,561,310,1810,1134,7169
"35017964500",1777,566,91,14,197,109,1320,542,4616
"35017964600",1987,671,0,8,392,190,1717,742,5707
"35017964700",4851,798,0,0,274,35,1612,401,7971
"35017964800",1582,235,0,0,84,9,783,88,2781
"35019961600",3139,412,2,20,229,120,2702,459,7083
"35021000100",467,58,0,0,39,1,174,44,783
"35023970000",1468,307,0,0,82,13,358,117,2345
"35023970200",1779,586,0,0,140,148,1471,644,4768
"35025000100",2180,551,54,0,246,102,1734,494,5361
"35025000200",2895,589,10,27,266,82,2247,512,6628
"35025000300",2524,953,210,118,125,89,2259,1010,7288
"35025000400",1790,491,149,311,248,275,1516,543,5323
"35025000502",4713,792,221,350,476,17,2259,541,9369
"35025000503",3082,181,138,19,134,28,1452,28,5062
"35025000504",2825,223,124,17,350,0,754,124,4417
"35025000600",5634,562,86,3,516,67,3288,550,10706
"35025000701",1396,244,8,0,44,0,269,206,2167
"35025000702",1825,159,0,0,43,4,913,135,3079
"35025000703",2327,37,124,29,151,0,856,37,3561
"35025000704",2604,98,0,0,303,2,993,78,4078
"35025000800",2609,559,0,0,150,35,1342,387,5082
"35025000900",2004,153,0,0,109,13,990,132,3401
"35025001003",2988,619,0,0,315,189,2245,527,6883
"35025001004",2693,573,61,0,363,106,2332,496,6624
"35025001005",1983,794,15,72,826,0,1977,739,6406
"35025001100",3725,290,0,0,377,36,1834,94,6356
"35027960200",1010,280,0,0,123,56,341,200,2010
"35027960300",1776,405,42,15,156,29,406,104,2933
"35027960400",5147,1094,0,0,692,240,2116,952,10241
"35027960600",4821,642,53,7,794,189,1023,203,7732
"35027960800",1587,238,0,0,318,76,667,153,3039
"35028000100",2963,231,0,0,397,16,313,120,4040
"35028000200",4153,81,13,0,484,259,783,97,5870
"35028000400",2375,347,24,0,570,2,437,191,3946
"35028000500",5181,156,43,0,547,0,882,30,6839
"35029000100",3308,1028,0,0,263,439,2048,996,8082
"35029000200",2905,1097,32,0,304,71,2255,908,7572
"35029000300",1606,471,45,16,197,54,1140,369,3898
"35029000400",3932,1207,0,0,155,97,1978,1006,8375
"35029000500",2489,1574,63,0,348,146,1585,1257,7462
"35029000600",1403,817,0,128,136,91,1267,806,4648
"35031940300",9,28,0,0,5980,3603,268,42,9930
"35031940500",41,41,4,0,562,1097,9,6,1760
"35031943500",93,5,68,29,2203,1298,29,3,3728
"35031943600",109,2,47,1,2889,2735,34,23,5840
"35031943700",38,8,0,0,2146,1741,21,16,3970
"35031943800",122,4,14,6,3272,2843,86,42,6389
"35031943901",495,74,0,0,2659,1713,199,23,5163
"35031943902",68,14,0,0,1900,1227,199,28,3436
"35031944000",28,5,0,0,1238,900,12,27,2210
"35031945200",1543,516,137,0,1984,1864,1590,525,8159
"35031945300",1068,342,19,0,750,1100,1296,503,5078
"35031945400",1262,257,16,34,1138,164,862,230,3963
"35031945500",2971,457,167,0,2021,150,1289,380,7435
"35031945600",1273,360,3,0,2848,1325,1386,467,7662
"35031945700",89,65,5,17,1110,969,71,30,2356
"35031946000",367,31,0,0,2368,2321,338,56,5481
"35031973100",383,32,0,0,365,115,38,3,936
"35033955200",2321,645,4,2,1243,445,2894,944,8498
"35035000100",667,528,67,37,228,229,486,451,2693
"35035000200",837,268,136,11,258,321,452,401,2684
"35035000303",1202,563,40,0,200,37,456,307,2805
"35035000304",2396,138,243,8,273,78,668,71,3875
"35035000305",1756,481,500,40,984,217,1028,545,5551
"35035000306",2464,80,140,31,347,6,751,26,3845
"35035000401",3543,388,83,27,332,266,946,378,5963
"35035000402",5877,481,169,8,682,292,1099,247,8855
"35035000500",2724,1441,25,260,620,517,1119,1618,8324
"35035000601",2455,376,247,91,389,12,441,51,4062
"35035000602",2144,236,5,0,207,108,372,28,3100
"35035000603",2435,477,0,0,285,0,477,108,3782
"35035000700",3998,562,20,0,697,290,1899,466,7932
"35035000901",1983,259,0,0,134,81,214,39,2710
"35035000902",3140,3192,0,0,961,515,3315,3071,14194
"35035940000",103,22,0,3,1959,1410,194,66,3757
"35037958601",2115,486,154,0,144,185,992,398,4474
"35037958602",1997,545,21,17,172,5,1170,438,4365
"35037958900",2418,242,0,0,158,4,755,61,3638
"35039000100",1365,623,0,0,512,244,1745,530,5019
"35039000200",2091,1180,22,19,354,94,1868,1086,6714
"35039000300",4108,1119,14,0,1138,80,4699,1099,12257
"35039000400",2983,471,2,0,662,435,2716,881,8150
"35039000500",2395,474,44,0,467,80,2151,251,5862
"35039940700",1243,432,47,0,1147,617,2092,964,6542
"35039940800",1742,252,10,6,2274,693,2532,495,8004
"35039941000",157,88,23,5,2152,737,201,33,3396
"35039944100",2980,1075,11,0,2289,689,3850,1180,12074
"35041000100",2558,1110,68,14,574,189,794,592,5899
"35041000200",1184,738,0,128,943,629,1519,1153,6294
"35041000300",2380,582,105,74,509,12,805,104,4571
"35041000401",1804,636,0,0,471,87,668,560,4226
"35041000402",2284,572,18,0,874,147,984,297,5176
"35043010503",1191,386,24,0,1551,202,1965,420,5739
"35043010601",3669,242,1,0,383,163,1179,138,5775
"35043010602",3206,151,41,0,553,46,1061,70,5128
"35043010702",5357,243,53,0,877,0,1933,112,8575
"35043010703",7184,701,339,0,1117,248,3438,370,13397
"35043010705",4083,517,8,70,626,231,1952,302,7789
"35043010712",3563,656,153,0,556,383,1611,637,7559
"35043010713",2900,987,51,38,1093,126,1827,650,7672
"35043010714",3790,536,185,17,386,81,1295,245,6535
"35043010715",2556,357,108,32,385,0,816,193,4447
"35043010716",4608,770,0,59,372,79,1194,370,7452
"35043010717",7188,162,38,0,1754,179,3606,88,13015
"35043010718",3658,410,19,10,904,97,1708,254,7060
"35043010719",2968,304,43,5,429,118,1618,104,5589
"35043010720",6413,367,625,0,1132,84,3112,160,11893
"35043010721",2380,653,296,4,807,199,1392,441,6172
"35043010722",3267,612,184,0,1052,265,1874,659,7913
"35043010723",6923,980,1061,0,1791,189,4803,753,16500
"35043010900",775,300,22,0,563,248,837,269,3014
"35043011000",757,206,28,0,811,163,527,134,2626
"35043011100",4868,182,24,0,1186,376,1190,34,7860
"35043011200",1279,124,0,0,1060,270,405,50,3188
"35043940200",174,3,0,0,2121,1264,188,18,3768
"35043940300",0,0,0,0,0,0,0,0,0
"35043940500",1421,330,31,14,1649,748,2454,863,7510
"35043940600",13,2,4,4,1446,510,4,1,1984
"35043940700",586,50,0,0,2589,1210,483,48,4966
"35043940900",13,6,0,0,962,1336,32,24,2373
"35045000100",1640,589,0,0,1737,332,1266,371,5935
"35045000201",4039,74,27,28,386,146,723,180,5603
"35045000202",3971,237,64,0,761,33,690,74,5830
"35045000204",1515,158,12,0,523,134,508,160,3010
"35045000205",2615,1093,0,0,1793,966,1584,436,8487
"35045000301",2641,150,161,0,1048,284,308,179,4771
"35045000302",2579,161,0,0,387,177,436,89,3829
"35045000401",3193,815,64,3,809,421,692,550,6547
"35045000402",909,358,33,0,1039,496,356,104,3295
"35045000503",857,259,26,9,2016,259,770,278,4474
"35045000504",889,145,0,72,787,93,91,81,2158
"35045000505",1921,17,0,0,3208,753,739,0,6638
"35045000607",1492,429,0,0,1545,30,824,154,4474
"35045000608",3976,492,37,0,1226,49,622,48,6450
"35045000609",1102,130,5,0,74,25,221,74,1631
"35045000610",2664,495,0,0,662,86,756,268,4931
"35045000611",2894,229,9,0,384,96,335,119,4066
"35045000612",1534,334,0,0,300,96,435,108,2807
"35045000613",2855,276,0,0,635,227,1010,81,5084
"35045000702",705,119,0,0,105,0,202,105,1236
"35045000705",1851,542,5,0,800,230,894,333,4655
"35045000706",1952,457,0,0,738,29,1441,244,4861
"35045000707",2281,202,42,0,1396,475,1219,118,5733
"35045000708",2035,881,0,7,2000,201,1249,487,6860
"35045000900",1491,82,5,0,561,59,943,44,3185
"35045942801",33,10,19,3,1772,778,6,0,2621
"35045942802",212,43,0,0,4313,1793,11,74,6446
"35045942803",26,12,13,0,1455,1258,15,0,2779
"35045942900",43,6,0,15,2396,1886,37,28,4411
"35045943000",33,14,13,0,3116,1548,111,47,4882
"35045943100",17,9,0,0,924,633,14,24,1621
"35045943201",833,27,0,0,2278,1723,260,37,5158
"35045943300",1685,442,0,0,448,15,434,79,3103
"35047957200",1795,563,17,62,1077,750,2563,1037,7864
"35047957300",1320,420,10,66,342,442,1098,515,4213
"35047957400",1820,932,0,14,720,491,2191,1136,7304
"35047957500",2078,466,35,0,997,400,2043,644,6663
"35047957600",2229,813,93,0,2107,651,3598,1142,10633
"35047957700",677,136,0,0,810,572,1108,595,3898
"35047957800",1837,486,37,5,1180,824,2585,1237,8191
"35049000101",3392,278,55,0,234,37,634,43,4673
"35049000200",3226,245,25,0,257,70,934,107,4864
"35049000300",1054,121,8,6,119,18,348,70,1744
"35049000400",266,20,4,0,5,0,56,13,364
"35049000500",1706,192,33,0,60,10,339,19,2359
"35049000600",1841,197,0,0,169,55,325,158,2745
"35049000700",1103,229,43,0,228,75,394,109,2181
"35049000800",1885,588,0,0,291,163,816,592,4335
"35049000900",2433,423,0,0,424,31,1566,243,5120
"35049001001",1728,155,0,18,220,104,535,180,2940
"35049001002",2109,1133,19,0,395,132,1534,1061,6383
"35049001102",2427,445,49,2,279,149,924,296,4571
"35049001103",1237,280,15,12,231,81,847,209,2912
"35049001105",1921,162,29,0,335,96,1110,121,3774
"35049001106",1914,742,0,0,293,45,1408,658,5060
"35049001107",3489,510,15,0,547,89,2177,410,7237
"35049001202",2919,1261,91,44,709,616,2473,1669,9782
"35049001203",1868,401,0,0,310,121,1475,393,4568
"35049001204",3478,718,30,0,935,434,3708,1035,10338
"35049001205",3218,1093,8,11,790,133,3559,1181,9993
"35049001301",955,129,3,0,437,4,804,86,2418
"35049001302",1628,607,52,0,413,192,1690,711,5293
"35049001303",4804,1354,102,29,1086,91,4154,1331,12951
"35049001304",420,132,0,0,146,107,469,231,1505
"35049010102",2123,933,0,0,1062,217,2502,1037,7874
"35049010203",919,177,0,0,150,28,283,68,1625
"35049010204",2044,67,0,0,133,0,421,22,2687
"35049010304",2288,333,27,0,453,4,1190,262,4557
"35049010308",1505,457,0,0,393,88,1392,486,4321
"35049010309",1987,144,0,0,185,44,366,46,2772
"35049010310",1078,64,0,0,73,0,233,9,1457
"35049010311",3162,105,16,0,401,65,831,52,4632
"35049010312",3687,439,0,0,237,0,996,140,5499
"35049010314",1461,395,30,0,268,0,854,226,3234
"35049010315",2179,217,13,0,454,13,1211,44,4131
"35049010316",1126,43,8,0,177,11,591,25,1981
"35049010400",2246,164,0,0,253,45,470,51,3229
"35049010500",1434,168,0,0,108,4,385,90,2189
"35049010601",4688,128,0,31,581,19,3321,135,8903
"35049010602",2681,226,9,0,88,155,383,0,3542
"35049010603",1735,158,11,0,337,19,1164,52,3476
"35049010700",5014,334,106,15,311,0,654,62,6496
"35049010800",2347,138,0,0,64,52,973,127,3701
"35049010900",1916,382,12,0,307,0,1221,306,4144
"35049940300",941,101,2,8,775,143,945,125,3040
"35049940400",685,167,0,0,287,116,319,194,1768
"35049940500",904,127,7,0,474,166,891,152,2721
"35049940600",2274,420,14,5,826,125,2143,429,6236
"35049940900",1370,530,14,7,731,290,1774,728,5444
"35049980000",79,0,0,0,15,0,77,0,171
"35051962200",2138,715,0,0,162,102,598,280,3995
"35051962300",2194,816,39,14,172,107,751,189,4282
"35051962401",1874,125,0,0,138,15,202,112,2466
"35051962402",2185,323,0,0,86,143,843,332,3912
"35053940000",28,0,0,0,414,401,21,0,864
"35053978100",3346,901,33,8,667,76,1854,522,7407
"35053978200",992,86,0,0,161,29,371,24,1663
"35053978301",2144,451,0,0,116,257,1401,601,4970
"35053978302",1546,812,0,2,212,236,684,578,4070
"35053978303",2563,902,13,51,505,66,1953,418,6471
"35055940000",805,246,0,0,567,212,1152,358,3340
"35055940100",4579,997,22,3,2416,714,3354,977,13062
"35055952100",3055,784,0,0,529,806,1580,1023,7777
"35055952300",1429,265,0,20,575,295,1051,401,4036
"35055952600",5199,1271,94,0,1272,687,4223,1191,13937
"35055952700",3551,952,27,0,700,657,2009,1093,8989
"35057963201",2235,1222,93,54,203,235,449,491,4982
"35057963202",2506,458,0,0,208,165,1122,291,4750
"35057963600",3101,1783,13,0,64,96,1067,925,7049
"35057963700",1577,633,12,0,113,187,828,615,3965
"35059950200",2754,381,3,58,450,59,1140,230,5075
"35061940300",10,7,0,0,745,264,29,3,1058
"35061970101",1893,1148,0,0,904,868,1971,1719,8503
"35061970102",4154,1074,110,0,885,416,2786,841,10266
"35061970200",2811,259,0,0,594,200,1328,308,5500
"35061970301",2631,1950,0,0,2101,711,3630,2182,13205
"35061970302",1614,339,64,0,840,165,1471,441,4934
"35061970303",4566,831,0,0,861,318,3128,884,10588
"35061970401",2788,939,64,0,588,144,1937,723,7183
"35061970404",3674,696,112,70,423,94,2457,574,8100
"35061970405",2026,271,42,24,778,14,1290,108,4553
"35061970700",2968,675,0,0,742,612,2066,845,7908
"35061970800",2680,1281,12,31,469,275,1987,1117,7852
"35061970901",2623,1195,10,0,661,315,1944,1301,8049
"35061970902",1247,288,28,0,497,125,1114,307,3606
"35061971000",3714,311,0,0,527,347,1866,360,7125
"35061971100",955,147,27,0,209,97,512,190,2137
"35061971300",1064,518,27,0,269,159,469,323,2829
"35061971400",2250,217,0,47,484,162,1608,269,5037
"36001000100",385,118,790,439,62,207,206,280,2487
"36001000200",401,153,2381,1351,48,164,390,144,5032
"36001000300",1918,472,968,966,414,317,209,132,5396
"36001000401",1619,71,68,13,70,42,107,0,1990
"36001000403",2899,348,589,152,415,251,263,128,5045
"36001000404",4,0,4,0,0,0,0,0,8
"36001000501",1603,472,669,295,406,222,600,160,4427
"36001000502",995,246,183,21,175,158,32,17,1827
"36001000600",540,832,1136,507,367,458,433,362,4635
"36001000700",416,143,1855,1264,177,52,419,171,4497
"36001000800",347,153,597,665,93,315,204,117,2491
"36001001100",319,287,281,177,96,58,43,26,1287
"36001001400",2129,357,332,26,176,310,182,95,3607
"36001001500",2065,1200,513,183,428,212,237,149,4987
"36001001600",1968,963,362,30,488,106,193,57,4167
"36001001700",2826,391,650,104,601,177,156,228,5133
"36001001801",5132,430,619,35,601,0,133,0,6950
"36001001802",2821,302,348,52,409,48,51,16,4047
"36001001901",1867,202,91,31,251,67,78,67,2654
"36001001902",2210,201,209,12,88,0,7,0,2727
"36001002000",2713,739,1372,443,836,867,669,282,7921
"36001002100",684,157,466,209,225,314,130,50,2235
"36001002200",1434,192,222,173,336,67,174,91,2689
"36001002300",500,117,625,362,60,324,48,244,2280
"36001002500",129,174,1244,966,159,118,154,75,3019
"36001002600",761,516,2599,542,447,763,279,225,6132
"36001012700",1850,204,144,0,102,0,65,0,2365
"36001012800",2315,680,65,35,226,457,136,414,4328
"36001012900",2170,549,43,95,287,114,124,67,3449
"36001013000",5455,536,173,27,54,19,120,4,6388
"36001013100",2232,158,27,0,69,122,208,19,2835
"36001013200",2338,615,51,6,137,165,96,34,3442
"36001013300",3523,292,718,73,167,67,182,28,5050
"36001013400",1619,185,83,0,69,79,111,0,2146
"36001013503",3369,285,107,62,663,94,102,38,4720
"36001013505",2223,232,12,0,105,53,100,5,2730
"36001013506",4593,326,484,67,745,356,624,98,7293
"36001013507",1649,251,144,0,298,90,38,0,2470
"36001013508",5566,288,120,79,659,1,279,11,7003
"36001013601",5649,491,436,0,1189,120,537,0,8422
"36001013602",2709,196,548,28,705,67,247,14,4514
"36001013703",1271,145,4,4,193,0,25,0,1642
"36001013705",5723,259,142,0,126,0,48,0,6298
"36001013706",1854,68,0,0,231,12,70,0,2235
"36001013707",4775,198,409,0,579,24,306,0,6291
"36001013801",6021,402,810,7,361,0,253,31,7885
"36001013802",4036,121,18,0,284,0,0,13,4472
"36001013901",2117,71,42,0,190,105,52,114,2691
"36001013902",4446,183,131,0,597,1,166,0,5524
"36001014001",2662,219,432,8,539,133,53,13,4059
"36001014002",3410,385,181,0,295,69,229,71,4640
"36001014100",4417,80,58,15,451,0,123,11,5155
"36001014201",4783,331,116,37,547,89,156,71,6130
"36001014202",5287,109,70,2,340,42,48,27,5925
"36001014203",5740,102,198,22,267,2,58,2,6391
"36001014301",2286,379,32,106,39,0,26,0,2868
"36001014302",7511,145,168,0,445,0,53,0,8322
"36001014401",3721,340,48,3,43,0,74,0,4229
"36001014402",2509,376,281,12,66,0,81,19,3344
"36001014501",2219,181,0,0,21,5,0,37,2463
"36001014502",3182,215,0,0,72,20,74,0,3563
"36001014503",2533,79,0,15,189,0,172,9,2997
"36001014606",3289,124,72,0,132,21,52,2,3692
"36001014607",7045,178,59,0,566,0,194,41,8083
"36001014608",2133,132,113,52,93,58,7,0,2588
"36001014609",3685,246,286,103,417,70,165,24,4996
"36001014611",1719,59,39,1,198,1,17,1,2035
"36001014612",1473,93,11,0,14,13,43,10,1657
"36001014613",2883,154,90,0,80,11,90,0,3308
"36001014614",4196,186,133,136,684,57,86,0,5478
"36001014615",1636,138,130,69,713,57,140,1,2884
"36001014700",2556,159,13,0,26,11,0,27,2792
"36001014801",2475,245,22,0,64,11,14,0,2831
"36001014802",1457,268,5,0,33,5,11,0,1779
"36001014803",3174,134,21,1,60,0,43,0,3433
"36003940200",0,0,0,0,20,0,0,0,20
"36003950100",2157,296,0,0,81,11,47,3,2595
"36003950300",2972,656,18,0,36,11,15,0,3708
"36003950400",3238,443,10,0,55,4,12,50,3812
"36003950500",2982,473,0,2,69,8,26,31,3591
"36003950600",2642,881,7,2,53,37,4,4,3630
"36003950700",2883,720,0,25,69,4,10,26,3737
"36003950800",2144,628,3,5,184,27,10,12,3013
"36003950900",3110,480,0,15,74,0,34,7,3720
"36003951000",2555,668,4,19,14,4,9,20,3293
"36003951100",3087,566,19,0,49,10,50,28,3809
"36003951200",3842,648,11,3,86,6,32,1,4629
"36003951300",3267,626,0,0,78,7,8,0,3986
"36005000100",0,0,0,0,0,0,0,0,0
"36005000200",1828,475,1007,120,1470,483,3116,959,9458
"36005000400",1730,336,1892,220,1500,222,3197,497,9594
"36005001600",1680,556,1359,702,1107,223,2900,863,9390
"36005001900",304,184,523,310,757,439,850,568,3935
"36005002000",940,1673,1995,1502,1045,1346,2238,2962,13701
"36005002300",381,457,1082,899,710,1216,1227,1719,7691
"36005002400",78,0,72,0,0,0,0,0,150
"36005002500",778,415,605,559,1253,1712,1983,2098,9403
"36005002701",281,241,593,539,556,806,862,1189,5067
"36005002702",390,384,729,781,1074,1277,1516,1774,7925
"36005002800",172,0,3713,332,960,117,1081,134,6509
"36005003100",227,17,397,43,577,205,849,211,2526
"36005003300",333,260,516,1055,845,869,1425,1128,6431
"36005003500",307,87,617,542,1574,795,1933,942,6797
"36005003700",59,34,32,12,48,61,81,61,388
"36005003800",225,152,387,158,208,63,411,223,1827
"36005003900",773,437,962,331,2864,1219,3662,1745,11993
"36005004001",267,120,153,15,763,101,601,127,2147
"36005004100",478,571,967,1096,1535,1734,2277,2549,11207
"36005004200",977,935,2091,1702,1169,246,2002,1306,10428
"36005004300",478,320,949,844,1805,1661,2293,2194,10544
"36005004400",338,261,1443,456,1182,861,1701,1081,7323
"36005004600",372,200,620,143,401,133,814,302,2985
"36005004800",333,106,808,303,1531,918,1945,921,6865
"36005005001",349,238,1477,420,1314,991,1527,1285,7601
"36005005002",283,543,574,553,2195,1460,2112,1999,9719
"36005005100",290,357,1126,1010,1442,1425,1973,1964,9587
"36005005200",228,243,242,386,684,494,841,746,3864
"36005005300",118,195,914,1073,646,755,665,952,5318
"36005005400",594,512,1182,440,1818,1619,2267,2140,10572
"36005005600",273,93,392,318,864,528,1049,590,4107
"36005005902",250,72,765,227,1265,539,1443,749,5310
"36005006000",158,2,82,195,571,244,631,241,2124
"36005006100",157,32,2669,273,517,58,500,122,4328
"36005006200",581,291,2077,1085,2310,1265,3403,1889,12901
"36005006300",775,373,940,220,1480,633,2039,1013,7473
"36005006400",557,451,838,448,719,577,1039,929,5558
"36005006500",539,256,882,957,1627,1199,1913,1400,8773
"36005006700",793,129,1390,828,1648,2458,2325,2597,12168
"36005006800",320,62,920,170,1308,508,1525,418,5231
"36005006900",647,303,2319,1120,1800,2329,2431,2579,13528
"36005007000",655,377,937,234,1559,749,1998,919,7428
"36005007100",163,62,741,320,852,329,1096,394,3957
"36005007200",716,281,573,551,2556,1097,1884,1000,8658
"36005007300",190,91,787,582,870,1228,1081,1286,6115
"36005007400",887,208,906,92,1142,400,2054,591,6280
"36005007500",334,194,1537,984,1917,580,2369,890,8805
"36005007600",716,540,947,392,1962,988,2317,1233,9095
"36005007700",202,73,250,263,751,394,913,455,3301
"36005007800",818,616,1020,319,2658,1087,2905,1409,10832
"36005007900",528,422,814,824,2184,1601,2798,2157,11328
"36005008300",269,321,861,745,2857,1812,3009,2436,12310
"36005008400",568,44,788,134,621,134,1249,143,3681
"36005008500",252,322,884,390,2335,1538,2655,1838,10214
"36005008600",888,366,543,548,930,599,1678,1003,6555
"36005008700",673,208,1096,401,2305,1172,3084,1443,10382
"36005008900",290,168,748,256,1282,694,1797,949,6184
"36005009000",835,499,662,499,705,276,1497,813,5786
"36005009200",744,170,680,137,2928,869,2535,794,8857
"36005009300",557,571,1030,371,1818,1393,2401,1987,10128
"36005009600",302,158,483,24,1207,185,1097,252,3708
"36005009800",1350,482,1311,208,1186,479,2550,975,8541
"36005011000",0,0,0,0,121,32,121,32,306
"36005011502",560,405,842,732,917,966,1692,1315,7429
"36005011700",299,71,344,180,424,285,745,410,2758
"36005011800",2962,328,18,11,587,117,815,127,4965
"36005011900",352,340,1241,612,1807,1251,2244,1612,9459
"36005012101",215,223,587,242,934,852,1191,1030,5274
"36005012102",82,190,257,170,586,550,714,789,3338
"36005012300",117,185,1123,323,1154,1458,1383,1521,7264
"36005012500",351,162,824,195,1263,1475,1536,1494,7300
"36005012701",224,135,222,260,561,590,803,757,3552
"36005012901",340,177,960,733,742,1043,1126,1194,6315
"36005013000",953,0,78,28,255,50,507,55,1926
"36005013100",310,89,960,400,1750,1174,2162,1180,8025
"36005013200",3649,157,895,70,2350,288,3352,359,11120
"36005013300",377,173,1959,464,3044,1208,3605,1447,12277
"36005013500",207,152,890,472,1230,941,1231,1184,6307
"36005013800",2130,136,145,1,540,27,634,1,3614
"36005014100",685,176,1723,364,1511,852,2231,1020,8562
"36005014300",81,55,162,246,214,199,264,172,1393
"36005014400",816,349,1138,1634,1271,809,1921,1597,9535
"36005014500",148,219,1403,1353,1900,1940,2006,2250,11219
"36005014701",479,295,1188,2289,1013,1614,1515,2143,10536
"36005014702",224,218,931,1301,1049,1502,1408,1708,8341
"36005014900",127,178,855,768,1154,1066,1300,1188,6636
"36005015100",216,355,1884,495,1805,685,2048,1051,8539
"36005015200",931,180,311,19,1169,193,1499,202,4504
"36005015300",196,125,1140,1187,863,955,1256,1092,6814
"36005015500",209,59,390,235,921,1331,1125,1420,5690
"36005015700",311,50,1133,225,1515,802,1821,859,6716
"36005015800",673,40,39,37,352,61,582,14,1798
"36005015900",180,149,66,96,450,479,649,646,2715
"36005016000",3252,78,32,0,841,64,938,41,5246
"36005016100",206,364,929,374,867,1400,1212,1751,7103
"36005016200",1016,141,67,45,409,66,666,55,2465
"36005016300",0,0,0,0,0,0,0,0,0
"36005016400",650,34,29,48,109,7,232,16,1125
"36005016500",39,43,470,204,257,146,312,211,1682
"36005016600",994,103,171,10,857,117,1031,135,3418
"36005016700",133,66,879,606,524,525,676,558,3967
"36005016900",61,46,430,283,243,149,306,188,1706
"36005017100",0,0,0,0,0,0,0,0,0
"36005017300",718,77,1270,543,1990,1683,2639,1210,10130
"36005017500",288,97,1861,1482,1601,1596,2184,1855,10964
"36005017701",105,47,1424,121,891,1953,971,1999,7511
"36005017702",180,208,1212,493,1717,1563,1663,1877,8913
"36005017901",369,54,1064,622,1149,1381,1924,1297,7860
"36005017902",173,126,774,724,1142,619,1340,692,5590
"36005018101",133,40,967,541,808,423,1001,497,4410
"36005018102",324,168,1528,463,1706,1181,1739,1231,8340
"36005018301",249,237,1762,210,1188,556,1677,698,6577
"36005018302",246,374,581,675,1765,437,2000,749,6827
"36005018400",2073,355,159,20,911,158,1120,294,5090
"36005018500",205,213,1893,1230,1764,1564,1948,1731,10548
"36005018900",706,584,1238,1004,2613,2009,3319,2815,14288
"36005019300",81,640,1447,1314,1277,958,1509,1664,8890
"36005019400",592,293,258,98,855,135,729,385,3345
"36005019500",367,562,1553,660,2981,1347,3483,1973,12926
"36005019700",466,427,1411,716,2621,1353,2865,1542,11401
"36005019900",713,331,1908,567,2313,2142,2915,2462,13351
"36005020000",503,242,245,59,2668,988,2029,584,7318
"36005020100",267,193,856,525,1306,1114,1641,1299,7201
"36005020200",380,138,323,62,942,374,949,317,3485
"36005020400",565,84,576,20,1410,460,1755,378,5248
"36005020501",259,289,1888,729,2383,1482,2929,1977,11936
"36005020502",42,254,420,288,749,370,775,585,3483
"36005020601",326,132,324,93,1635,214,974,120,3818
"36005020900",222,262,875,581,1698,713,1909,880,7140
"36005021001",733,123,4594,601,2578,618,2876,692,12815
"36005021002",619,103,2958,519,1651,566,1628,175,8219
"36005021100",455,140,1154,1176,1235,1280,1682,1496,8618
"36005021200",482,28,1676,337,2381,353,1721,90,7068
"36005021301",49,71,230,53,339,452,424,518,2136
"36005021302",277,323,2216,1097,1458,690,1783,1250,9094
"36005021501",293,227,840,352,1697,1161,2005,1420,7995
"36005021502",248,234,795,616,2217,1771,2418,1992,10291
"36005021601",505,516,603,424,1240,826,1584,1068,6766
"36005021602",858,240,2225,320,1895,705,1634,806,8683
"36005021700",172,248,1271,1022,986,1270,1209,1502,7680
"36005021800",1125,49,1714,399,2485,1059,3332,1066,11229
"36005021900",154,55,84,82,667,235,851,313,2441
"36005022000",246,46,99,161,567,817,737,824,3497
"36005022101",281,91,402,334,1578,1198,1704,1311,6899
"36005022102",306,363,487,678,1709,1435,1863,1974,8815
"36005022200",597,93,479,203,1353,683,1645,381,5434
"36005022300",638,252,1046,497,1272,1342,1827,1540,8414
"36005022401",383,187,495,69,1207,311,1345,408,4405
"36005022403",855,155,462,25,1284,696,1541,815,5833
"36005022404",1234,407,792,111,1299,344,1581,377,6145
"36005022500",418,340,1430,1194,2959,1180,3313,1512,12346
"36005022701",476,196,1593,632,1981,913,2576,1151,9518
"36005022702",136,64,511,117,321,336,442,331,2258
"36005022703",243,23,257,275,864,209,662,224,2757
"36005022800",1283,348,1481,22,2335,722,1961,869,9021
"36005022901",791,248,910,497,1838,1284,2610,1546,9724
"36005022902",238,182,602,326,1364,659,1493,935,5799
"36005023000",871,384,264,56,1414,345,1609,316,5259
"36005023100",148,91,343,186,359,360,503,447,2437
"36005023200",708,205,63,19,1286,403,1297,429,4410
"36005023301",171,156,975,293,1601,1135,1937,1282,7550
"36005023302",90,335,409,457,1292,1009,1335,1438,6365
"36005023501",123,241,348,130,1026,1176,1170,1418,5632
"36005023502",484,206,604,389,1561,1307,1953,1603,8107
"36005023600",508,347,139,86,880,291,919,298,3468
"36005023702",20,43,221,104,548,280,593,306,2115
"36005023703",420,253,691,423,1694,1503,1942,1719,8645
"36005023704",135,110,541,409,995,1525,1140,1661,6516
"36005023800",592,90,372,125,869,519,1008,543,4118
"36005023900",387,298,829,1002,3281,2408,3500,2930,14635
"36005024000",561,107,607,437,1688,563,2078,603,6644
"36005024100",406,100,1185,670,2204,1618,2680,1672,10535
"36005024300",363,132,1006,587,1724,1844,2188,1752,9596
"36005024400",1066,54,130,54,1103,144,1243,135,3929
"36005024501",242,320,1044,563,1529,1453,1878,1915,8944
"36005024502",246,254,380,816,1009,892,1297,1254,6148
"36005024600",1019,67,153,6,919,55,768,62,3049
"36005024700",118,56,923,203,347,317,479,381,2824
"36005024800",1542,157,178,0,746,106,745,114,3588
"36005024900",0,0,0,0,0,0,0,0,0
"36005025000",1609,162,0,32,737,120,598,189,3447
"36005025100",492,415,1138,509,2661,1349,2833,1681,11078
"36005025200",1128,215,107,36,781,377,632,300,3576
"36005025300",419,112,994,251,2989,1063,3123,1148,10099
"36005025400",1253,210,79,10,495,117,440,111,2715
"36005025500",477,128,662,646,1751,2148,2201,2340,10353
"36005025600",423,191,200,137,643,161,705,222,2682
"36005025700",74,115,348,64,822,305,924,394,3046
"36005026100",222,0,966,40,558,111,677,111,2685
"36005026300",590,182,796,105,2577,1788,3023,1962,11023
"36005026400",2174,187,243,144,2594,500,2493,539,8874
"36005026500",558,505,516,195,3580,1518,3386,1860,12118
"36005026601",1510,211,85,10,984,235,1153,281,4469
"36005026602",2526,661,250,149,1865,318,2541,590,8900
"36005026701",443,89,67,112,2072,876,1725,735,6119
"36005026702",605,217,1113,225,3225,1439,3608,1624,12056
"36005026900",237,336,464,150,1818,857,1833,936,6631
"36005027300",867,169,1618,397,3459,1351,4279,1458,13598
"36005027401",4010,204,0,0,362,0,403,15,4994
"36005027402",2910,334,116,0,311,11,643,33,4358
"36005027600",23,0,32,0,0,8,0,8,71
"36005027700",526,242,869,489,2521,1245,2769,1331,9992
"36005027900",1993,254,808,217,2765,262,3336,495,10130
"36005028100",1522,97,907,101,982,81,1229,69,4988
"36005028300",529,64,492,434,1249,595,1768,664,5795
"36005028400",12,25,21,9,129,16,126,25,363
"36005028500",1744,376,137,0,800,176,1009,248,4490
"36005028600",767,161,11,0,219,114,285,141,1698
"36005028700",1027,390,283,70,1165,346,1461,265,5007
"36005028800",2439,24,80,128,836,20,460,4,3991
"36005028900",1520,105,91,125,1970,322,2324,164,6621
"36005029301",1366,117,31,0,212,70,222,14,2032
"36005029302",4275,58,231,16,877,0,1125,0,6582
"36005029500",2836,153,587,23,1025,101,837,96,5658
"36005029600",455,55,237,37,523,113,263,90,1773
"36005029700",2507,94,185,8,781,9,828,0,4412
"36005030000",2384,359,252,33,2521,252,2772,353,8926
"36005030100",503,91,26,1,284,22,320,29,1276
"36005030200",960,128,5904,392,1981,242,2084,261,11952
"36005030701",3868,251,270,0,701,158,634,158,6040
"36005030900",2602,42,181,7,270,49,344,22,3517
"36005031000",2155,34,412,140,955,261,889,24,4870
"36005031200",968,69,240,1,726,11,330,28,2373
"36005031400",1219,58,198,0,528,60,483,25,2571
"36005031600",744,15,369,109,548,171,496,40,2492
"36005031800",1048,118,260,5,495,139,489,165,2719
"36005031900",11,56,0,2,0,1,0,2,72
"36005032300",3481,118,451,14,501,30,811,70,5476
"36005032400",463,298,425,130,1042,529,1279,696,4862
"36005032600",1652,32,576,20,932,166,708,164,4250
"36005032800",922,322,701,373,1285,656,1441,942,6642
"36005033000",1895,171,789,319,1539,984,2283,1074,9054
"36005033201",1060,201,628,162,1516,558,1940,678,6743
"36005033202",679,182,1035,358,1155,320,1438,507,5674
"36005033400",342,61,300,124,510,88,737,136,2298
"36005033500",1154,73,69,12,349,25,230,39,1951
"36005033600",882,381,2186,1083,1458,623,2158,991,9762
"36005033700",1688,76,146,3,311,53,308,14,2599
"36005033800",298,275,1552,347,962,786,995,847,6062
"36005034000",400,345,1431,336,1307,754,1486,744,6803
"36005034200",429,19,856,170,465,181,670,136,2926
"36005034300",793,21,129,22,435,139,492,126,2157
"36005034400",406,13,897,90,681,237,485,234,3043
"36005034500",1661,339,217,22,1028,162,702,143,4274
"36005034800",734,88,3419,726,1542,773,1942,895,10119
"36005035000",99,7,1072,160,336,107,424,50,2255
"36005035100",1127,271,174,6,610,118,727,254,3287
"36005035600",170,25,1447,58,596,49,513,74,2932
"36005035800",414,7,5374,348,1281,102,1397,135,9058
"36005035900",109,62,363,210,617,599,716,664,3340
"36005036000",499,32,1211,153,918,40,961,114,3928
"36005036100",495,121,984,685,1898,1908,2427,2259,10777
"36005036300",681,449,599,969,2810,2463,3518,2849,14338
"36005036400",7,0,1992,128,258,4,175,4,2568
"36005036501",169,205,1253,969,677,604,894,768,5539
"36005036502",94,130,317,95,637,679,637,791,3380
"36005036700",193,148,412,271,640,817,927,970,4378
"36005036800",153,13,1497,291,49,101,221,109,2434
"36005036901",37,97,229,328,795,785,826,910,4007
"36005036902",103,75,528,461,590,476,789,560,3582
"36005037000",125,59,1505,147,520,107,604,112,3179
"36005037100",383,323,1325,490,793,594,1308,873,6089
"36005037200",102,12,1064,200,493,178,350,182,2581
"36005037300",516,257,1369,527,1527,1250,1993,1455,8894
"36005037400",211,447,1750,326,288,691,484,1083,5280
"36005037504",332,324,523,667,814,796,930,1137,5523
"36005037600",244,0,980,83,947,186,877,175,3492
"36005037800",309,109,1733,220,379,482,651,522,4405
"36005037900",378,194,1613,932,955,1107,1394,1269,7842
"36005038000",150,93,2425,1300,294,423,448,509,5642
"36005038100",539,326,1466,469,2235,1422,2842,1894,11193
"36005038200",48,160,1708,279,308,150,321,273,3247
"36005038301",217,155,937,198,1411,1348,1667,1480,7413
"36005038302",84,167,1476,1372,1424,1365,1680,1618,9186
"36005038500",161,235,610,935,1540,1540,1664,1777,8462
"36005038600",194,62,5359,678,924,257,724,342,8540
"36005038700",510,591,502,242,664,759,820,1070,5158
"36005038800",11,7,1533,436,421,63,458,82,3011
"36005038900",850,749,354,322,1800,1701,2042,1654,9472
"36005039000",121,9,1609,920,268,264,339,273,3803
"36005039100",1357,684,424,303,2207,1833,2698,2283,11789
"36005039200",107,79,922,388,225,29,287,70,2107
"36005039300",562,307,1237,961,2962,2373,3328,2619,14349
"36005039400",245,205,2289,947,682,339,840,584,6131
"36005039500",211,91,1054,485,1276,773,1750,877,6517
"36005039600",91,39,2721,779,283,371,312,399,4995
"36005039700",158,270,156,77,387,384,494,309,2235
"36005039800",147,0,2048,414,160,0,150,0,2919
"36005039901",230,174,502,452,1986,1824,1833,1872,8873
"36005039902",599,165,566,731,1750,1237,1930,1417,8395
"36005040100",366,352,550,210,2008,1582,2189,1930,9187
"36005040302",447,118,519,194,1681,1132,2018,1134,7243
"36005040303",542,300,696,298,1806,1031,2093,1246,8012
"36005040304",316,166,237,97,2221,1192,2233,1328,7790
"36005040400",95,0,2023,342,310,48,308,48,3174
"36005040501",321,139,968,98,1940,931,1964,944,7305
"36005040502",154,441,1437,264,2137,1499,2193,1945,10070
"36005040600",45,250,2149,564,466,154,355,389,4372
"36005040701",297,176,551,173,1167,810,1398,884,5456
"36005040702",1713,428,987,365,2676,1594,2931,1764,12458
"36005040800",466,93,2019,694,873,395,1110,405,6055
"36005040900",490,112,1761,335,277,73,402,123,3573
"36005041100",565,114,650,97,1069,412,1337,508,4752
"36005041300",1386,234,617,99,3819,1299,3829,1301,12584
"36005041400",584,42,2431,419,1054,138,910,202,5780
"36005041500",843,143,965,76,2789,1031,2898,1078,9823
"36005041800",136,299,1754,738,830,458,569,979,5763
"36005041900",1982,318,1021,131,2498,981,2671,970,10572
"36005042000",254,66,1510,411,761,375,755,464,4596
"36005042100",1245,272,699,223,2003,1201,2181,1430,9254
"36005042200",252,16,2779,224,115,177,356,133,4052
"36005042300",788,285,515,258,1543,1096,1590,1169,7244
"36005042400",162,16,1862,232,70,102,188,100,2732
"36005042500",707,259,798,41,2475,1854,2429,1752,10315
"36005042600",317,0,4836,914,413,196,320,196,7192
"36005042800",228,4,1458,152,150,33,274,33,2332
"36005042901",889,210,592,92,1321,951,1437,622,6114
"36005042902",557,179,723,436,1641,945,1854,1196,7531
"36005043000",163,13,2379,159,538,69,488,51,3860
"36005043100",859,408,1394,882,4658,1684,3916,1830,15631
"36005043400",351,172,2089,310,816,81,743,156,4718
"36005043500",0,0,52,0,0,0,0,0,52
"36005043600",78,68,1382,204,466,46,274,46,2564
"36005044200",445,63,2334,730,198,278,495,343,4886
"36005044400",115,66,2473,388,369,150,387,165,4113
"36005044800",102,0,1726,125,228,0,198,19,2398
"36005044901",1060,187,48,19,127,17,162,51,1671
"36005044902",1698,139,0,8,161,25,192,41,2264
"36005045101",1334,47,21,0,129,0,133,8,1672
"36005045102",1528,80,65,5,213,2,252,4,2149
"36005045600",939,18,1312,158,782,66,1013,0,4288
"36005045800",250,298,1403,1000,718,1574,1412,1804,8459
"36005046000",74,6,1579,369,163,384,254,470,3299
"36005046201",4270,660,16329,570,5391,684,8169,824,36897
"36005046202",375,93,5257,1000,1252,604,1679,621,10881
"36005048400",337,54,3184,228,524,0,735,9,5071
"36005050400",4,0,30,0,29,0,49,0,112
"36005051600",3243,165,63,7,956,4,1143,4,5585
"36007000100",1374,318,283,249,204,465,88,32,3013
"36007000200",1546,707,171,233,188,151,0,109,3105
"36007000300",1373,459,198,130,159,128,172,107,2726
"36007000400",1213,425,200,149,48,86,23,34,2178
"36007000500",771,676,79,100,119,57,82,94,1978
"36007000600",1245,422,322,99,53,105,153,121,2520
"36007000700",2149,367,140,212,171,135,28,162,3364
"36007000900",886,396,203,51,79,42,121,53,1831
"36007001100",422,477,63,587,122,75,140,185,2071
"36007001200",397,282,38,61,25,56,32,12,903
"36007001300",602,822,301,417,44,221,91,273,2771
"36007001400",2419,1648,132,338,344,269,145,176,5471
"36007001500",3787,348,420,0,152,231,97,39,5074
"36007001600",1831,122,41,35,70,176,57,9,2341
"36007001700",2374,1128,203,113,88,190,0,183,4279
"36007001800",2142,836,309,391,148,252,182,89,4349
"36007010200",4509,670,0,0,87,41,0,4,5311
"36007011901",2502,302,11,0,47,17,35,26,2940
"36007011902",2355,287,0,0,57,0,38,19,2756
"36007011903",2300,307,0,0,13,38,23,0,2681
"36007012000",1256,155,11,6,11,4,8,0,1451
"36007012101",3155,408,30,0,9,120,0,26,3748
"36007012102",3723,244,18,12,23,31,27,12,4090
"36007012103",2926,247,43,13,100,1,66,41,3437
"36007012201",2103,239,14,0,71,0,0,0,2427
"36007012202",3072,743,0,0,192,7,0,0,4014
"36007012300",4099,1003,37,26,3,0,0,18,5186
"36007012400",2088,331,10,0,62,33,44,0,2568
"36007012500",5583,455,70,0,82,0,29,13,6232
"36007012600",4877,717,0,12,136,21,216,16,5995
"36007012701",4620,654,44,0,15,7,40,0,5380
"36007012702",4356,222,48,11,180,53,47,0,4917
"36007012800",3768,655,49,80,58,76,80,33,4799
"36007012900",1353,123,0,0,10,0,0,0,1486
"36007013000",3652,174,17,1,345,0,107,0,4296
"36007013100",2085,403,58,0,110,0,225,0,2881
"36007013201",1805,95,21,155,42,0,55,0,2173
"36007013202",2633,245,28,0,223,0,122,0,3251
"36007013301",4035,397,144,37,314,113,29,2,5071
"36007013303",2438,137,0,0,59,0,0,0,2634
"36007013304",5169,306,54,28,316,14,0,0,5887
"36007013400",3003,570,78,8,235,216,118,167,4395
"36007013500",1104,435,68,186,146,99,92,66,2196
"36007013600",2317,793,152,169,114,0,47,31,3623
"36007013700",2414,418,48,23,158,46,172,84,3363
"36007013800",2510,307,136,3,143,34,81,51,3265
"36007013900",1121,574,310,108,186,197,30,29,2555
"36007014000",1448,552,104,131,556,344,42,217,3394
"36007014100",2398,244,91,67,171,30,29,2,3032
"36007014200",2151,81,66,33,384,21,136,0,2872
"36007014301",3451,339,21,0,816,190,128,12,4957
"36007014302",1658,388,20,17,290,496,55,71,2995
"36007014400",3974,237,273,90,192,15,205,0,4986
"36007014500",3109,191,316,0,40,0,56,0,3712
"36007014600",5130,250,0,0,208,0,156,0,5744
"36009940000",9,0,0,0,147,188,0,0,344
"36009940200",0,0,0,0,0,0,0,0,0
"36009940300",2850,1012,93,114,1423,636,247,145,6520
"36009960100",2844,514,36,0,1,33,78,4,3510
"36009960200",3562,479,0,0,43,25,27,0,4136
"36009960300",4015,411,4,3,158,0,33,0,4624
"36009960400",3206,683,6,0,161,50,28,46,4180
"36009960500",4057,1241,8,7,62,21,72,24,5492
"36009960600",2657,557,16,0,85,60,56,14,3445
"36009960702",2327,263,14,0,90,10,20,4,2728
"36009960800",3658,616,20,19,76,63,88,13,4553
"36009961000",3641,477,70,0,57,26,1,5,4277
"36009961100",3189,623,90,0,141,71,5,8,4127
"36009961200",3143,408,5,0,91,7,63,3,3720
"36009961300",3259,586,0,37,12,17,16,21,3948
"36009961400",3793,875,0,0,115,50,91,17,4941
"36009961500",1543,329,50,0,27,0,0,0,1949
"36009961600",2856,745,0,0,256,111,54,0,4022
"36009961700",1700,1386,119,0,116,35,32,44,3432
"36009961800",3557,620,276,70,108,0,0,0,4631
"36009962200",2577,473,8,0,40,3,16,7,3124
"36011040100",3965,666,3,0,37,16,11,12,4710
"36011040200",4346,346,27,0,111,8,58,0,4896
"36011040300",3446,464,14,4,25,29,71,3,4056
"36011040400",3783,454,5,0,76,14,49,5,4386
"36011040500",2912,306,19,0,80,0,93,3,3413
"36011040600",3014,87,1,2,143,1,13,1,3262
"36011040700",3637,95,1,0,27,1,12,0,3773
"36011040800",3533,291,15,0,97,37,22,13,4008
"36011040900",3316,607,22,0,19,15,10,13,4002
"36011041000",3987,391,29,10,59,83,246,156,4961
"36011041100",4028,198,15,0,86,2,97,0,4426
"36011041200",4527,307,31,0,156,78,67,74,5240
"36011041300",2640,776,288,28,75,102,107,0,4016
"36011041400",3503,566,34,198,173,32,91,0,4597
"36011041500",2323,307,22,48,109,19,63,14,2905
"36011041600",2086,137,16,2,31,13,24,0,2309
"36011041700",3002,618,169,0,160,0,65,5,4019
"36011041800",3467,565,791,65,49,77,57,10,5081
"36011042100",1415,810,22,28,193,107,31,5,2611
"36011990200",0,0,0,0,0,0,0,0,0
"36013030100",2108,1025,174,25,67,202,54,181,3836
"36013030200",2645,825,140,28,321,119,378,145,4601
"36013030300",735,636,149,153,201,131,243,239,2487
"36013030400",3600,521,101,12,130,105,41,164,4674
"36013030500",1148,1533,143,76,48,301,191,312,3752
"36013030600",2407,732,0,162,59,116,83,141,3700
"36013030700",3043,938,0,99,112,91,130,334,4747
"36013030800",3381,803,102,2,166,56,26,103,4639
"36013035100",3577,625,22,0,194,13,49,31,4511
"36013035300",2185,279,17,1,53,53,67,59,2714
"36013035400",1918,751,47,14,112,145,321,361,3669
"36013035500",2290,390,95,143,42,92,711,342,4105
"36013035600",2406,516,46,188,98,79,382,192,3907
"36013035700",1974,552,23,98,159,103,479,486,3874
"36013035800",2986,627,42,12,75,4,0,152,3898
"36013035901",3860,860,14,21,66,18,283,0,5122
"36013035902",124,58,0,0,0,13,0,7,202
"36013036000",3264,552,18,77,151,118,266,310,4756
"36013036100",3912,660,2,4,72,22,26,14,4712
"36013036300",3143,713,12,9,54,15,59,16,4021
"36013036401",2433,228,13,9,31,4,44,2,2764
"36013036402",2574,869,0,0,45,39,33,2,3562
"36013036500",3991,678,15,0,0,7,62,222,4975
"36013036600",2823,452,5,8,20,0,34,61,3403
"36013036700",3207,937,4,0,31,14,18,4,4215
"36013036800",3656,526,0,0,67,23,70,24,4366
"36013036901",2434,127,0,0,35,22,12,9,2639
"36013036902",3286,262,54,0,45,0,0,0,3647
"36013037000",3075,257,20,0,31,60,6,26,3475
"36013037100",3332,253,26,0,74,113,56,0,3854
"36013037200",2945,295,10,19,103,0,61,7,3440
"36013037300",4258,754,0,0,90,47,42,38,5229
"36013037400",3242,422,0,0,58,32,78,12,3844
"36013037500",4496,450,44,0,32,10,21,30,5083
"36013037600",1908,382,33,0,52,79,47,68,2569
"36013990000",0,0,0,0,0,0,0,0,0
"36015000100",1487,832,192,271,148,133,8,82,3153
"36015000200",1691,337,162,285,65,112,12,0,2664
"36015000300",0,0,0,0,0,0,0,0,0
"36015000400",1510,165,71,67,25,84,10,49,1981
"36015000500",2098,587,233,61,142,18,155,0,3294
"36015000600",1183,672,94,176,58,251,57,211,2702
"36015000700",603,751,158,184,89,189,42,47,2063
"36015000900",2398,615,100,29,212,29,212,51,3646
"36015001000",1367,1006,51,162,159,153,76,77,3051
"36015001100",2082,563,93,60,156,53,67,0,3074
"36015010100",3181,386,14,0,26,20,84,0,3711
"36015010200",5134,508,28,29,168,2,45,2,5916
"36015010300",7021,510,74,0,173,4,71,2,7855
"36015010400",3255,97,0,14,82,0,0,14,3462
"36015010500",2317,313,60,0,83,196,106,16,3091
"36015010600",2348,113,89,0,144,31,0,0,2725
"36015010700",6414,317,111,0,540,0,165,21,7568
"36015010800",2690,509,0,15,108,101,0,0,3423
"36015010900",4820,137,143,0,272,0,0,0,5372
"36015011000",3342,383,11,0,40,0,21,13,3810
"36015011100",5478,825,29,28,370,263,242,0,7235
"36015011200",4310,363,3,0,4,35,102,2,4819
"36017970100",5013,695,16,28,50,31,76,8,5917
"36017970200",3321,701,7,0,66,27,59,23,4204
"36017970300",2942,605,42,22,92,0,19,0,3722
"36017970400",1805,951,35,0,73,143,129,117,3253
"36017970500",4764,759,8,5,139,18,27,0,5720
"36017970601",3380,697,3,9,37,22,41,7,4196
"36017970602",3489,484,13,6,118,23,181,11,4325
"36017970700",1934,306,5,0,93,10,45,12,2405
"36017970801",3130,375,0,0,46,6,52,0,3609
"36017970802",2981,629,61,75,81,68,40,29,3964
"36017970900",4313,564,2,3,125,31,80,22,5140
"36017971000",2740,431,26,0,103,17,11,0,3328
"36019100100",4744,757,16,3,103,35,38,2,5698
"36019100200",3652,493,15,10,26,23,16,0,4235
"36019100300",4743,1077,29,5,82,69,34,24,6063
"36019100400",3203,734,10,9,85,16,43,4,4104
"36019100600",4642,646,42,0,130,31,9,0,5500
"36019100700",3078,344,32,0,59,21,24,0,3558
"36019100800",3737,376,18,6,45,42,0,38,4262
"36019100900",3418,898,56,82,219,124,36,25,4858
"36019101000",3170,390,49,0,188,71,56,9,3933
"36019101100",97,47,0,0,0,0,0,0,144
"36019101300",1300,1047,185,33,32,154,11,105,2867
"36019101400",1573,233,19,0,62,5,0,2,1894
"36019101600",1152,329,16,2,32,28,23,26,1608
"36019101700",4434,615,0,1,107,11,26,27,5221
"36019101800",4517,536,54,102,45,9,28,0,5291
"36019101900",5845,759,108,79,163,30,36,74,7094
"36019102000",2564,395,27,0,31,91,37,10,3155
"36019102100",1567,285,0,0,91,4,20,0,1967
"36019102200",1910,964,13,89,109,53,32,59,3229
"36021000100",2059,148,42,0,140,25,52,0,2466
"36021000200",1303,139,0,0,73,20,47,0,1582
"36021000300",3485,198,33,13,108,116,70,108,4131
"36021000401",2192,71,0,5,20,0,13,8,2309
"36021000402",5357,242,35,0,195,80,247,60,6216
"36021000500",1690,304,16,1,36,34,33,0,2114
"36021000600",2395,266,69,0,1,1,13,14,2759
"36021000700",4353,347,240,43,82,5,191,6,5267
"36021000800",1213,220,35,0,13,0,8,0,1489
"36021000900",1444,124,160,0,30,5,6,0,1769
"36021001000",4847,681,25,12,102,37,57,3,5764
"36021001100",2900,429,156,76,298,126,143,156,4284
"36021001200",1132,518,591,295,634,255,262,153,3840
"36021001300",1652,284,199,21,244,120,71,27,2618
"36021001400",2899,311,42,16,121,13,197,28,3627
"36021001500",928,189,0,0,13,0,49,4,1183
"36021001600",2965,476,0,16,106,0,118,10,3691
"36021001700",1110,198,76,0,58,30,25,40,1537
"36021001800",1633,90,6,25,52,0,31,0,1837
"36021001900",1546,245,7,0,149,29,114,21,2111
"36021002000",1710,152,12,11,96,5,149,0,2135
"36023970100",2998,311,0,3,75,16,32,0,3435
"36023970200",5134,597,12,19,36,25,15,3,5841
"36023970300",2515,218,39,0,236,29,97,29,3163
"36023970400",2507,132,0,2,47,107,207,0,3002
"36023970500",2790,500,0,0,130,0,143,0,3563
"36023970600",2161,490,249,0,55,0,138,0,3093
"36023970700",3438,1502,60,24,173,35,67,95,5394
"36023970800",89,46,0,0,0,0,0,0,135
"36023970900",2776,1088,123,90,229,92,30,28,4456
"36023971000",4639,305,0,0,283,0,89,40,5356
"36023971100",4042,656,50,0,98,8,45,17,4916
"36023971200",3691,368,45,0,119,12,75,12,4322
"36025970100",3747,587,21,0,130,11,60,13,4569
"36025970200",2393,258,3,3,87,21,78,17,2860
"36025970300",1984,140,13,9,34,0,22,3,2205
"36025970400",4682,769,0,0,184,0,159,3,5797
"36025970500",3663,426,21,96,60,16,78,19,4379
"36025970600",3979,1276,0,10,48,23,69,75,5480
"36025970700",1901,381,63,0,35,0,72,0,2452
"36025970800",2740,350,23,39,52,6,27,11,3248
"36025970900",0,0,0,0,6,0,0,0,6
"36025971000",2497,620,24,12,17,19,36,15,3240
"36025971100",1779,392,79,15,66,0,9,35,2375
"36025971200",2907,439,15,3,178,52,328,43,3965
"36025971300",1487,469,0,0,41,0,53,0,2050
"36025971400",2706,288,30,35,20,34,33,32,3178
"36027010000",3585,232,217,35,182,0,255,7,4513
"36027020003",3932,299,101,50,162,0,323,0,4867
"36027020004",2529,86,48,32,78,0,255,0,3028
"36027020005",4745,155,231,1,221,6,293,6,5658
"36027030000",3659,393,21,28,156,15,47,125,4444
"36027040001",3880,338,19,0,316,6,261,0,4820
"36027040003",2481,435,334,64,579,104,589,190,4776
"36027050102",3327,63,154,0,279,0,407,2,4232
"36027050103",4540,353,259,32,387,28,346,14,5959
"36027050104",5735,91,135,0,883,21,406,0,7271
"36027050203",4322,180,91,0,522,26,356,106,5603
"36027050204",2344,61,42,2,290,0,124,7,2870
"36027050205",4667,80,64,1,265,0,349,0,5426
"36027060100",2586,526,549,0,532,48,425,52,4718
"36027060201",2871,103,82,12,194,60,308,60,3690
"36027060202",3090,481,286,32,560,48,381,346,5224
"36027060301",3614,141,239,67,459,0,369,0,4889
"36027060302",1579,66,155,0,865,50,218,2,2935
"36027060400",1348,249,93,0,311,0,229,45,2275
"36027070101",3110,324,208,11,379,0,204,16,4252
"36027070102",2756,275,163,0,73,9,368,37,3681
"36027070201",2499,424,49,10,167,10,230,14,3403
"36027070301",4863,445,404,44,195,5,284,3,6243
"36027070401",2011,398,232,3,407,5,152,6,3214
"36027080103",3893,194,117,78,405,66,309,111,5173
"36027080104",3156,70,20,10,204,48,199,13,3720
"36027080201",4060,42,300,0,230,10,413,0,5055
"36027080202",2278,124,93,0,232,0,66,0,2793
"36027090000",1813,90,74,0,278,0,113,0,2368
"36027100000",2447,160,66,5,275,46,477,107,3583
"36027110003",3803,51,57,3,228,5,123,5,4275
"36027110004",1614,57,16,2,117,79,368,77,2330
"36027110005",1784,165,69,15,131,69,360,107,2700
"36027120000",2208,194,4,8,94,9,118,0,2635
"36027130003",4655,255,215,42,350,2,171,2,5692
"36027130004",1409,97,60,3,57,4,108,2,1740
"36027130005",2173,271,116,0,0,1,201,57,2819
"36027140101",2011,615,316,103,454,94,618,179,4390
"36027140200",4782,330,985,23,455,125,689,9,7398
"36027140300",2816,824,1124,51,481,142,691,93,6222
"36027140400",4211,62,312,1,725,6,422,6,5745
"36027140500",1791,198,179,64,489,149,288,30,3188
"36027140602",1872,306,216,0,402,34,291,138,3259
"36027140700",5003,100,840,129,744,116,329,55,7316
"36027140801",2251,237,34,13,190,193,229,137,3284
"36027150003",1134,400,12,2,157,0,176,27,1908
"36027150004",3428,160,28,0,84,45,148,51,3944
"36027150005",2249,122,0,9,23,0,66,9,2478
"36027150006",1293,194,24,4,165,35,85,31,1831
"36027160003",2069,92,43,19,82,5,89,0,2399
"36027160004",2261,55,41,8,46,0,63,0,2474
"36027160005",1987,245,74,16,120,14,60,40,2556
"36027170000",3078,208,146,86,174,46,319,42,4099
"36027180001",4562,100,0,0,193,0,183,0,5038
"36027190101",3220,51,132,1,617,38,247,0,4306
"36027190102",1246,42,286,0,186,26,193,0,1979
"36027190203",2003,190,133,4,234,0,273,25,2862
"36027190204",4044,133,161,22,968,10,906,23,6267
"36027190301",2577,183,229,18,308,0,305,0,3620
"36027190401",1638,63,158,0,144,0,215,0,2218
"36027190402",2416,226,169,0,569,18,590,0,3988
"36027200001",2696,205,102,36,9,0,48,0,3096
"36027200002",1320,60,3,5,104,50,14,55,1611
"36027210101",3130,362,411,263,381,154,780,204,5685
"36027210201",2259,295,1130,149,336,64,680,185,5098
"36027210301",3047,110,397,82,638,18,727,18,5037
"36027220100",1446,352,882,507,739,90,631,53,4700
"36027220201",936,433,794,498,320,120,485,164,3750
"36027220300",581,278,1611,1108,638,179,658,297,5350
"36027220700",708,135,1015,282,228,140,244,86,2838
"36027220801",1866,389,708,240,557,369,547,519,5195
"36027220901",1508,61,1437,193,504,75,487,2,4267
"36027221001",2660,96,258,242,372,22,57,0,3707
"36027221100",1078,331,905,282,841,737,1171,905,6250
"36027300000",2465,303,620,2,1573,399,1464,191,7017
"36027410000",1167,258,275,24,259,43,205,28,2259
"36027610000",0,0,0,0,0,0,0,0,0
"36027640001",0,0,0,0,0,0,0,0,0
"36027640002",67,24,4,9,0,12,9,12,137
"36029000110",1579,420,167,0,324,337,300,398,3525
"36029000200",2573,757,29,43,266,453,306,256,4683
"36029000500",1138,631,6,16,138,138,281,186,2534
"36029000600",3546,370,240,219,72,54,196,109,4806
"36029000700",3423,122,16,3,81,0,48,0,3693
"36029000800",3719,756,91,0,145,11,159,69,4950
"36029000900",2005,198,38,31,135,0,217,0,2624
"36029001000",3888,788,142,208,37,65,77,49,5254
"36029001100",1826,661,82,74,93,81,123,77,3017
"36029001402",114,45,1710,844,127,30,48,43,2961
"36029001500",60,65,806,552,38,1,4,44,1570
"36029001600",274,194,570,663,81,187,0,125,2094
"36029001700",604,421,344,126,120,50,3,76,1744
"36029001900",2332,256,240,0,88,16,27,0,2959
"36029002300",2157,697,147,307,0,63,22,144,3537
"36029002400",2417,825,390,362,70,365,41,192,4662
"36029002502",110,74,1280,341,34,140,0,104,2083
"36029002702",333,84,398,430,328,1027,0,13,2613
"36029002800",333,250,731,578,73,130,54,31,2180
"36029002900",147,66,917,800,33,30,0,20,2013
"36029003000",320,31,934,1002,234,58,32,44,2655
"36029003100",28,52,1254,361,17,26,4,12,1754
"36029003301",8,40,2388,1226,39,0,17,0,3718
"36029003302",88,31,1628,1178,37,189,49,93,3293
"36029003400",19,19,1582,617,37,45,0,7,2326
"36029003500",50,65,1605,1201,19,40,32,0,3012
"36029003600",192,164,1207,1071,24,48,37,8,2751
"36029003700",343,88,2007,1685,109,95,18,105,4450
"36029003800",306,11,1406,1118,98,57,205,18,3219
"36029003901",19,0,616,313,23,16,0,6,993
"36029004001",350,457,1758,1698,120,193,39,234,4849
"36029004100",364,58,2865,945,117,62,45,61,4517
"36029004200",120,9,2040,1269,37,0,0,53,3528
"36029004300",555,89,2593,2284,437,34,83,34,6109
"36029004401",202,70,2827,1213,27,0,12,0,4351
"36029004402",52,2,1057,1476,33,100,26,82,2828
"36029004500",4027,247,842,309,151,218,195,0,5989
"36029004601",1461,253,474,99,394,567,55,62,3365
"36029004602",14,3,0,0,0,0,0,0,17
"36029004700",750,718,2903,582,694,164,213,202,6226
"36029004800",3393,249,257,47,259,0,338,0,4543
"36029004900",3902,516,409,190,949,34,585,31,6616
"36029005000",1440,175,311,232,147,96,113,88,2602
"36029005100",3093,468,657,172,144,0,298,164,4996
"36029005201",2097,263,166,78,154,6,111,0,2875
"36029005202",166,649,991,296,110,59,17,44,2332
"36029005300",450,62,229,154,25,13,6,16,955
"36029005400",2878,398,395,57,273,56,147,26,4230
"36029005500",1174,615,354,392,531,806,537,389,4798
"36029005600",1491,552,848,324,369,728,403,630,5345
"36029005700",944,329,246,231,94,595,155,530,3124
"36029005801",1922,539,149,98,133,555,211,381,3988
"36029005802",2055,937,188,442,465,510,712,298,5607
"36029005900",1588,631,238,253,508,641,645,584,5088
"36029006100",1164,619,557,990,1210,324,522,392,5778
"36029006201",0,0,0,0,0,0,0,0,0
"36029006301",3216,621,260,0,266,284,122,304,5073
"36029006302",2238,232,30,11,35,0,100,1,2647
"36029006501",1824,227,166,176,285,114,285,0,3077
"36029006601",1317,296,160,48,333,541,193,75,2963
"36029006602",1313,89,280,115,77,163,175,163,2375
"36029006701",2022,220,295,63,234,319,172,57,3382
"36029006702",1538,324,450,214,169,228,52,205,3180
"36029006800",2191,555,103,272,344,507,382,191,4545
"36029006901",435,392,219,293,817,1135,627,614,4532
"36029006902",1525,355,299,190,766,808,579,611,5133
"36029007000",863,273,164,568,264,751,228,796,3907
"36029007101",610,515,257,683,1036,678,1110,1062,5951
"36029007102",675,239,378,513,410,530,463,617,3825
"36029007202",834,89,349,87,394,41,446,97,2337
"36029007302",6891,725,14,0,416,0,391,23,8460
"36029007303",5933,363,126,55,512,49,274,8,7320
"36029007304",5109,226,0,2,118,0,36,0,5491
"36029007600",2769,208,0,5,52,22,18,0,3074
"36029007700",3765,493,23,9,149,17,129,17,4602
"36029007800",4568,367,0,1,127,108,46,0,5217
"36029007901",2719,266,103,0,178,0,72,0,3338
"36029007902",5286,147,345,0,185,70,209,3,6245
"36029007903",3139,68,18,31,34,7,11,0,3308
"36029007904",2664,301,54,0,304,0,174,0,3497
"36029007905",3573,333,95,0,123,47,122,0,4293
"36029008001",4211,337,333,293,545,0,158,0,5877
"36029008002",4980,575,115,38,134,10,33,272,6157
"36029008003",4590,593,139,0,284,69,186,0,5861
"36029008101",4896,154,75,1,246,117,70,2,5561
"36029008102",3725,215,45,2,71,34,96,18,4206
"36029008201",2118,249,37,0,68,5,114,5,2596
"36029008202",3173,181,153,0,0,8,39,8,3562
"36029008300",1100,501,151,70,188,286,45,210,2551
"36029008400",1635,455,0,0,50,343,29,0,2512
"36029008500",2070,89,74,41,95,13,146,5,2533
"36029008600",4046,258,95,0,189,0,19,0,4607
"36029008700",4036,469,49,24,116,31,232,0,4957
"36029008800",2899,291,192,102,87,0,67,18,3656
"36029008900",3879,179,75,41,92,38,93,0,4397
"36029009004",3373,37,48,0,108,0,186,0,3752
"36029009006",6300,220,180,7,668,39,173,5,7592
"36029009007",6062,282,31,0,1011,0,273,15,7674
"36029009008",3741,174,64,6,596,0,21,0,4602
"36029009009",4092,121,134,0,721,46,30,0,5144
"36029009010",4437,571,214,8,758,1,201,27,6217
"36029009104",3859,187,39,3,224,0,131,4,4447
"36029009106",2610,122,198,71,147,59,58,20,3285
"36029009107",3104,628,769,73,272,425,159,389,5819
"36029009109",2459,149,42,0,352,137,26,6,3171
"36029009110",0,5,0,0,0,2,0,0,7
"36029009112",1921,351,13,156,178,84,39,0,2742
"36029009113",5731,202,290,0,514,37,198,19,6991
"36029009114",3418,147,67,1,490,173,133,3,4432
"36029009115",1355,792,249,234,271,912,16,72,3901
"36029009116",3882,419,372,2,436,387,126,0,5624
"36029009200",2256,249,84,87,379,432,0,105,3592
"36029009301",2534,590,896,267,595,357,46,21,5306
"36029009302",1887,269,241,19,173,50,29,0,2668
"36029009401",4362,518,203,13,340,10,100,10,5556
"36029009402",3800,160,113,0,145,0,149,17,4384
"36029009501",4019,68,719,134,110,0,12,0,5062
"36029009502",5608,342,68,17,354,0,140,27,6556
"36029009600",4876,619,189,50,447,64,193,0,6438
"36029009701",2625,152,81,1,89,0,15,0,2963
"36029009702",4196,209,43,0,149,11,56,42,4706
"36029009800",1508,209,0,0,0,10,89,7,1823
"36029009900",3093,357,103,0,19,52,45,21,3690
"36029010001",2659,214,7,0,71,9,76,0,3036
"36029010002",3608,233,58,45,86,31,47,18,4126
"36029010003",3051,292,231,18,154,64,67,1,3878
"36029010101",3544,113,525,36,113,0,74,10,4415
"36029010102",1876,655,635,181,274,28,92,290,4031
"36029010103",3419,390,298,10,15,0,11,0,4143
"36029010201",1811,116,642,102,186,9,0,0,2866
"36029010202",1042,162,1316,333,101,53,47,88,3142
"36029010300",517,145,442,220,141,82,150,25,1722
"36029010400",1050,378,498,183,134,111,89,54,2497
"36029010500",1163,326,565,8,231,0,58,0,2351
"36029010600",2049,198,194,0,122,0,80,2,2645
"36029010700",1605,343,256,74,69,18,28,0,2393
"36029010803",1609,114,18,22,23,19,19,9,1833
"36029010804",3341,251,42,0,70,11,40,19,3774
"36029010805",4760,220,2,0,0,0,106,16,5104
"36029010807",4014,536,163,80,401,119,223,40,5576
"36029010808",2631,380,358,52,514,64,106,18,4123
"36029010809",3041,21,0,0,64,0,180,0,3306
"36029010901",1968,148,62,1,139,11,133,10,2472
"36029010902",3419,444,287,133,0,23,70,18,4394
"36029011000",1489,297,22,23,43,39,4,12,1929
"36029011100",1968,234,92,0,0,6,20,6,2326
"36029011200",6147,239,18,0,60,19,62,19,6564
"36029011300",4222,372,188,216,134,0,0,4,5136
"36029011400",1558,303,121,98,147,0,124,0,2351
"36029011500",1412,102,47,9,27,4,85,13,1699
"36029011600",1995,77,0,0,61,0,52,0,2185
"36029011700",3455,261,7,8,36,29,79,29,3904
"36029011800",3414,115,36,71,27,18,21,2,3704
"36029012001",3805,506,18,0,156,16,169,7,4677
"36029012002",3154,95,29,0,75,29,22,0,3404
"36029012003",4650,137,0,4,90,0,93,0,4974
"36029012300",2000,583,136,50,85,85,137,88,3164
"36029012400",1383,433,89,6,70,195,145,154,2475
"36029012501",3654,729,29,27,156,76,140,98,4909
"36029012502",1821,90,7,0,2,20,67,3,2010
"36029012800",2052,370,21,24,80,26,41,39,2653
"36029012901",5638,610,51,13,150,218,198,16,6894
"36029012902",3131,184,43,20,20,0,24,0,3422
"36029013001",2746,248,11,0,25,119,0,0,3149
"36029013002",4809,577,51,0,108,0,47,33,5625
"36029013101",5697,307,254,0,122,0,27,0,6407
"36029013102",7554,390,43,8,57,0,122,0,8174
"36029013201",5102,572,21,30,194,2,214,2,6137
"36029013202",4823,222,30,10,66,7,97,7,5262
"36029013300",3405,115,21,9,174,23,303,23,4073
"36029013400",5798,335,0,0,136,46,118,0,6433
"36029013501",6637,97,0,0,146,0,162,0,7042
"36029013502",6703,78,15,0,216,14,91,14,7131
"36029013600",2805,95,38,1,9,1,27,11,2987
"36029013701",5877,243,94,1,77,2,48,2,6344
"36029013702",5452,145,42,0,227,8,85,25,5984
"36029013800",6984,600,22,0,143,18,113,0,7880
"36029013900",1975,155,0,3,47,16,0,16,2212
"36029014000",3336,132,0,37,33,0,79,0,3617
"36029014101",5915,161,0,2,99,0,82,0,6259
"36029014102",5190,170,0,1,72,0,0,0,5433
"36029014204",3628,247,9,0,50,3,40,3,3980
"36029014206",7318,158,0,1,0,0,289,0,7766
"36029014207",4816,110,154,63,32,0,81,0,5256
"36029014208",4854,67,47,0,120,0,65,0,5153
"36029014209",3919,59,34,0,69,0,73,0,4154
"36029014300",5433,279,1,0,388,0,36,0,6137
"36029014400",3577,405,0,2,33,71,30,7,4125
"36029014501",3136,302,7,1,68,0,16,22,3552
"36029014502",1693,533,0,3,0,140,33,140,2542
"36029014601",4532,262,136,0,224,0,90,0,5244
"36029014603",3718,38,90,1,491,0,46,0,4384
"36029014604",7295,140,50,7,600,0,164,0,8256
"36029014701",4959,220,9,29,178,13,121,12,5541
"36029014702",7052,491,19,38,530,10,106,34,8280
"36029014801",2299,138,0,1,117,0,24,0,2579
"36029014803",5708,187,91,14,98,0,18,0,6116
"36029014901",2256,276,21,5,19,8,30,0,2615
"36029014903",5169,357,0,34,162,1,35,1,5759
"36029014904",0,0,0,0,0,0,0,0,0
"36029015001",5124,221,0,0,0,0,54,0,5399
"36029015002",2690,153,0,0,187,0,53,0,3083
"36029015003",2931,351,1,0,53,8,44,8,3396
"36029015101",2999,226,2,0,43,0,0,0,3270
"36029015102",2598,159,0,0,16,3,25,10,2811
"36029015201",2903,84,0,55,8,0,0,55,3105
"36029015202",4777,142,3,3,0,0,0,20,4945
"36029015301",4585,205,0,4,6,2,53,2,4857
"36029015302",2721,111,0,0,0,0,24,4,2860
"36029015401",2268,244,21,0,12,0,0,0,2545
"36029015402",4326,697,0,0,124,5,130,23,5305
"36029015501",1538,181,38,0,73,28,33,9,1900
"36029015503",2185,208,16,6,76,44,14,0,2549
"36029015504",3736,373,1,0,118,0,63,0,4291
"36029015600",1825,134,11,0,107,94,29,74,2274
"36029015700",3177,187,7,8,58,3,9,0,3449
"36029015800",3945,208,9,0,57,0,0,0,4219
"36029015900",3377,526,37,17,138,32,47,47,4221
"36029016100",31,3,1,0,3,2,2,2,44
"36029016200",1442,125,86,59,179,0,110,23,2024
"36029016300",1582,483,0,270,126,113,144,171,2889
"36029016400",816,253,778,647,535,17,524,103,3673
"36029016500",631,174,103,93,39,41,40,79,1200
"36029016600",16,22,1743,672,74,19,10,0,2556
"36029016700",1597,357,27,5,57,17,84,137,2281
"36029016800",104,31,1985,1246,134,19,194,11,3724
"36029016900",1710,275,516,236,254,143,136,31,3301
"36029017000",76,6,1859,736,95,31,28,10,2841
"36029017100",788,662,405,1367,847,1335,307,1102,6813
"36029017200",1701,479,0,0,46,9,11,81,2327
"36029017300",6560,284,0,10,128,0,87,0,7069
"36029017400",1465,685,620,809,241,367,306,329,4822
"36029017501",950,284,8,0,173,8,0,0,1423
"36029017502",2158,274,7,0,22,0,0,0,2461
"36029940000",78,35,3,0,1153,482,12,62,1825
"36029940100",0,0,0,0,18,0,0,0,18
"36029990000",0,0,0,0,0,0,0,0,0
"36031960100",2416,189,4,3,64,32,49,16,2773
"36031960200",2507,218,4,5,67,5,8,3,2817
"36031960300",2811,265,8,3,26,13,45,3,3174
"36031960498",2194,130,55,23,42,13,20,0,2477
"36031960598",3693,351,54,7,117,64,194,58,4538
"36031960700",1691,255,2,0,36,7,18,0,2009
"36031960800",1716,174,0,1,38,19,10,9,1967
"36031960900",2991,325,4,11,119,51,56,35,3592
"36031961000",4119,427,2,21,63,0,24,0,4656
"36031961100",1638,167,3,0,64,10,0,0,1882
"36031961200",3949,823,27,3,34,48,0,8,4892
"36031961300",879,68,0,1,39,3,32,4,1026
"36031961400",1100,158,0,0,6,1,4,3,1272
"36033940000",57,129,0,0,1957,1090,66,0,3299
"36033950100",3447,776,13,10,84,2,17,21,4370
"36033950200",3117,726,8,29,747,170,33,21,4851
"36033950300",4433,1445,15,0,88,23,82,14,6100
"36033950400",4136,775,48,16,125,30,0,1,5131
"36033950501",2121,1039,13,48,97,129,90,61,3598
"36033950502",1415,199,0,0,55,0,10,0,1679
"36033950600",1336,259,0,0,39,10,7,4,1655
"36033950700",1789,446,5,1,9,10,16,2,2278
"36033950800",1580,137,8,0,34,14,13,3,1789
"36033950900",2742,566,38,23,120,0,7,0,3496
"36033951000",1801,334,4,6,0,3,0,1,2149
"36033951100",2809,581,3,38,5,0,0,3,3439
"36033951200",1939,147,6,2,29,0,4,0,2127
"36035970100",2327,206,0,2,38,1,22,0,2596
"36035970200",2486,363,3,0,23,20,86,8,2989
"36035970300",2976,444,0,0,33,29,0,0,3482
"36035970400",1576,192,0,0,32,12,0,10,1822
"36035970500",3272,625,17,6,77,3,13,0,4013
"36035970600",5547,874,18,2,86,9,67,18,6621
"36035970700",2398,1114,8,128,44,215,70,182,4159
"36035970800",1851,811,36,14,123,40,37,9,2921
"36035970900",2206,782,108,40,55,55,71,64,3381
"36035971000",2127,495,12,8,13,39,56,52,2802
"36035971100",1519,562,0,0,98,53,0,138,2370
"36035971200",3274,336,186,14,99,50,102,10,4071
"36035971300",3484,743,3,0,126,36,111,0,4503
"36035971400",3160,240,19,0,67,0,31,6,3523
"36035971500",4548,468,19,59,104,10,97,13,5318
"36037940100",19,11,0,0,389,93,6,0,518
"36037950100",4483,595,0,7,195,60,30,72,5442
"36037950200",4708,379,35,6,310,68,328,82,5916
"36037950300",5279,555,67,16,120,113,97,0,6247
"36037950400",5906,530,0,3,324,19,356,33,7171
"36037950500",2607,162,41,13,79,4,0,4,2910
"36037950600",1474,488,50,119,152,29,87,122,2521
"36037950700",1273,487,102,275,32,44,53,11,2277
"36037950800",1675,642,58,69,46,24,0,58,2572
"36037950900",1700,290,48,69,176,38,119,52,2492
"36037951000",1666,361,44,134,116,100,22,10,2453
"36037951100",4562,304,31,107,123,53,21,6,5207
"36037951200",3787,458,191,0,98,12,66,2,4614
"36037951300",3695,429,42,6,45,35,11,10,4273
"36037951400",5107,503,16,7,19,31,37,32,5752
"36039080100",2927,162,12,17,115,1,43,0,3277
"36039080201",3175,424,12,2,43,0,27,21,3704
"36039080202",2270,369,36,0,20,0,0,0,2695
"36039080300",2636,371,10,0,61,2,94,0,3174
"36039080401",1888,482,0,13,198,6,173,0,2760
"36039080402",1807,201,0,0,46,0,35,51,2140
"36039080501",2232,249,97,0,26,0,65,0,2669
"36039080502",3180,568,0,8,178,0,0,22,3956
"36039080600",2921,303,7,0,37,77,227,132,3704
"36039080700",2321,238,39,40,46,0,73,0,2757
"36039080800",0,0,0,0,0,0,0,0,0
"36039080900",3238,493,24,13,135,102,221,58,4284
"36039081000",2815,520,595,256,120,90,66,53,4515
"36039081101",3374,409,24,59,98,0,77,50,4091
"36039081102",1835,281,255,0,443,57,375,0,3246
"36041950100",797,95,0,4,20,1,20,0,937
"36041950300",654,107,1,1,56,0,0,2,821
"36041950400",1607,246,0,2,4,27,17,1,1904
"36041950500",896,113,8,0,79,13,7,13,1129
"36043010100",5193,701,49,41,155,23,96,32,6290
"36043010201",2679,566,21,26,58,42,27,51,3470
"36043010202",3774,249,23,2,65,25,45,25,4208
"36043010300",4085,569,12,30,359,122,216,60,5453
"36043010400",2249,1075,0,8,59,21,0,0,3412
"36043010501",2074,436,0,0,40,0,0,78,2628
"36043010502",1592,158,0,0,0,0,10,0,1760
"36043010701",2026,605,7,1,68,16,0,10,2733
"36043010702",1634,298,7,44,63,0,26,8,2080
"36043010900",2950,337,19,0,43,66,5,0,3420
"36043011001",1797,413,4,7,29,0,52,0,2302
"36043011002",2798,366,1,0,49,2,40,0,3256
"36043011100",1550,344,6,0,53,0,10,0,1963
"36043011200",4542,976,5,105,212,4,120,4,5968
"36043011301",1437,138,12,0,0,0,0,0,1587
"36043011302",2995,339,0,3,9,2,78,2,3428
"36043011400",4009,384,56,1,95,0,77,0,4622
"36043011501",2640,396,9,3,138,25,40,20,3271
"36043011502",1793,170,0,3,3,3,61,3,2036
"36045060100",3797,577,30,0,73,19,86,9,4591
"36045060200",5522,642,39,32,34,15,52,0,6336
"36045060300",3442,422,9,4,122,7,55,0,4061
"36045060400",6145,804,32,9,167,0,161,4,7322
"36045060500",4064,253,251,7,377,59,315,0,5326
"36045060600",4285,517,931,12,643,209,922,190,7709
"36045060700",3804,410,6,0,155,31,163,0,4569
"36045060803",3212,711,689,124,1009,114,1238,139,7236
"36045060804",3242,268,565,108,634,178,623,130,5748
"36045060900",4275,1494,87,4,180,55,40,17,6152
"36045061000",2764,466,123,0,250,15,259,30,3907
"36045061100",4797,372,168,18,582,118,199,102,6356
"36045061200",1655,1023,268,55,221,142,207,225,3796
"36045061300",1596,733,108,42,518,200,359,29,3585
"36045061400",2544,1092,49,10,52,47,86,99,3979
"36045061500",2553,406,506,5,468,25,327,55,4345
"36045061600",3278,692,35,45,166,4,42,1,4263
"36045061700",1985,238,6,6,96,0,60,6,2397
"36045061800",5888,905,6,10,475,12,87,0,7383
"36045061900",2660,673,123,22,57,80,97,10,3722
"36045062100",2679,720,399,144,92,168,154,135,4491
"36045062200",3535,483,127,4,216,74,134,83,4656
"36045062400",3655,271,33,0,226,32,137,23,4377
"36045062500",2711,479,16,3,39,2,4,5,3259
"36045980000",0,17,0,0,0,0,0,0,17
"36045990001",0,0,0,0,0,0,0,0,0
"36047000100",2787,400,388,85,472,167,294,121,4714
"36047000200",350,112,106,72,651,548,975,627,3441
"36047000301",2792,517,81,65,374,140,243,122,4334
"36047000501",2630,200,204,14,493,74,139,49,3803
"36047000502",1949,100,61,32,310,52,179,13,2696
"36047000700",3136,160,72,0,583,48,274,3,4276
"36047000900",2456,175,86,96,909,17,246,37,4022
"36047001100",552,44,94,0,236,41,85,6,1058
"36047001300",1157,472,148,143,360,282,208,242,3012
"36047001500",1971,316,885,626,1518,617,799,594,7326
"36047001800",0,0,0,0,0,0,0,0,0
"36047002000",403,49,85,6,591,234,826,268,2462
"36047002100",3261,144,76,105,614,74,203,79,4556
"36047002200",1482,418,96,31,1758,934,2136,970,7825
"36047002300",165,162,1283,1235,659,838,421,846,5609
"36047002901",81,185,932,772,575,896,338,656,4435
"36047003000",1099,169,50,49,444,30,398,21,2260
"36047003100",633,5,682,18,485,39,207,43,2112
"36047003300",1635,334,292,100,692,104,483,179,3819
"36047003400",1809,497,29,0,583,108,462,15,3503
"36047003500",561,21,586,76,301,5,182,0,1732
"36047003600",2666,310,111,3,1285,59,537,10,4981
"36047003700",706,43,25,4,145,56,62,55,1096
"36047003800",1177,28,12,0,269,69,67,0,1622
"36047003900",1459,103,216,42,566,69,405,27,2887
"36047004100",2272,109,348,60,463,47,124,72,3495
"36047004300",2172,114,67,45,584,110,449,92,3633
"36047004400",2009,111,9,0,284,7,166,59,2645
"36047004500",2829,110,35,10,332,2,118,2,3438
"36047004600",1237,29,8,0,136,3,36,13,1462
"36047004700",1217,68,187,44,321,52,329,70,2288
"36047004900",1687,42,22,0,317,0,254,0,2322
"36047005000",2150,90,19,4,242,5,251,1,2762
"36047005100",1571,133,92,0,339,8,416,81,2640
"36047005201",1154,241,0,20,116,191,167,48,1937
"36047005202",2009,113,71,14,229,0,215,0,2651
"36047005300",1192,195,125,133,569,209,501,283,3207
"36047005400",2379,482,67,0,435,34,367,102,3866
"36047005601",1953,170,32,32,169,126,222,11,2715
"36047005602",1058,159,0,0,513,0,317,0,2047
"36047005800",1955,412,9,0,629,316,421,48,3790
"36047005900",737,180,148,75,256,15,193,107,1711
"36047006000",1818,338,11,0,387,163,379,65,3161
"36047006200",1736,246,41,161,537,90,662,12,3485
"36047006300",1510,141,22,0,268,11,224,72,2248
"36047006400",2536,283,38,6,303,78,122,71,3437
"36047006500",4370,236,79,45,638,44,410,0,5822
"36047006600",2433,561,66,6,728,3,744,120,4661
"36047006700",3402,125,21,8,234,9,257,23,4079
"36047006800",2213,823,62,24,1435,720,1310,299,6886
"36047006900",2494,140,158,0,769,15,548,90,4214
"36047007000",1453,161,85,11,587,166,399,62,2924
"36047007100",1385,280,1169,489,1034,645,1228,857,7087
"36047007200",484,117,37,12,900,791,597,762,3700
"36047007400",898,417,149,94,3000,1466,2734,1565,10323
"36047007500",3401,178,0,3,1179,13,608,124,5506
"36047007600",1001,392,190,0,1782,1410,1541,1492,7808
"36047007700",3300,189,63,9,826,22,711,47,5167
"36047007800",1179,604,246,3,2620,805,3061,1318,9836
"36047008000",1127,365,184,21,2389,278,2969,474,7807
"36047008200",950,437,141,28,1669,923,1976,1020,7144
"36047008400",1043,246,39,10,1612,910,1977,999,6836
"36047008500",610,328,1962,1575,699,1742,1559,1766,10241
"36047008600",0,0,0,0,0,0,0,0,0
"36047008800",1325,154,52,0,1650,216,1846,226,5469
"36047009000",393,187,47,0,1827,770,1002,424,4650
"36047009200",910,278,144,65,2105,1879,1160,767,7308
"36047009400",1275,248,56,3,2352,1895,1155,202,7186
"36047009600",1272,973,113,8,2203,1382,1825,1034,8810
"36047009800",1027,531,143,30,3268,3179,2485,1924,12587
"36047010000",882,141,19,24,2846,2362,1083,1007,8364
"36047010100",1519,357,58,22,1697,722,1896,979,7250
"36047010200",758,275,10,0,3184,1038,975,252,6492
"36047010400",420,116,18,0,3697,1671,501,113,6536
"36047010600",528,86,0,100,2775,2198,494,187,6368
"36047010800",472,101,27,10,2147,1510,318,216,4801
"36047011000",739,202,31,0,1152,579,554,363,3620
"36047011200",2268,1262,247,27,1817,906,1813,549,8889
"36047011400",1721,1099,180,47,1022,360,367,174,4970
"36047011600",397,290,73,9,2450,1055,366,54,4694
"36047011700",1759,246,89,16,552,12,669,68,3411
"36047011800",259,11,0,32,1168,596,354,76,2496
"36047011900",1178,76,43,19,262,32,357,33,2000
"36047012000",76,61,0,0,756,362,45,33,1333
"36047012100",1093,90,82,10,443,80,400,67,2265
"36047012200",582,312,60,7,2860,1876,1655,1206,8558
"36047012600",815,273,48,18,1044,569,549,279,3595
"36047012700",1100,252,1059,401,883,234,779,282,4990
"36047012801",719,223,36,0,831,263,164,23,2259
"36047012901",1299,132,117,12,873,144,728,69,3374
"36047012902",1193,99,261,12,433,59,533,91,2681
"36047013000",2202,710,51,17,1694,550,1326,397,6947
"36047013100",2423,169,390,52,1003,189,847,229,5302
"36047013200",1007,84,10,0,937,359,386,18,2801
"36047013300",3601,96,150,52,735,40,638,13,5325
"36047013400",2773,180,0,9,841,57,580,28,4468
"36047013500",2555,93,348,8,595,95,349,69,4112
"36047013600",2601,313,19,9,713,158,431,66,4310
"36047013700",2069,353,162,111,534,29,450,116,3824
"36047013800",2044,389,24,10,669,263,537,122,4058
"36047013900",2265,237,321,45,663,108,591,48,4278
"36047014000",1359,219,0,0,194,71,134,89,2066
"36047014100",2369,131,290,37,1018,83,712,84,4724
"36047014200",1920,422,35,0,665,63,488,55,3648
"36047014300",1822,114,58,82,1088,446,1149,538,5297
"36047014500",2393,481,141,25,1248,136,1590,134,6148
"36047014700",1308,154,91,0,403,148,463,183,2750
"36047014800",1064,92,0,0,46,54,5,0,1261
"36047014900",4391,263,156,56,870,21,1188,101,7046
"36047015000",1200,58,0,1,296,87,31,45,1718
"36047015100",2927,219,168,23,871,54,655,50,4967
"36047015200",1486,193,11,4,676,49,217,19,2655
"36047015300",2139,114,87,0,447,9,455,9,3260
"36047015400",0,0,0,0,0,0,0,0,0
"36047015500",3028,104,168,0,306,68,132,9,3815
"36047015700",3432,44,208,2,580,23,308,2,4599
"36047015900",3917,138,462,21,612,0,342,19,5511
"36047016000",2524,407,196,33,830,485,858,155,5488
"36047016100",2009,195,350,11,435,124,269,149,3542
"36047016200",1457,224,81,0,728,57,291,9,2847
"36047016300",1817,130,654,66,483,64,183,5,3402
"36047016400",454,55,58,0,70,0,72,0,709
"36047016500",4330,256,145,5,910,60,448,46,6200
"36047016600",1891,89,0,0,95,5,197,56,2333
"36047016700",4169,90,39,0,770,184,545,137,5934
"36047016800",1110,65,103,0,435,88,97,0,1898
"36047016900",3143,458,150,28,598,402,626,314,5719
"36047017000",1893,228,80,0,1402,512,700,0,4815
"36047017100",3411,126,51,21,332,2,244,46,4233
"36047017200",1496,49,134,0,2255,106,546,82,4668
"36047017400",987,74,0,0,798,49,120,0,2028
"36047017500",0,0,0,0,0,0,0,0,0
"36047017600",1051,148,16,0,963,144,434,91,2847
"36047017700",0,0,0,0,0,0,0,0,0
"36047017800",974,115,0,0,1440,496,566,237,3828
"36047017900",862,92,1705,477,497,128,591,236,4588
"36047018000",1693,705,0,61,871,182,917,68,4497
"36047018100",1712,173,917,4,512,106,454,106,3984
"36047018200",1179,63,66,0,1669,623,534,150,4284
"36047018300",1465,102,516,27,503,79,267,60,3019
"36047018400",1247,52,56,0,964,208,52,14,2593
"36047018501",429,369,1177,1495,458,579,589,783,5879
"36047018600",1225,62,28,0,680,77,169,0,2241
"36047018700",584,74,254,77,350,45,276,74,1734
"36047018800",1689,126,0,6,865,193,226,37,3142
"36047019000",1828,465,16,33,2066,726,843,480,6457
"36047019100",1033,253,722,112,437,291,443,265,3556
"36047019200",1458,630,0,22,1014,253,266,149,3792
"36047019300",806,430,2588,212,269,48,464,5,4822
"36047019400",1069,109,23,28,2058,499,591,165,4542
"36047019500",1684,275,1463,104,504,158,587,59,4834
"36047019600",1421,614,89,7,2401,556,545,469,6102
"36047019700",1504,170,1002,289,499,34,229,0,3727
"36047019800",978,210,8,8,666,108,78,0,2056
"36047019900",1159,144,805,167,499,89,220,90,3173
"36047020000",1255,245,4,4,629,79,363,85,2664
"36047020100",1770,165,1293,119,520,10,363,19,4259
"36047020200",1354,103,0,0,669,0,108,0,2234
"36047020300",717,145,402,99,291,34,96,30,1814
"36047020400",1135,120,0,0,593,99,28,0,1975
"36047020500",1401,73,702,55,455,60,126,4,2876
"36047020600",1640,151,26,1,842,46,192,22,2920
"36047020700",2215,38,1508,78,588,109,686,66,5288
"36047020800",1252,207,9,29,1407,368,100,63,3435
"36047021000",1441,455,0,31,2345,661,537,82,5552
"36047021100",384,20,454,166,269,69,397,132,1891
"36047021200",1052,253,20,0,2665,1164,207,46,5407
"36047021300",676,166,2378,867,175,34,211,29,4536
"36047021400",811,441,0,0,833,316,61,0,2462
"36047021500",2012,217,1921,214,497,275,437,179,5752
"36047021600",2144,1765,0,0,407,142,105,249,4812
"36047021700",1062,78,1531,435,710,88,411,48,4363
"36047021800",2001,1786,0,22,440,140,115,268,4772
"36047021900",733,132,1767,492,351,133,271,80,3959
"36047022000",1842,1782,10,4,574,101,379,25,4717
"36047022100",1140,215,1555,722,431,181,476,230,4950
"36047022200",2270,1947,20,11,196,80,345,114,4983
"36047022400",2475,1732,99,7,851,790,690,603,7247
"36047022600",571,152,50,11,1136,518,1184,366,3988
"36047022700",753,76,2095,246,334,206,420,67,4197
"36047022800",1448,660,51,9,699,452,309,169,3797
"36047022900",1130,114,1444,538,477,77,109,91,3980
"36047023000",1827,1254,58,0,491,202,532,305,4669
"36047023100",1244,222,1187,278,408,165,236,77,3817
"36047023200",2649,2293,0,41,547,213,485,289,6517
"36047023300",923,272,1724,1047,605,282,647,306,5806
"36047023400",2394,2639,0,0,40,78,55,78,5284
"36047023500",1089,1435,560,165,418,340,643,298,4948
"36047023600",2960,2363,0,12,149,209,183,38,5914
"36047023800",2866,1230,0,0,36,10,231,0,4373
"36047024000",2299,1887,0,29,124,54,111,66,4570
"36047024100",872,413,555,39,252,60,465,42,2698
"36047024200",1773,957,7,0,254,61,127,20,3199
"36047024300",956,190,2177,393,440,89,512,150,4907
"36047024400",1581,1386,16,2,597,175,387,171,4315
"36047024500",496,69,2284,658,279,69,150,0,4005
"36047024600",1595,462,9,1,775,352,98,114,3406
"36047024700",391,48,1105,331,180,43,145,8,2251
"36047024800",1229,298,36,0,1005,483,505,246,3802
"36047024900",567,149,2592,438,88,124,72,49,4079
"36047025000",383,80,20,7,842,195,122,15,1664
"36047025100",243,121,1788,833,222,315,129,274,3925
"36047025200",2637,338,63,0,1627,664,716,216,6261
"36047025300",603,284,1135,178,139,194,335,159,3027
"36047025400",1089,267,0,0,2418,465,402,201,4842
"36047025500",622,522,1569,551,793,1170,1711,1727,8665
"36047025600",895,262,25,0,1735,278,296,47,3538
"36047025700",307,232,586,245,480,248,517,432,3047
"36047025800",1791,425,2,1,1274,732,392,285,4902
"36047025901",506,188,730,211,159,120,359,263,2536
"36047025902",191,484,846,1516,125,575,513,1082,5332
"36047026000",1097,124,46,0,1869,551,284,53,4024
"36047026100",1094,216,2266,850,475,86,808,145,5940
"36047026200",883,218,42,0,980,299,211,174,2807
"36047026300",206,63,1217,289,115,105,140,117,2252
"36047026400",1606,324,9,65,2317,625,670,157,5773
"36047026500",585,64,1727,635,241,276,241,244,4013
"36047026600",1751,237,0,7,1318,105,405,104,3927
"36047026700",571,110,1846,541,239,74,176,24,3581
"36047026800",1746,405,12,0,1119,403,729,223,4637
"36047026900",394,24,1857,274,89,38,233,8,2917
"36047027000",1419,327,18,0,709,66,133,19,2691
"36047027100",132,80,1631,403,145,111,131,5,2638
"36047027200",1473,442,0,0,1528,234,591,11,4279
"36047027300",186,3,1576,725,119,39,57,29,2734
"36047027400",1229,321,2,2,1407,129,220,70,3380
"36047027500",418,79,2349,864,472,143,494,86,4905
"36047027600",1296,360,0,12,1882,775,946,354,5625
"36047027700",305,84,2631,1754,141,43,379,54,5391
"36047027800",1296,275,0,25,1270,552,239,14,3671
"36047027900",269,79,2961,407,128,60,447,101,4452
"36047028000",764,100,12,1,662,151,179,21,1890
"36047028100",357,1002,1439,1237,493,312,523,1256,6619
"36047028200",1314,148,0,0,1285,479,157,23,3406
"36047028300",527,202,1501,826,515,401,1020,608,5600
"36047028400",1681,325,11,43,1203,399,334,61,4057
"36047028501",140,33,0,0,94,0,108,0,375
"36047028502",116,164,873,665,325,483,446,681,3753
"36047028600",2037,468,256,0,1278,653,689,245,5626
"36047028700",482,83,1392,491,178,130,478,54,3288
"36047028800",1254,293,0,8,1472,468,494,246,4235
"36047028900",372,179,1692,657,332,121,392,356,4101
"36047029000",2135,567,0,16,1025,274,154,277,4448
"36047029100",349,72,1989,207,98,120,206,147,3188
"36047029200",1260,265,20,62,725,208,341,74,2955
"36047029300",153,261,1847,549,447,155,438,342,4192
"36047029400",1185,308,78,24,593,204,120,149,2661
"36047029500",590,124,2032,751,283,23,319,23,4145
"36047029600",2657,624,62,0,2100,268,265,53,6029
"36047029700",244,66,2152,1019,294,194,159,79,4207
"36047029800",2144,191,0,1,1297,238,503,138,4512
"36047029900",26,35,1080,1095,288,114,211,191,3040
"36047030000",1295,216,0,0,2146,391,415,115,4578
"36047030100",40,73,1847,500,222,70,60,140,2952
"36047030200",1172,237,38,0,2459,449,287,64,4706
"36047030300",37,0,2057,2118,227,530,198,593,5760
"36047030400",1454,635,21,17,1460,144,206,69,4006
"36047030500",2143,308,1743,448,753,355,519,348,6617
"36047030600",812,188,0,7,736,266,96,64,2169
"36047030700",84,41,2290,1106,324,459,408,591,5303
"36047030800",1301,250,22,0,235,90,295,38,2231
"36047030900",37,48,1053,699,178,119,59,248,2441
"36047031100",148,137,1633,658,200,29,234,180,3219
"36047031300",233,13,2718,993,152,123,108,257,4597
"36047031400",2541,790,87,10,861,112,223,113,4737
"36047031500",1033,91,2117,1056,383,102,302,63,5147
"36047031701",598,125,1780,379,346,34,106,24,3392
"36047031702",734,132,1902,458,477,154,484,201,4542
"36047031900",548,439,2049,655,64,17,255,54,4081
"36047032100",736,283,3427,925,340,171,429,281,6592
"36047032300",448,24,2289,496,486,92,420,103,4358
"36047032500",450,122,4675,886,134,163,392,92,6914
"36047032600",1373,758,1370,1037,1379,1030,1356,1218,9521
"36047032700",253,169,1426,326,306,21,359,102,2962
"36047032800",325,79,746,311,902,258,299,64,2984
"36047032900",1348,376,2737,682,556,84,728,88,6599
"36047033000",867,687,1366,904,484,318,805,552,5983
"36047033100",2322,312,1315,210,114,105,196,105,4679
"36047033300",2727,425,1152,215,123,77,50,88,4857
"36047033500",1392,298,694,147,253,14,236,53,3087
"36047033600",2831,350,281,28,443,63,381,25,4402
"36047033700",1170,320,1829,149,113,237,166,309,4293
"36047033900",622,144,2037,1214,378,100,229,110,4834
"36047034000",342,423,535,232,243,122,208,164,2269
"36047034100",288,3,1644,351,175,95,224,8,2788
"36047034200",1356,897,1538,755,514,688,733,569,7050
"36047034300",186,7,2207,1118,1204,360,1066,544,6692
"36047034500",102,38,1707,867,85,94,79,112,3084
"36047034700",21,50,1977,919,109,181,297,199,3753
"36047034800",965,330,86,1,476,316,531,360,3065
"36047034900",247,35,3069,1405,315,226,256,354,5907
"36047035000",2114,596,0,0,78,18,18,0,2824
"36047035100",152,537,2215,636,372,513,466,127,5018
"36047035200",255,307,100,52,30,52,82,46,924
"36047035300",891,225,2532,684,583,211,489,228,5843
"36047035400",4845,463,37,0,28,0,266,0,5639
"36047035500",434,194,3679,825,287,185,436,258,6298
"36047035601",2122,451,19,0,0,0,6,5,2603
"36047035602",3857,856,43,1,78,0,49,71,4955
"36047035700",24,67,965,1098,132,208,207,239,2940
"36047035900",7,65,2645,2172,93,136,246,276,5640
"36047036001",1903,883,20,24,22,47,55,10,2964
"36047036002",2108,1354,14,0,282,212,39,212,4221
"36047036100",14,42,1412,544,236,111,323,115,2797
"36047036200",1267,794,45,6,665,568,558,626,4529
"36047036300",45,75,2771,676,408,101,393,178,4647
"36047036400",1037,285,20,44,553,138,199,30,2306
"36047036501",33,98,1980,427,132,0,235,0,2905
"36047036502",83,13,430,307,231,82,294,80,1520
"36047036600",1956,761,77,74,1071,582,642,499,5662
"36047036700",98,27,765,156,317,63,369,80,1875
"36047036900",285,62,2339,1029,555,539,824,565,6198
"36047037000",2492,327,0,0,1068,187,166,31,4271
"36047037100",32,55,3177,839,368,207,634,150,5462
"36047037300",364,255,1925,713,420,433,379,623,5112
"36047037401",3330,269,50,0,332,154,154,0,4289
"36047037402",2774,561,239,0,644,450,475,41,5184
"36047037500",540,195,1556,415,243,180,433,117,3679
"36047037700",487,84,2482,558,180,449,396,466,5102
"36047037900",200,114,2122,884,126,91,247,88,3872
"36047038100",187,95,3466,1370,196,236,248,335,6133
"36047038200",565,313,1509,1024,1234,1141,760,674,7220
"36047038300",247,10,3290,655,281,29,474,60,5046
"36047038500",255,219,1798,689,321,82,545,140,4049
"36047038600",1449,319,0,3,1450,401,449,181,4252
"36047038700",484,213,1951,842,385,112,686,241,4914
"36047038800",2977,506,62,9,296,181,273,109,4413
"36047038900",743,302,153,93,1355,511,1529,621,5307
"36047039000",1829,417,0,0,27,45,58,14,2390
"36047039100",722,503,271,343,898,349,1298,730,5114
"36047039200",1979,334,62,0,228,204,103,19,2929
"36047039300",1199,355,1022,411,352,83,1305,651,5378
"36047039400",1974,200,0,0,286,20,255,14,2749
"36047039500",850,835,1073,295,365,371,898,986,5673
"36047039600",1704,196,0,0,112,78,78,60,2228
"36047039700",965,199,1102,757,128,110,760,325,4346
"36047039800",1048,160,0,0,1267,336,286,183,3280
"36047039900",914,272,1216,693,148,120,1173,578,5114
"36047040000",1152,337,0,9,1519,383,385,57,3842
"36047040100",598,267,1377,488,404,156,768,283,4341
"36047040200",945,187,16,0,1160,375,234,56,2973
"36047040300",327,149,1511,884,323,522,453,724,4893
"36047040400",1133,179,10,0,943,186,179,84,2714
"36047040500",235,111,471,259,396,67,654,113,2306
"36047040600",1109,161,26,0,1838,201,348,160,3843
"36047040700",0,0,0,0,0,0,0,0,0
"36047040800",1163,252,110,0,1226,553,113,202,3619
"36047040900",816,516,919,281,723,483,1720,932,6390
"36047041000",1153,280,0,0,324,73,247,10,2087
"36047041100",559,49,843,371,1005,560,1370,531,5288
"36047041200",1679,228,8,0,722,198,568,78,3481
"36047041300",1081,162,1821,217,662,422,2021,490,6876
"36047041401",1146,148,0,0,161,25,74,15,1569
"36047041402",1235,376,0,0,0,0,12,0,1623
"36047041500",1644,254,1525,495,460,91,2134,521,7124
"36047041600",1757,388,0,54,235,210,172,174,2990
"36047041700",983,359,743,305,566,202,1559,674,5391
"36047041800",1691,356,6,61,176,8,255,135,2688
"36047041900",1471,665,891,165,372,466,1787,948,6765
"36047042000",1238,408,15,0,233,0,51,38,1983
"36047042100",1546,559,1091,258,393,169,1887,629,6532
"36047042200",2331,527,16,46,525,22,467,162,4096
"36047042300",2091,817,719,72,726,272,2487,1030,8214
"36047042400",1956,346,40,0,1023,67,407,18,3857
"36047042500",1051,154,223,129,768,568,1247,703,4843
"36047042600",1904,201,74,0,1656,573,397,214,5019
"36047042700",1869,974,341,296,1178,951,2033,1882,9524
"36047042800",2087,532,30,0,987,124,210,21,3991
"36047042900",2558,718,520,244,1142,544,3216,1133,10075
"36047043000",1473,398,0,0,1161,362,326,0,3720
"36047043100",1477,1259,577,70,1530,723,2287,1659,9582
"36047043200",2393,414,23,1,1381,578,531,129,5450
"36047043300",1637,460,1040,144,668,646,2303,1051,7949
"36047043400",1931,424,0,79,657,237,182,0,3510
"36047043500",1549,669,1320,456,980,147,2683,1110,8914
"36047043600",2695,372,0,3,1278,475,292,0,5115
"36047043700",2111,661,1367,706,713,564,2713,1220,10055
"36047043800",1452,413,53,10,449,255,206,256,3094
"36047043900",1760,456,588,410,797,138,2373,778,7300
"36047044000",2002,599,51,3,145,143,156,101,3200
"36047044100",2048,839,766,142,1708,636,3306,1338,10783
"36047044200",2178,257,0,0,267,41,8,16,2767
"36047044300",2398,665,320,105,1510,380,2862,803,9043
"36047044400",2358,603,45,0,393,10,223,23,3655
"36047044500",1526,901,326,22,1688,500,1824,1195,7982
"36047044600",1021,163,1,10,639,182,87,138,2241
"36047044700",1118,114,244,203,231,350,830,399,3489
"36047044800",1202,228,14,0,299,171,95,144,2153
"36047044900",814,202,906,663,375,461,796,690,4907
"36047045000",262,232,0,0,4,0,15,6,519
"36047045200",2342,141,0,0,5,150,36,70,2744
"36047045300",785,274,122,354,348,318,633,494,3328
"36047045400",1328,118,14,3,132,301,91,76,2063
"36047045600",1591,427,22,5,374,143,63,3,2628
"36047045800",1504,102,14,0,17,14,17,0,1668
"36047046000",1505,468,93,50,1302,610,87,34,4149
"36047046201",1619,328,0,0,519,219,210,0,2895
"36047046202",1325,535,0,5,243,75,261,80,2524
"36047046400",1671,782,26,5,133,86,35,11,2749
"36047046800",1414,847,1,5,48,3,10,2,2330
"36047047000",1505,1153,24,0,107,17,49,32,2887
"36047047200",2182,679,0,0,0,5,7,0,2873
"36047047400",2232,625,0,0,72,0,22,0,2951
"36047047600",2562,1001,17,63,202,104,223,82,4254
"36047047700",2658,360,169,1,500,66,208,186,4148
"36047047800",1875,1353,0,11,917,164,626,159,5105
"36047048000",1783,750,31,45,655,359,514,273,4410
"36047048100",2040,320,124,16,442,150,1055,143,4290
"36047048200",2193,996,227,28,1297,922,289,95,6047
"36047048400",3337,1792,255,9,492,308,458,13,6664
"36047048500",1476,290,222,54,774,218,1099,239,4372
"36047048600",985,220,56,0,1461,633,874,321,4550
"36047048800",1689,397,234,5,1044,592,627,157,4745
"36047048900",705,409,862,600,825,428,1745,889,6463
"36047049000",2122,1846,434,20,1630,91,780,257,7180
"36047049100",1476,251,979,195,2464,652,1717,246,7980
"36047049200",1250,482,441,95,794,565,174,388,4189
"36047049300",2712,883,567,597,1930,709,3361,1341,12100
"36047049400",2566,540,473,126,1406,415,650,95,6271
"36047049500",1901,285,15,6,427,67,437,70,3208
"36047049600",1341,219,60,32,1984,240,877,80,4833
"36047049700",1953,215,30,0,512,66,235,37,3048
"36047049800",1669,359,171,11,1868,457,347,105,4987
"36047049900",1362,75,5,0,252,34,314,9,2051
"36047050000",2269,181,251,0,785,171,355,24,4036
"36047050100",2005,217,149,13,480,98,428,65,3455
"36047050202",1971,199,5,15,213,2,219,2,2626
"36047050300",1956,209,0,0,227,39,483,63,2977
"36047050400",2416,297,551,87,1296,177,878,61,5763
"36047050500",1639,326,485,431,846,562,1386,819,6494
"36047050600",815,503,2399,397,1308,311,1216,773,7722
"36047050700",749,1109,185,48,223,103,360,113,2890
"36047050801",336,131,2020,714,413,334,741,274,4963
"36047050803",469,26,1120,114,176,177,242,113,2437
"36047050804",936,169,2621,559,1150,347,1405,405,7592
"36047050900",1619,2180,38,61,108,98,158,72,4334
"36047051001",603,71,2872,247,481,0,626,23,4923
"36047051002",683,89,2917,482,583,265,887,273,6179
"36047051100",1721,342,269,101,700,665,898,691,5387
"36047051200",550,86,3357,621,996,493,819,482,7404
"36047051300",2984,368,90,35,734,247,1190,459,6107
"36047051400",1356,98,3160,613,1542,467,1541,479,9256
"36047051500",918,70,75,0,276,28,187,45,1599
"36047051601",315,130,3317,513,587,324,591,179,5956
"36047051602",137,44,2483,652,334,97,459,23,4229
"36047051700",1403,182,134,0,279,0,191,11,2200
"36047051800",1038,175,1262,104,651,251,411,356,4248
"36047051900",3220,241,132,6,569,131,438,63,4800
"36047052000",1061,151,834,109,1689,722,566,39,5171
"36047052300",3428,513,88,37,1155,437,2372,795,8825
"36047052500",1526,1226,159,16,305,106,623,228,4189
"36047052600",1739,403,1100,14,1149,290,823,75,5593
"36047052700",1884,1439,541,329,1661,765,2256,2396,11271
"36047052800",1091,43,113,0,460,136,145,0,1988
"36047052900",1772,1849,43,26,152,152,184,155,4333
"36047053000",1822,560,68,72,863,234,180,30,3829
"36047053100",4172,4519,23,9,161,24,301,0,9209
"36047053200",1389,178,157,20,496,299,53,29,2621
"36047053300",2620,4102,0,72,19,70,26,24,6933
"36047053400",1660,1074,150,0,675,462,163,0,4184
"36047053500",1553,2427,27,135,68,116,143,94,4563
"36047053700",1558,1526,0,0,62,45,16,0,3207
"36047053800",2353,1185,82,5,545,44,509,200,4923
"36047053900",1065,1381,81,0,72,39,311,70,3019
"36047054200",2702,958,118,62,392,487,384,328,5431
"36047054300",212,0,40,39,91,0,90,0,472
"36047054400",1990,670,0,0,236,22,16,0,2934
"36047054500",2735,3172,438,287,171,248,1047,463,8561
"36047054600",3158,887,77,4,197,108,307,62,4800
"36047054700",2231,1890,84,177,554,135,609,362,6042
"36047054800",1816,225,15,1,53,61,176,1,2348
"36047054900",1874,792,67,10,640,97,387,123,3990
"36047055000",2143,906,23,1,612,59,388,114,4246
"36047055100",3509,540,574,105,1210,200,2956,432,9526
"36047055200",2195,310,11,1,333,329,94,24,3297
"36047055300",2021,181,1,2,512,163,402,176,3458
"36047055400",2435,597,25,6,710,255,422,108,4558
"36047055500",3428,288,285,12,994,171,751,201,6130
"36047055600",2530,400,14,4,619,7,61,9,3644
"36047055700",1780,227,57,0,278,42,442,72,2898
"36047055800",1437,313,0,0,445,49,296,9,2549
"36047056000",2727,378,35,22,248,271,90,15,3786
"36047056100",2295,234,135,0,292,47,174,59,3236
"36047056200",1204,76,0,0,150,89,0,0,1519
"36047056300",2623,726,20,55,780,315,377,307,5203
"36047056400",2089,76,39,0,334,0,204,0,2742
"36047056500",2432,274,21,0,362,36,271,70,3466
"36047056600",1487,163,166,11,878,42,230,18,2995
"36047056800",909,35,0,0,318,120,43,94,1519
"36047056900",1134,171,10,1,97,19,169,2,1603
"36047057000",2253,212,51,22,716,33,271,31,3589
"36047057100",3332,348,36,0,150,20,114,0,4000
"36047057200",847,345,1571,1350,474,367,810,660,6424
"36047057300",1540,342,166,10,241,76,141,15,2531
"36047057400",1368,90,38,7,1136,242,61,18,2960
"36047057500",2788,450,0,0,699,91,490,57,4575
"36047057600",1560,365,15,0,1027,103,76,0,3146
"36047057800",1278,538,20,0,1192,224,298,183,3733
"36047057900",553,111,11,0,299,42,392,49,1457
"36047058000",1277,362,52,0,2021,287,361,144,4504
"36047058200",1686,270,0,0,595,593,56,206,3406
"36047058400",2001,298,33,31,940,0,202,10,3515
"36047058600",948,69,84,0,1282,275,447,81,3186
"36047058800",1975,503,54,9,795,169,223,97,3825
"36047058900",1516,75,41,0,132,7,69,0,1840
"36047059000",627,141,161,65,791,108,107,28,2028
"36047059100",3128,374,67,0,243,6,287,130,4235
"36047059200",2582,247,104,0,1432,215,166,17,4763
"36047059300",1556,213,24,0,193,45,239,137,2407
"36047059401",4151,1004,48,2,1940,595,99,143,7982
"36047059402",3575,291,67,0,864,20,163,38,5018
"36047059600",1925,229,199,0,93,5,42,17,2510
"36047059800",1759,665,392,19,487,162,184,10,3678
"36047060000",4738,639,85,2,332,188,306,105,6395
"36047060600",1464,366,59,29,317,247,229,47,2758
"36047060800",2263,289,198,50,202,124,156,46,3328
"36047061002",3980,302,0,0,0,0,35,0,4317
"36047061003",732,341,0,0,669,96,427,139,2404
"36047061004",3665,1848,63,56,434,138,113,213,6530
"36047061200",767,107,0,0,0,0,0,0,874
"36047061600",1279,214,15,16,10,38,18,38,1628
"36047062000",1662,188,0,0,30,0,33,10,1923
"36047062200",2444,293,157,45,102,67,202,77,3387
"36047062600",1318,345,123,10,534,312,180,125,2947
"36047062800",4599,318,20,0,193,0,373,9,5512
"36047063200",1137,112,5,1,202,1,79,0,1537
"36047063600",1242,40,0,0,63,4,230,0,1579
"36047063800",1187,28,9,0,425,0,55,0,1704
"36047064000",1371,90,0,0,290,266,153,9,2179
"36047064200",1945,305,8,0,139,37,120,94,2648
"36047064400",1829,243,19,9,595,114,261,67,3137
"36047064600",2116,100,32,13,141,0,320,0,2722
"36047064800",1033,27,543,78,237,0,269,0,2187
"36047065000",458,62,452,49,253,48,199,1,1522
"36047065200",1013,71,18,0,139,0,13,0,1254
"36047065400",1324,107,33,0,301,0,72,0,1837
"36047065600",1392,117,27,0,258,33,266,23,2116
"36047065800",1556,102,19,0,268,9,28,6,1988
"36047066000",1704,10,14,6,324,0,171,0,2229
"36047066200",1073,46,0,0,583,27,170,10,1909
"36047066600",0,0,0,0,0,0,0,0,0
"36047067000",563,122,1461,125,455,37,311,136,3210
"36047067200",115,106,1228,82,29,120,100,127,1907
"36047067400",446,1,1276,46,134,29,186,0,2118
"36047067600",260,30,1597,62,81,0,148,36,2214
"36047067800",224,10,1987,116,40,0,40,0,2417
"36047068000",268,4,1297,501,69,11,71,191,2412
"36047068200",647,20,1986,92,269,13,470,17,3514
"36047068600",750,104,544,8,230,24,144,6,1810
"36047068800",734,32,1076,8,6,0,124,0,1980
"36047069000",319,23,1154,48,186,71,125,1,1927
"36047069200",222,109,2221,28,249,13,150,31,3023
"36047069601",1609,504,1597,101,202,19,330,208,4570
"36047069602",3567,284,1768,0,686,362,798,379,7844
"36047069800",1107,93,0,0,248,0,148,0,1596
"36047070000",1628,127,43,0,0,0,51,9,1858
"36047070201",4966,408,109,0,532,0,520,0,6535
"36047070202",16,0,0,0,0,0,0,0,16
"36047070203",0,0,0,0,0,0,0,0,0
"36047070600",2551,19,94,0,84,0,148,0,2896
"36047072000",137,27,1597,90,118,0,28,0,1997
"36047072200",81,4,2319,386,88,18,71,13,2980
"36047072400",58,7,1813,107,52,1,96,1,2135
"36047072600",66,0,1950,89,5,0,25,0,2135
"36047072800",273,10,3391,172,204,0,153,0,4203
"36047073000",162,18,2085,89,186,10,151,0,2701
"36047073200",99,0,2361,210,188,0,77,0,2935
"36047073400",94,0,2049,100,114,0,123,0,2480
"36047073600",225,131,1970,363,624,249,219,269,4050
"36047073800",925,112,1790,402,238,116,231,149,3963
"36047074000",276,127,2368,428,1020,45,262,101,4627
"36047074200",1335,288,1431,120,349,66,216,53,3858
"36047074400",1981,223,46,83,158,9,113,3,2616
"36047074600",1393,198,486,10,104,57,223,5,2476
"36047074800",956,451,338,85,18,58,59,58,2023
"36047075000",1886,453,260,94,130,65,110,25,3023
"36047075200",985,11,25,0,0,0,0,0,1021
"36047075400",1107,457,0,1,0,1,0,1,1567
"36047075600",1381,169,43,108,238,32,70,12,2053
"36047075800",1451,121,0,0,262,7,161,7,2009
"36047076000",2262,398,33,0,123,197,89,25,3127
"36047076200",2119,559,294,12,901,975,487,621,5968
"36047076400",1007,269,2020,205,306,238,152,207,4404
"36047076600",178,43,1682,223,290,31,311,25,2783
"36047076800",1800,688,43,9,569,121,263,66,3559
"36047077000",592,23,1833,565,206,66,369,25,3679
"36047077200",994,255,1282,125,193,68,248,1,3166
"36047077400",559,64,1654,371,303,382,88,61,3482
"36047077600",107,35,3181,207,409,17,251,21,4228
"36047078000",93,5,2327,116,45,0,144,0,2730
"36047078200",28,7,3821,701,128,0,90,0,4775
"36047078400",53,11,2353,212,154,18,122,18,2941
"36047078600",178,93,2686,676,1078,155,782,40,5688
"36047078800",80,9,2321,536,183,108,250,86,3573
"36047079000",108,0,4114,594,310,142,181,126,5575
"36047079200",81,180,2048,849,368,186,230,212,4154
"36047079400",17,4,1507,410,10,0,99,0,2047
"36047079601",946,97,2885,360,338,102,308,140,5176
"36047079602",263,39,2797,767,254,522,327,582,5551
"36047079801",664,80,1673,76,305,88,238,77,3201
"36047079802",869,182,3443,688,605,169,536,0,6492
"36047080000",800,47,2085,645,178,30,203,36,4024
"36047080200",318,100,3131,706,460,316,412,321,5764
"36047080400",211,77,1999,675,106,214,201,29,3512
"36047080600",1320,672,1670,435,19,112,78,49,4355
"36047080800",7,47,126,312,81,175,31,68,847
"36047081000",195,86,1319,391,141,62,91,9,2294
"36047081400",9,3,1935,625,181,48,87,6,2894
"36047081600",15,0,1982,545,223,61,133,68,3027
"36047081800",66,30,2540,1117,368,126,458,186,4891
"36047082000",151,82,3078,956,498,46,337,77,5225
"36047082200",199,399,5418,985,265,179,346,539,8330
"36047082400",156,0,2897,846,352,72,489,78,4890
"36047082600",303,60,3439,796,211,71,137,224,5241
"36047082800",136,106,2750,378,149,93,320,126,4058
"36047083000",137,0,4746,632,476,32,251,0,6274
"36047083200",66,0,2029,92,154,0,53,4,2398
"36047083400",11,65,1370,145,42,0,49,0,1682
"36047083600",26,5,1724,111,81,58,12,10,2027
"36047083800",134,3,2155,89,23,3,144,3,2554
"36047084000",132,4,1769,114,193,36,233,30,2511
"36047084600",12,20,1281,286,47,58,59,37,1800
"36047084800",1,0,1270,282,26,20,16,8,1623
"36047085000",14,0,1409,165,6,6,72,0,1672
"36047085200",0,0,8,0,0,0,0,0,8
"36047085400",18,0,1612,142,141,15,126,15,2069
"36047085600",23,0,2668,339,260,0,295,13,3598
"36047085800",46,0,1847,304,121,54,90,54,2516
"36047086000",0,19,2668,680,163,156,267,196,4149
"36047086200",2,0,2481,429,73,18,20,17,3040
"36047086400",11,0,1838,277,37,40,137,40,2380
"36047086600",38,18,2668,357,72,22,104,12,3291
"36047086800",73,219,2133,496,134,56,238,9,3358
"36047087000",32,6,2306,658,133,52,121,52,3360
"36047087200",34,16,2194,381,81,20,135,36,2897
"36047087401",64,65,2016,810,67,100,140,111,3373
"36047087600",265,55,1109,123,54,82,32,18,1738
"36047087800",0,11,1721,729,63,81,29,71,2705
"36047088000",187,0,2433,524,56,0,135,83,3418
"36047088200",105,29,5465,878,150,33,131,97,6888
"36047088400",140,55,3494,976,209,20,168,22,5084
"36047088600",26,0,3279,931,176,60,261,58,4791
"36047088800",59,12,3250,511,216,226,246,258,4778
"36047089000",400,107,3553,2183,79,239,414,395,7370
"36047089200",107,70,2329,1067,61,17,166,36,3853
"36047089400",157,0,2392,903,115,128,226,122,4043
"36047089600",113,12,2106,807,302,71,160,71,3642
"36047089800",0,52,1278,403,29,15,65,52,1894
"36047090000",60,193,2929,1461,333,330,380,593,6279
"36047090200",83,14,1674,1055,283,312,265,288,3974
"36047090600",81,191,1530,1516,635,358,736,656,5703
"36047090800",117,222,1453,1956,235,781,414,996,6174
"36047091000",192,218,1527,3454,256,401,448,773,7269
"36047091200",411,223,1997,2224,928,844,1123,1338,9088
"36047091600",11,107,3075,1257,117,223,111,367,5268
"36047091800",195,161,1336,783,327,240,761,675,4478
"36047092000",132,25,1930,888,165,210,365,277,3992
"36047092200",20,1,2516,308,35,0,8,0,2888
"36047092400",38,11,2261,677,324,24,409,138,3882
"36047092800",0,16,2095,292,273,4,178,7,2865
"36047093000",8,2,2167,244,155,5,26,0,2607
"36047093200",17,0,1242,44,20,13,14,0,1350
"36047093400",67,5,2046,262,84,0,123,7,2594
"36047093600",0,0,1679,123,80,0,27,0,1909
"36047093800",7,19,1628,520,9,13,9,13,2218
"36047094401",8,0,3313,550,45,0,129,20,4065
"36047094402",63,124,1797,791,39,48,93,163,3118
"36047094600",144,39,1537,167,66,25,145,0,2123
"36047095000",97,4,2701,369,65,0,95,0,3331
"36047095400",48,17,4211,475,24,68,37,27,4907
"36047095600",286,13,3328,543,294,154,230,61,4909
"36047095800",182,29,2555,444,531,56,382,74,4253
"36047096000",0,0,0,0,0,0,0,0,0
"36047096200",53,18,1224,343,144,2,142,2,1928
"36047096400",55,0,1418,456,231,33,145,66,2404
"36047096600",131,0,1537,254,437,0,298,37,2694
"36047096800",287,14,860,157,104,44,97,31,1594
"36047097000",258,15,1531,263,108,5,151,36,2367
"36047097400",178,78,1965,321,164,146,160,166,3178
"36047098200",79,71,2147,1372,142,313,323,390,4837
"36047098400",102,6,1492,383,52,0,49,0,2084
"36047098600",87,0,2861,217,144,53,194,0,3556
"36047098800",197,65,2174,426,140,0,146,25,3173
"36047099000",19,60,1186,118,97,54,32,48,1614
"36047099200",34,60,1547,320,69,49,124,1,2204
"36047099400",220,20,1433,214,33,103,51,167,2241
"36047099600",199,0,3168,284,75,93,100,10,3929
"36047099800",112,17,3117,365,91,0,148,0,3850
"36047100400",165,0,2258,233,175,0,51,0,2882
"36047100600",91,9,1877,347,228,0,76,0,2628
"36047100800",155,76,1387,344,73,90,148,14,2287
"36047101000",141,22,1297,210,364,4,265,29,2332
"36047101200",175,40,1610,109,180,27,166,0,2307
"36047101400",73,15,1744,248,118,37,64,28,2327
"36047101600",116,0,1349,32,68,12,11,0,1588
"36047101800",35,0,1489,87,107,0,81,0,1799
"36047102000",116,130,1663,139,40,44,96,0,2228
"36047102200",139,12,1503,127,269,155,39,24,2268
"36047102400",89,12,1736,36,208,29,23,29,2162
"36047102600",89,10,2205,134,8,35,34,37,2552
"36047102800",41,1,1247,157,83,0,53,0,1582
"36047103400",189,258,1458,1222,630,272,558,408,4995
"36047105801",1706,603,2323,1305,177,266,945,293,7618
"36047105804",965,936,2576,821,756,337,996,333,7720
"36047107000",112,0,775,33,213,8,285,4,1430
"36047107800",124,12,3235,305,288,24,306,66,4360
"36047109800",83,51,1292,393,164,50,153,53,2239
"36047110400",196,7,3421,640,243,441,528,536,6012
"36047110600",224,100,2130,1385,357,213,707,317,5433
"36047111000",282,99,1268,1311,282,158,508,299,4207
"36047111600",275,267,1607,1079,384,31,650,184,4477
"36047111800",221,177,1660,886,22,0,257,146,3369
"36047112000",278,187,1625,840,0,284,252,637,4103
"36047112200",444,143,1825,928,218,177,520,263,4518
"36047112400",25,60,2080,1010,94,105,286,231,3891
"36047112600",474,85,1955,800,224,288,611,444,4881
"36047112800",48,246,2306,797,88,294,135,311,4225
"36047113000",38,50,2261,1478,216,306,351,429,5129
"36047113200",101,0,1513,228,33,42,156,23,2096
"36047113400",101,128,1091,894,331,363,489,589,3986
"36047114201",598,76,323,79,467,205,863,254,2865
"36047114202",521,157,1217,111,497,153,1197,317,4170
"36047114400",247,306,992,577,185,233,416,534,3490
"36047114600",523,261,860,139,712,613,1233,874,5215
"36047115000",179,73,1156,297,608,454,750,422,3939
"36047115200",90,80,1192,879,767,191,611,269,4079
"36047115600",174,87,1290,1432,633,513,736,670,5535
"36047115800",236,167,1612,438,393,90,673,208,3817
"36047116000",171,55,1136,408,277,92,512,173,2824
"36047116200",70,0,1348,494,114,47,217,51,2341
"36047116400",399,305,1589,376,212,223,649,536,4289
"36047116600",382,205,1287,600,343,48,671,279,3815
"36047116800",405,139,399,314,170,152,531,274,2384
"36047117000",226,114,450,98,551,167,765,199,2570
"36047117201",438,95,412,136,1049,396,1384,449,4359
"36047117202",1327,109,1085,178,355,67,1603,243,4967
"36047117400",1896,676,663,160,675,185,2294,735,7284
"36047117601",964,364,471,256,807,175,1686,543,5266
"36047117602",670,245,489,190,822,378,1529,562,4885
"36047117800",239,189,529,153,453,60,636,201,2460
"36047118000",0,0,0,0,0,0,0,0,0
"36047118201",881,174,435,262,1131,171,1859,384,5297
"36047118202",1084,371,436,204,485,185,1536,577,4878
"36047118400",1804,731,941,250,1310,374,2652,873,8935
"36047118600",754,345,509,404,532,237,924,524,4229
"36047118800",740,217,1672,1048,651,191,909,235,5663
"36047119000",589,334,592,371,260,458,756,630,3990
"36047119200",565,428,993,680,430,82,779,473,4430
"36047119400",483,364,1991,654,104,14,689,378,4677
"36047119600",417,300,2411,571,850,300,742,356,5947
"36047119800",500,97,885,416,647,775,1213,832,5365
"36047120000",237,137,943,199,228,481,274,353,2852
"36047120200",257,345,691,93,554,117,263,401,2721
"36047120800",462,140,5246,2113,543,43,754,221,9522
"36047121000",435,1014,1427,1051,220,111,1008,1078,6344
"36047121400",223,460,1595,1498,495,194,849,697,6011
"36047122000",326,0,3487,925,624,211,885,348,6806
"36047123700",2096,3601,187,29,399,210,535,179,7236
"36047150200",1946,138,89,7,697,40,533,29,3479
"36047152200",1430,115,673,96,885,525,310,269,4303
"36047990100",0,0,0,0,0,0,0,0,0
"36049950100",2246,239,10,0,8,27,12,18,2560
"36049950200",3851,427,34,11,46,10,84,0,4463
"36049950300",6524,726,95,2,215,110,160,29,7861
"36049950400",2450,306,4,0,21,7,43,16,2847
"36049950500",1929,378,2,0,22,8,9,7,2355
"36049950600",1543,341,21,22,29,3,11,0,1970
"36049950700",4375,599,10,6,74,16,43,4,5127
"36051030100",3708,203,137,14,119,26,32,0,4239
"36051030201",3689,911,52,74,152,182,16,32,5108
"36051030202",5058,528,78,0,157,54,32,93,6000
"36051030300",2860,248,15,0,41,143,28,37,3372
"36051030400",2373,793,31,0,150,71,38,13,3469
"36051030500",0,0,0,0,0,0,0,0,0
"36051030600",3416,444,6,0,131,1,51,11,4060
"36051030700",6542,908,5,0,186,11,35,0,7687
"36051030800",4266,500,6,0,123,222,293,219,5629
"36051030900",1802,504,92,28,74,5,220,181,2906
"36051031000",2,2,1,6,5,0,3,1,20
"36051031100",4127,558,26,0,65,52,23,17,4868
"36051031200",3188,499,0,12,40,15,9,15,3778
"36051031300",3790,688,0,0,79,16,35,2,4610
"36051031400",3536,922,0,29,25,12,60,41,4625
"36053030101",1821,734,49,28,65,30,25,75,2827
"36053030102",3687,929,29,0,101,14,72,0,4832
"36053030103",3104,143,0,0,196,15,108,0,3566
"36053030200",2887,458,12,54,48,197,10,0,3666
"36053030300",4419,766,41,30,66,36,2,0,5360
"36053030401",6416,771,86,0,31,0,78,22,7404
"36053030402",2939,120,0,0,24,0,39,0,3122
"36053030403",4448,315,3,0,36,0,67,0,4869
"36053030501",2136,268,69,0,9,0,26,0,2508
"36053030502",3532,130,0,0,73,18,25,0,3778
"36053030600",6319,576,15,0,209,93,116,6,7334
"36053030700",4496,528,0,62,74,5,32,65,5262
"36053030800",2864,479,51,0,29,17,12,0,3452
"36053030900",1595,280,0,0,269,24,0,1,2169
"36053031000",4429,644,16,0,101,15,131,0,5336
"36053031100",2146,401,0,0,9,0,0,0,2556
"36055000200",159,352,384,817,252,463,48,452,2927
"36055000700",303,158,652,471,267,189,511,363,2914
"36055001000",2147,256,251,228,88,45,32,93,3140
"36055001300",75,122,397,899,211,243,203,513,2663
"36055001500",76,49,387,133,39,176,122,219,1201
"36055001800",2467,683,800,347,542,275,617,106,5837
"36055001900",1201,320,462,251,167,157,437,145,3140
"36055002000",1511,371,1104,781,484,214,600,254,5319
"36055002100",1433,247,1337,248,295,78,377,68,4083
"36055002200",543,379,534,484,516,266,289,49,3060
"36055002300",434,359,791,681,491,739,374,301,4170
"36055002400",795,373,907,501,194,229,256,178,3433
"36055002700",2,23,719,605,33,38,0,85,1505
"36055002900",2720,618,178,165,190,76,131,45,4123
"36055003000",1199,363,291,236,29,38,21,90,2267
"36055003100",3455,887,53,22,199,23,195,23,4857
"36055003200",538,255,253,200,116,193,103,118,1776
"36055003300",826,273,53,113,53,65,53,32,1468
"36055003400",1358,251,257,280,252,103,143,18,2662
"36055003500",807,148,66,7,48,30,25,6,1137
"36055003600",1830,283,68,12,214,36,75,56,2574
"36055003700",2165,331,79,225,97,98,51,98,3144
"36055003802",0,0,0,0,0,0,0,0,0
"36055003805",2494,657,560,419,472,103,171,116,4992
"36055003900",139,226,974,427,119,441,148,592,3066
"36055004000",410,253,277,302,129,173,292,245,2081
"36055004100",278,182,94,323,165,91,184,96,1413
"36055004602",439,228,1044,780,125,62,297,86,3061
"36055004701",961,348,617,564,454,105,579,263,3891
"36055004702",511,195,590,316,247,206,441,340,2846
"36055004800",279,392,582,630,273,298,452,534,3440
"36055004900",209,208,596,560,217,258,336,343,2727
"36055005000",142,239,519,492,228,357,189,585,2751
"36055005100",120,63,573,284,156,82,273,124,1675
"36055005200",246,78,335,795,207,114,462,205,2442
"36055005300",330,375,540,483,49,199,244,525,2745
"36055005400",1177,235,1339,517,374,604,507,627,5380
"36055005500",153,477,668,601,238,81,355,498,3071
"36055005600",220,257,699,765,218,242,301,179,2881
"36055005700",187,132,636,609,240,98,243,119,2264
"36055005800",1156,263,1142,1443,477,170,711,231,5593
"36055005900",235,133,577,340,113,108,208,111,1825
"36055006000",1927,298,659,87,124,48,147,111,3401
"36055006100",2069,163,102,0,83,8,109,0,2534
"36055006200",326,86,1830,589,53,0,50,43,2977
"36055006300",285,237,1245,644,150,111,146,295,3113
"36055006400",125,91,1138,1194,46,41,35,99,2769
"36055006500",49,156,940,447,24,176,71,54,1917
"36055006600",16,82,1086,673,22,151,16,62,2108
"36055006700",318,193,2012,665,114,42,79,81,3504
"36055006800",593,92,1431,629,179,7,90,103,3124
"36055006900",306,150,722,820,67,63,93,47,2268
"36055007000",619,247,1394,628,105,16,231,30,3270
"36055007100",817,51,1296,760,84,92,136,57,3293
"36055007500",533,109,1051,777,58,221,98,429,3276
"36055007600",2053,183,299,428,156,82,165,76,3442
"36055007700",1744,181,192,121,199,62,49,62,2610
"36055007801",1924,215,104,42,113,27,189,0,2614
"36055007802",1190,57,91,15,21,1,23,9,1407
"36055007900",216,498,430,572,203,288,270,859,3336
"36055008000",376,193,504,653,218,394,448,397,3183
"36055008100",1310,285,1268,348,724,105,1144,184,5368
"36055008200",895,444,1145,212,551,146,954,285,4632
"36055008301",1625,288,805,457,585,89,1163,165,5177
"36055008400",508,430,1029,225,452,149,749,403,3945
"36055008500",2208,499,179,266,49,54,109,0,3364
"36055008600",3272,250,327,21,250,0,246,0,4366
"36055008701",1264,503,1185,17,657,80,422,241,4369
"36055008702",378,208,455,370,64,118,162,13,1768
"36055008800",595,465,830,282,300,96,259,395,3222
"36055009200",119,346,307,303,72,156,219,475,1997
"36055009301",411,374,330,834,403,195,654,452,3653
"36055009302",823,214,160,188,62,33,58,48,1586
"36055009400",979,576,411,486,182,216,278,168,3296
"36055009500",1009,159,827,804,58,125,72,56,3110
"36055009601",60,132,822,338,60,5,63,103,1583
"36055009602",303,94,394,755,83,347,155,175,2306
"36055009603",437,300,476,660,62,212,118,191,2456
"36055009604",343,88,251,89,68,139,245,139,1362
"36055010100",3309,181,56,35,81,0,166,11,3839
"36055010200",3560,146,20,0,86,0,18,0,3830
"36055010300",3398,60,62,8,53,25,62,4,3672
"36055010400",3609,399,307,142,381,44,530,69,5481
"36055010500",4214,122,90,0,127,8,33,0,4594
"36055010601",2038,185,230,98,288,46,465,103,3453
"36055010602",3354,264,149,2,228,15,313,15,4340
"36055010700",3074,118,45,77,47,0,119,0,3480
"36055010800",2449,136,118,34,152,0,220,0,3109
"36055010901",2075,213,1456,585,311,111,605,132,5488
"36055010902",2390,313,246,128,72,79,126,109,3463
"36055011000",3967,416,570,35,322,58,441,96,5905
"36055011100",3221,152,271,127,410,8,90,0,4279
"36055011201",3323,111,28,1,36,0,32,7,3538
"36055011203",1810,50,18,5,86,9,16,0,1994
"36055011205",4881,108,77,0,157,10,74,0,5307
"36055011207",4652,138,26,12,164,2,120,32,5146
"36055011208",4412,399,56,0,472,0,43,0,5382
"36055011301",7106,199,121,0,287,29,64,0,7806
"36055011302",5683,122,19,2,66,0,46,2,5940
"36055011400",6004,1530,210,23,824,267,224,263,9345
"36055011501",5916,252,45,3,563,16,509,3,7307
"36055011503",5086,131,48,19,93,24,135,24,5560
"36055011504",5306,77,39,28,845,0,140,0,6435
"36055011505",5573,282,4,9,262,0,38,0,6168
"36055011601",5207,322,318,13,159,68,79,35,6201
"36055011603",825,206,5,0,113,23,93,29,1294
"36055011604",2394,34,0,0,44,0,34,2,2508
"36055011605",1817,38,44,3,132,0,168,0,2202
"36055011703",7780,254,97,28,432,90,279,0,8960
"36055011705",4660,229,4,4,194,0,55,0,5146
"36055011706",4070,207,0,1,364,0,88,0,4730
"36055011707",6555,345,0,2,278,0,72,1,7253
"36055011708",2909,145,150,0,230,0,29,0,3463
"36055011800",4835,148,2,4,309,1,36,21,5356
"36055011901",4513,846,5,133,465,34,251,0,6247
"36055011902",5355,365,79,3,118,0,149,2,6071
"36055012000",2033,450,15,201,69,33,113,14,2928
"36055012100",2990,465,148,73,160,41,92,135,4104
"36055012201",2996,232,214,7,124,37,51,35,3696
"36055012202",3085,159,65,14,77,0,68,6,3474
"36055012301",5164,294,86,27,407,0,81,3,6062
"36055012304",3831,78,39,1,475,0,49,57,4530
"36055012305",3736,51,58,1,475,0,177,6,4504
"36055012306",4044,106,56,26,994,29,68,3,5326
"36055012401",2680,261,24,0,68,0,54,0,3087
"36055012402",5797,154,28,0,193,0,66,0,6238
"36055012500",3790,113,124,37,276,14,55,0,4409
"36055012600",3994,201,87,0,287,26,319,1,4915
"36055012700",3310,80,88,2,243,42,236,0,4001
"36055012800",3627,331,248,133,560,12,329,1,5241
"36055012900",4072,185,264,30,604,23,44,0,5222
"36055013001",2440,604,267,140,1578,710,77,0,5816
"36055013002",4427,570,373,27,812,41,380,16,6646
"36055013101",5048,321,409,0,534,61,271,176,6820
"36055013103",909,721,153,0,247,142,52,214,2438
"36055013104",3110,564,775,53,735,56,210,39,5542
"36055013203",4350,386,435,277,319,6,223,1,5997
"36055013204",6227,631,535,171,888,46,136,43,8677
"36055013205",2988,655,357,56,566,56,25,56,4759
"36055013206",4455,413,512,0,1008,208,319,22,6937
"36055013300",3200,140,24,8,45,0,75,1,3493
"36055013401",3275,426,307,83,177,43,274,38,4623
"36055013402",2851,155,173,0,153,0,19,17,3368
"36055013503",5089,55,48,23,244,0,276,0,5735
"36055013505",3139,285,178,30,208,0,194,29,4063
"36055013506",7272,368,546,0,283,53,353,42,8917
"36055013507",5485,166,106,34,108,0,63,0,5962
"36055013508",3516,77,156,12,155,0,53,0,3969
"36055013601",4146,312,391,51,155,38,158,44,5295
"36055013603",4776,68,123,0,364,10,321,0,5662
"36055013604",3948,355,541,296,88,19,102,134,5483
"36055013701",1960,222,1,12,78,0,102,88,2463
"36055013702",3275,232,7,1,102,12,274,10,3913
"36055013800",4386,1583,85,49,136,404,297,128,7068
"36055013901",3057,152,248,40,487,45,176,0,4205
"36055013902",2279,285,534,506,226,99,277,113,4319
"36055014001",3624,225,368,111,286,11,180,33,4838
"36055014003",3745,301,154,68,167,42,112,72,4661
"36055014004",2929,205,264,0,153,23,179,0,3753
"36055014102",3030,282,335,31,138,79,70,79,4044
"36055014103",3645,318,113,20,183,20,174,42,4515
"36055014104",2729,143,24,348,303,123,268,103,4041
"36055014202",5283,572,590,50,292,64,83,79,7013
"36055014203",4668,693,544,113,633,60,274,508,7493
"36055014204",1915,95,275,8,162,14,69,0,2538
"36055014301",2220,277,137,179,126,12,313,82,3346
"36055014302",3755,358,571,0,277,73,57,64,5155
"36055014400",3408,203,472,54,261,39,179,32,4648
"36055014501",3565,92,368,34,111,24,75,2,4271
"36055014503",2603,235,417,0,203,0,102,85,3645
"36055014504",4584,75,659,1,228,0,63,0,5610
"36055014505",4290,318,77,46,259,149,211,114,5464
"36055014601",4838,144,117,107,29,48,217,34,5534
"36055014602",3486,338,658,143,130,0,201,116,5072
"36055014700",3838,231,348,189,138,26,72,117,4959
"36055014802",4645,387,168,0,114,0,124,60,5498
"36055014803",3268,157,0,0,88,0,70,14,3597
"36055014804",6413,234,3,199,140,7,267,96,7359
"36055014901",4941,389,97,2,242,0,221,92,5984
"36055014903",4848,158,128,0,101,60,81,103,5479
"36055014905",4582,226,88,0,124,36,267,14,5337
"36055014906",3395,110,69,0,63,0,23,0,3660
"36055015000",4986,442,75,3,95,27,174,43,5845
"36055015101",4198,312,346,0,84,7,44,2,4993
"36055015102",3563,455,0,52,46,0,20,34,4170
"36055015200",5628,503,0,17,477,0,499,35,7159
"36055015301",272,153,0,36,37,16,0,0,514
"36055015303",2498,330,78,69,159,17,87,0,3238
"36055015304",2840,1090,69,0,205,184,24,102,4514
"36055015400",3231,287,13,0,82,11,67,54,3745
"36055980000",0,0,0,0,0,0,0,0,0
"36055980100",15,0,0,0,3,0,0,0,18
"36055990000",0,0,0,0,0,0,0,0,0
"36057070200",1091,634,1,0,69,345,118,538,2796
"36057070300",865,531,17,40,402,138,425,320,2738
"36057070400",1348,147,41,7,60,88,100,113,1904
"36057070500",1866,285,4,2,461,11,429,124,3182
"36057070600",1236,567,70,46,146,175,505,297,3042
"36057070700",1875,266,154,20,342,239,491,239,3626
"36057070800",1466,465,181,36,286,211,381,330,3356
"36057070900",582,360,15,91,251,284,350,415,2348
"36057072100",4795,777,43,0,51,13,156,11,5846
"36057072200",3272,248,20,2,225,14,198,11,3990
"36057072300",2357,701,20,1,63,9,32,19,3202
"36057072400",1746,628,11,7,24,6,39,9,2470
"36057072500",3044,1019,0,0,101,39,21,0,4224
"36057072600",2943,508,40,27,57,56,51,60,3742
"36057072700",3255,671,29,15,85,0,67,32,4154
"36057072800",3523,322,41,2,124,0,103,19,4134
"36059300100",4059,231,9,0,87,59,58,1,4504
"36059300300",3611,279,22,0,375,43,462,0,4792
"36059300400",4577,265,29,0,878,9,273,0,6031
"36059300500",4463,121,30,3,694,0,195,0,5506
"36059300600",4587,285,15,2,1562,122,209,31,6813
"36059300700",4515,181,12,18,1058,174,582,77,6617
"36059300800",1996,172,246,0,1667,41,158,0,4280
"36059300900",5037,70,29,25,2381,126,90,6,7764
"36059301000",4944,123,43,0,469,34,144,51,5808
"36059301101",4320,302,45,15,1693,309,1445,345,8474
"36059301102",4106,45,155,1,481,57,334,0,5179
"36059301200",5291,93,15,0,507,70,842,50,6868
"36059301300",2745,36,318,149,915,51,947,48,5209
"36059301400",1896,21,0,0,182,0,86,0,2185
"36059301500",2643,83,0,0,346,7,120,3,3202
"36059301600",3603,369,32,2,754,10,265,135,5170
"36059301700",2467,64,0,0,174,6,129,0,2840
"36059301800",2998,326,760,31,988,40,807,196,6146
"36059301900",2514,5,0,0,278,0,126,0,2923
"36059302000",3722,229,48,0,564,29,149,0,4741
"36059302101",3739,164,10,0,303,40,72,0,4328
"36059302102",2816,145,0,2,408,29,231,0,3631
"36059302200",2426,153,217,138,1374,16,612,0,4936
"36059302300",2428,32,47,8,2250,0,74,0,4839
"36059302400",3776,141,0,1,1226,2,359,64,5569
"36059302501",1866,69,0,0,703,26,64,20,2748
"36059302502",1719,47,80,2,739,37,108,38,2770
"36059302600",1694,62,28,7,701,19,394,20,2925
"36059302700",2315,111,25,0,1870,155,274,0,4750
"36059302800",3640,21,161,0,2303,130,583,0,6838
"36059302900",3013,94,69,2,1205,63,406,30,4882
"36059303000",3235,144,9,1,2254,70,665,1,6379
"36059303101",1802,12,0,0,1921,20,601,0,4356
"36059303102",2217,17,27,0,2067,0,243,0,4571
"36059303201",1540,0,50,0,2184,55,299,0,4128
"36059303202",2476,104,15,2,1700,95,1030,95,5517
"36059303301",2281,90,0,1,896,0,284,89,3641
"36059303302",3387,50,36,2,435,144,341,145,4540
"36059303400",2237,33,12,0,281,22,163,0,2748
"36059303500",3788,106,17,0,1093,202,694,237,6137
"36059303600",4627,287,175,81,1711,342,1816,340,9379
"36059303700",5515,106,186,0,726,0,907,84,7524
"36059303800",3783,246,196,83,706,138,429,11,5592
"36059303900",1367,45,1959,59,543,30,380,31,4414
"36059304001",2303,50,0,0,235,0,131,6,2725
"36059304002",2492,111,334,39,1252,115,1304,95,5742
"36059304100",601,269,1164,3,1950,389,1717,523,6616
"36059304202",1538,97,604,0,1001,167,1625,157,5189
"36059304203",755,56,2451,237,1852,147,2079,218,7795
"36059304204",487,69,1669,437,1574,608,1944,611,7399
"36059404300",1914,73,36,0,1109,4,595,9,3740
"36059404400",4596,143,0,0,226,11,365,0,5341
"36059404500",3672,55,143,3,321,16,662,0,4872
"36059404600",3794,114,21,0,467,0,409,0,4805
"36059404700",4268,93,104,1,1652,70,955,47,7190
"36059404800",1781,76,2441,390,2328,185,1732,31,8964
"36059404901",706,53,4039,71,813,44,627,81,6434
"36059404902",415,94,2448,141,1254,524,741,510,6127
"36059405000",1510,80,1591,77,2344,135,971,161,6869
"36059405100",1391,68,4409,150,1991,93,1500,92,9694
"36059405200",1662,122,2299,265,2914,485,1502,388,9637
"36059405301",2503,209,186,9,779,43,624,25,4378
"36059405302",3066,216,36,0,742,33,683,24,4800
"36059405400",4493,139,524,104,2853,301,1791,30,10235
"36059405500",4629,279,34,0,512,45,640,98,6237
"36059405600",3679,49,80,1,802,0,511,0,5122
"36059405700",4089,150,53,0,638,120,763,17,5830
"36059405800",3440,102,27,9,579,108,447,17,4729
"36059405900",3886,66,378,0,585,82,781,82,5860
"36059406001",3358,168,164,5,876,337,687,125,5720
"36059406002",2444,90,358,16,365,81,548,119,4021
"36059406100",2180,45,209,9,273,21,438,0,3175
"36059406201",1513,64,361,7,916,129,830,139,3959
"36059406202",712,110,4729,195,429,333,908,443,7859
"36059406300",3223,171,13,0,249,124,181,18,3979
"36059406400",6510,152,0,0,107,19,212,0,7000
"36059406501",6234,290,1,13,163,1,254,1,6957
"36059406600",3869,46,0,0,309,28,194,0,4446
"36059406701",642,233,756,221,907,364,1302,534,4959
"36059406702",981,133,1486,716,1002,519,1038,500,6375
"36059406801",544,86,1463,491,1571,287,1952,365,6759
"36059406802",732,212,1095,89,1774,663,2452,813,7830
"36059406900",740,328,2536,785,1621,765,2009,760,9544
"36059407000",196,33,3470,966,2776,512,2785,406,11144
"36059407101",474,242,3433,235,928,165,1202,394,7073
"36059407102",1236,43,3694,222,717,134,1875,187,8108
"36059407201",649,351,1016,584,1774,757,2198,797,8126
"36059407203",310,91,1477,278,905,124,1039,94,4318
"36059407204",354,212,997,106,608,240,569,318,3404
"36059407301",1985,67,469,80,200,18,142,19,2980
"36059407302",1457,307,1408,204,1022,398,1471,188,6455
"36059407401",955,246,2611,372,1090,207,1512,378,7371
"36059407402",680,49,1365,105,838,291,1083,316,4727
"36059407501",563,192,2268,140,1607,249,2008,412,7439
"36059407502",683,61,2762,190,1848,41,2358,61,8004
"36059407600",3669,219,182,0,1254,117,590,33,6064
"36059407700",3595,120,0,1,1347,61,1144,47,6315
"36059407801",4050,217,47,0,1074,141,931,168,6628
"36059407802",345,23,0,0,228,72,61,0,729
"36059407900",4348,179,534,1,611,149,294,62,6178
"36059408000",5030,106,131,5,1000,0,639,33,6944
"36059408100",5108,138,25,208,918,113,500,0,7010
"36059408200",4772,112,157,0,1330,0,1066,0,7437
"36059408300",5373,104,155,0,953,76,879,41,7581
"36059408400",3370,24,108,1,214,11,345,21,4094
"36059408500",5581,67,105,2,467,35,200,0,6457
"36059408600",3433,249,41,0,914,32,905,32,5606
"36059408700",3934,103,120,0,349,11,549,11,5077
"36059408800",6151,65,125,12,543,53,785,53,7787
"36059408900",4746,123,40,13,792,96,553,22,6385
"36059409000",5009,158,42,0,526,0,694,14,6443
"36059409100",4223,92,18,0,783,0,534,0,5650
"36059409200",4876,206,2,0,878,0,839,11,6812
"36059409300",3739,44,0,0,436,36,354,27,4636
"36059409400",3394,125,21,2,765,74,658,0,5039
"36059409500",3836,61,0,0,152,0,141,0,4190
"36059409600",4541,111,14,2,336,0,543,0,5547
"36059409700",3721,67,19,0,223,48,160,7,4245
"36059409800",724,117,3911,122,719,0,565,31,6189
"36059409900",1883,143,4584,78,1743,206,887,132,9656
"36059410000",1504,82,1031,0,847,34,517,12,4027
"36059410100",5209,47,203,1,381,0,283,0,6124
"36059410200",3131,162,96,0,353,0,301,0,4043
"36059410300",2331,82,1855,118,2167,231,2214,151,9149
"36059410400",1070,7,1995,196,1997,124,1563,29,6981
"36059410500",2541,231,1837,25,1942,457,1691,542,9266
"36059410600",3493,272,832,49,2508,226,1947,216,9543
"36059410700",3727,666,345,9,1596,25,1394,314,8076
"36059410800",2971,30,482,37,1307,36,1006,0,5869
"36059410900",2676,125,2041,144,1447,155,804,2,7394
"36059411000",1931,219,596,217,1885,236,1790,218,7092
"36059411100",748,173,1307,220,1785,642,1976,683,7534
"36059411200",5202,198,0,0,1029,222,1132,110,7893
"36059411301",3149,97,318,0,389,8,222,8,4191
"36059411302",6574,123,50,0,43,0,279,0,7069
"36059411400",4828,350,151,83,598,74,462,241,6787
"36059411500",2509,48,36,0,68,13,73,0,2747
"36059411600",6320,98,20,8,82,1,55,0,6584
"36059411700",5221,142,40,30,481,118,225,0,6257
"36059411800",5093,178,367,8,414,1,584,1,6646
"36059411901",2857,143,37,0,389,105,444,86,4061
"36059411902",3001,178,114,0,442,0,594,31,4360
"36059412000",5103,350,245,1,518,0,1287,38,7542
"36059412100",5978,146,31,43,234,18,1041,100,7591
"36059412200",5031,96,0,0,25,28,239,28,5447
"36059412301",2429,112,23,8,618,37,623,28,3878
"36059412302",2764,145,47,123,501,0,429,34,4043
"36059412400",3947,83,493,150,265,279,514,286,6017
"36059412500",4153,27,49,0,161,8,250,0,4648
"36059412600",3309,201,21,0,187,0,179,0,3897
"36059412700",3702,0,23,0,77,0,254,0,4056
"36059412800",2194,76,455,0,406,0,628,0,3759
"36059412900",1055,91,3514,67,975,104,951,94,6851
"36059413001",2900,370,1,1,323,24,424,138,4181
"36059413002",3206,76,0,0,334,122,323,122,4183
"36059413100",4250,273,47,2,451,9,571,0,5603
"36059413200",5338,355,117,0,118,18,302,89,6337
"36059413300",5746,162,10,2,404,0,401,2,6727
"36059413400",5095,152,27,2,235,82,594,0,6187
"36059413500",3693,273,2220,87,1968,54,2442,57,10794
"36059413600",2934,133,865,196,608,492,1060,464,6752
"36059413700",3328,470,632,169,290,224,556,587,6256
"36059413803",2177,134,1178,82,509,50,636,114,4880
"36059413804",2145,96,942,0,370,17,422,7,3999
"36059413900",1122,199,3377,847,1576,318,2504,435,10378
"36059414001",130,31,2870,126,887,34,842,34,4954
"36059414002",857,229,2368,355,1096,61,1691,300,6957
"36059414100",1036,312,3373,158,1224,1,1634,214,7952
"36059414201",1577,332,1084,93,1822,600,2509,748,8765
"36059414202",1025,366,1702,245,634,235,1442,498,6147
"36059414301",1286,258,1066,30,888,118,1486,285,5417
"36059414303",1960,51,1234,47,916,220,1437,194,6059
"36059414304",895,233,683,53,1201,565,1630,617,5877
"36059414400",1026,259,2107,277,1099,917,1898,1070,8653
"36059414501",3079,191,1368,71,451,82,1291,81,6614
"36059414502",2671,91,517,0,791,94,975,97,5236
"36059414600",3175,131,9,0,439,1,272,1,4028
"36059414700",4043,125,17,0,399,0,273,0,4857
"36059414800",5443,168,3,0,822,57,783,12,7288
"36059414900",5845,355,93,1,819,167,602,23,7905
"36059415000",5240,427,44,2,353,1,634,36,6737
"36059415101",2199,42,172,0,153,0,101,6,2673
"36059415102",4434,65,47,0,169,0,124,0,4839
"36059415201",2903,45,154,18,214,1,245,31,3611
"36059415202",3611,75,0,0,180,9,347,9,4231
"36059415300",5728,63,74,0,266,0,629,8,6768
"36059415401",4771,121,55,2,223,5,179,0,5356
"36059415402",4153,62,0,2,298,47,95,0,4657
"36059415500",2544,53,11,0,23,0,132,0,2763
"36059415600",4972,218,1,4,297,0,278,0,5770
"36059415700",5500,181,1,1,263,0,332,7,6285
"36059415802",7160,73,44,0,219,5,494,0,7995
"36059416000",3484,138,0,0,253,0,329,0,4204
"36059416100",6265,274,0,0,160,0,239,15,6953
"36059416201",3205,107,47,31,346,19,517,30,4302
"36059416202",3171,480,4,1,598,291,841,389,5775
"36059416300",3414,94,68,0,61,0,197,24,3858
"36059416401",3646,130,26,0,123,0,255,11,4191
"36059416402",2449,65,96,98,113,27,164,27,3039
"36059416500",2906,132,817,373,1400,335,1431,351,7745
"36059416600",4418,314,197,15,400,13,662,13,6032
"36059416701",3487,57,60,1,594,28,937,11,5175
"36059416702",3180,77,15,125,691,49,526,36,4699
"36059416801",1859,27,0,91,206,12,130,27,2352
"36059416802",3424,308,0,0,30,0,130,23,3915
"36059416900",3761,53,2,1,35,0,268,0,4120
"36059517000",2520,124,116,3,262,18,282,9,3334
"36059517101",2638,259,386,101,1539,398,1728,426,7475
"36059517102",1746,98,3,1,259,0,145,0,2252
"36059517200",3166,352,912,470,2600,1099,2435,867,11901
"36059517301",1881,389,79,0,332,71,408,252,3412
"36059517302",3110,230,226,8,938,269,680,260,5721
"36059517400",4379,173,146,0,204,67,146,67,5182
"36059517500",3372,61,25,0,312,0,234,3,4007
"36059517600",4113,31,117,8,302,49,254,49,4923
"36059517701",5748,163,288,4,1585,65,259,61,8173
"36059517705",2190,39,60,8,399,14,129,10,2849
"36059517801",2965,82,34,12,223,26,190,5,3537
"36059517802",2761,91,83,14,309,12,490,0,3760
"36059517901",4594,140,0,6,139,38,325,2,5244
"36059517902",2513,186,11,1,101,24,118,15,2969
"36059518000",5622,164,292,2,415,67,566,46,7174
"36059518100",2561,110,0,0,80,0,190,0,2941
"36059518201",3725,145,56,8,372,14,160,4,4484
"36059518203",2945,75,30,3,519,51,70,6,3699
"36059518204",3516,169,47,3,300,0,70,0,4105
"36059518300",4047,295,0,4,1166,137,201,50,5900
"36059518400",3227,59,3,6,1177,0,249,3,4724
"36059518501",3733,354,167,45,2116,73,83,0,6571
"36059518502",1686,137,53,0,1276,46,139,0,3337
"36059518600",2895,22,0,0,1184,29,72,1,4203
"36059518700",3623,114,19,80,1549,62,224,0,5671
"36059518800",2396,5,35,19,965,50,119,20,3609
"36059518900",3832,124,1081,23,1900,16,612,96,7684
"36059519000",4357,164,235,1,1706,124,697,68,7352
"36059519100",4097,208,0,2,1732,18,794,0,6851
"36059519200",4217,462,9,26,1495,47,665,116,7037
"36059519300",3661,171,176,63,1921,61,1343,75,7471
"36059519400",3380,123,0,0,718,28,239,25,4513
"36059519500",4193,140,3,0,1746,50,693,68,6893
"36059519601",3438,52,0,4,886,100,249,27,4756
"36059519602",1781,89,0,0,156,0,46,0,2072
"36059519702",4604,112,166,0,625,0,167,0,5674
"36059519703",2818,0,21,0,576,36,156,0,3607
"36059519704",2393,78,7,0,516,25,95,1,3115
"36059519801",1999,24,0,0,613,0,283,0,2919
"36059519802",4073,132,64,0,624,86,210,28,5217
"36059519900",4790,35,72,3,266,11,162,0,5339
"36059520001",6306,154,1,0,529,0,314,0,7304
"36059520002",3445,206,1,2,436,40,392,0,4522
"36059520100",4763,143,0,6,340,0,111,0,5363
"36059520200",2862,63,0,3,446,0,353,0,3727
"36059520300",5544,184,14,0,227,0,490,11,6470
"36059520401",2847,185,79,0,668,6,482,29,4296
"36059520402",3771,200,60,18,392,30,667,69,5207
"36059520501",3390,142,7,0,421,9,620,0,4589
"36059520502",4600,118,167,11,193,38,262,0,5389
"36059520600",5053,53,106,156,635,0,780,105,6888
"36059520700",4699,144,171,0,98,8,297,8,5425
"36059520800",3497,217,0,1,143,1,265,22,4146
"36059520900",4290,72,51,0,202,0,158,0,4773
"36059521000",4512,468,0,0,100,0,223,75,5378
"36059521100",4683,71,0,0,94,9,258,9,5124
"36059521200",2719,78,75,1,121,14,152,0,3160
"36059521301",2049,17,7,6,93,0,148,0,2320
"36059521302",5037,115,0,0,142,13,393,48,5748
"36059521400",6378,3,0,2,381,0,246,0,7010
"36059521500",4567,87,21,0,180,0,426,0,5281
"36059521601",4217,83,9,0,67,1,159,1,4537
"36059521602",3142,0,11,0,64,0,224,0,3441
"36059521700",4315,233,14,0,123,10,446,11,5152
"36059521801",3395,118,162,0,60,0,202,8,3945
"36059521802",3808,80,38,48,132,0,301,63,4470
"36059521902",3915,45,2,2,102,0,218,19,4303
"36059522000",3367,486,1692,42,1824,320,2477,429,10637
"36059522700",5014,36,1,0,29,2,317,0,5399
"36059980100",0,0,0,0,0,0,0,0,0
"36059981100",0,0,0,0,0,0,0,0,0
"36059982100",0,0,0,0,0,0,0,0,0
"36059990100",0,0,0,0,0,0,0,0,0
"36059990200",0,0,0,0,0,0,0,0,0
"36059990301",0,0,0,0,0,0,0,0,0
"36059990302",0,0,0,0,0,0,0,0,0
"36059990400",0,0,0,0,0,0,0,0,0
"36061000100",0,0,0,0,0,0,0,0,0
"36061000201",354,289,58,121,1023,946,634,351,3776
"36061000202",2143,710,902,239,2811,963,2128,729,10625
"36061000500",0,0,0,0,0,0,0,0,0
"36061000600",540,533,42,1437,6258,3568,2779,1318,16475
"36061000700",5850,574,207,7,1803,353,525,56,9375
"36061000800",568,162,76,8,6081,2570,308,46,9819
"36061000900",1195,65,30,0,303,33,133,0,1759
"36061001001",1030,69,55,8,354,12,392,12,1932
"36061001002",902,722,559,595,2187,1001,2602,1359,9927
"36061001200",1681,246,126,8,1241,396,815,267,4780
"36061001300",2951,206,104,0,997,116,408,55,4837
"36061001401",2238,131,87,0,612,47,323,49,3487
"36061001402",775,313,182,15,1067,580,371,295,3598
"36061001501",3710,238,248,48,1412,328,580,32,6596
"36061001502",4296,393,176,2,1454,144,286,52,6803
"36061001600",1153,71,54,0,3733,2539,325,53,7928
"36061001800",2423,417,114,180,3430,1502,538,251,8855
"36061002000",688,434,572,403,1266,1501,1439,1373,7676
"36061002100",5093,90,67,21,1246,80,206,4,6807
"36061002201",1527,536,945,247,2467,1109,2052,859,9742
"36061002202",1065,165,44,51,559,135,187,107,2313
"36061002400",1159,249,343,541,1931,1334,2022,770,8349
"36061002500",461,287,489,270,1713,1859,1026,859,6964
"36061002601",1418,291,224,310,1394,442,1577,397,6053
"36061002602",2302,145,91,59,1264,402,657,266,5186
"36061002700",268,9,8,1,909,148,20,0,1363
"36061002800",2203,617,723,399,1784,1484,2080,1391,10681
"36061002900",274,43,119,0,3322,922,119,17,4816
"36061003001",2186,401,68,6,1288,266,455,299,4969
"36061003002",1464,266,209,90,619,172,510,190,3520
"36061003100",767,33,61,50,541,124,49,47,1672
"36061003200",5741,498,144,79,1000,267,356,80,8165
"36061003300",3914,174,168,0,717,32,363,12,5380
"36061003400",4133,971,53,43,728,548,874,249,7599
"36061003601",1181,196,232,196,759,674,841,378,4457
"36061003602",1525,327,59,211,572,169,239,202,3304
"36061003700",2105,65,40,0,304,60,172,21,2767
"36061003800",5254,728,179,14,1631,399,514,190,8909
"36061003900",3781,248,248,17,862,60,482,96,5794
"36061004000",5259,862,497,43,602,45,466,150,7924
"36061004100",2397,214,58,126,3677,1049,288,127,7936
"36061004200",2125,206,89,73,376,57,62,19,3007
"36061004300",2284,243,2,4,1211,520,327,9,4600
"36061004400",11197,1297,495,148,2378,685,1077,130,17407
"36061004500",671,10,1,2,275,25,25,0,1009
"36061004700",1833,200,0,0,262,65,60,11,2431
"36061004800",4012,397,221,88,1381,91,242,116,6548
"36061004900",3617,184,114,0,449,24,202,16,4606
"36061005000",3684,357,46,0,811,40,301,30,5269
"36061005200",1980,225,0,38,631,91,149,30,3144
"36061005400",3390,182,16,0,799,25,364,3,4779
"36061005501",2963,116,99,0,908,84,10,0,4180
"36061005502",1614,177,44,95,329,19,300,51,2629
"36061005600",1794,434,69,117,514,30,129,95,3182
"36061005700",2247,98,94,0,427,33,112,53,3064
"36061005800",2097,109,18,41,922,0,59,38,3284
"36061005900",4070,160,108,0,456,27,174,15,5010
"36061006000",3812,198,92,35,600,326,232,92,5387
"36061006100",3165,89,0,0,322,96,132,0,3804
"36061006200",1381,463,247,426,606,418,323,140,4004
"36061006300",4938,141,44,23,921,81,241,49,6438
"36061006400",5291,541,298,27,1429,95,376,1,8058
"36061006500",3993,578,156,23,580,65,205,65,5665
"36061006600",6402,918,237,137,2830,579,2622,569,14294
"36061006700",4151,194,86,1,528,51,141,20,5172
"36061006800",4369,291,170,237,878,153,526,62,6686
"36061006900",1718,90,46,8,345,70,168,10,2455
"36061007000",5180,408,363,11,1782,387,194,29,8354
"36061007100",4455,384,35,38,929,63,113,42,6059
"36061007200",4742,236,65,13,1867,427,513,27,7890
"36061007300",4712,294,49,63,520,39,408,134,6219
"36061007400",2287,316,34,47,547,34,328,0,3593
"36061007500",3829,162,19,3,298,30,340,4,4685
"36061007600",771,150,50,0,736,205,37,16,1965
"36061007700",4745,147,129,0,529,49,478,0,6077
"36061007800",5433,595,277,6,1714,7,406,104,8542
"36061007900",3531,330,13,0,195,32,234,21,4356
"36061008000",3795,424,59,38,571,59,279,33,5258
"36061008100",6895,741,93,41,990,129,692,122,9703
"36061008200",2184,144,103,0,547,82,59,47,3166
"36061008300",1917,366,376,65,909,296,913,285,5127
"36061008400",885,117,53,10,799,190,113,33,2200
"36061008601",1946,156,39,0,666,0,148,6,2961
"36061008602",0,0,0,0,0,0,0,0,0
"36061008603",3696,139,17,0,340,80,225,28,4525
"36061008700",5664,328,59,0,1108,0,850,30,8039
"36061008800",4527,348,152,0,1586,168,349,0,7130
"36061008900",3729,320,214,204,622,117,543,256,6005
"36061009000",4760,334,96,78,1799,239,638,96,8040
"36061009100",4219,386,94,154,1475,337,345,92,7102
"36061009200",1328,51,17,32,279,10,57,36,1810
"36061009300",6118,412,443,1791,1472,414,1542,536,12728
"36061009400",11,0,0,0,4,0,0,0,15
"36061009500",1575,147,81,1,403,178,79,0,2464
"36061009600",86,0,0,0,51,12,7,0,156
"36061009700",3142,564,125,57,990,244,1044,399,6565
"36061009800",6100,176,70,59,1169,80,371,14,8039
"36061009900",2965,222,183,23,1326,112,309,13,5153
"36061010000",1280,111,19,4,239,28,209,18,1908
"36061010100",673,44,30,44,413,55,60,13,1332
"36061010200",201,19,0,2,36,0,7,1,266
"36061010300",1109,64,143,14,435,76,56,20,1917
"36061010400",683,57,16,6,205,15,69,1,1052
"36061010601",6317,264,105,25,437,111,317,0,7576
"36061010602",3303,206,214,0,730,0,255,0,4708
"36061010800",7054,262,122,0,1118,69,442,1,9068
"36061010900",104,5,13,6,38,20,0,2,188
"36061011000",6156,301,245,74,656,24,578,0,8034
"36061011100",2515,241,312,127,1098,387,552,318,5550
"36061011201",643,42,10,0,80,17,30,0,822
"36061011202",253,13,0,0,21,0,4,0,291
"36061011203",876,59,0,26,163,42,68,6,1240
"36061011300",18,6,7,18,77,0,0,6,132
"36061011401",1136,28,9,5,90,8,21,4,1301
"36061011402",1983,82,11,0,257,12,73,18,2436
"36061011500",1486,253,194,147,771,167,510,194,3722
"36061011600",1841,158,355,1,599,0,109,27,3090
"36061011700",2216,210,350,1,825,268,596,240,4706
"36061011800",7866,515,35,4,774,81,358,0,9633
"36061011900",229,249,199,268,47,76,74,178,1320
"36061012000",2781,152,10,31,165,19,118,61,3337
"36061012100",5531,584,228,157,1621,71,1421,160,9773
"36061012200",2951,101,0,0,74,0,94,15,3235
"36061012400",6557,644,395,29,2154,21,863,50,10713
"36061012500",1414,122,23,37,828,59,154,25,2662
"36061012600",9765,288,168,32,2161,13,750,5,13182
"36061012700",3963,495,168,93,1971,284,1463,357,8794
"36061012800",5587,279,7,0,353,0,340,18,6584
"36061012900",3470,319,137,196,1412,204,642,210,6590
"36061013000",2875,211,4,9,161,13,78,74,3425
"36061013100",1679,347,108,20,433,188,264,233,3272
"36061013200",8530,570,0,0,854,141,406,180,10681
"36061013300",3009,222,199,99,934,383,922,184,5952
"36061013400",8593,1358,201,9,1225,302,760,169,12617
"36061013500",3519,658,562,243,1033,266,1766,528,8575
"36061013600",13779,477,187,0,1427,10,1187,1,17068
"36061013700",4992,382,42,22,1099,161,316,7,7021
"36061013800",10744,802,64,37,1118,110,734,88,13697
"36061013900",5560,451,457,2,1619,147,743,77,9056
"36061014000",6365,484,109,0,671,42,257,137,8065
"36061014200",3895,258,5,6,303,0,211,10,4688
"36061014300",0,1,0,2,0,1,0,2,6
"36061014401",4589,152,16,0,407,64,264,35,5527
"36061014402",6384,346,264,48,612,21,155,60,7890
"36061014500",3362,160,85,4,728,26,314,18,4697
"36061014601",3632,127,34,28,626,16,219,23,4705
"36061014602",6736,305,91,0,583,33,558,0,8306
"36061014700",2057,58,80,13,918,23,340,5,3494
"36061014801",2446,79,61,0,439,56,166,34,3281
"36061014802",5361,144,104,0,939,203,459,18,7228
"36061014900",4644,158,11,18,643,110,386,31,6001
"36061015001",1597,176,0,0,112,67,55,0,2007
"36061015002",4715,178,36,3,239,0,624,28,5823
"36061015100",3777,330,671,239,1395,1069,1015,1071,9567
"36061015200",4569,410,748,343,1266,238,1174,567,9315
"36061015300",7908,303,125,2,949,71,957,32,10347
"36061015400",10633,1139,705,57,2009,150,1487,335,16515
"36061015500",7705,523,143,0,1718,62,176,0,10327
"36061015601",3540,494,408,0,921,27,547,171,6108
"36061015602",777,97,192,229,688,132,723,167,3005
"36061015700",7776,504,111,29,952,84,618,37,10111
"36061015801",4594,214,189,6,480,43,263,113,5902
"36061015802",2382,117,177,11,1031,90,386,51,4245
"36061015900",7368,716,144,81,613,197,449,117,9685
"36061016001",3415,68,2,11,365,0,214,9,4084
"36061016002",1935,225,81,28,647,76,326,49,3367
"36061016100",5211,136,125,16,679,22,245,0,6434
"36061016200",1737,642,2611,1221,1153,1822,2306,2353,13845
"36061016300",5512,421,35,45,914,145,303,29,7404
"36061016400",1690,484,1656,388,1892,791,2068,982,9951
"36061016500",5254,330,389,24,697,66,699,150,7609
"36061016600",2507,821,763,243,2117,687,2783,1198,11119
"36061016700",5064,495,95,14,790,10,441,0,6909
"36061016800",1072,327,727,748,734,444,1170,634,5856
"36061016900",6309,269,256,73,631,238,391,101,8268
"36061017000",1674,331,1781,494,2002,1525,2442,1214,11463
"36061017100",7167,478,497,217,630,70,799,188,10046
"36061017200",1396,359,1107,402,1880,511,2827,732,9214
"36061017300",6293,149,284,134,1582,44,1706,6,10198
"36061017401",721,296,990,703,831,466,896,1001,5904
"36061017402",489,164,752,287,397,220,507,211,3027
"36061017500",9160,197,107,152,733,17,1393,14,11773
"36061017700",4955,358,1114,642,1718,669,2037,780,12273
"36061017800",1144,376,494,298,1216,258,1530,446,5762
"36061017900",6187,674,151,144,1743,165,1589,318,10971
"36061018000",972,594,1585,509,3576,1020,3688,1420,13364
"36061018100",5297,463,1823,158,1223,44,1247,60,10315
"36061018200",964,349,944,805,2201,1943,2641,1831,11678
"36061018300",6339,213,154,197,1190,117,1145,208,9563
"36061018400",817,457,2618,1072,1774,1058,2482,1502,11780
"36061018500",3026,258,780,38,998,74,400,3,5577
"36061018600",454,724,2311,1426,1194,1012,1218,1542,9881
"36061018700",6062,250,317,433,910,312,311,520,9115
"36061018800",1206,451,1061,388,1568,778,2083,890,8425
"36061018900",2763,1614,2283,1550,2808,1252,2753,3030,18053
"36061019000",576,49,1469,439,533,67,319,79,3531
"36061019100",6555,504,487,392,1367,54,951,104,10414
"36061019200",236,290,657,1141,867,864,987,1290,6332
"36061019300",3264,1020,1483,750,1506,1187,2042,2103,13355
"36061019400",667,190,1066,1564,1383,1974,1733,2127,10704
"36061019500",5082,614,448,64,1073,247,1109,263,8900
"36061019600",631,242,798,447,1073,802,1170,864,6027
"36061019701",392,103,75,7,107,225,74,92,1075
"36061019702",575,220,694,166,311,161,309,185,2621
"36061019800",488,93,1330,272,254,54,265,104,2860
"36061019900",4535,768,190,173,1058,429,647,156,7956
"36061020000",737,126,1492,245,552,24,488,53,3717
"36061020101",423,68,31,1,91,36,22,1,673
"36061020102",1298,91,1795,604,403,99,812,145,5247
"36061020300",352,91,143,34,118,97,68,29,932
"36061020500",2127,66,20,25,310,10,125,38,2721
"36061020600",341,87,1538,552,311,96,345,198,3468
"36061020701",1205,290,53,86,652,427,292,176,3181
"36061020800",1141,217,2297,899,502,241,369,242,5908
"36061020901",258,142,1427,755,939,543,1049,620,5733
"36061021000",291,275,3371,1640,979,528,1068,877,9029
"36061021100",3167,678,1372,502,2185,1637,1176,664,11381
"36061021200",262,52,3069,225,469,106,881,136,5200
"36061021303",690,174,2257,1369,1013,557,976,707,7743
"36061021400",240,28,1811,677,186,65,232,10,3249
"36061021500",424,294,1797,554,446,205,490,303,4513
"36061021600",1882,386,3927,1187,621,410,712,509,9634
"36061021703",8,0,0,0,0,0,0,0,8
"36061021800",1239,362,2503,2133,849,436,796,434,8752
"36061021900",323,275,1802,1218,1498,1238,2031,1589,9974
"36061022000",861,118,2568,736,738,358,661,239,6279
"36061022102",509,31,1209,238,291,73,125,0,2476
"36061022200",801,68,613,1055,324,176,291,165,3493
"36061022301",1969,449,788,413,3247,1101,4393,1398,13758
"36061022302",718,209,617,403,835,650,1178,768,5378
"36061022400",730,267,2293,2700,1315,657,1740,785,10487
"36061022500",2769,345,1847,1306,2862,1140,4615,1397,16281
"36061022600",522,57,1763,1208,468,180,556,181,4935
"36061022700",1320,390,1771,690,743,327,936,616,6793
"36061022800",723,85,2491,1502,829,184,462,290,6566
"36061022900",1408,776,2432,625,2238,1059,2897,1547,12982
"36061023000",1185,262,4207,1825,1296,475,1722,849,11821
"36061023100",1936,435,1491,716,1883,353,2493,754,10061
"36061023200",406,276,4306,1316,1125,931,1590,1188,11138
"36061023300",1470,278,2143,651,1374,821,1812,1267,9816
"36061023400",533,195,2337,1088,657,352,704,652,6518
"36061023501",719,215,1826,1331,1353,1197,1186,1684,9511
"36061023502",240,57,986,351,206,0,264,39,2143
"36061023600",396,0,4576,1090,738,204,1100,278,8382
"36061023700",1634,344,2242,410,2288,526,3116,687,11247
"36061023801",4333,165,778,137,2757,587,1033,178,9968
"36061023802",868,124,15,85,315,57,65,56,1585
"36061023900",393,227,1420,158,362,250,918,463,4191
"36061024000",41,437,100,726,26,115,36,355,1836
"36061024100",1618,335,2294,326,1968,1370,2836,1654,12401
"36061024200",247,367,1278,894,508,628,579,1051,5552
"36061024301",604,382,1257,523,694,324,887,758,5429
"36061024302",472,493,2519,1795,1162,794,1635,1498,10368
"36061024500",2952,1624,1406,524,6752,2793,9288,3961,29300
"36061024700",2576,1041,752,271,2809,511,4108,1662,13730
"36061024900",146,56,210,151,563,180,678,295,2279
"36061025100",516,285,282,217,909,326,1374,521,4430
"36061025300",3266,1128,632,527,4860,1740,6668,2689,21510
"36061025500",1712,396,200,79,1567,933,1698,747,7332
"36061025700",1437,39,1765,305,758,142,669,140,5255
"36061025900",884,165,1579,459,655,413,770,526,5451
"36061026100",2101,978,1162,401,5541,3191,7679,4241,25294
"36061026300",1381,611,617,285,4884,1929,5629,2603,17939
"36061026500",2894,610,1103,143,2730,576,3909,1023,12988
"36061026700",801,163,63,5,577,160,786,201,2756
"36061026900",1489,521,427,212,4656,1158,6002,1523,15988
"36061027100",3665,1270,401,149,2960,1259,4569,1930,16203
"36061027300",4067,861,433,81,1255,238,1610,300,8845
"36061027500",2497,186,163,92,765,9,981,64,4757
"36061027700",1216,464,192,405,2398,1520,3219,2061,11475
"36061027900",2444,496,601,72,6328,1076,7213,1314,19544
"36061028100",2373,136,154,12,304,7,371,16,3373
"36061028300",3140,317,726,96,2891,532,4580,656,12938
"36061028500",1382,461,714,250,3477,1464,4438,2021,14207
"36061028700",1480,417,112,52,1441,633,1742,830,6707
"36061029100",1864,989,718,241,6136,2313,7920,3355,23536
"36061029300",2094,1303,572,228,3783,1401,5227,2860,17468
"36061029500",3411,439,190,51,3359,714,4228,930,13322
"36061029700",0,0,0,0,0,0,0,0,0
"36061029900",743,244,676,328,1430,1146,2216,1380,8163
"36061030300",1724,266,145,240,1279,1016,1610,1285,7565
"36061030700",2476,124,145,17,689,44,930,65,4490
"36061030900",1782,746,1186,754,3463,1307,4723,2064,16025
"36061031100",0,0,0,0,0,0,0,0,0
"36061031703",6097,343,165,0,2233,37,622,41,9538
"36061031704",4582,220,76,14,1969,26,917,0,7804
"36061031900",0,0,0,0,0,0,0,0,0
"36063020100",2654,565,74,65,35,122,27,31,3573
"36063020200",59,209,790,1230,25,171,6,49,2539
"36063020300",1359,163,185,226,67,108,0,79,2187
"36063020400",485,164,644,139,22,18,48,42,1562
"36063020500",684,348,295,513,26,167,32,7,2072
"36063020600",230,141,548,163,75,34,31,17,1239
"36063020700",1319,263,452,643,24,211,0,182,3094
"36063020900",875,409,480,805,14,101,18,110,2812
"36063021000",1329,540,357,256,143,113,5,40,2783
"36063021100",503,157,202,311,156,23,24,0,1376
"36063021200",980,398,364,176,164,159,71,69,2381
"36063021300",686,679,361,254,190,128,96,55,2449
"36063021400",1329,325,254,99,28,53,13,4,2105
"36063021700",1633,761,607,170,68,67,0,45,3351
"36063022000",2615,385,84,38,282,9,96,0,3509
"36063022100",1986,237,54,0,130,9,0,9,2425
"36063022200",2815,296,329,0,87,37,47,6,3617
"36063022300",2285,69,68,21,110,92,5,0,2650
"36063022401",1617,117,43,14,67,0,34,6,1898
"36063022500",2486,131,26,14,103,0,16,0,2776
"36063022601",1839,421,75,35,121,16,103,0,2610
"36063022602",4714,683,205,64,46,1,31,0,5744
"36063022702",6288,216,0,2,15,0,0,0,6521
"36063022711",9115,367,259,0,432,11,312,0,10496
"36063022712",6339,678,352,29,474,32,288,7,8199
"36063022803",3290,82,0,0,76,0,177,0,3625
"36063022804",3039,208,11,0,0,25,15,26,3324
"36063022901",2065,97,0,0,17,0,45,0,2224
"36063022902",2491,169,43,1,67,0,77,0,2848
"36063023001",1913,246,36,15,31,3,40,3,2287
"36063023100",2037,269,6,12,27,43,36,25,2455
"36063023200",1967,574,46,2,189,0,90,14,2882
"36063023300",5432,1120,143,43,324,5,33,21,7121
"36063023401",5485,454,84,174,123,23,176,10,6529
"36063023402",3721,155,144,8,193,0,171,0,4392
"36063023404",4914,213,287,33,22,188,69,200,5926
"36063023405",2627,470,78,8,298,24,68,19,3592
"36063023500",1722,503,99,266,21,0,18,0,2629
"36063023600",2617,631,226,82,346,68,225,42,4237
"36063023700",833,438,185,92,156,6,68,0,1778
"36063023800",2583,367,60,30,54,62,237,37,3430
"36063023901",3240,384,379,14,107,9,44,0,4177
"36063023902",4268,328,47,26,132,0,150,88,5039
"36063024001",5041,678,31,0,118,0,0,0,5868
"36063024002",1533,216,0,0,32,0,9,0,1790
"36063024101",3398,339,0,0,128,14,22,14,3915
"36063024102",2403,266,0,6,39,33,142,25,2914
"36063024201",5858,576,14,3,47,40,5,0,6543
"36063024202",2304,375,0,3,78,10,41,5,2816
"36063024301",1028,116,0,3,10,0,0,0,1157
"36063024302",4155,449,16,24,82,40,67,12,4845
"36063024303",5273,183,121,20,167,0,13,0,5777
"36063024401",2179,170,0,0,143,0,21,2,2515
"36063024404",4301,224,34,16,75,8,30,0,4688
"36063024405",4741,240,0,0,178,12,166,0,5337
"36063024406",1848,24,0,0,82,0,81,0,2035
"36063024501",2720,153,53,11,0,11,63,4,3015
"36063024502",3222,372,1,6,124,3,76,72,3876
"36063024600",4388,206,80,8,94,0,0,1,4777
"36063940001",76,16,0,0,627,301,8,19,1047
"36063940100",0,0,0,0,0,0,0,0,0
"36063990000",0,0,0,0,0,0,0,0,0
"36065020102",453,258,99,113,88,120,99,59,1289
"36065020300",197,441,140,119,79,93,16,108,1193
"36065020705",1312,321,266,0,211,50,53,42,2255
"36065020802",1812,608,393,302,491,305,414,431,4756
"36065020803",895,654,76,40,333,634,219,503,3354
"36065020900",781,720,156,276,91,130,10,136,2300
"36065021000",387,356,127,172,184,198,72,203,1699
"36065021101",393,145,85,98,151,119,201,46,1238
"36065021102",822,320,228,363,220,564,151,128,2796
"36065021103",668,274,131,45,157,26,139,59,1499
"36065021201",520,390,342,185,326,290,175,126,2354
"36065021202",742,443,177,200,589,802,175,210,3338
"36065021301",1881,636,23,320,23,4,0,313,3200
"36065021302",2399,808,167,56,298,163,298,305,4494
"36065021303",2278,104,6,0,122,25,14,26,2575
"36065021401",1173,509,271,342,279,95,143,56,2868
"36065021402",832,408,129,407,55,107,68,55,2061
"36065021500",422,322,714,365,454,446,170,240,3133
"36065021601",4139,297,417,222,116,21,398,21,5631
"36065021602",1873,97,41,0,82,8,22,40,2163
"36065021701",2647,168,75,0,138,0,76,0,3104
"36065021702",1876,225,50,27,257,202,105,0,2742
"36065021900",1322,485,68,15,117,184,24,86,2301
"36065022000",1927,1187,87,96,50,77,119,141,3684
"36065022100",2128,361,19,12,72,6,54,30,2682
"36065022200",2269,58,25,0,11,0,0,0,2363
"36065022400",2914,255,51,1,179,7,27,0,3434
"36065022500",1890,1331,174,45,171,82,214,86,3993
"36065022701",1833,62,28,1,103,0,67,2,2096
"36065022702",3380,356,79,1,134,0,110,12,4072
"36065022800",2458,246,122,14,36,0,9,20,2905
"36065023000",5133,525,12,0,402,13,45,92,6222
"36065023200",3933,565,25,0,2,6,2,0,4533
"36065023300",2260,316,0,0,66,0,50,2,2694
"36065023400",3403,616,128,73,51,49,0,11,4331
"36065023501",2272,60,11,0,26,0,25,0,2394
"36065023502",4047,282,14,0,71,7,11,0,4432
"36065023702",3182,428,20,0,133,0,17,49,3829
"36065023901",2078,79,29,1,56,0,17,0,2260
"36065023902",1767,233,14,0,15,0,9,0,2038
"36065024000",3973,351,0,2,88,28,6,16,4464
"36065024101",1277,211,0,0,5,2,0,0,1495
"36065024102",2611,289,6,0,24,19,10,30,2989
"36065024200",3721,622,4,0,50,28,27,15,4467
"36065024301",2763,48,131,0,97,0,28,0,3067
"36065024302",3086,241,16,0,10,61,152,33,3599
"36065024303",2272,216,44,0,55,11,15,21,2634
"36065024400",3191,666,3,8,65,27,41,17,4018
"36065024500",4005,720,0,25,90,42,61,23,4966
"36065024700",5098,1005,0,16,88,16,27,0,6250
"36065024800",2706,242,107,0,17,1,115,1,3189
"36065024900",4889,378,13,21,74,9,108,20,5512
"36065025001",2720,222,12,0,46,0,56,0,3056
"36065025002",3196,324,61,1,161,5,81,5,3834
"36065025003",1265,26,1,1,31,11,1,0,1336
"36065025100",1596,152,5,43,17,0,0,57,1870
"36065025200",3702,200,28,4,134,27,0,0,4095
"36065025300",6726,365,109,0,269,2,128,23,7622
"36065025400",4962,140,1,0,483,0,0,37,5623
"36065025500",3974,204,55,24,90,40,58,48,4493
"36065025600",3684,649,18,0,45,22,32,26,4476
"36065025700",2018,364,0,0,12,0,14,3,2411
"36065025800",1134,221,10,0,13,5,7,28,1418
"36065025900",4,30,33,0,0,0,0,0,67
"36065026100",1931,108,7,0,22,0,13,0,2081
"36065026200",5341,235,14,0,497,26,0,6,6119
"36065026300",2391,645,241,15,475,108,417,155,4447
"36065026400",801,445,685,774,1138,1191,347,301,5682
"36065026500",24,45,10,25,0,0,10,0,114
"36065026600",68,103,0,38,12,26,0,26,273
"36065026700",4512,880,0,0,62,16,0,0,5470
"36065980002",0,0,0,0,0,0,0,0,0
"36065980003",0,0,0,0,0,0,0,0,0
"36065980100",0,0,0,0,0,0,0,0,0
"36067000100",406,70,79,0,12,77,15,4,663
"36067000200",1329,912,201,29,214,339,230,173,3427
"36067000300",1080,58,224,57,123,64,26,0,1632
"36067000400",2160,387,345,92,301,70,117,61,3533
"36067000501",644,293,226,191,251,534,147,113,2399
"36067000600",1320,418,388,397,458,712,212,73,3978
"36067000700",529,49,290,141,472,137,116,25,1759
"36067000800",986,151,830,494,220,45,78,16,2820
"36067000900",2381,181,266,63,105,23,72,57,3148
"36067001000",2219,750,750,286,170,289,184,132,4780
"36067001400",592,504,346,497,747,1062,258,56,4062
"36067001500",877,285,243,504,507,686,115,227,3444
"36067001600",883,439,503,261,179,108,26,147,2546
"36067001701",1048,344,146,162,172,629,89,374,2964
"36067001702",1861,154,65,203,22,0,149,0,2454
"36067001800",1785,198,291,214,224,0,163,0,2875
"36067001900",2542,755,297,8,118,27,39,45,3831
"36067002000",1335,408,100,84,105,5,110,12,2159
"36067002101",973,996,329,408,150,216,158,302,3532
"36067002300",431,308,209,287,313,93,76,28,1745
"36067002400",534,382,220,382,197,215,95,155,2180
"36067002700",1345,320,88,7,34,216,49,5,2064
"36067002901",2233,213,51,10,94,119,35,80,2835
"36067003000",357,469,225,374,70,332,219,676,2722
"36067003200",600,229,154,94,243,338,17,10,1685
"36067003400",222,213,221,143,103,311,30,74,1317
"36067003500",531,395,358,646,123,231,39,287,2610
"36067003601",313,282,924,540,193,66,60,146,2524
"36067003602",572,198,1099,117,124,68,113,22,2313
"36067003800",755,549,514,293,203,111,353,113,2891
"36067003900",487,747,508,749,298,428,293,402,3912
"36067004000",525,126,534,407,151,48,168,60,2019
"36067004200",48,221,566,1067,118,183,145,276,2624
"36067004301",69,149,151,319,68,51,88,43,938
"36067004302",98,477,31,116,43,175,8,49,997
"36067004400",537,1189,20,84,91,93,4,73,2091
"36067004500",2140,1197,156,73,137,394,105,103,4305
"36067004600",2922,168,613,414,302,20,101,2,4542
"36067004800",1200,80,152,65,100,5,20,0,1622
"36067004900",663,213,205,168,17,131,43,25,1465
"36067005000",1875,74,408,282,14,8,22,86,2769
"36067005100",307,268,822,379,200,143,124,198,2441
"36067005200",162,137,964,503,105,204,7,164,2246
"36067005300",101,51,715,836,21,110,76,103,2013
"36067005400",163,207,1136,982,196,103,104,172,3063
"36067005500",977,388,806,393,362,411,104,0,3441
"36067005601",1010,92,123,53,110,11,71,11,1481
"36067005602",82,177,21,97,0,138,0,7,522
"36067005700",631,34,710,287,133,30,72,7,1904
"36067005800",216,217,994,768,108,226,138,168,2835
"36067005900",128,36,998,459,14,63,80,29,1807
"36067006000",1783,367,1133,391,87,2,342,2,4107
"36067006101",636,340,1251,665,285,246,110,130,3663
"36067006102",763,232,251,194,208,150,8,21,1827
"36067006103",1651,149,509,91,195,0,133,0,2728
"36067010100",2667,170,0,0,52,0,48,0,2937
"36067010200",4655,861,14,0,218,13,28,0,5789
"36067010301",5389,366,149,0,73,31,126,0,6134
"36067010321",2389,150,81,0,86,16,13,0,2735
"36067010322",3279,101,121,0,266,0,56,0,3823
"36067010400",3801,240,9,1,50,0,191,0,4292
"36067010500",2034,201,42,4,103,7,28,2,2421
"36067010600",1988,44,0,13,71,19,1,23,2159
"36067010700",1498,202,17,0,22,8,7,0,1754
"36067010800",4067,357,42,0,373,1,214,1,5055
"36067010900",1912,192,9,0,111,0,53,0,2277
"36067011011",2882,150,23,35,130,0,120,0,3340
"36067011012",3322,247,46,11,254,0,107,0,3987
"36067011021",2570,147,157,0,104,8,110,14,3110
"36067011022",2563,340,156,54,53,0,0,117,3283
"36067011101",4801,339,551,0,226,0,124,0,6041
"36067011102",2327,680,306,204,214,69,167,58,4025
"36067011201",2668,476,114,20,114,179,79,27,3677
"36067011202",4079,185,144,0,274,36,266,0,4984
"36067011231",3962,320,241,1,252,41,123,55,4995
"36067011232",3154,371,78,32,245,2,26,1,3909
"36067011241",2210,76,7,0,145,9,41,49,2537
"36067011242",5177,498,628,15,174,0,205,30,6727
"36067011300",2836,163,0,0,19,0,44,0,3062
"36067011401",5908,609,30,70,322,66,185,123,7313
"36067011402",3847,466,21,2,160,4,111,3,4614
"36067011500",5127,260,45,0,363,30,91,1,5917
"36067011600",4600,223,0,0,187,0,143,0,5153
"36067011700",2585,290,14,53,105,0,107,0,3154
"36067011800",5797,246,23,0,154,42,91,0,6353
"36067011900",3553,85,0,0,197,58,114,47,4054
"36067012000",5219,487,2,0,128,0,24,0,5860
"36067012100",3921,170,20,0,189,23,178,1,4502
"36067012200",1014,105,46,15,15,3,13,15,1226
"36067012300",3063,278,1,0,145,1,75,1,3564
"36067012400",3632,346,40,0,131,30,52,0,4231
"36067012500",3362,254,49,9,149,1,93,69,3986
"36067012600",4868,114,22,0,259,1,43,28,5335
"36067012700",1662,160,0,0,104,17,49,42,2034
"36067012800",2874,91,0,0,42,3,103,0,3113
"36067012900",2143,463,0,1,95,22,229,17,2970
"36067013000",3059,317,14,19,357,0,206,55,4027
"36067013100",4124,297,20,26,93,0,79,10,4649
"36067013200",2360,109,0,7,72,1,54,0,2603
"36067013300",1982,140,54,7,47,0,72,1,2303
"36067013400",4597,388,211,42,218,99,66,86,5707
"36067013500",4673,247,96,0,270,67,132,0,5485
"36067013600",2726,146,87,0,137,7,103,7,3213
"36067013701",3543,308,309,177,379,184,48,0,4948
"36067013800",1908,100,11,4,45,0,11,0,2079
"36067013900",2164,368,161,0,120,0,98,40,2951
"36067014000",2565,503,168,130,249,57,180,53,3905
"36067014200",2711,552,38,137,210,53,59,114,3874
"36067014300",2312,524,56,0,121,1,75,0,3089
"36067014400",1955,182,72,22,152,0,45,0,2428
"36067014500",3441,167,57,85,204,0,65,0,4019
"36067014600",2664,249,413,69,582,144,138,28,4287
"36067014700",4565,158,483,13,803,11,163,0,6196
"36067014800",2573,155,55,1,125,10,117,10,3046
"36067014900",1458,103,1,12,117,11,21,0,1723
"36067015000",4022,126,57,0,111,7,110,9,4442
"36067015100",4685,280,27,47,671,0,51,0,5761
"36067015201",2640,151,79,0,93,76,120,0,3159
"36067015202",3727,130,413,1,457,24,13,0,4765
"36067015203",2116,104,79,0,287,63,13,0,2662
"36067015400",4826,271,143,4,452,0,203,0,5899
"36067015500",2455,156,0,0,74,6,0,0,2691
"36067015601",2888,342,1,1,86,34,62,0,3414
"36067015700",6610,221,64,0,344,0,59,0,7298
"36067015800",4199,357,20,122,163,60,0,0,4921
"36067016001",3415,83,6,5,121,44,85,5,3764
"36067016002",2940,32,19,8,48,0,73,0,3120
"36067016100",1617,44,89,1,383,44,147,11,2336
"36067016200",1428,145,236,41,265,74,48,36,2273
"36067016300",5942,197,186,67,264,28,212,0,6896
"36067016400",3643,123,11,0,65,0,131,0,3973
"36067016501",1684,69,0,12,23,0,68,0,1856
"36067016502",3974,165,18,0,204,6,5,0,4372
"36067016600",4378,222,0,0,41,6,81,10,4738
"36067016700",2450,29,0,2,83,2,0,6,2572
"36067016801",1522,115,0,0,22,4,22,25,1710
"36067016802",2284,228,0,0,25,4,27,0,2568
"36067016901",2411,182,21,2,101,7,20,44,2788
"36067016902",1987,105,7,16,149,12,175,20,2471
"36067940000",0,0,0,0,161,0,161,0,322
"36069050101",3187,89,38,1,34,0,16,1,3366
"36069050102",10347,250,58,0,474,0,275,0,11404
"36069050201",5256,837,199,4,124,168,68,184,6840
"36069050202",5258,150,22,92,357,75,533,4,6491
"36069050301",3969,250,109,3,46,34,81,25,4517
"36069050302",4088,497,9,22,99,34,38,28,4815
"36069050400",5999,727,79,7,161,6,15,28,7022
"36069050500",5494,563,16,11,42,9,27,23,6185
"36069050601",5325,367,4,50,210,8,66,12,6042
"36069050602",3622,491,14,11,109,46,156,5,4454
"36069050800",2738,314,19,18,4,22,0,8,3123
"36069050900",2024,181,0,4,71,32,42,1,2355
"36069051000",2094,469,32,3,95,24,12,7,2736
"36069051100",1577,493,12,6,64,27,18,51,2248
"36069051200",2952,265,27,6,96,22,58,12,3438
"36069051300",3865,284,10,8,95,0,37,5,4304
"36069051400",2556,140,2,4,26,9,47,0,2784
"36069051500",2793,187,87,27,46,88,211,174,3613
"36069051600",2678,331,290,88,135,17,176,135,3850
"36069051700",852,335,222,166,129,51,202,237,2194
"36069051800",1416,287,309,136,248,204,465,111,3176
"36069051900",1752,817,70,82,170,105,215,102,3313
"36069052000",4675,276,0,0,191,0,214,0,5356
"36069052100",3427,300,0,0,71,3,31,3,3835
"36069052200",2003,327,0,8,17,7,4,26,2392
"36071000100",985,115,601,102,552,338,824,250,3767
"36071000200",1146,150,233,295,718,57,984,154,3737
"36071000300",2349,386,678,896,1949,904,3419,1102,11683
"36071000400",829,373,1166,1009,408,603,1152,539,6079
"36071000501",708,470,190,357,960,462,1387,772,5306
"36071000502",438,404,717,762,1228,456,1300,701,6006
"36071000600",1236,383,780,459,406,471,1258,767,5760
"36071001100",1458,343,1298,151,1127,293,1487,350,6507
"36071001200",623,132,433,106,819,688,969,722,4492
"36071001300",2264,38,609,9,511,0,845,9,4285
"36071001500",1820,516,852,238,1134,428,1554,521,7063
"36071001600",3271,166,1210,306,1433,423,1666,416,8891
"36071002100",1762,408,285,18,521,127,281,59,3461
"36071002200",2252,472,343,252,274,26,258,28,3905
"36071002300",1403,184,29,0,266,0,149,25,2056
"36071010101",4211,46,307,3,298,16,701,10,5592
"36071010102",3621,154,387,82,461,171,648,5,5529
"36071010200",3460,194,588,0,236,87,389,140,5094
"36071010300",2483,95,539,21,629,0,791,21,4579
"36071010400",2664,173,365,0,736,2,944,4,4888
"36071010500",5568,624,736,49,1077,222,1557,352,10185
"36071010600",6216,346,225,0,642,0,547,0,7976
"36071010700",4499,679,314,4,1164,206,1109,360,8335
"36071010801",2502,292,484,43,262,55,486,54,4178
"36071010802",4614,218,50,0,226,20,744,55,5927
"36071010901",2500,262,255,14,80,0,197,38,3346
"36071010902",5086,507,39,0,498,0,682,12,6824
"36071011000",3589,511,226,0,512,72,615,149,5674
"36071011101",1253,142,874,0,699,7,532,21,3528
"36071011102",2355,86,585,0,732,36,837,36,4667
"36071011200",2268,147,1104,122,603,60,974,88,5366
"36071011300",3423,408,1906,65,1553,259,1968,259,9841
"36071011400",3115,174,85,0,373,138,397,120,4402
"36071011500",3958,361,282,41,356,166,556,206,5926
"36071011601",3413,430,85,0,191,41,241,57,4458
"36071011602",2745,503,96,19,237,21,236,61,3918
"36071011701",3935,233,0,11,440,8,366,1,4994
"36071011702",3847,212,108,0,282,66,326,9,4850
"36071011801",3671,190,117,0,470,210,723,193,5574
"36071011802",2185,109,140,1,172,7,208,7,2829
"36071011900",4236,266,164,0,477,11,427,41,5622
"36071012100",2443,139,140,26,657,38,688,15,4146
"36071012200",3007,161,39,10,329,2,309,11,3868
"36071012300",4239,285,179,27,605,9,448,0,5792
"36071012601",2147,13,727,0,755,0,764,0,4406
"36071012602",1756,172,541,199,821,20,696,91,4296
"36071012700",2556,214,279,60,894,64,1191,22,5280
"36071012800",3325,56,610,59,619,9,1272,9,5959
"36071012900",2559,92,7,0,189,0,155,0,3002
"36071013000",3763,323,0,0,601,58,861,30,5636
"36071013100",4505,192,24,0,168,26,444,0,5359
"36071013201",3934,259,194,0,831,7,1155,48,6428
"36071013202",1359,187,131,7,218,75,323,50,2350
"36071013300",6307,437,177,18,542,0,1015,0,8496
"36071013400",2353,129,146,0,424,53,496,53,3654
"36071013500",5209,324,289,0,468,86,824,61,7261
"36071013600",2635,69,82,0,343,55,387,52,3623
"36071013700",1716,17,380,51,518,33,415,51,3181
"36071013800",2043,144,163,33,270,45,113,53,2864
"36071013900",3752,164,43,0,534,4,951,2,5450
"36071014101",2638,131,172,0,709,288,552,281,4771
"36071014102",3743,130,701,5,1383,108,1400,97,7567
"36071014201",2998,283,91,41,392,29,512,80,4426
"36071014202",5227,270,28,0,628,22,803,22,7000
"36071014301",3416,237,684,82,616,72,994,78,6179
"36071014302",5170,145,388,0,954,17,1058,17,7749
"36071014400",3446,197,273,0,383,4,519,5,4827
"36071014501",3741,137,0,33,528,18,563,18,5038
"36071014502",4368,236,383,0,86,0,297,0,5370
"36071014600",6015,340,238,0,314,46,463,136,7552
"36071014700",2531,93,446,0,580,92,331,92,4165
"36071014800",5167,431,254,30,624,0,833,109,7448
"36071014900",3122,44,69,0,348,13,293,0,3889
"36071015003",1975,2646,0,0,0,13,31,13,4678
"36071015004",2332,4359,0,0,36,0,0,294,7021
"36071015005",2838,1582,0,0,0,0,13,25,4458
"36071015006",2631,3752,0,0,16,9,41,43,6492
"36071015100",1522,774,757,310,1289,510,1367,729,7258
"36071015200",7234,250,1096,0,1257,7,1502,16,11362
"36073040200",2990,227,7,3,40,7,43,3,3320
"36073040300",1843,383,44,128,156,108,107,28,2797
"36073040400",2510,407,118,38,148,60,191,48,3520
"36073040500",1800,466,123,22,16,0,160,22,2609
"36073040600",4525,539,0,5,74,33,86,7,5269
"36073040700",3396,1386,643,20,153,236,161,399,6394
"36073040801",3886,658,31,18,127,13,82,4,4819
"36073040802",3094,504,20,27,65,28,31,23,3792
"36073401200",2855,351,52,28,69,5,22,5,3387
"36073401300",4046,447,72,10,213,16,55,54,4913
"36073990000",0,0,0,0,0,0,0,0,0
"36075020100",2885,604,0,22,86,46,25,58,3726
"36075020200",3129,655,1,5,46,7,17,6,3866
"36075020301",1712,425,0,0,28,11,21,0,2197
"36075020302",2687,711,15,0,0,5,9,31,3458
"36075020400",4175,745,29,2,46,184,18,22,5221
"36075020500",4759,1034,3,3,103,23,50,0,5975
"36075020600",4222,531,0,0,189,1,116,2,5061
"36075020701",3391,747,0,11,91,0,7,0,4247
"36075020702",3695,537,2,0,91,0,27,8,4360
"36075020703",4143,706,0,0,214,20,14,0,5097
"36075020800",3109,445,0,1,78,0,0,9,3642
"36075020901",1729,561,11,1,148,37,82,34,2603
"36075020902",4979,714,28,0,127,0,59,0,5907
"36075021000",5145,501,0,0,90,0,93,0,5829
"36075021101",2268,1696,0,4,79,205,56,200,4508
"36075021102",1255,776,0,27,62,126,42,207,2495
"36075021103",2239,357,0,1,53,0,44,13,2707
"36075021104",1964,403,0,0,47,5,31,19,2469
"36075021200",5598,925,48,0,118,6,63,0,6758
"36075021300",3677,843,40,3,138,18,24,59,4802
"36075021401",3647,606,9,19,39,27,52,27,4426
"36075021402",1280,164,12,2,38,1,15,0,1512
"36075021501",2445,360,0,3,63,5,0,0,2876
"36075021502",5808,712,34,0,146,23,125,53,6901
"36075021601",1834,933,50,1,56,75,40,22,3011
"36075021602",1967,1258,11,43,19,71,38,103,3510
"36075021603",2995,540,0,0,17,3,97,19,3671
"36075021604",2468,1110,0,30,132,199,26,175,4140
"36075021605",2222,695,135,22,272,23,122,20,3511
"36075990000",0,0,0,0,0,0,0,0,0
"36077590100",3928,435,5,8,93,65,77,9,4620
"36077590201",1593,257,0,1,44,20,16,0,1931
"36077590202",3080,314,15,1,180,0,53,6,3649
"36077590300",3456,487,24,0,152,12,19,10,4160
"36077590400",4517,596,10,0,52,4,52,9,5240
"36077590500",2520,372,0,2,26,9,9,0,2938
"36077590600",1653,150,6,3,46,24,16,3,1901
"36077590700",3296,636,27,10,45,19,176,4,4213
"36077590800",3776,668,73,282,155,116,177,149,5396
"36077590900",1449,299,48,56,162,31,89,42,2176
"36077591000",2092,1214,0,0,98,65,55,28,3552
"36077591100",1757,841,56,54,159,72,220,7,3166
"36077591200",730,125,0,9,9,5,0,57,935
"36077591300",61,0,0,0,0,0,0,0,61
"36077591400",4521,1088,16,6,149,9,134,67,5990
"36077591500",2968,485,0,3,79,34,41,13,3623
"36077591600",3837,370,10,8,75,10,54,1,4365
"36079010100",3327,98,161,2,216,9,601,9,4423
"36079010200",5818,607,54,120,826,174,946,327,8872
"36079010300",3692,189,188,0,464,160,775,259,5727
"36079010400",2968,98,354,2,147,11,454,0,4034
"36079010500",4461,182,126,8,191,26,472,26,5492
"36079010600",3552,100,23,0,159,10,179,16,4039
"36079010700",2285,138,14,3,147,8,152,52,2799
"36079010800",2487,231,82,48,395,13,199,66,3521
"36079010900",6640,430,135,0,305,25,493,118,8146
"36079011000",3787,249,25,0,113,16,519,0,4709
"36079011100",5479,22,155,1,270,17,415,0,6359
"36079011200",5857,307,13,0,849,44,1044,152,8266
"36079011300",3734,167,0,0,214,55,277,102,4549
"36079011400",4576,100,85,4,319,1,486,1,5572
"36079011500",5235,288,47,6,635,56,657,52,6976
"36079011600",5234,10,43,0,255,0,605,2,6149
"36079011700",4546,149,46,22,48,50,340,60,5261
"36079011800",6298,449,120,21,753,240,1455,492,9828
"36079011900",4753,175,132,0,178,71,467,134,5910
"36081000100",3830,420,302,49,1538,264,283,100,6786
"36081000200",1546,191,48,0,1293,286,1577,283,5224
"36081000400",1617,288,210,45,2119,271,2319,355,7224
"36081000600",1007,79,186,115,2054,366,1782,172,5761
"36081000700",3825,225,105,0,1499,126,855,65,6700
"36081000800",1442,351,65,23,1388,243,1502,425,5439
"36081001000",1574,254,206,44,1578,176,2139,192,6163
"36081001200",2554,370,118,16,1723,217,2652,281,7931
"36081001400",1707,121,106,0,1692,155,2455,220,6456
"36081001600",1500,451,206,68,821,198,1796,493,5533
"36081001800",1389,187,287,7,1073,457,1672,308,5380
"36081001900",820,38,32,0,677,88,331,0,1986
"36081002000",492,28,57,30,1113,204,824,114,2862
"36081002200",872,98,147,16,863,178,1149,153,3476
"36081002400",569,221,198,32,1145,92,913,265,3435
"36081002500",715,645,1548,1561,1044,866,1472,1300,9151
"36081002600",945,212,201,3,1032,74,1232,204,3903
"36081002800",1129,111,154,45,1181,333,1248,352,4553
"36081003000",407,117,204,13,614,214,597,274,2440
"36081003100",475,117,36,16,351,63,521,136,1715
"36081003200",458,56,173,0,749,177,843,106,2562
"36081003300",1055,291,61,15,1048,335,498,289,3592
"36081003400",631,42,104,32,1318,262,1153,236,3778
"36081003600",1061,0,205,27,2024,407,1238,163,5125
"36081003700",0,0,0,0,0,0,0,0,0
"36081003800",853,162,99,40,996,350,1202,364,4066
"36081003900",576,308,30,36,440,256,545,341,2532
"36081004001",620,107,55,5,1261,180,937,152,3317
"36081004002",199,102,11,0,953,279,456,79,2079
"36081004200",864,140,127,27,2598,1031,1543,507,6837
"36081004300",535,267,489,260,372,481,595,675,3674
"36081004401",767,29,283,19,1804,814,864,132,4712
"36081004500",1961,143,158,32,1116,123,662,61,4256
"36081004700",1322,425,749,418,900,197,1115,465,5591
"36081005000",19,0,0,0,18,0,18,0,55
"36081005100",567,100,11,28,985,503,261,101,2556
"36081005200",472,88,155,23,1697,301,780,262,3778
"36081005300",2136,306,91,0,1273,237,918,68,5029
"36081005400",1923,357,255,16,2154,918,1629,597,7849
"36081005500",343,81,26,0,404,89,321,70,1334
"36081005700",1979,446,161,31,1234,464,1256,357,5928
"36081005800",2640,279,203,274,2291,98,2459,379,8623
"36081005900",2739,387,62,8,859,117,1063,148,5383
"36081006100",3600,494,58,78,1453,259,1172,224,7338
"36081006201",4086,326,252,26,828,478,1279,371,7646
"36081006202",4602,717,281,0,1499,245,2276,335,9955
"36081006300",3205,655,302,0,829,443,1341,333,7108
"36081006501",2654,358,19,29,439,51,736,33,4319
"36081006502",2194,498,20,10,939,184,647,120,4612
"36081006900",2068,420,187,7,1578,102,1102,168,5632
"36081007100",2217,350,78,0,893,287,773,95,4693
"36081007300",2736,233,30,0,659,707,1076,81,5522
"36081007500",2730,392,31,0,972,199,927,164,5415
"36081007700",765,81,22,15,462,101,305,35,1786
"36081007900",1203,186,64,151,1393,428,1222,325,4972
"36081008100",608,38,22,0,424,112,423,83,1710
"36081008300",1640,234,213,127,1099,214,1101,165,4793
"36081008500",425,77,22,3,480,125,439,55,1626
"36081008600",1154,302,84,0,1179,112,1091,351,4273
"36081008700",885,291,1691,1111,530,599,1135,907,7149
"36081008800",2358,239,355,7,941,28,2045,92,6065
"36081009100",1670,251,118,1,751,72,803,69,3735
"36081009400",388,90,243,0,1839,402,583,105,3650
"36081009500",1664,285,89,0,621,96,328,141,3224
"36081009600",747,61,454,74,2446,297,923,50,5052
"36081009700",2854,134,57,11,316,38,294,23,3727
"36081009800",294,77,238,75,1669,465,431,131,3380
"36081009900",0,0,0,0,0,0,0,0,0
"36081010000",420,258,896,102,1732,393,421,411,4633
"36081010100",1845,180,7,7,387,75,428,43,2972
"36081010200",371,60,466,44,1998,222,871,144,4176
"36081010300",2586,407,94,8,684,33,519,48,4379
"36081010400",277,52,768,82,1644,619,260,7,3709
"36081010500",1764,829,132,32,1279,79,1506,302,5923
"36081010600",369,7,577,92,2026,670,411,56,4208
"36081010701",0,0,0,0,0,0,0,0,0
"36081010800",284,37,209,54,2478,446,552,73,4133
"36081011000",605,135,261,46,2013,521,900,226,4707
"36081011100",2271,298,3,9,759,100,623,160,4223
"36081011200",453,131,42,55,1090,378,358,103,2610
"36081011300",2831,138,36,17,961,246,832,33,5094
"36081011400",470,73,33,134,287,53,516,90,1656
"36081011500",1379,214,53,0,525,185,368,67,2791
"36081011600",258,34,196,79,1639,103,610,89,3008
"36081011700",2517,226,29,182,683,69,637,22,4365
"36081011800",584,51,186,0,1417,528,745,65,3576
"36081011900",1108,159,10,0,267,130,280,103,2057
"36081012000",207,48,124,4,1404,680,325,175,2967
"36081012100",1650,132,36,0,319,109,345,28,2619
"36081012200",817,138,116,57,1997,496,1047,267,4935
"36081012301",2129,133,68,22,295,23,428,21,3119
"36081012400",760,136,237,97,1453,413,1089,334,4519
"36081012500",1293,95,11,16,350,64,570,16,2415
"36081012601",572,138,262,17,1389,350,1532,263,4523
"36081012602",437,150,26,18,1832,197,1123,207,3990
"36081012800",874,186,166,0,857,155,817,175,3230
"36081013000",686,80,193,0,662,18,415,31,2085
"36081013200",1151,315,196,0,540,94,393,292,2981
"36081013400",3374,183,549,0,1277,524,1144,61,7112
"36081013500",1428,68,0,0,200,0,212,6,1914
"36081013600",1421,125,115,0,346,56,467,41,2571
"36081013700",1218,171,29,0,256,115,138,191,2118
"36081013800",1366,109,173,15,1451,486,636,234,4470
"36081014000",2604,111,253,37,600,128,594,99,4426
"36081014100",1019,83,88,5,436,98,469,61,2259
"36081014201",789,217,312,26,2441,542,1494,234,6055
"36081014202",608,153,193,46,1231,320,766,243,3560
"36081014300",2588,258,83,0,834,294,971,174,5202
"36081014400",304,160,95,38,1250,158,668,198,2871
"36081014500",1387,335,173,0,371,47,426,53,2792
"36081014700",2450,126,142,35,601,11,684,11,4060
"36081014800",310,25,181,92,1246,346,528,198,2926
"36081014900",1763,143,32,11,437,44,589,50,3069
"36081015000",164,133,215,14,2160,209,618,78,3591
"36081015100",1946,299,2,0,319,144,167,170,3047
"36081015200",245,119,403,98,1617,326,509,163,3480
"36081015300",1097,206,56,18,632,74,325,118,2526
"36081015400",203,8,220,115,1643,335,580,54,3158
"36081015500",1564,170,40,6,442,114,538,38,2912
"36081015600",319,40,457,123,1916,249,368,7,3479
"36081015700",647,105,17,0,435,253,232,37,1726
"36081015801",183,28,915,200,1939,287,463,94,4109
"36081015802",525,85,864,135,2831,239,846,158,5683
"36081015900",2226,411,80,12,629,606,671,160,4795
"36081016100",1167,312,165,6,762,194,899,266,3771
"36081016300",1608,348,641,318,539,334,1496,418,5702
"36081016400",95,37,1329,162,1847,208,226,94,3998
"36081016600",604,164,585,11,1895,137,1074,164,4634
"36081016800",335,31,353,42,2478,162,807,124,4332
"36081016900",3170,244,96,0,1847,199,1155,124,6835
"36081017000",194,28,579,167,1202,164,328,23,2685
"36081017100",0,0,0,0,0,0,0,0,0
"36081017200",189,6,640,124,1346,44,449,6,2804
"36081017400",169,41,1018,305,1161,173,470,274,3611
"36081017600",100,10,987,132,1156,113,340,65,2903
"36081017800",178,20,945,156,770,173,368,106,2716
"36081017900",541,48,16,13,321,55,311,45,1350
"36081018000",170,0,358,167,612,149,204,28,1688
"36081018101",2164,523,0,0,1387,203,1314,390,5981
"36081018102",2251,350,46,9,870,218,576,133,4453
"36081018200",65,8,1383,94,692,153,343,71,2809
"36081018300",3662,502,188,2,1342,574,1691,420,8381
"36081018401",104,0,1603,168,366,31,270,0,2542
"36081018402",109,34,1444,453,225,77,272,94,2708
"36081018501",1912,470,66,0,1118,119,1167,356,5208
"36081018502",2297,306,36,0,583,326,868,194,4610
"36081018600",199,7,1003,311,306,36,190,1,2053
"36081018700",1419,94,51,0,1390,116,901,44,4015
"36081018800",5,6,1004,137,316,8,226,13,1715
"36081018900",1624,235,228,13,1097,273,1263,195,4928
"36081019000",150,15,1169,87,756,100,267,101,2645
"36081019200",269,22,1272,47,390,9,527,25,2561
"36081019400",135,0,1459,130,708,71,218,5,2726
"36081019600",117,147,1193,230,1010,24,355,161,3237
"36081019800",120,107,893,395,950,516,408,368,3757
"36081019900",238,11,46,0,235,88,271,87,976
"36081020200",25,0,744,114,627,183,290,75,2058
"36081020400",160,24,683,288,776,251,334,85,2601
"36081020500",533,114,12,6,272,57,622,142,1758
"36081020600",308,31,486,6,892,132,711,143,2709
"36081020800",451,20,661,52,1138,232,716,175,3445
"36081021200",455,43,90,101,1230,376,1051,286,3632
"36081021400",1018,396,410,26,3148,1417,1510,1047,8972
"36081021600",1542,212,483,0,1863,273,1447,154,5974
"36081021900",4,0,0,0,0,0,0,0,4
"36081022001",1928,141,633,109,2677,282,1538,211,7519
"36081022002",2447,551,949,30,2117,327,1223,292,7936
"36081022900",0,0,0,0,0,0,0,0,0
"36081023000",866,42,19,0,1350,153,1003,57,3490
"36081023200",1030,279,378,200,3001,368,1326,151,6733
"36081023500",3518,936,126,16,2925,1178,3817,1013,13529
"36081023600",472,218,241,34,1555,177,862,92,3651
"36081023800",280,173,488,95,2590,1048,1240,505,6419
"36081024000",624,475,852,117,3071,910,2124,987,9160
"36081024300",3257,329,41,0,2220,252,2129,357,8585
"36081024500",3652,111,99,0,1909,387,2248,330,8736
"36081024600",0,0,0,0,0,0,0,0,0
"36081024700",497,59,35,0,900,78,587,80,2236
"36081024900",1917,157,13,20,2235,518,986,152,5998
"36081025100",2943,261,29,0,2393,283,2088,108,8105
"36081025301",2175,322,22,7,1238,191,1055,122,5132
"36081025302",1508,246,46,0,784,297,1307,207,4395
"36081025400",28,68,4594,1519,2070,815,1453,348,10895
"36081025500",677,53,0,0,590,103,323,50,1796
"36081025700",602,93,55,0,548,28,374,47,1747
"36081025800",116,32,1320,173,347,54,188,86,2316
"36081025900",1427,51,54,0,1427,394,1307,116,4776
"36081026000",77,16,1084,877,644,94,544,176,3512
"36081026100",2034,718,331,0,2864,1134,2173,927,10181
"36081026200",25,0,773,215,163,32,114,32,1354
"36081026300",1491,540,31,0,4014,1048,1886,462,9472
"36081026400",114,55,1453,256,391,66,395,126,2856
"36081026500",861,180,24,0,2532,521,643,266,5027
"36081026600",60,15,1228,288,164,178,119,113,2165
"36081026700",2517,403,30,0,2796,793,2996,659,10194
"36081026901",1954,193,10,0,2168,745,2272,408,7750
"36081026902",976,491,86,0,2453,509,1238,555,6308
"36081027000",160,6,1133,465,178,138,249,143,2472
"36081027100",2371,143,259,0,4176,1563,2771,815,12098
"36081027200",0,5,1959,297,146,15,113,9,2544
"36081027300",4211,1214,176,97,1709,789,5087,1685,14968
"36081027400",147,38,1208,58,330,0,288,38,2107
"36081027500",3696,1380,136,19,2023,235,4447,1487,13423
"36081027600",9,0,994,76,140,43,147,51,1460
"36081027700",4163,678,254,14,1848,681,4275,1175,13088
"36081027800",45,15,1559,441,222,143,303,152,2880
"36081027900",3024,584,220,18,2088,299,3396,787,10416
"36081028000",0,0,1418,39,313,0,273,0,2043
"36081028100",3240,270,53,12,716,144,2450,360,7245
"36081028200",23,0,1371,111,183,8,122,15,1833
"36081028300",3640,695,174,83,2228,496,3510,926,11752
"36081028400",86,0,2850,858,356,132,218,141,4641
"36081028500",2959,485,118,0,1049,471,1452,790,7324
"36081028700",3562,581,93,0,1809,378,2137,487,9047
"36081028800",112,58,3428,454,610,31,360,109,5162
"36081028900",2153,338,161,0,2532,390,1543,254,7371
"36081029100",1547,474,27,6,3262,1009,1349,534,8208
"36081029300",190,16,0,0,896,115,87,4,1308
"36081029400",40,52,5551,427,426,112,324,214,7146
"36081029500",1825,174,143,0,1435,145,899,67,4688
"36081029700",964,342,54,0,646,112,315,309,2742
"36081029900",0,0,0,0,0,0,0,0,0
"36081030600",182,36,3304,386,85,21,246,80,4340
"36081030902",2632,715,107,2,3098,1308,2064,543,10469
"36081030903",1694,326,40,0,3638,735,2454,316,9203
"36081030904",1102,207,12,2,2181,340,1778,111,5733
"36081031700",4900,315,41,0,1003,178,1123,125,7685
"36081032000",239,59,3344,751,287,238,181,193,5292
"36081032700",1324,217,199,0,1865,507,2319,273,6704
"36081032800",106,2,2010,186,60,12,139,2,2517
"36081032900",1395,215,67,41,1943,395,1807,400,6263
"36081033000",152,1,5452,1033,464,3,662,4,7771
"36081033100",0,0,0,0,0,0,0,0,0
"36081033401",126,0,2645,377,341,0,328,0,3817
"36081033402",169,32,11342,1231,232,43,357,262,13668
"36081033700",742,95,60,0,2183,475,2056,508,6119
"36081033900",1010,117,274,0,1855,108,2054,144,5562
"36081034700",884,115,378,7,1600,290,1941,252,5467
"36081035100",1207,235,175,0,2164,434,2158,615,6988
"36081035200",169,1,2432,183,236,5,181,5,3212
"36081035300",545,164,199,106,1044,370,1520,422,4370
"36081035700",914,138,816,188,1559,287,1653,263,5818
"36081035800",2,2,3640,274,143,27,213,0,4301
"36081036100",426,178,746,133,1126,324,1480,499,4912
"36081036300",129,52,276,23,1244,370,1349,296,3739
"36081036500",708,283,585,73,1542,504,2030,752,6477
"36081036600",6,0,2418,324,241,5,138,0,3132
"36081036700",161,197,1173,39,945,122,832,205,3674
"36081036800",78,0,2106,170,81,5,208,0,2648
"36081037100",183,76,379,145,727,279,707,207,2703
"36081037300",421,95,414,54,1233,283,1218,282,4000
"36081037500",1612,367,153,37,1272,438,2673,759,7311
"36081037600",8,0,5178,215,409,119,205,119,6253
"36081037700",1028,358,415,66,1240,540,2274,898,6819
"36081037900",1888,335,161,158,3537,1142,5247,1535,14003
"36081038100",1877,1466,1115,153,2624,474,4435,1966,14110
"36081038301",0,0,0,0,0,0,0,0,0
"36081038302",0,0,0,0,0,0,0,0,0
"36081038400",47,6,1857,218,264,1,203,0,2596
"36081039400",74,0,2478,168,150,135,174,50,3229
"36081039800",56,0,1525,74,76,0,85,0,1816
"36081039900",1616,262,157,0,1506,552,2876,579,7548
"36081040000",17,0,1295,94,66,0,38,0,1510
"36081040100",2448,769,69,45,3652,1017,5087,1644,14731
"36081040200",6,0,1364,190,23,34,34,8,1659
"36081040300",2310,724,196,87,3042,923,4858,1608,13748
"36081040400",25,23,3284,585,330,45,262,45,4599
"36081040500",1139,521,48,14,1011,429,2081,933,6176
"36081040700",2323,706,459,42,3467,461,5535,1140,14133
"36081040900",1375,211,139,195,3016,970,3783,1199,10888
"36081041100",1472,414,104,18,1351,501,2495,634,6989
"36081041300",1503,466,0,0,2009,844,2650,953,8425
"36081041400",48,61,2547,270,523,228,519,217,4413
"36081041500",1864,240,120,0,1017,445,1975,524,6185
"36081042400",6,0,2178,280,115,13,64,0,2656
"36081042600",36,27,14,56,0,1,0,16,150
"36081042700",1960,547,68,0,1702,896,2981,1209,9363
"36081043200",0,0,1416,31,50,5,88,0,1590
"36081043400",50,0,1277,48,322,11,139,0,1847
"36081043701",1532,399,226,195,745,242,1904,796,6039
"36081043702",2171,755,962,186,1773,366,2507,994,9714
"36081043900",1973,687,52,136,933,731,2544,1416,8472
"36081044000",42,0,2208,681,787,61,570,21,4370
"36081044301",509,1422,134,205,941,324,1059,1555,6149
"36081044302",1319,263,460,178,2159,368,1924,355,7026
"36081044400",192,92,656,112,1381,568,786,404,4191
"36081044601",683,99,729,118,1038,380,1250,255,4552
"36081044602",166,286,736,545,2090,1081,880,641,6425
"36081044800",207,5,244,93,1639,483,389,38,3098
"36081045000",631,26,45,0,1052,148,481,5,2388
"36081045200",80,7,91,61,282,81,59,0,661
"36081045400",329,35,471,48,2857,534,335,0,4609
"36081045500",2199,933,6667,1141,1822,207,2162,454,15585
"36081045600",56,5,56,87,1071,125,27,26,1453
"36081045700",466,55,8,0,2032,392,615,49,3617
"36081045800",239,16,209,5,1363,254,226,4,2316
"36081045900",1088,67,2,4,2110,652,1703,245,5871
"36081046000",423,159,868,157,2694,1500,1264,475,7540
"36081046100",609,278,11,1,1627,456,955,316,4253
"36081046200",847,329,383,123,5712,831,2942,200,11367
"36081046300",1316,378,20,23,1649,591,1615,520,6112
"36081046400",434,28,262,31,508,84,289,49,1685
"36081046500",1834,324,8,0,1076,376,2317,584,6519
"36081046600",482,211,794,39,1148,830,427,41,3972
"36081046700",2133,1516,149,1,2299,717,2594,1678,11087
"36081046800",366,27,267,16,2122,373,392,185,3748
"36081046900",2458,646,101,94,3261,1645,2997,1183,12385
"36081047000",295,40,367,19,2299,302,697,3,4022
"36081047100",796,19,11,0,2528,864,893,84,5195
"36081047200",603,320,700,13,1838,140,464,64,4142
"36081047300",709,74,95,0,2267,554,624,132,4455
"36081047500",1169,178,40,2,2466,704,999,352,5910
"36081047600",518,65,267,2,600,7,94,43,1596
"36081047800",1357,41,1056,222,2678,146,1296,0,6796
"36081047900",1276,98,52,1,3096,833,824,86,6266
"36081048000",346,58,503,27,1790,208,563,27,3522
"36081048100",1804,480,179,166,3488,410,1901,257,8685
"36081048200",70,15,331,14,966,86,271,49,1802
"36081048300",1446,184,28,0,1891,663,1482,491,6185
"36081048400",358,38,1249,193,2951,188,549,23,5549
"36081048500",722,65,54,0,3337,461,828,64,5531
"36081048900",384,39,4,1,1129,92,514,30,2193
"36081049200",475,10,2485,65,1121,224,536,8,4924
"36081049301",1195,88,22,19,581,28,430,63,2426
"36081049302",1525,128,101,0,279,133,413,113,2692
"36081049500",899,140,5,0,230,9,463,24,1770
"36081049600",407,46,591,13,1786,261,544,24,3672
"36081049700",1155,207,20,5,1198,90,590,102,3367
"36081049900",1188,72,0,0,3139,581,891,42,5913
"36081050000",184,154,2198,572,660,246,481,210,4705
"36081050201",37,0,1129,19,219,16,183,16,1619
"36081050202",31,10,944,56,276,27,104,23,1471
"36081050400",131,3,1628,168,81,2,139,0,2152
"36081050500",765,88,19,14,484,86,293,21,1770
"36081050600",13,0,1352,49,254,18,99,0,1785
"36081050700",2032,255,66,0,1043,173,583,22,4174
"36081050800",37,13,1560,151,249,62,79,0,2151
"36081051000",13,36,1559,51,412,7,81,36,2195
"36081051100",1705,45,0,0,176,35,278,19,2258
"36081051200",40,0,1871,241,663,97,219,75,3206
"36081051300",1111,84,0,0,783,45,396,13,2432
"36081051500",2119,268,57,0,243,6,487,125,3305
"36081051600",103,7,1478,121,111,46,220,53,2139
"36081051700",1198,120,0,15,320,124,670,148,2595
"36081051800",0,104,2159,51,110,17,134,118,2693
"36081052000",37,2,1422,53,83,2,68,15,1682
"36081052100",1206,166,76,0,183,112,219,78,2040
"36081052200",5,0,1696,110,26,17,122,5,1981
"36081052400",0,0,1350,72,111,88,66,88,1775
"36081052500",1179,293,23,0,280,59,344,83,2261
"36081052600",45,50,1117,392,315,40,213,54,2226
"36081052800",8,0,1153,198,135,0,93,0,1587
"36081053000",0,0,1975,137,155,44,51,53,2415
"36081053100",2129,348,0,0,192,116,698,211,3694
"36081053200",52,0,1428,84,135,0,79,0,1778
"36081053401",91,0,1736,40,149,0,118,0,2134
"36081053500",742,134,0,7,349,96,799,206,2333
"36081053601",54,0,1232,87,350,18,222,13,1976
"36081053800",18,0,1458,112,114,0,30,0,1732
"36081053900",2305,606,89,1,1016,308,1424,430,6179
"36081054000",218,74,2413,577,863,185,451,207,4988
"36081054200",853,230,1121,64,2623,585,852,199,6527
"36081054500",2293,575,15,0,748,182,1882,473,6168
"36081054700",3128,861,196,15,631,542,2904,1038,9315
"36081054800",280,0,495,26,1420,95,324,45,2685
"36081054900",3069,1227,139,45,759,239,2886,1076,9440
"36081055100",2965,775,109,10,864,207,1775,462,7167
"36081055200",441,56,1020,106,1094,193,643,66,3619
"36081055300",1097,510,52,19,583,175,918,486,3840
"36081055400",485,42,459,17,1191,150,468,33,2845
"36081055500",1518,428,108,7,159,100,1259,474,4053
"36081055600",471,20,215,22,1593,90,484,14,2909
"36081055700",2505,474,44,14,454,290,1603,695,6079
"36081055800",421,32,221,9,1027,48,467,0,2225
"36081055900",660,292,29,0,339,81,861,288,2550
"36081056000",515,4,106,74,750,184,269,0,1902
"36081056100",43,0,45,0,32,0,15,0,135
"36081056200",522,27,274,0,656,176,334,109,2098
"36081056400",355,9,174,15,965,57,293,29,1897
"36081056500",964,268,0,10,112,26,909,270,2559
"36081056600",180,76,363,5,1020,59,515,22,2240
"36081056700",3380,118,132,0,429,172,2237,109,6577
"36081056800",498,84,2983,117,611,123,789,145,5350
"36081057700",3019,277,0,0,410,91,1019,200,5016
"36081057900",1268,139,13,0,171,19,496,34,2140
"36081058000",58,10,2864,230,375,6,364,66,3973
"36081058100",2303,379,59,0,128,6,945,237,4057
"36081058200",81,0,3554,681,489,188,368,208,5569
"36081058300",2413,256,249,9,355,45,1241,78,4646
"36081058500",3011,631,62,0,735,37,1615,567,6658
"36081058700",2622,434,38,0,317,10,517,203,4141
"36081058900",2601,869,23,33,398,204,1175,531,5834
"36081059000",24,0,1071,201,132,0,92,0,1520
"36081059100",4019,500,81,0,436,174,2041,413,7664
"36081059200",81,0,958,34,42,0,43,0,1158
"36081059300",3062,436,136,0,489,67,908,192,5290
"36081059400",12,0,1359,36,127,19,81,0,1634
"36081059500",2967,538,176,23,523,198,1416,458,6299
"36081059600",19,1,1386,24,33,0,60,0,1523
"36081059800",88,3,1403,94,138,1,144,2,1873
"36081059900",1232,63,5,1,45,29,254,66,1695
"36081060000",32,0,1005,31,11,7,116,0,1202
"36081060100",1326,175,5,0,348,82,694,125,2755
"36081060300",1607,103,15,0,258,23,605,91,2702
"36081060600",33,0,1234,23,103,0,87,0,1480
"36081060701",16,0,0,0,0,0,16,0,32
"36081060800",0,0,1525,95,21,0,16,0,1657
"36081061000",12,0,1492,12,40,0,27,0,1583
"36081061200",62,0,1335,104,27,0,41,6,1575
"36081061301",4290,900,100,0,603,388,1347,777,8405
"36081061302",11,0,4,0,0,0,0,0,15
"36081061400",53,0,1120,26,122,0,96,0,1417
"36081061601",10,7,2131,75,124,6,75,0,2428
"36081061602",38,19,1071,60,87,0,106,15,1396
"36081061800",75,6,1637,56,81,5,14,6,1880
"36081061900",2006,310,23,0,314,46,674,164,3537
"36081062000",44,0,1253,34,187,0,134,0,1652
"36081062100",1966,385,24,0,120,94,520,273,3382
"36081062200",45,0,1441,72,85,5,113,0,1761
"36081062300",1600,286,6,0,131,26,576,155,2780
"36081062400",0,0,0,0,0,0,0,0,0
"36081062500",2206,104,37,11,210,18,461,44,3091
"36081062600",106,25,2680,170,91,24,198,43,3337
"36081062700",2476,157,7,0,277,0,1196,52,4165
"36081062900",2426,201,45,49,335,30,504,100,3690
"36081063000",25,0,1693,60,79,1,159,1,2018
"36081063200",27,0,2078,131,197,26,79,26,2564
"36081063301",1278,102,7,0,35,14,241,13,1690
"36081063302",1405,68,0,0,17,0,425,6,1921
"36081063500",2417,133,22,7,49,1,486,63,3178
"36081063700",2721,63,0,53,290,72,769,125,4093
"36081063800",327,7,2936,508,333,2,337,0,4450
"36081063900",1720,177,43,0,580,18,524,47,3109
"36081064101",1526,235,17,6,254,0,258,123,2419
"36081064102",154,0,0,0,0,0,10,0,164
"36081064500",1165,58,22,1,596,106,223,32,2203
"36081064600",20,0,2633,270,161,0,115,20,3219
"36081065000",66,0,2698,113,193,0,204,0,3274
"36081065400",557,19,2230,135,153,24,554,26,3698
"36081065501",0,0,0,0,0,0,0,0,0
"36081065600",298,67,4114,471,251,22,310,67,5600
"36081065702",1333,103,84,12,229,0,321,0,2082
"36081065703",2576,92,0,0,81,32,254,45,3080
"36081065900",1604,117,0,0,33,11,148,0,1913
"36081066000",358,114,3015,86,101,0,335,96,4105
"36081066100",1184,87,15,0,169,3,98,27,1583
"36081066300",2072,114,6,0,249,8,144,13,2606
"36081066400",423,77,7868,629,860,146,577,1,10581
"36081066501",3044,226,0,1,90,12,198,1,3572
"36081066701",1903,143,47,0,148,39,415,39,2734
"36081066900",1463,49,0,0,66,18,58,7,1661
"36081067100",1697,68,5,30,307,22,148,0,2277
"36081067700",1463,47,20,0,296,0,82,20,1928
"36081067900",2466,425,76,2,414,22,1108,126,4639
"36081068000",232,2,4326,90,376,31,330,2,5389
"36081068200",0,0,1104,106,54,14,49,14,1341
"36081068300",1517,288,242,31,1844,549,1472,444,6387
"36081068700",1758,196,120,0,2155,453,749,148,5579
"36081069000",25,3,3027,333,70,2,10,26,3496
"36081069300",1312,75,102,224,754,397,616,147,3627
"36081069400",243,14,2582,587,242,0,332,21,4021
"36081069500",952,85,4,0,634,83,367,57,2182
"36081069701",1984,251,274,73,1141,267,801,150,4941
"36081069702",2016,75,36,2,1262,157,180,19,3747
"36081070300",1223,62,44,0,652,26,317,47,2371
"36081070700",1348,96,0,0,724,88,357,72,2685
"36081070900",1384,52,20,0,1002,85,217,0,2760
"36081071100",3020,611,95,0,1812,327,485,97,6447
"36081071303",3946,167,67,0,981,157,1003,36,6357
"36081071304",3179,966,310,21,1353,362,640,71,6902
"36081071305",2529,255,60,0,1791,206,824,48,5713
"36081071306",2681,885,288,0,2151,238,1375,158,7776
"36081071600",0,0,0,0,0,0,0,0,0
"36081071701",3331,369,64,43,1459,305,609,31,6211
"36081071702",1829,268,60,0,1387,321,730,18,4613
"36081071900",1547,327,106,23,532,52,370,46,3003
"36081072100",2730,598,63,0,1260,85,826,198,5760
"36081072300",1145,45,76,0,699,0,138,0,2103
"36081072900",682,31,17,0,360,57,78,12,1237
"36081073100",990,87,18,0,389,17,106,0,1607
"36081073700",1236,51,0,0,417,43,127,1,1875
"36081073900",3392,211,223,0,1383,68,699,62,6038
"36081074100",1942,161,64,0,820,34,404,19,3444
"36081074300",2636,205,15,0,1622,139,849,22,5488
"36081074500",1873,480,213,56,1116,88,387,65,4278
"36081074700",886,145,343,59,1896,104,289,92,3814
"36081074900",1143,22,0,0,315,8,93,0,1581
"36081075701",3272,99,16,18,1476,172,639,46,5738
"36081075702",2484,40,262,59,1112,366,297,28,4648
"36081076901",2417,44,246,0,1369,96,367,22,4561
"36081076902",866,15,25,0,499,81,144,0,1630
"36081077300",1181,160,217,0,589,42,351,21,2561
"36081077500",1563,114,48,30,245,14,115,80,2209
"36081077902",4265,451,202,10,389,55,172,52,5596
"36081077903",1755,162,107,0,1014,91,382,52,3563
"36081077904",3503,726,161,0,2041,297,553,0,7281
"36081077905",1165,153,217,39,1029,3,539,14,3159
"36081077906",1704,145,174,0,985,201,431,0,3640
"36081077907",2063,449,64,0,385,41,397,0,3399
"36081077908",1486,114,887,51,1018,553,432,227,4768
"36081078800",95,8,1007,187,244,34,127,14,1716
"36081079000",59,4,1202,314,700,218,201,71,2769
"36081079200",99,0,1501,381,520,45,264,12,2822
"36081079300",0,0,0,0,0,0,0,0,0
"36081079701",432,94,179,58,5206,1088,585,72,7714
"36081079702",398,19,9,8,3331,1149,572,0,5486
"36081079900",615,85,62,0,1998,645,545,132,4082
"36081080301",653,165,36,0,3567,416,953,161,5951
"36081080302",1227,56,154,0,1998,95,488,0,4018
"36081080900",3700,112,411,161,2196,146,878,0,7604
"36081081400",215,274,1839,263,1218,169,323,274,4575
"36081081800",329,112,1460,145,1446,854,691,169,5206
"36081083700",633,36,0,0,3982,844,356,51,5902
"36081083800",1669,55,703,31,3158,620,1489,65,7790
"36081084000",939,44,798,124,4168,382,1273,29,7757
"36081084500",257,40,718,57,2473,893,293,142,4873
"36081084601",732,36,219,6,1487,191,478,109,3258
"36081084602",116,119,66,112,789,54,266,119,1641
"36081084900",351,295,164,66,4628,1771,992,202,8469
"36081085300",264,46,79,0,3096,1024,224,22,4755
"36081085500",985,197,151,90,3976,976,941,170,7486
"36081085700",598,155,107,34,3157,1368,721,134,6274
"36081085900",919,63,95,4,3071,1104,548,87,5891
"36081086100",287,49,16,25,1463,338,291,95,2564
"36081086300",834,84,110,31,4307,1479,1112,103,8060
"36081086400",714,93,314,44,1477,245,893,178,3958
"36081086500",645,132,0,33,2406,1165,408,31,4820
"36081086900",106,34,16,12,1465,717,136,149,2635
"36081087100",153,119,406,369,920,349,260,203,2779
"36081088400",6059,331,31,56,547,207,790,88,8109
"36081088901",2334,353,110,77,5308,2123,1118,1047,12470
"36081089200",7247,213,0,0,552,18,890,0,8920
"36081090700",499,99,0,0,554,60,173,86,1471
"36081091601",3823,139,1,1,41,0,60,1,4066
"36081091602",0,0,0,0,0,0,0,0,0
"36081091800",8,0,0,0,0,0,0,0,8
"36081091900",1347,221,30,0,3277,815,1770,302,7762
"36081092200",2048,40,0,0,0,0,89,0,2177
"36081092500",1224,276,64,92,1765,399,1396,365,5581
"36081092800",3194,41,11,0,37,0,13,0,3296
"36081092900",1715,14,62,0,4235,633,2540,224,9423
"36081093401",3224,167,24,0,192,6,385,6,4004
"36081093402",2730,265,158,33,590,65,354,0,4195
"36081093800",3294,268,421,42,560,97,888,117,5687
"36081093900",1820,285,140,0,2514,219,1164,192,6334
"36081094201",1535,117,935,277,447,36,1063,31,4441
"36081094202",961,452,1431,656,866,296,724,658,6044
"36081094203",3289,267,1086,29,893,20,1047,20,6651
"36081094500",2165,345,30,1,1403,183,1136,13,5276
"36081094700",1219,138,6,12,1109,215,949,92,3740
"36081095400",1127,123,2369,724,561,89,720,124,5837
"36081096400",596,128,1885,433,784,41,810,142,4819
"36081097202",662,140,1176,577,51,28,588,159,3381
"36081097203",747,807,2098,1547,685,589,1469,1253,9195
"36081097204",529,120,1751,601,388,66,763,109,4327
"36081097300",1742,22,0,0,218,10,252,0,2244
"36081098100",1495,139,0,0,698,104,163,112,2711
"36081098700",2158,44,51,0,332,11,291,0,2887
"36081099100",4939,207,0,0,1025,41,785,60,7057
"36081099200",677,398,2077,507,493,12,897,310,5371
"36081099701",1750,94,29,0,620,66,79,0,2638
"36081099703",2583,34,24,0,1136,81,331,0,4189
"36081099704",4599,554,103,14,1825,145,848,0,8088
"36081099705",1735,63,0,0,843,79,179,12,2911
"36081099801",1426,65,4057,818,703,180,1393,155,8797
"36081099802",838,565,3245,459,121,119,532,154,6033
"36081099900",0,0,0,0,0,0,0,0,0
"36081100801",982,376,663,105,143,8,354,40,2671
"36081100802",2824,888,3571,296,1157,265,2032,857,11890
"36081101001",3368,1254,1834,1195,1647,487,2568,1606,13959
"36081101002",2848,617,421,296,14,31,188,58,4473
"36081101700",4520,99,49,2,1158,250,648,2,6728
"36081102900",2397,210,0,2,923,0,792,28,4352
"36081103201",621,832,3348,1135,958,238,1186,1295,9613
"36081103202",3301,581,1657,224,842,290,2007,384,9286
"36081103300",2668,272,7,0,973,124,407,0,4451
"36081103900",4228,137,0,0,2225,144,851,60,7645
"36081104700",3487,3,45,5,2707,417,920,0,7584
"36081105900",2318,63,0,0,1396,84,103,11,3975
"36081107201",1873,223,1,2,5,8,48,56,2216
"36081107202",0,0,0,0,0,0,0,0,0
"36081108500",1133,121,23,3,1045,171,260,18,2774
"36081109300",2121,2,41,0,1005,47,555,1,3772
"36081109700",1159,31,1,0,428,0,148,0,1767
"36081109900",2069,45,13,2,1552,221,980,20,4902
"36081111300",1214,28,0,7,1045,182,159,136,2771
"36081112300",1027,33,26,3,945,305,539,129,3007
"36081112900",1472,42,97,0,557,84,98,0,2350
"36081113300",1050,51,16,0,587,25,285,36,2050
"36081113900",1725,178,39,0,1300,157,496,38,3933
"36081114100",1313,45,38,1,888,52,197,3,2537
"36081114700",859,187,42,0,714,0,233,6,2041
"36081115100",638,17,0,0,511,23,112,0,1301
"36081115500",609,12,0,0,1492,213,640,25,2991
"36081115700",849,50,97,0,2027,492,50,64,3629
"36081115900",533,174,155,0,2839,639,470,122,4932
"36081116100",649,22,93,0,2582,794,949,8,5097
"36081116300",786,202,351,30,5093,1896,854,158,9370
"36081116700",301,52,9,13,1149,464,395,198,2581
"36081117100",882,126,69,7,1239,486,663,219,3691
"36081117500",2032,20,24,4,2507,431,447,191,5656
"36081118100",603,118,64,0,737,55,156,0,1733
"36081118500",501,38,37,0,1315,295,517,112,2815
"36081118700",534,95,18,3,1470,284,452,177,3033
"36081118900",389,50,0,0,1782,331,251,39,2842
"36081119100",561,129,0,0,2426,304,1012,85,4517
"36081119300",471,103,37,17,1223,228,243,31,2353
"36081119500",506,15,100,0,764,27,338,0,1750
"36081119900",324,15,53,9,842,234,138,1,1616
"36081120100",310,14,13,5,1065,199,181,6,1793
"36081120300",392,101,3,0,978,260,113,50,1897
"36081120500",132,39,18,9,1800,732,140,2,2872
"36081120700",1286,56,7,6,1221,205,586,12,3379
"36081121100",0,0,0,0,0,0,0,0,0
"36081121500",896,15,73,0,2749,701,877,101,5412
"36081122300",1438,43,27,0,1645,385,308,11,3857
"36081122701",3735,404,377,326,6073,874,3500,0,15289
"36081122702",2032,853,974,1445,1181,522,1432,790,9229
"36081124100",1224,64,274,11,1148,421,158,8,3308
"36081124700",2084,183,33,19,842,279,227,4,3671
"36081125700",426,172,239,57,1820,448,125,120,3407
"36081126500",525,69,131,46,572,170,223,24,1760
"36081126700",765,57,70,82,1219,221,341,86,2841
"36081127700",2560,87,288,7,379,173,88,11,3593
"36081128300",20,0,0,0,9,0,0,0,29
"36081129102",2129,148,3,0,1186,112,217,2,3797
"36081129103",2378,88,45,62,1184,120,257,0,4134
"36081129104",1964,88,124,0,1899,163,208,34,4480
"36081130100",1619,139,749,43,1332,102,708,50,4742
"36081133300",2048,104,59,3,1261,151,458,40,4124
"36081133900",633,128,2,1,545,6,139,0,1454
"36081134100",952,5,5,0,2296,297,128,48,3731
"36081134700",2405,224,786,60,5282,1265,1832,36,11890
"36081136700",1970,229,398,5,3062,390,794,22,6870
"36081137700",1821,357,211,11,3440,416,197,135,6588
"36081138501",1380,45,30,0,2874,243,242,0,4814
"36081138502",9,23,0,0,0,0,9,7,48
"36081139900",800,36,0,0,853,18,110,5,1822
"36081140300",1054,68,13,0,1056,85,324,0,2600
"36081140901",338,24,19,0,513,54,90,0,1038
"36081140902",814,149,119,4,2038,6,167,125,3422
"36081141700",1498,82,196,0,2925,120,720,22,5563
"36081142900",1640,97,0,0,1383,204,121,17,3462
"36081143500",821,42,0,0,1198,92,161,0,2314
"36081144100",1189,42,0,0,1666,357,361,63,3678
"36081144700",563,104,392,5,1653,459,621,63,3860
"36081145101",862,21,0,0,665,108,123,0,1779
"36081145102",741,53,44,0,1648,117,281,18,2902
"36081145900",1732,43,10,0,1000,128,514,33,3460
"36081146300",1371,106,25,3,1109,165,125,106,3010
"36081146700",1664,192,29,1,1262,165,422,70,3805
"36081147100",1586,13,26,0,1252,163,443,103,3586
"36081147900",2751,36,28,0,1589,431,940,202,5977
"36081148300",1827,41,24,11,986,31,88,0,3008
"36081150701",1897,39,0,0,874,96,198,0,3104
"36081150702",1772,97,11,0,948,210,252,163,3453
"36081152901",2649,276,43,4,3445,368,636,119,7540
"36081152902",2362,121,387,8,2131,123,50,11,5193
"36081155101",1869,43,18,0,17,0,57,0,2004
"36081155102",3632,215,658,30,2204,111,838,25,7713
"36081156700",122,74,50,92,440,108,27,53,966
"36081157101",2564,331,260,13,4201,490,993,14,8866
"36081157102",594,92,31,0,1126,222,280,53,2398
"36081157901",1883,360,135,9,2499,94,169,265,5414
"36081157902",1406,86,62,1,1917,274,254,22,4022
"36081157903",1564,133,0,0,2079,76,157,0,4009
"36081161700",3341,70,0,3,1426,69,1325,26,6260
"36081162100",2124,451,322,26,3869,375,1530,336,9033
"36081990100",0,0,0,0,0,0,0,0,0
"36083040100",2640,528,368,360,275,103,375,253,4902
"36083040200",3211,869,438,407,108,54,402,49,5538
"36083040300",1429,548,168,115,384,60,127,29,2860
"36083040400",697,401,372,396,88,175,227,235,2591
"36083040500",824,329,409,508,101,10,170,57,2408
"36083040600",705,401,185,108,79,44,6,27,1555
"36083040700",1438,1014,418,349,475,200,132,122,4148
"36083040800",1080,255,287,36,119,95,13,72,1957
"36083040900",1537,335,426,256,118,141,158,136,3107
"36083041000",1678,751,460,349,258,260,203,226,4185
"36083041100",3566,427,465,231,447,236,371,210,5953
"36083041200",2332,186,48,42,255,0,156,9,3028
"36083041300",2000,410,202,85,105,99,17,31,2949
"36083041400",2935,354,106,87,325,249,167,121,4344
"36083051500",1548,547,59,114,184,239,71,109,2871
"36083051600",5045,677,249,37,534,244,314,26,7126
"36083051701",2925,408,0,0,72,0,86,0,3491
"36083051702",2927,360,33,0,47,7,55,0,3429
"36083051800",5234,494,0,0,0,0,21,0,5749
"36083051901",3526,292,50,116,103,0,72,0,4159
"36083051902",3016,253,21,21,78,23,43,0,3455
"36083052002",1556,91,5,0,62,0,23,0,1737
"36083052003",4182,51,126,1,129,26,6,0,4521
"36083052004",5424,93,12,0,447,0,82,0,6058
"36083052101",1893,147,42,0,35,28,32,14,2191
"36083052102",1475,155,0,0,26,0,13,0,1669
"36083052103",1649,57,0,0,13,0,4,0,1723
"36083052201",4422,80,2,0,24,5,21,2,4556
"36083052203",5365,79,43,0,125,0,48,0,5660
"36083052204",2796,126,0,0,2,0,23,11,2958
"36083052301",3610,257,174,0,175,1,303,2,4522
"36083052303",996,161,3,0,14,0,2,0,1176
"36083052304",5879,178,108,0,175,6,78,0,6424
"36083052402",2101,29,34,2,89,0,47,0,2302
"36083052403",5450,534,142,1,475,0,191,32,6825
"36083052404",6382,215,107,0,503,0,416,0,7623
"36083052501",6100,209,61,0,140,9,37,0,6556
"36083052502",4691,275,59,0,134,0,55,0,5214
"36083052503",1140,48,10,5,38,0,23,2,1266
"36083052601",3281,177,94,5,187,32,141,0,3917
"36083052602",953,62,17,0,45,0,45,0,1122
"36083052603",2516,346,0,0,29,0,45,13,2949
"36085000300",711,183,246,118,448,15,187,152,2060
"36085000600",1508,274,124,11,226,124,295,22,2584
"36085000700",1486,482,1845,997,534,643,1293,538,7818
"36085000800",3642,273,271,46,1087,320,1278,238,7155
"36085000900",456,46,711,253,361,33,655,18,2533
"36085001100",734,185,1423,357,172,161,574,250,3856
"36085001700",547,187,180,50,406,148,235,271,2024
"36085001800",479,0,41,0,57,0,73,0,650
"36085002001",1820,109,114,2,477,8,449,15,2994
"36085002002",2523,371,47,3,388,75,157,29,3593
"36085002100",1155,321,795,302,738,279,1052,380,5022
"36085002700",232,302,433,126,392,191,437,299,2412
"36085002900",962,391,1676,1177,1287,288,1549,750,8080
"36085003300",1836,214,778,44,763,111,576,198,4520
"36085003600",1184,197,179,0,943,105,603,187,3398
"36085003900",1236,149,335,69,222,48,509,11,2579
"36085004000",2675,1449,3655,1535,2570,694,2997,2016,17591
"36085004700",1729,47,216,1,152,32,325,0,2502
"36085005000",2438,184,402,21,610,25,330,93,4103
"36085005900",2164,283,210,12,222,0,174,20,3085
"36085006400",2073,231,254,247,316,95,445,267,3928
"36085006700",1947,177,134,10,267,74,197,33,2839
"36085007000",5931,1159,411,103,934,313,903,349,10103
"36085007400",3279,561,16,3,813,139,555,203,5569
"36085007500",2090,342,533,473,395,252,1451,504,6040
"36085007700",289,169,482,160,206,19,282,115,1722
"36085008100",1162,378,941,613,559,130,511,463,4757
"36085009601",2348,226,72,32,466,294,416,148,4002
"36085009602",2822,79,54,0,506,1,361,0,3823
"36085009700",1868,456,1414,188,233,157,684,572,5572
"36085010500",2660,558,681,220,658,63,1180,287,6307
"36085011201",4968,96,0,0,778,13,711,0,6566
"36085011202",4410,509,78,6,633,203,595,222,6656
"36085011401",1379,411,142,274,480,198,245,457,3586
"36085011402",2868,167,108,0,519,60,339,109,4170
"36085012100",2713,272,0,1,282,180,426,309,4183
"36085012200",3293,152,41,0,228,0,179,7,3900
"36085012500",1515,222,628,9,216,78,648,185,3501
"36085012804",3001,309,27,0,648,57,736,72,4850
"36085012805",2716,147,0,0,59,18,494,0,3434
"36085012806",4721,329,366,45,441,131,1350,105,7488
"36085013201",1349,67,23,0,107,0,154,0,1700
"36085013203",4852,385,37,0,383,109,551,22,6339
"36085013204",4112,412,9,9,292,3,265,10,5112
"36085013301",135,347,301,388,50,310,105,482,2118
"36085013302",860,260,1382,174,704,196,1072,427,5075
"36085013400",3106,278,11,0,228,28,443,99,4193
"36085013800",5918,109,48,0,23,0,373,0,6471
"36085014100",1174,504,245,48,327,45,759,266,3368
"36085014604",6618,658,0,0,152,40,822,130,8420
"36085014605",3274,137,0,3,231,19,362,11,4037
"36085014606",6360,387,0,0,472,106,531,0,7856
"36085014607",4151,291,0,2,280,177,304,16,5221
"36085014608",3467,192,0,0,136,0,399,0,4194
"36085014700",2895,227,84,1,225,0,314,0,3746
"36085015100",3817,221,23,2,711,44,526,46,5390
"36085015400",0,0,0,0,0,0,0,0,0
"36085015601",5654,279,0,0,528,98,337,100,6996
"36085015602",3280,82,0,0,84,0,128,0,3574
"36085015603",3943,391,12,0,232,18,152,153,4901
"36085016901",2560,142,201,0,280,100,500,93,3876
"36085017005",4193,189,0,3,269,2,300,0,4956
"36085017007",3737,189,411,9,795,210,991,93,6435
"36085017008",6620,317,60,20,398,0,768,14,8197
"36085017009",3975,343,14,0,41,32,278,51,4734
"36085017010",7876,611,30,0,475,93,1085,69,10239
"36085017011",4067,318,16,5,210,0,401,28,5045
"36085017012",4119,402,11,30,231,0,454,112,5359
"36085017300",1092,304,394,174,532,33,316,189,3034
"36085017600",4507,174,26,0,265,8,282,9,5271
"36085017700",5620,291,39,6,924,2,280,30,7192
"36085018100",2217,367,6,23,270,17,367,56,3323
"36085018701",1236,188,60,0,202,35,101,88,1910
"36085018702",3936,112,177,133,1983,35,1071,46,7493
"36085018901",3661,445,260,3,619,211,515,74,5788
"36085018902",2714,320,153,25,1732,236,483,45,5708
"36085019700",1587,56,15,0,122,23,45,45,1893
"36085019800",5889,273,28,20,360,56,334,61,7021
"36085020100",2397,282,186,72,402,173,777,115,4404
"36085020700",1665,1303,2009,250,426,500,1591,1673,9417
"36085020801",6732,1707,142,3,471,83,552,284,9974
"36085020803",5383,473,15,0,320,0,477,73,6741
"36085020804",4562,395,11,1,582,42,198,0,5791
"36085021300",2174,727,426,218,887,395,1357,615,6799
"36085022300",805,175,1008,156,418,65,782,133,3542
"36085022600",7452,153,277,3,749,90,1798,57,10579
"36085022800",39,0,0,0,0,0,0,0,39
"36085023100",1303,429,1268,141,857,256,1157,287,5698
"36085023900",1477,201,361,29,707,518,1451,644,5388
"36085024401",5670,265,0,0,434,15,460,74,6918
"36085024402",3424,275,26,0,484,0,153,3,4365
"36085024700",1087,252,656,97,554,38,670,170,3524
"36085024800",4342,365,0,0,97,30,280,44,5158
"36085025100",4939,290,0,0,637,13,510,0,6389
"36085027301",2482,303,209,76,476,264,326,0,4136
"36085027302",2355,227,140,0,508,112,232,33,3607
"36085027702",4845,312,138,23,830,394,831,252,7625
"36085027704",3350,186,0,0,792,29,369,19,4745
"36085027705",4116,184,120,0,1080,124,432,18,6074
"36085027706",2471,122,294,0,489,142,467,33,4018
"36085027900",1409,110,1,1,124,13,110,14,1782
"36085029102",2156,100,156,0,336,66,557,27,3398
"36085029103",6526,323,44,50,656,45,764,17,8425
"36085029104",5503,253,520,126,728,143,1329,59,8661
"36085030301",2779,223,532,71,1152,132,1387,114,6390
"36085030302",2530,671,1223,142,1335,378,1732,516,8527
"36085031901",305,200,932,731,311,71,363,329,3242
"36085031902",871,367,1657,1286,184,246,447,519,5577
"36085032300",413,101,255,81,231,50,409,106,1646
"36085990100",0,0,0,0,0,0,0,0,0
"36087010101",4664,237,367,0,344,0,605,0,6217
"36087010102",3957,13,471,27,678,136,932,136,6350
"36087010200",3514,147,256,0,342,167,696,201,5323
"36087010501",3930,285,375,2,616,0,1047,139,6394
"36087010502",3854,189,1187,24,1385,429,1655,423,9146
"36087010503",1349,33,563,0,378,17,163,12,2515
"36087010601",2599,102,285,125,453,202,1508,256,5530
"36087010602",2416,752,1327,49,2103,67,3144,492,10350
"36087010701",2107,272,618,108,1066,50,1829,273,6323
"36087010702",829,319,622,69,1389,664,2260,1030,7182
"36087010703",1591,306,519,49,1068,209,1849,507,6098
"36087010801",3678,125,307,0,375,3,227,0,4715
"36087010802",4242,188,160,13,663,40,408,0,5714
"36087010803",3846,272,140,210,858,60,253,7,5646
"36087010804",3018,261,149,0,679,0,321,159,4587
"36087010901",4212,117,112,0,697,0,662,9,5809
"36087010902",2731,138,186,0,844,128,480,128,4635
"36087011000",1696,59,78,12,67,0,108,0,2020
"36087011101",4502,447,166,96,1143,51,1098,188,7691
"36087011102",3381,337,1000,2,1260,110,1065,236,7391
"36087011200",5248,110,107,13,745,40,387,7,6657
"36087011301",1803,71,2306,390,2165,597,1852,617,9801
"36087011302",3647,198,342,16,1344,70,952,69,6638
"36087011303",4604,126,280,0,1045,39,551,53,6698
"36087011401",3222,69,43,2,668,22,305,15,4346
"36087011403",4094,58,272,16,1024,49,437,52,6002
"36087011404",2483,145,432,35,696,7,381,25,4204
"36087011405",1841,30,1131,20,882,0,267,3,4174
"36087011501",6560,537,176,0,440,0,573,36,8322
"36087011502",4196,563,1037,0,1700,82,1477,279,9334
"36087011504",1264,113,4045,61,1291,121,1168,115,8178
"36087011505",1088,1916,0,3,112,31,1,0,3151
"36087011506",1268,3330,10,4,95,38,59,26,4830
"36087011601",2834,56,406,2,173,36,134,4,3645
"36087011602",4234,463,160,28,648,0,188,17,5738
"36087011603",4389,166,129,48,529,58,641,38,5998
"36087011700",2621,99,140,39,174,7,368,17,3465
"36087011800",340,71,160,9,288,4,127,6,1005
"36087011901",2442,153,119,0,643,137,634,150,4278
"36087011902",2121,158,355,7,583,165,774,176,4339
"36087012000",3085,84,192,5,366,110,143,120,4105
"36087012101",3855,2299,18,0,142,0,144,0,6458
"36087012102",2842,5404,260,0,0,206,44,181,8937
"36087012103",3144,2383,12,0,1,103,3,74,5720
"36087012105",2849,2490,104,26,200,119,162,133,6083
"36087012106",1417,1365,465,4,550,85,661,85,4632
"36087012202",373,149,3266,549,1170,703,870,616,7696
"36087012203",1987,814,182,0,16,23,51,6,3079
"36087012204",1877,1519,167,0,95,17,87,12,3774
"36087012300",532,481,1676,531,1634,1194,1711,1313,9072
"36087012401",1211,190,2581,345,598,221,454,67,5667
"36087012402",576,212,2196,205,1734,1008,1726,1051,8708
"36087012501",4012,477,627,8,316,74,485,109,6108
"36087012502",2798,224,1100,34,729,210,561,130,5786
"36087012600",5166,553,257,51,426,0,358,40,6851
"36087012700",3707,265,0,29,523,37,387,152,5100
"36087012800",5417,244,86,0,826,0,201,0,6774
"36087013001",1911,178,31,60,279,18,159,62,2698
"36087013002",4050,173,4,5,823,106,321,124,5606
"36087013003",1933,373,208,11,181,23,196,32,2957
"36087013100",3813,905,755,178,486,43,802,252,7234
"36087013200",2075,139,279,3,356,21,213,0,3086
"36087013300",2009,143,80,0,325,0,133,34,2724
"36087013401",3557,82,28,2,734,0,459,26,4888
"36087013402",3057,237,165,22,651,0,326,115,4573
"36089490100",2376,804,13,6,71,12,0,3,3285
"36089490200",2993,423,0,0,220,14,47,16,3713
"36089490300",3781,1287,5,0,238,193,19,0,5523
"36089490400",2640,224,0,0,127,147,84,0,3222
"36089490500",2934,723,2,39,196,37,32,30,3993
"36089490600",3641,836,27,4,74,21,21,0,4624
"36089490700",4695,799,42,3,133,73,68,6,5819
"36089490800",2175,660,45,27,182,79,75,19,3262
"36089490900",2535,839,96,8,73,89,18,23,3681
"36089491000",3744,524,14,2,249,14,45,4,4596
"36089491100",7,4,7,0,4,0,0,0,22
"36089491200",14,0,0,0,27,0,24,0,65
"36089491300",3570,419,0,0,83,0,11,1,4084
"36089491400",2382,732,0,7,172,13,16,0,3322
"36089491500",2864,752,9,40,42,104,45,15,3871
"36089491600",1574,510,0,0,57,24,49,1,2215
"36089491700",2958,1112,25,6,71,13,12,0,4197
"36089491800",3281,1026,14,6,52,25,56,7,4467
"36089491900",0,0,0,0,0,0,0,0,0
"36089492000",3722,633,0,0,112,18,88,0,4573
"36089492100",2515,660,42,5,75,186,69,34,3586
"36089492300",5538,818,25,11,111,50,32,37,6622
"36089492400",2253,499,5,2,45,57,0,27,2888
"36089492500",1997,464,4,11,37,42,41,8,2604
"36089492600",4897,730,26,1,102,36,42,0,5834
"36089492700",4432,1535,103,7,41,53,12,0,6183
"36089492800",2375,513,14,3,56,16,4,0,2981
"36089492900",1686,439,8,0,27,25,13,9,2207
"36091060101",4854,442,89,27,71,0,69,0,5552
"36091060102",5262,188,40,0,66,0,74,22,5652
"36091060200",3147,326,79,8,2,24,156,8,3750
"36091060300",3393,386,40,86,34,0,128,0,4067
"36091060400",1965,455,9,0,59,42,53,0,2583
"36091060501",1500,180,0,0,54,0,10,0,1744
"36091060502",1956,225,11,0,15,0,18,0,2225
"36091060503",2023,120,0,5,46,13,63,0,2270
"36091060601",2434,262,32,9,149,13,33,0,2932
"36091060602",4283,504,0,3,102,0,2,0,4894
"36091060701",6475,539,68,2,208,0,206,0,7498
"36091060702",8488,266,188,0,220,62,132,84,9440
"36091060800",4659,310,39,31,45,38,152,0,5274
"36091060901",3425,160,104,12,95,10,169,0,3975
"36091060902",1509,215,90,2,30,16,5,2,1869
"36091061000",2925,508,36,7,444,6,245,13,4184
"36091061100",4891,363,173,97,232,0,247,0,6003
"36091061200",4183,418,21,0,187,9,136,16,4970
"36091061301",3082,76,34,0,186,0,13,0,3391
"36091061302",6352,152,27,19,132,13,289,13,6997
"36091061303",0,0,0,0,0,0,0,0,0
"36091061401",4145,716,0,2,87,20,58,29,5057
"36091061403",5938,162,2,37,60,0,44,0,6243
"36091061404",2547,199,30,1,71,0,49,10,2907
"36091061500",3220,183,0,0,121,13,90,0,3627
"36091061600",3964,108,14,2,51,11,25,0,4175
"36091061701",4003,549,44,10,307,15,102,2,5032
"36091061702",4177,43,21,0,62,0,43,0,4346
"36091061800",4622,293,29,63,329,26,251,0,5613
"36091061901",8210,220,80,2,334,12,150,0,9008
"36091061903",5477,222,66,3,124,28,237,10,6167
"36091062000",6106,246,57,0,4,1,133,1,6548
"36091062100",1534,231,18,0,16,11,32,0,1842
"36091062200",2480,372,20,18,44,43,31,23,3031
"36091062300",1723,372,33,16,21,22,41,0,2228
"36091062403",5417,538,53,13,420,21,171,122,6755
"36091062404",1757,58,47,0,28,0,50,11,1951
"36091062405",5210,849,126,0,777,99,33,300,7394
"36091062406",3270,242,22,0,148,91,92,10,3875
"36091062501",4622,64,100,0,231,40,110,0,5167
"36091062503",5296,29,125,0,530,0,482,0,6462
"36091062505",2889,155,139,0,430,0,59,0,3672
"36091062506",5045,87,123,14,332,0,40,0,5641
"36091062507",2923,196,53,103,330,15,124,20,3764
"36091062508",3626,163,171,9,251,0,138,0,4358
"36091062509",2986,68,72,9,73,0,21,0,3229
"36091062601",2154,84,30,1,182,21,22,0,2494
"36091062602",5998,18,36,1,634,0,313,0,7000
"36091062700",5405,352,64,0,337,21,35,0,6214
"36091062800",1752,221,65,10,115,70,87,16,2336
"36093020101",1666,89,245,14,615,14,33,0,2676
"36093020102",1396,562,386,80,318,91,114,283,3230
"36093020200",954,316,369,41,240,75,125,146,2266
"36093020300",496,96,119,20,62,5,30,9,837
"36093020500",3457,307,705,71,318,120,250,0,5228
"36093020600",1996,92,381,140,282,32,189,4,3116
"36093020700",1934,275,1189,380,1451,791,533,325,6878
"36093020800",959,353,570,737,631,90,280,239,3859
"36093020900",489,378,473,1249,371,544,194,243,3941
"36093021001",111,158,105,101,78,74,3,34,664
"36093021002",346,501,390,443,290,56,227,368,2621
"36093021200",2396,310,79,46,235,121,89,211,3487
"36093021400",782,487,773,321,517,79,232,153,3344
"36093021500",1027,442,727,178,499,338,351,421,3983
"36093021600",1694,177,271,223,842,363,236,148,3954
"36093021700",1306,456,1026,361,277,451,407,365,4649
"36093021800",5760,462,580,28,977,65,231,0,8103
"36093031900",6429,350,248,19,756,70,98,12,7982
"36093032000",5280,195,234,1,579,19,155,77,6540
"36093032101",4386,282,0,7,692,0,86,158,5611
"36093032102",1423,143,57,0,144,25,112,5,1909
"36093032200",4306,228,122,1,171,10,176,0,5014
"36093032300",2447,230,132,0,97,0,36,2,2944
"36093032402",2694,75,19,0,227,0,126,0,3141
"36093032403",1865,144,45,12,72,0,31,0,2169
"36093032404",6243,132,36,0,64,15,205,0,6695
"36093032502",2965,197,10,0,177,11,106,11,3477
"36093032503",3554,266,83,2,140,0,67,47,4159
"36093032504",1945,94,5,0,120,0,99,0,2263
"36093032601",1703,102,16,0,64,0,48,0,1933
"36093032602",3727,106,4,8,110,0,17,0,3972
"36093032700",3125,464,219,0,236,0,190,9,4243
"36093032901",3750,115,70,2,185,9,60,0,4191
"36093032902",3758,101,206,11,195,28,196,1,4496
"36093033002",2173,77,0,0,33,0,34,9,2326
"36093033003",3121,152,33,0,277,0,117,0,3700
"36093033004",2085,397,0,0,190,0,41,0,2713
"36093033101",1958,96,0,7,0,0,32,0,2093
"36093033102",5653,328,12,2,285,0,165,0,6445
"36093033200",2128,372,298,142,399,29,111,99,3578
"36093033300",1783,162,36,2,67,13,87,12,2162
"36093033400",1134,168,142,49,124,17,120,0,1754
"36093033500",1307,235,169,62,95,41,108,42,2059
"36095740100",4296,474,2,0,68,1,49,13,4903
"36095740200",4228,781,48,32,131,37,109,38,5404
"36095740300",0,0,0,0,0,0,0,0,0
"36095740400",4438,728,27,3,173,4,111,6,5490
"36095740500",3056,440,1,23,97,26,53,25,3721
"36095740600",2524,332,10,0,49,6,48,2,2971
"36095740700",4626,735,9,5,50,0,208,7,5640
"36095740800",2682,297,1,4,46,8,84,2,3124
"36097950100",4512,363,0,0,97,18,90,0,5080
"36097950200",1359,83,19,3,73,4,32,0,1573
"36097950300",2474,631,20,0,40,16,0,4,3185
"36097950400",2983,584,31,0,29,29,39,49,3744
"36097950500",3625,817,11,28,50,19,23,34,4607
"36099950100",2108,287,0,0,13,8,74,0,2490
"36099950200",1921,397,16,0,99,42,3,7,2485
"36099950300",2888,339,0,3,55,30,115,32,3462
"36099950400",2342,403,65,0,63,102,16,58,3049
"36099950500",2918,399,16,3,16,195,23,0,3570
"36099950600",3105,451,48,8,15,17,48,58,3750
"36099950700",3463,298,0,14,95,39,12,0,3921
"36099950800",3271,334,65,0,99,0,69,34,3872
"36099950900",3129,462,37,9,107,19,35,0,3798
"36099951000",2034,214,0,0,72,8,40,0,2368
"36101960100",1097,233,2,0,20,8,0,0,1360
"36101960200",2989,422,22,16,38,15,105,21,3628
"36101960300",2050,427,3,0,64,10,40,0,2594
"36101960400",3278,646,39,2,34,46,17,0,4062
"36101960500",2266,350,0,7,18,0,34,0,2675
"36101960600",3262,585,2,0,117,27,37,26,4056
"36101960700",2208,692,42,10,140,17,29,41,3179
"36101960800",2066,572,22,15,90,84,56,27,2932
"36101960900",1565,687,0,8,7,62,0,3,2332
"36101961000",2961,638,13,8,36,19,26,15,3716
"36101961100",3220,933,63,42,15,28,25,36,4362
"36101961200",2840,587,33,57,96,28,0,82,3723
"36101961300",2940,739,2,24,30,46,3,110,3894
"36101961400",1873,198,5,9,21,0,5,9,2120
"36101961500",1574,222,6,0,31,0,13,0,1846
"36101961600",1546,146,22,5,20,3,9,0,1751
"36101961700",3100,217,0,14,8,4,52,15,3410
"36101961800",2519,781,2,6,14,5,12,0,3339
"36101961900",2767,507,0,30,17,15,7,30,3373
"36101962000",3474,660,12,0,55,2,0,1,4204
"36101962100",2424,945,4,0,33,74,4,0,3484
"36101962200",2184,319,7,4,32,23,4,22,2595
"36101962300",6428,581,321,0,903,63,231,5,8532
"36101962400",2274,364,204,29,154,11,32,0,3068
"36101962500",1729,513,9,29,66,48,91,0,2485
"36101962600",2083,336,62,8,135,31,30,12,2697
"36101962700",2160,420,31,23,66,145,14,6,2865
"36101962800",3105,241,47,0,106,0,39,0,3538
"36101962900",2345,288,55,2,82,4,4,0,2780
"36101963000",3472,441,8,0,59,32,60,0,4072
"36103110101",3367,108,0,0,146,13,113,0,3747
"36103110102",4547,68,0,11,371,0,258,11,5266
"36103110200",4318,247,0,0,142,84,144,86,5021
"36103110300",4910,182,58,0,138,27,293,26,5634
"36103110401",2537,10,10,0,129,21,255,10,2972
"36103110402",3027,26,30,0,25,97,42,0,3247
"36103110501",2647,153,10,0,34,0,42,0,2886
"36103110502",2580,74,35,0,138,0,89,0,2916
"36103110600",6768,190,71,9,374,0,129,5,7546
"36103110801",1840,67,6,0,85,6,72,0,2076
"36103110803",5078,408,24,35,80,20,248,58,5951
"36103110901",2299,151,0,0,71,0,78,0,2599
"36103110902",2207,277,925,38,440,307,951,447,5592
"36103111001",1511,140,139,22,255,37,336,2,2442
"36103111002",2299,440,264,405,1649,690,1872,1025,8644
"36103111100",4533,460,604,132,2086,808,3592,1011,13226
"36103111201",2248,442,253,91,1192,567,1667,831,7291
"36103111202",3197,322,429,0,679,2,939,124,5692
"36103111300",4348,160,72,0,91,0,214,25,4910
"36103111401",1218,6,16,11,35,8,53,0,1347
"36103111402",4205,145,43,0,292,0,201,49,4935
"36103111503",3069,144,649,351,206,29,297,22,4767
"36103111504",1105,56,58,0,147,3,47,1,1417
"36103111505",3961,151,1225,154,1275,48,1571,67,8452
"36103111506",2042,170,623,52,519,80,566,102,4154
"36103111601",3472,170,41,36,94,30,223,30,4096
"36103111602",2892,0,117,2,146,2,105,2,3266
"36103111701",5061,317,0,39,227,0,579,56,6279
"36103111703",2816,130,0,0,191,26,281,0,3444
"36103111704",3043,79,13,0,59,0,118,0,3312
"36103111801",5042,40,15,1,925,63,99,64,6249
"36103111802",2683,71,36,0,33,21,56,0,2900
"36103111803",2294,26,99,0,397,0,294,0,3110
"36103111804",2182,62,0,0,137,0,42,13,2436
"36103111900",4556,79,17,0,438,0,276,0,5366
"36103112001",3706,339,4,51,663,63,731,37,5594
"36103112002",3922,159,110,0,483,6,363,6,5049
"36103112102",3367,53,46,0,500,0,313,0,4279
"36103112103",3369,147,79,0,267,83,293,25,4263
"36103112104",1702,153,33,0,515,3,108,20,2534
"36103112204",3575,166,21,0,198,0,278,0,4238
"36103112206",6047,293,0,147,927,0,516,0,7930
"36103112210",6134,90,157,11,1061,0,268,7,7728
"36103112211",3993,63,136,0,455,12,297,11,4967
"36103112212",2297,97,368,0,592,3,174,0,3531
"36103112213",3592,168,476,20,904,40,316,20,5536
"36103112214",5379,162,620,33,797,0,121,0,7112
"36103122300",2890,190,54,9,795,104,777,96,4915
"36103122403",753,14,1382,88,248,10,304,5,2804
"36103122404",3008,163,344,0,227,18,715,75,4550
"36103122405",756,48,2225,223,501,0,430,49,4232
"36103122406",657,129,2839,554,950,224,1259,332,6944
"36103122501",683,271,2139,624,249,24,954,232,5176
"36103122502",245,1,2983,388,829,25,1204,3,5678
"36103122601",4017,191,480,1,1000,51,1083,11,6834
"36103122602",3973,265,58,16,388,24,516,101,5341
"36103122603",4545,216,580,0,607,0,677,14,6639
"36103122704",1048,33,655,0,449,77,438,69,2769
"36103122705",1798,198,145,8,545,72,261,49,3076
"36103122706",2584,215,343,17,457,0,369,39,4024
"36103122707",2645,67,11,0,366,13,277,0,3379
"36103122801",2789,198,2275,24,596,131,903,21,6937
"36103122802",2998,93,482,60,366,52,559,34,4644
"36103122901",5037,280,26,0,822,0,908,0,7073
"36103122902",3852,172,22,193,245,47,439,86,5056
"36103123001",4002,144,225,0,1096,141,1110,185,6903
"36103123002",3615,114,50,59,568,78,643,8,5135
"36103123101",2681,243,35,19,313,54,469,72,3886
"36103123102",3019,117,219,0,355,0,629,17,4356
"36103123201",690,32,664,34,424,45,468,41,2398
"36103123202",1466,189,4568,266,2871,92,3720,39,13211
"36103123301",1458,254,4591,305,1719,110,2722,193,11352
"36103123302",290,7,769,130,352,191,427,98,2264
"36103123401",3737,184,176,2,427,0,1151,88,5765
"36103123402",5311,387,283,19,678,458,677,345,8158
"36103123500",3155,334,655,34,950,591,1023,631,7373
"36103123600",3059,61,0,0,234,0,157,0,3511
"36103123701",3440,324,459,282,2257,203,3924,342,11231
"36103123702",5838,209,555,136,1571,68,3005,98,11480
"36103123801",3259,203,264,0,65,0,357,8,4156
"36103123802",3167,266,23,0,87,0,341,0,3884
"36103123900",4752,218,296,0,122,35,805,38,6266
"36103124001",4336,224,156,10,231,0,1085,0,6042
"36103124002",3376,61,72,0,72,16,589,31,4217
"36103124101",3997,374,11,1,393,9,614,77,5476
"36103124102",2719,150,0,0,181,220,164,220,3654
"36103124200",4600,257,0,0,408,1,577,0,5843
"36103124300",4998,324,55,0,920,76,878,87,7338
"36103124401",3055,80,18,0,183,21,405,21,3783
"36103124402",3564,88,0,0,51,0,183,0,3886
"36103124500",4255,178,31,11,894,27,566,11,5973
"36103124601",2470,86,47,0,87,0,173,5,2868
"36103124602",3647,193,22,54,155,11,293,55,4430
"36103134702",4919,198,55,0,364,157,315,175,6183
"36103134703",3614,98,10,0,281,0,134,0,4137
"36103134704",2109,132,13,0,172,6,45,0,2477
"36103134902",3826,337,13,0,162,23,107,0,4468
"36103134903",1063,55,11,2,104,2,114,22,1373
"36103134904",5637,126,28,0,756,0,363,4,6914
"36103134906",5204,264,2,0,350,21,440,8,6289
"36103134907",4269,191,0,16,78,11,105,11,4681
"36103135002",4599,236,14,0,329,59,165,20,5422
"36103135003",4301,101,109,0,122,9,144,2,4788
"36103135004",2742,124,29,0,103,0,77,0,3075
"36103135005",2863,193,0,1,122,0,186,1,3366
"36103135101",3217,120,231,0,418,1,358,11,4356
"36103135102",3895,82,0,8,329,74,414,6,4808
"36103135103",4285,105,72,0,393,21,76,21,4973
"36103135104",4995,233,0,0,125,0,286,0,5639
"36103135201",2025,35,0,2,78,41,36,0,2217
"36103135204",4152,82,28,1,153,0,162,0,4578
"36103135205",4151,194,28,0,511,63,240,0,5187
"36103135208",2868,83,9,0,85,0,98,0,3143
"36103135209",2836,18,47,0,82,0,81,0,3064
"36103135301",3553,223,98,0,151,1,79,0,4105
"36103135303",3637,40,92,0,427,9,318,0,4523
"36103135304",3077,42,38,0,231,0,133,2,3523
"36103135401",5766,119,159,17,410,132,76,49,6728
"36103135402",6263,138,23,1,605,0,448,0,7478
"36103135403",3644,182,179,0,266,13,281,111,4676
"36103145602",2895,275,941,21,1363,688,3275,832,10290
"36103145603",2997,569,1278,101,1432,596,4156,886,12015
"36103145604",2600,319,345,10,1627,177,3439,475,8992
"36103145605",1950,86,772,47,836,131,1970,212,6004
"36103145701",4088,103,424,78,576,0,679,14,5962
"36103145702",3092,146,741,0,2031,494,3836,564,10904
"36103145703",2488,304,736,168,1489,372,2453,527,8537
"36103145704",3165,331,1092,432,2088,95,3183,175,10561
"36103145803",4258,245,61,3,340,0,449,42,5398
"36103145804",2145,113,413,0,614,7,935,46,4273
"36103145805",5433,188,38,1,354,2,476,27,6519
"36103145807",3990,113,68,0,218,0,447,17,4853
"36103145808",2557,249,9,57,35,75,132,28,3142
"36103145901",1874,97,650,68,674,130,1042,203,4738
"36103145902",2897,283,2466,119,2983,518,4210,221,13697
"36103145903",4023,213,841,50,739,116,1380,94,7456
"36103146001",2909,169,680,152,1311,383,3152,453,9209
"36103146002",2322,55,952,13,1938,622,3641,578,10121
"36103146003",4080,193,1817,75,2299,430,3531,396,12821
"36103146102",990,75,298,39,965,137,1412,99,4015
"36103146103",3348,35,245,0,457,352,722,326,5485
"36103146105",2788,232,1209,44,2382,157,3991,338,11141
"36103146106",1552,217,348,65,1755,82,2666,118,6803
"36103146201",2028,348,588,19,1520,438,2861,685,8487
"36103146202",1521,216,1806,364,1348,61,2741,221,8278
"36103146203",2986,461,1090,86,605,218,2737,503,8686
"36103146204",2844,197,1308,67,1614,430,3423,535,10418
"36103146205",1968,11,78,1,53,0,191,0,2302
"36103146206",1596,122,271,0,421,103,525,103,3141
"36103146300",1490,118,451,29,192,9,142,29,2460
"36103146402",3459,171,35,0,409,1,350,0,4425
"36103146403",2137,206,1394,136,831,225,2262,233,7424
"36103146404",1685,348,657,115,712,228,1314,376,5435
"36103146500",4601,243,106,0,354,0,759,0,6063
"36103146604",3308,202,176,7,559,7,332,7,4598
"36103146605",914,16,0,0,29,0,130,0,1089
"36103146606",6916,396,0,0,196,0,579,25,8112
"36103146607",1969,149,79,6,149,33,148,58,2591
"36103146608",2368,106,0,0,160,0,221,0,2855
"36103146611",2710,153,169,0,142,48,280,0,3502
"36103146612",4856,85,9,1,296,55,447,3,5752
"36103146613",3793,34,16,0,49,0,449,0,4341
"36103146614",5441,77,29,0,473,0,497,23,6540
"36103146615",3883,64,99,12,438,78,561,0,5135
"36103146703",2277,159,616,5,617,68,995,68,4805
"36103146704",1740,43,0,0,185,10,260,0,2238
"36103146705",3041,254,78,1,6,30,293,30,3733
"36103146706",2288,77,43,5,100,34,162,2,2711
"36103146800",5365,72,0,0,218,0,224,0,5879
"36103146901",4671,258,13,0,303,0,443,0,5688
"36103146902",3289,183,0,0,56,0,49,7,3584
"36103147001",4012,107,0,0,295,0,293,0,4707
"36103147003",4042,112,79,0,449,2,873,8,5565
"36103147004",192,3,3,0,3,0,0,0,201
"36103147100",2839,47,30,0,170,7,206,0,3299
"36103147200",2891,620,1053,19,1564,40,2054,294,8535
"36103147300",3236,195,2555,107,1551,747,2103,807,11301
"36103147401",5053,305,242,36,138,42,748,246,6810
"36103147402",3394,31,0,0,97,0,241,0,3763
"36103147501",6472,505,201,0,21,0,405,0,7604
"36103147502",6120,207,0,4,90,0,203,0,6624
"36103147503",1446,48,0,0,67,0,57,0,1618
"36103147601",2061,72,25,0,49,0,93,0,2300
"36103147602",4642,158,65,3,70,0,357,0,5295
"36103147701",2843,44,8,0,294,59,72,0,3320
"36103147702",4385,106,11,0,179,20,109,36,4846
"36103147802",3621,63,8,0,45,0,353,0,4090
"36103147803",2970,109,30,0,27,16,151,10,3313
"36103147804",5649,91,0,0,165,3,150,3,6061
"36103147901",3713,300,38,18,88,79,215,17,4468
"36103147902",3723,130,0,5,211,0,89,0,4158
"36103158001",3415,93,82,4,480,8,211,8,4301
"36103158002",5080,329,66,0,706,130,243,0,6554
"36103158006",5687,89,83,1,611,230,444,1,7146
"36103158007",47,0,0,0,51,0,0,0,98
"36103158009",2504,13,0,0,188,130,110,0,2945
"36103158010",3049,27,86,0,489,17,54,0,3722
"36103158011",3990,233,93,13,415,0,164,1,4909
"36103158102",4200,129,104,34,322,8,1142,28,5967
"36103158103",3726,226,202,159,209,16,937,12,5487
"36103158104",4723,165,174,0,506,25,548,0,6141
"36103158107",3186,407,22,0,405,25,285,99,4429
"36103158108",2012,272,46,0,497,115,214,77,3233
"36103158110",3285,135,0,0,210,9,503,30,4172
"36103158111",3073,128,88,10,165,4,552,16,4036
"36103158112",3382,330,156,2,258,176,796,101,5201
"36103158114",3064,157,20,0,308,5,462,26,4042
"36103158115",5939,245,282,0,596,0,324,0,7386
"36103158116",1280,88,134,0,295,126,205,47,2175
"36103158202",6504,1063,72,9,703,131,1118,673,10273
"36103158203",1387,15,22,0,116,16,32,0,1588
"36103158205",1904,60,0,0,25,0,219,0,2208
"36103158206",2887,254,33,21,297,32,316,53,3893
"36103158207",4138,132,120,0,418,11,167,18,5004
"36103158304",6190,755,31,10,443,0,552,436,8417
"36103158306",5204,155,37,0,256,0,470,0,6122
"36103158308",6756,931,337,5,672,0,1769,486,10956
"36103158309",3433,247,677,25,562,12,746,27,5729
"36103158310",3246,238,52,5,147,44,189,74,3995
"36103158315",3347,185,480,39,477,62,754,105,5449
"36103158317",5901,414,0,0,174,16,905,0,7410
"36103158318",3892,61,10,1,150,0,348,0,4462
"36103158319",2699,202,104,69,357,104,408,44,3987
"36103158320",5607,116,160,4,75,47,443,7,6459
"36103158321",7168,189,963,24,1799,241,1520,73,11977
"36103158322",1782,7,0,0,284,33,53,0,2159
"36103158323",5388,335,115,0,699,36,400,16,6989
"36103158401",1186,20,0,0,67,0,66,0,1339
"36103158402",4032,169,17,5,97,0,354,0,4674
"36103158403",1606,110,174,16,147,17,199,27,2296
"36103158405",4234,152,28,0,186,4,207,45,4856
"36103158407",5009,291,4,0,227,16,519,16,6082
"36103158408",3761,314,65,0,49,35,348,42,4614
"36103158409",3100,125,107,110,409,13,255,0,4119
"36103158410",3058,259,5,1,0,0,14,0,3337
"36103158502",3278,339,0,6,48,0,417,0,4088
"36103158505",3793,380,109,0,279,77,377,147,5162
"36103158506",2142,132,11,0,264,17,213,25,2804
"36103158507",3350,120,12,0,394,27,700,0,4603
"36103158508",5704,143,160,0,357,0,825,0,7189
"36103158509",3742,437,210,102,233,92,896,157,5869
"36103158510",5884,241,1,0,457,288,572,288,7731
"36103158511",5815,234,94,2,687,24,1414,58,8328
"36103158512",3171,132,0,40,199,16,369,55,3982
"36103158604",4225,223,42,0,427,7,654,34,5612
"36103158605",4365,145,248,7,434,1,638,11,5849
"36103158606",3863,400,16,0,358,11,637,23,5308
"36103158607",2560,299,241,7,87,0,501,51,3746
"36103158608",2887,315,12,9,610,43,385,43,4304
"36103158609",3909,91,176,27,242,22,549,7,5023
"36103158704",6866,374,1107,305,414,17,1927,94,11104
"36103158705",1365,347,1652,220,212,46,869,207,4918
"36103158707",1286,61,212,0,143,7,46,7,1762
"36103158708",2300,315,685,274,264,12,111,223,4184
"36103158709",1855,147,13,0,95,12,265,10,2397
"36103158710",2911,122,323,29,122,27,290,12,3836
"36103158711",3582,121,721,0,755,64,611,29,5883
"36103158712",5878,1004,678,43,140,0,2227,189,10159
"36103158802",4457,210,0,0,41,0,442,0,5150
"36103158803",5950,116,343,2,297,12,1129,1,7850
"36103158804",5783,400,261,0,215,0,1392,180,8231
"36103158900",5009,926,497,179,652,52,1807,638,9760
"36103159000",3606,584,248,68,202,11,1080,339,6138
"36103159102",4618,1010,258,54,270,22,1372,471,8075
"36103159103",2688,825,850,882,539,258,1883,801,8726
"36103159105",6015,275,120,69,700,0,1640,31,8850
"36103159106",4472,183,508,88,525,6,974,90,6846
"36103159107",3559,155,74,0,118,0,636,0,4542
"36103159108",6524,168,216,32,549,15,1910,85,9499
"36103159201",3015,152,0,0,35,0,887,0,4089
"36103159203",4706,562,190,19,58,1,289,74,5899
"36103159204",3305,181,95,170,17,8,665,39,4480
"36103159300",1869,91,19,0,79,0,61,0,2119
"36103159404",4593,950,534,213,1208,52,1065,655,9270
"36103159406",3663,282,125,6,70,35,710,88,4979
"36103159407",5509,227,415,30,432,114,1130,33,7890
"36103159408",3019,354,211,12,373,0,608,99,4676
"36103159410",7255,415,399,120,192,5,597,15,8998
"36103159411",2786,380,109,0,120,82,250,138,3865
"36103159412",7086,178,127,0,269,99,308,46,8113
"36103159505",6414,588,486,84,510,239,1611,0,9932
"36103159506",5615,555,734,512,845,148,1598,52,10059
"36103159508",5640,614,579,211,396,188,1165,207,9000
"36103159509",2192,372,10,128,124,0,433,25,3284
"36103159510",118,9,9,0,22,0,46,5,209
"36103159511",5550,257,405,268,405,131,1307,55,8378
"36103159512",2005,200,97,57,61,0,339,53,2812
"36103159601",6401,59,0,22,89,13,205,13,6802
"36103159602",3888,169,50,0,42,0,100,0,4249
"36103169701",7146,292,46,0,168,0,614,8,8274
"36103169703",1441,46,6,0,41,0,106,0,1640
"36103169704",5919,263,429,30,346,138,1031,0,8156
"36103169800",3602,306,353,534,575,367,1162,504,7403
"36103169901",4015,150,1329,387,228,228,238,364,6939
"36103169902",4595,364,22,8,9,0,332,235,5565
"36103170001",5134,176,74,0,203,0,156,0,5743
"36103170002",3755,130,23,16,104,0,84,14,4126
"36103170101",1358,352,279,20,94,1,288,211,2603
"36103170201",5862,295,0,3,131,4,121,23,6439
"36103170202",3478,316,13,0,44,0,165,69,4085
"36103180300",2636,30,0,0,85,0,85,0,2836
"36103190401",4542,414,912,56,418,350,2292,654,9638
"36103190402",1944,241,70,37,64,42,299,145,2842
"36103190403",3269,163,0,18,274,0,1460,20,5204
"36103190502",2094,259,11,6,174,12,346,56,2958
"36103190503",2402,178,1,19,135,0,163,109,3007
"36103190504",1633,41,0,4,16,0,17,0,1711
"36103190601",4051,144,23,0,259,0,142,0,4619
"36103190603",3883,231,95,8,50,132,1419,222,6040
"36103190604",3037,252,18,0,129,0,303,74,3813
"36103190704",2778,165,77,3,42,0,501,105,3671
"36103190705",3018,160,33,0,384,92,645,42,4374
"36103190706",3776,262,281,11,286,7,443,57,5123
"36103190707",4216,434,99,0,248,47,412,391,5847
"36103190708",1772,106,25,2,11,20,170,70,2176
"36103190800",2028,112,295,229,168,94,29,94,3049
"36103200901",1061,54,4,0,29,0,58,0,1206
"36103200902",5475,409,299,8,618,160,464,201,7634
"36103201001",5348,287,106,12,122,190,1251,18,7334
"36103201003",3569,270,229,32,41,4,1043,48,5236
"36103201004",2822,404,94,9,119,26,302,37,3813
"36103201100",2582,352,839,112,1895,80,3274,272,9406
"36103990100",0,0,0,0,0,0,0,0,0
"36105950100",3089,254,53,13,84,0,120,16,3629
"36105950200",2904,478,0,104,121,85,222,47,3961
"36105950300",1182,97,21,3,11,0,34,5,1353
"36105950400",2636,241,5,8,52,19,80,36,3077
"36105950500",2128,429,131,10,187,110,433,110,3538
"36105950600",1580,270,44,0,160,2,196,87,2339
"36105950700",2712,590,224,145,476,100,958,306,5511
"36105950800",2373,744,99,91,485,199,632,107,4730
"36105950900",1356,1218,84,313,476,68,840,123,4478
"36105951000",920,165,207,72,280,148,230,219,2241
"36105951100",1332,115,66,3,143,37,312,42,2050
"36105951200",6277,616,328,8,428,36,573,39,8305
"36105951300",3191,470,134,9,134,108,252,234,4532
"36105951500",1476,269,271,168,120,170,205,147,2826
"36105951600",1894,701,67,110,105,120,222,422,3641
"36105951700",3516,164,54,0,345,0,343,35,4457
"36105951800",1481,937,1805,522,874,392,1261,624,7896
"36105951900",1272,338,18,60,392,25,115,108,2328
"36105952000",1780,138,37,52,20,0,94,56,2177
"36105952100",2100,169,10,69,187,74,147,38,2794
"36105952200",1229,102,8,3,24,71,29,54,1520
"36105952300",1077,123,69,16,79,5,57,5,1431
"36105952400",1922,380,41,10,61,0,54,41,2509
"36105952500",1954,297,13,0,159,5,156,35,2619
"36107020100",5418,593,4,3,97,50,25,0,6190
"36107020200",4536,452,37,0,167,0,78,1,5271
"36107020300",6287,235,39,0,136,147,78,0,6922
"36107020401",4746,295,27,0,54,7,38,4,5171
"36107020402",3539,22,0,2,26,8,65,1,3663
"36107020500",3066,451,37,19,132,30,148,21,3904
"36107020600",6596,757,12,0,153,14,67,39,7638
"36107020701",2586,336,18,1,81,32,125,0,3179
"36107020702",3808,574,0,1,0,1,18,1,4403
"36107020703",3262,745,73,13,23,13,23,13,4165
"36109000100",868,193,105,40,78,181,54,65,1584
"36109000200",640,1826,0,27,621,2155,78,250,5597
"36109000300",72,20,0,0,18,61,11,5,187
"36109000400",209,62,22,0,184,90,35,44,646
"36109000500",2477,344,214,77,971,472,128,2,4685
"36109000600",2441,247,8,4,1304,192,300,4,4500
"36109000700",1927,495,8,27,370,558,67,137,3589
"36109000800",1371,503,192,342,182,107,191,176,3064
"36109000900",2660,315,189,61,226,166,83,119,3819
"36109001000",1860,856,193,346,394,65,204,280,4198
"36109001100",2972,1447,49,26,306,164,214,79,5257
"36109001200",75,58,1,2,47,1,44,1,229
"36109001300",3271,491,133,68,1228,949,128,38,6306
"36109001400",3115,241,21,29,198,24,55,20,3703
"36109001500",4405,691,23,163,1067,179,51,7,6586
"36109001600",3530,474,3,3,53,99,102,7,4271
"36109001700",3931,665,40,92,375,10,97,10,5220
"36109001800",3699,773,160,0,206,0,273,0,5111
"36109001900",5821,421,113,31,181,11,63,0,6641
"36109002000",3556,278,2,42,158,22,160,41,4259
"36109002100",3926,492,30,12,41,10,79,0,4590
"36109002200",3886,433,23,8,90,29,60,19,4548
"36109002300",4945,277,20,0,217,0,181,0,5640
"36111950100",4722,218,52,0,162,80,140,0,5374
"36111950200",3167,438,14,24,220,38,436,117,4454
"36111950300",3705,438,215,17,229,0,112,167,4883
"36111950400",3457,365,0,22,225,5,284,17,4375
"36111950500",2520,201,104,15,202,47,105,69,3263
"36111950600",2347,330,15,0,109,0,75,22,2898
"36111950900",1038,122,11,0,7,11,27,9,1225
"36111951000",3675,349,3,73,216,60,132,61,4569
"36111951100",2134,174,47,0,122,0,109,0,2586
"36111951200",3327,289,35,0,50,15,39,23,3778
"36111951300",2857,552,113,25,197,117,200,0,4061
"36111951400",2608,449,28,117,265,0,184,16,3667
"36111951500",2647,225,116,0,136,32,81,44,3281
"36111951600",1793,111,56,0,136,0,69,34,2199
"36111951700",2600,423,728,174,490,126,649,100,5290
"36111951800",887,139,303,86,284,41,85,12,1837
"36111951900",1435,505,217,219,233,0,388,133,3130
"36111952000",1365,356,235,129,302,36,401,89,2913
"36111952100",1770,639,544,185,459,171,638,278,4684
"36111952200",2787,128,380,142,152,25,174,6,3794
"36111952300",1135,47,106,102,308,27,119,0,1844
"36111952400",1849,385,154,199,240,44,429,222,3522
"36111952500",2789,140,132,0,252,0,107,0,3420
"36111952600",4663,556,60,25,5,24,170,66,5569
"36111952700",2446,179,18,40,23,41,37,25,2809
"36111952800",2788,225,84,18,43,14,252,4,3428
"36111952900",4677,486,14,38,370,0,111,17,5713
"36111953000",1616,88,0,5,56,0,17,0,1782
"36111953300",3904,119,77,66,294,42,373,77,4952
"36111953400",3197,542,68,50,332,178,509,131,5007
"36111953500",1424,750,42,37,47,89,144,44,2577
"36111953600",3646,619,243,0,294,82,290,265,5439
"36111953700",4736,182,321,0,93,43,261,31,5667
"36111953800",3453,266,91,1,79,20,100,1,4011
"36111953900",3853,295,190,0,259,218,281,152,5248
"36111954000",3911,474,174,103,214,0,386,54,5316
"36111954100",3973,683,400,52,304,63,1049,220,6744
"36111954200",4881,483,53,159,87,22,388,73,6146
"36111954400",6824,2144,106,284,240,229,394,591,10812
"36111954500",2491,374,7,12,84,62,202,166,3398
"36111954600",1322,197,20,0,146,51,225,23,1984
"36111954700",1400,222,37,32,154,65,225,17,2152
"36111954800",2572,623,485,24,923,147,1262,199,6235
"36111954900",1238,101,0,0,104,0,101,0,1544
"36111955000",4631,325,41,50,372,27,285,0,5731
"36111955300",2100,237,6,2,212,0,9,1,2567
"36111955400",2700,260,118,0,177,18,199,21,3493
"36113070100",2275,250,22,0,43,0,38,0,2628
"36113070200",1315,523,22,23,44,32,58,25,2042
"36113070300",3115,305,18,45,45,69,235,18,3850
"36113070400",3084,530,17,3,251,2,162,20,4069
"36113070500",1611,467,27,8,118,45,18,7,2301
"36113070601",5065,185,0,85,43,0,153,0,5531
"36113070602",1184,196,0,0,16,0,34,0,1430
"36113070701",3523,348,0,0,55,41,78,0,4045
"36113070702",3778,439,83,0,194,18,79,37,4628
"36113070800",6251,821,212,27,186,76,54,11,7638
"36113070900",4171,161,1,1,32,6,40,0,4412
"36113071000",2986,298,0,12,11,0,71,0,3378
"36113072000",3065,376,1,2,15,5,7,14,3485
"36113073000",3356,634,18,0,11,0,79,15,4113
"36113073500",1713,305,0,13,39,3,26,3,2102
"36113074000",1434,245,0,0,35,25,0,0,1739
"36113075000",2554,753,0,0,0,2,0,4,3313
"36113076000",2263,164,15,0,40,64,10,0,2556
"36113078000",2064,78,43,0,94,0,32,0,2311
"36115080100",3102,1396,0,0,71,46,1,0,4616
"36115080200",2192,256,7,75,33,15,16,75,2669
"36115080300",4488,544,132,0,247,2,126,113,5652
"36115081000",3334,229,85,4,90,4,35,2,3783
"36115082001",3654,1061,48,9,94,1,39,5,4911
"36115082002",1144,120,0,0,20,4,32,0,1320
"36115084000",5228,989,2,39,141,5,55,36,6495
"36115085000",2124,147,0,2,39,6,86,2,2406
"36115086000",1348,309,0,38,38,26,32,5,1796
"36115087000",3204,399,3,0,21,0,0,0,3627
"36115088000",5062,603,39,99,30,13,66,8,5920
"36115089000",4311,366,1,0,154,1,41,13,4887
"36115090000",2309,337,9,2,20,12,45,56,2790
"36115091000",1605,169,10,0,25,0,33,0,1842
"36115092000",2844,357,0,0,92,20,16,0,3329
"36115093000",1701,219,2,0,27,10,7,0,1966
"36115094000",2227,70,0,0,26,0,24,0,2347
"36117020101",4812,150,216,2,141,12,135,3,5471
"36117020102",4021,581,89,0,99,0,100,54,4944
"36117020201",4248,203,41,0,65,0,57,2,4616
"36117020202",4625,41,67,0,98,0,103,0,4934
"36117020301",3466,293,8,3,31,40,54,3,3898
"36117020302",4784,211,20,7,154,4,289,0,5469
"36117020401",2337,119,46,24,114,6,190,13,2849
"36117020402",3422,331,63,241,51,95,116,11,4330
"36117020500",4207,309,31,39,89,4,19,18,4716
"36117020600",3414,530,20,0,72,49,75,35,4195
"36117020700",2903,670,4,2,82,46,107,67,3881
"36117020800",2221,246,47,40,57,42,12,8,2673
"36117020900",3689,997,188,176,342,50,294,120,5856
"36117021000",5248,958,16,26,226,34,130,57,6695
"36117021100",3251,993,253,55,261,0,268,37,5118
"36117021200",2887,738,319,160,187,12,365,59,4727
"36117021400",2232,618,171,77,87,56,91,3,3335
"36117021501",1836,119,0,94,34,132,147,55,2417
"36117021502",3396,572,102,43,45,24,16,53,4251
"36117021600",3632,544,90,7,6,47,111,43,4480
"36117021700",3164,284,14,0,175,0,120,41,3798
"36117021800",1502,372,69,11,56,2,56,82,2150
"36117990100",0,0,0,0,0,0,0,0,0
"36119000101",580,700,891,21,1521,896,2128,1541,8278
"36119000103",720,352,1013,776,1426,422,1682,597,6988
"36119000104",20,0,0,0,0,0,0,0,20
"36119000201",2063,699,1429,197,2929,850,3967,1322,13456
"36119000202",1573,262,624,198,1240,180,1635,301,6013
"36119000203",2223,418,113,13,540,87,1274,230,4898
"36119000300",1145,818,754,392,878,494,1592,1270,7343
"36119000401",1110,646,907,230,623,183,1103,477,5279
"36119000402",756,371,1792,614,862,323,997,702,6417
"36119000500",851,281,911,451,388,244,1279,369,4774
"36119000600",1332,1063,2100,338,1600,306,1984,1069,9792
"36119000701",2607,180,410,14,285,113,721,63,4393
"36119000702",1894,113,1520,393,531,245,1384,266,6346
"36119000801",3553,269,741,0,1166,66,1523,0,7318
"36119000802",1240,353,276,18,634,22,594,266,3403
"36119000803",2511,174,475,118,1127,155,1641,237,6438
"36119000900",2042,152,372,10,719,0,854,53,4202
"36119001000",239,266,600,476,64,119,193,229,2186
"36119001101",1148,665,474,221,585,821,1304,1287,6505
"36119001102",2291,376,497,651,813,156,1805,596,7185
"36119001200",1501,579,400,368,725,462,1395,1090,6520
"36119001301",1639,317,784,0,1766,31,2049,138,6724
"36119001302",1342,494,409,345,984,349,1249,741,5913
"36119001303",908,1148,882,1006,2118,610,2144,1510,10326
"36119001401",2352,259,403,8,786,200,749,258,5015
"36119001402",1168,85,88,0,296,73,250,38,1998
"36119001403",2539,223,258,6,590,106,917,100,4739
"36119001502",2404,155,178,76,194,94,586,94,3781
"36119001503",2325,144,173,0,283,28,512,9,3474
"36119001504",2894,123,351,38,1177,91,1317,40,6031
"36119001505",1119,103,554,0,374,9,477,53,2689
"36119001600",1589,528,221,46,495,275,939,493,4586
"36119001700",6443,377,261,132,406,0,1773,74,9466
"36119001800",315,44,996,66,419,134,525,152,2651
"36119001900",1174,19,93,0,405,6,350,6,2053
"36119002000",3434,73,264,7,923,16,1026,16,5759
"36119002101",2295,203,223,0,780,9,582,36,4128
"36119002103",3047,85,0,1,245,1,178,0,3557
"36119002104",3870,100,522,12,914,162,1376,74,7030
"36119002105",1613,44,45,1,191,0,46,9,1949
"36119002106",592,85,765,32,1095,167,447,81,3264
"36119002107",898,124,81,18,486,181,292,281,2361
"36119002201",1977,45,223,14,462,21,443,5,3190
"36119002202",4069,259,47,0,375,0,458,63,5271
"36119002203",1069,221,67,10,324,0,401,118,2210
"36119002204",3178,288,346,0,190,45,688,57,4792
"36119002300",2974,176,247,205,670,107,963,154,5496
"36119002401",1129,45,123,2,146,43,243,44,1775
"36119002402",2469,238,601,55,487,71,956,62,4939
"36119002403",3648,675,341,3,561,309,1090,54,6681
"36119002404",1701,135,146,9,720,190,526,169,3596
"36119002405",2269,99,146,23,604,134,813,31,4119
"36119002600",117,34,2708,714,491,9,429,22,4524
"36119002700",25,20,2420,1061,164,260,232,244,4426
"36119002800",47,11,1684,463,140,18,46,14,2423
"36119002900",128,0,2726,760,212,0,358,22,4206
"36119003000",41,48,2193,215,563,163,320,141,3684
"36119003100",114,64,1542,596,241,50,251,59,2917
"36119003200",161,9,1518,268,199,58,240,66,2519
"36119003300",83,0,2386,437,93,78,128,78,3283
"36119003400",320,88,3970,391,362,0,489,88,5708
"36119003500",322,98,796,279,172,252,299,237,2455
"36119003600",895,161,1441,197,972,183,1218,296,5363
"36119003700",1146,274,1286,278,734,300,802,441,5261
"36119003800",1343,44,703,227,580,26,549,18,3490
"36119003900",2293,107,761,0,77,0,541,37,3816
"36119004000",1303,192,3383,363,644,30,869,130,6914
"36119004100",314,211,3090,354,369,49,208,286,4881
"36119004200",1111,282,2601,206,224,52,314,207,4997
"36119004300",545,68,568,7,74,15,75,0,1352
"36119004400",1875,47,1265,33,271,94,357,11,3953
"36119004500",996,61,313,16,63,0,167,10,1626
"36119004600",2574,16,0,2,334,55,55,1,3037
"36119004700",2912,105,11,0,159,10,187,0,3384
"36119004800",4555,219,924,3,781,86,411,78,7057
"36119004900",2127,114,53,0,488,0,101,0,2883
"36119005001",2866,54,193,0,566,8,306,0,3993
"36119005002",3809,111,28,10,471,1,112,1,4543
"36119005100",3508,81,202,93,372,0,388,0,4644
"36119005200",4215,87,17,3,408,0,240,12,4982
"36119005300",3258,116,814,8,1196,22,819,79,6312
"36119005400",1371,20,31,5,104,32,159,32,1754
"36119005500",4684,133,299,7,427,13,308,1,5872
"36119005600",0,0,0,0,0,0,0,0,0
"36119005701",4187,374,749,1,718,294,1804,38,8165
"36119005702",1583,115,488,15,175,91,751,77,3295
"36119005800",2148,234,561,48,1247,50,2096,135,6519
"36119005901",2214,316,336,102,783,476,1262,486,5975
"36119005902",3333,173,955,57,493,20,707,66,5804
"36119006000",2126,511,762,161,531,130,739,520,5480
"36119006100",1481,573,709,94,954,92,1249,596,5748
"36119006200",3339,801,479,113,868,315,2780,815,9510
"36119006300",1637,255,1227,548,1959,231,2486,253,8596
"36119006400",1316,100,2696,343,1263,28,1614,47,7407
"36119006500",2425,231,1539,205,695,603,1196,762,7656
"36119006600",4259,249,797,45,404,8,536,12,6310
"36119006700",4243,101,423,0,353,13,358,6,5497
"36119006801",4900,167,134,10,474,2,101,8,5796
"36119006802",4974,113,342,0,327,76,288,39,6159
"36119006900",5295,174,42,3,399,0,248,0,6161
"36119007000",5371,207,20,23,633,0,547,0,6801
"36119007100",5148,216,108,3,471,59,454,26,6485
"36119007200",4421,248,334,55,1254,238,1074,143,7767
"36119007300",2761,325,197,149,880,290,1488,335,6425
"36119007401",3634,126,406,7,463,49,722,38,5445
"36119007402",2609,105,44,16,244,0,120,0,3138
"36119007500",4247,83,16,1,454,22,225,0,5048
"36119007600",5563,115,18,26,407,0,209,0,6338
"36119007700",4037,198,24,0,481,119,389,197,5445
"36119007800",1734,264,427,145,1373,366,2625,581,7515
"36119007900",2846,357,273,12,3643,1021,4886,1287,14325
"36119008000",1011,272,442,110,2822,562,3395,764,9378
"36119008100",2624,226,129,0,1442,315,2393,427,7556
"36119008200",4556,215,141,6,1792,0,2215,58,8983
"36119008301",2032,86,170,43,440,179,661,179,3790
"36119008302",5678,142,0,1,626,18,234,0,6699
"36119008401",1826,114,24,0,126,0,178,0,2268
"36119008403",2506,163,33,4,823,91,358,63,4041
"36119008404",3533,146,221,11,1064,192,820,238,6225
"36119008500",2811,103,8,0,117,0,150,0,3189
"36119008602",3583,202,98,67,298,44,114,10,4416
"36119008700",4613,478,10,2,422,278,1670,482,7955
"36119008800",1808,243,516,111,1770,229,1572,323,6572
"36119008901",3557,331,468,27,459,45,973,83,5943
"36119008902",1986,284,398,28,772,169,1137,281,5055
"36119009000",2107,181,340,98,1033,352,1076,388,5575
"36119009100",2466,406,671,91,1941,108,2973,352,9008
"36119009200",3117,355,786,311,2257,384,3517,771,11498
"36119009300",1061,267,458,843,837,130,542,301,4439
"36119009400",1804,253,396,151,1384,268,1621,452,6329
"36119009500",3090,197,499,138,847,268,1661,268,6968
"36119009600",3499,94,270,12,286,126,253,152,4692
"36119009701",2512,125,8,0,150,2,200,0,2997
"36119009702",1940,99,94,30,251,24,175,32,2645
"36119009703",3298,70,127,3,398,64,415,61,4436
"36119009800",3939,48,12,28,575,8,239,31,4880
"36119009900",2528,82,42,3,316,3,263,0,3237
"36119010000",4080,32,35,13,1152,41,69,0,5422
"36119010100",3872,28,0,0,642,121,171,0,4834
"36119010200",4466,37,128,4,143,17,159,0,4954
"36119010300",2089,246,96,0,341,0,272,3,3047
"36119010400",2493,134,78,104,766,0,536,38,4149
"36119010500",5362,175,307,14,622,15,339,15,6849
"36119010600",3064,69,217,0,1189,2,534,14,5089
"36119010701",3812,237,197,0,1459,0,244,0,5949
"36119010702",4103,85,166,35,1053,163,207,0,5812
"36119010801",2358,74,187,0,663,44,341,9,3676
"36119010803",2124,47,338,37,847,24,682,9,4108
"36119010804",2023,52,333,9,226,67,282,0,2992
"36119010901",1160,65,460,36,297,5,217,11,2251
"36119010902",2313,23,2200,75,1170,0,1064,2,6847
"36119010903",1207,96,2084,334,839,119,776,142,5597
"36119011000",871,54,849,0,809,40,681,40,3344
"36119011101",3677,123,1056,14,1244,0,1026,60,7200
"36119011102",2139,24,184,90,362,0,304,0,3103
"36119011200",1587,183,906,143,978,330,1163,447,5737
"36119011300",5481,164,29,0,811,12,482,0,6979
"36119011400",4724,113,276,2,700,7,642,0,6464
"36119011500",3242,266,542,38,1079,18,1769,92,7046
"36119011600",2931,646,389,133,1981,934,2962,1490,11466
"36119011700",2452,145,0,7,356,2,383,4,3349
"36119011800",4246,38,76,6,951,13,552,1,5883
"36119011902",3704,87,0,26,613,33,680,18,5161
"36119012000",3995,80,6,46,308,21,365,0,4821
"36119012101",4706,160,33,9,442,28,208,22,5608
"36119012102",4207,111,0,0,352,32,332,32,5066
"36119012200",6009,115,99,27,548,0,636,0,7434
"36119012301",1871,59,143,0,421,0,470,12,2976
"36119012303",4576,85,31,0,337,0,487,0,5516
"36119012304",4317,88,0,0,184,13,113,0,4715
"36119012400",4792,99,26,0,216,76,123,0,5332
"36119012501",2762,58,40,5,136,2,28,4,3035
"36119012502",5415,190,198,0,283,10,333,0,6429
"36119012503",3168,25,148,1,201,0,187,0,3730
"36119012600",3676,173,176,0,556,141,122,113,4957
"36119012700",3976,180,39,0,295,12,147,14,4663
"36119012802",4975,442,200,1,1285,50,1508,347,8808
"36119012900",2221,181,254,18,1221,587,1665,639,6786
"36119013000",3980,113,210,206,1545,431,2089,492,9066
"36119013102",5447,332,124,12,611,33,212,21,6792
"36119013103",4453,15,0,4,698,12,303,12,5497
"36119013104",5175,24,88,0,586,0,319,0,6192
"36119013201",3060,32,1,0,588,16,248,1,3946
"36119013202",2152,86,72,19,624,0,103,0,3056
"36119013301",633,200,612,114,1124,302,1504,364,4853
"36119013304",1445,187,704,96,2122,451,2461,645,8111
"36119013400",3163,429,710,109,1511,661,2238,623,9444
"36119013500",2342,79,224,1,1005,208,1394,191,5444
"36119013600",2215,71,452,27,1795,289,1885,309,7043
"36119013700",4062,390,238,14,577,95,519,73,5968
"36119013800",2560,75,184,0,246,0,108,18,3191
"36119013900",3632,160,476,10,663,1,1017,30,5989
"36119014000",1686,21,31,19,379,82,340,45,2603
"36119014100",2897,326,713,257,1359,200,1356,158,7266
"36119014200",1236,250,802,44,884,127,1128,194,4665
"36119014300",559,200,688,286,1875,569,1921,585,6683
"36119014400",2117,113,1398,174,2056,88,2449,109,8504
"36119014500",2888,81,591,42,836,36,842,40,5356
"36119014604",3322,265,90,0,559,63,657,80,5036
"36119014605",2158,136,170,0,570,17,276,15,3342
"36119014606",5195,66,192,20,285,89,226,85,6158
"36119014607",3426,133,362,0,332,0,537,0,4790
"36119014701",3063,101,615,72,859,47,1019,87,5863
"36119014703",4933,252,181,57,800,34,1227,235,7719
"36119014704",1603,71,367,156,359,149,563,154,3422
"36119014804",6310,97,131,70,743,99,1632,143,9225
"36119014805",3431,90,88,12,315,0,459,1,4396
"36119014806",5971,0,151,0,648,0,563,0,7333
"36119014808",3101,36,90,4,284,0,296,0,3811
"36119014809",5461,140,295,82,552,1,576,20,7127
"36119014810",1927,63,52,0,140,0,138,0,2320
"36119014811",5444,76,152,8,274,17,678,17,6666
"36119014901",5505,86,5,6,518,42,518,20,6700
"36119014903",4081,145,18,0,267,0,150,4,4665
"36119014907",3656,50,64,1,259,13,396,24,4463
"36119014908",2792,33,0,2,286,0,165,3,3281
"36119014909",2510,90,0,0,172,0,147,2,2921
"36119015000",4292,199,59,1,369,8,388,67,5383
"36119981000",110,243,15,116,289,158,34,57,1022
"36119982000",0,0,0,0,0,0,0,0,0
"36119983000",11,0,0,10,6,0,0,0,27
"36119984000",43,24,52,17,31,0,40,0,207
"36119985000",0,0,0,0,0,0,0,0,0
"36121970100",2183,219,32,0,21,0,16,7,2478
"36121970200",3568,209,0,0,87,43,27,0,3934
"36121970300",3133,111,0,0,52,20,74,9,3399
"36121970400",3654,226,22,58,21,14,26,26,4047
"36121970500",3777,942,0,0,44,56,42,15,4876
"36121970600",3873,565,0,8,0,0,20,3,4469
"36121970700",2485,313,23,2,39,0,67,57,2986
"36121970800",2568,365,0,0,67,12,17,36,3065
"36121970900",1767,106,11,0,32,9,0,0,1925
"36121971000",3301,670,0,75,56,43,46,48,4239
"36121971100",2238,352,22,0,36,7,42,7,2704
"36123150100",5139,795,0,14,63,26,211,38,6286
"36123150200",4126,810,77,14,32,42,0,0,5101
"36123150300",4563,779,21,8,49,8,87,62,5577
"36123150400",2663,307,4,0,19,0,20,0,3013
"36123150500",3678,637,7,6,83,0,21,17,4449
"37001020100",1998,426,410,529,393,352,387,339,4834
"37001020200",1159,426,907,420,671,263,752,209,4807
"37001020300",3157,922,1613,864,906,97,1788,626,9973
"37001020400",1070,300,3101,811,330,878,510,655,7655
"37001020501",1945,553,292,166,425,257,348,286,4272
"37001020502",1402,315,872,297,398,361,616,319,4580
"37001020601",2871,16,23,0,65,0,6,0,2981
"37001020602",1998,125,201,40,65,43,99,29,2600
"37001020701",3201,171,399,122,441,15,310,0,4659
"37001020702",2124,361,1270,430,290,84,207,200,4966
"37001020801",1142,70,48,195,172,2,185,0,1814
"37001020802",2802,691,879,1031,327,331,1095,198,7354
"37001020901",2081,621,248,69,366,309,716,676,5086
"37001020902",2597,220,157,55,328,136,295,282,4070
"37001021000",1202,623,598,462,354,400,345,329,4313
"37001021101",1613,341,499,151,146,104,141,138,3133
"37001021102",2127,301,290,253,167,202,176,91,3607
"37001021201",2323,740,863,446,617,329,695,413,6426
"37001021204",3003,423,388,49,385,61,554,120,4983
"37001021205",3256,292,1101,160,331,0,111,0,5251
"37001021206",2986,544,1101,103,301,352,209,343,5939
"37001021207",2210,452,246,135,267,12,268,117,3707
"37001021300",3176,459,1441,293,366,156,226,118,6235
"37001021400",1918,430,80,8,50,83,57,55,2681
"37001021500",3902,406,219,4,271,13,265,13,5093
"37001021600",3575,806,578,65,80,130,97,129,5460
"37001021701",2831,82,78,2,92,0,81,0,3166
"37001021702",3242,626,275,137,130,0,21,0,4431
"37001021703",3003,711,362,16,1029,473,75,446,6115
"37001021801",3542,711,252,0,43,62,123,0,4733
"37001021802",2953,653,71,0,89,0,0,0,3766
"37001021803",2466,300,50,17,95,0,62,2,2992
"37001021901",3097,509,346,22,110,208,38,208,4538
"37001021902",3565,334,267,65,137,5,211,11,4595
"37001022001",2596,273,220,57,180,62,131,73,3592
"37001022002",3013,242,629,127,231,186,436,115,4979
"37003040100",2712,627,30,10,8,0,0,3,3390
"37003040200",3443,417,21,0,10,7,60,7,3965
"37003040300",2403,229,81,178,46,16,0,16,2969
"37003040400",4582,1223,656,25,169,101,220,189,7165
"37003040500",4759,1156,351,0,516,335,437,314,7868
"37003040600",3991,848,35,0,368,161,213,0,5616
"37003040700",5344,858,175,0,68,0,127,0,6572
"37005950100",3252,661,17,0,13,163,168,175,4449
"37005950200",2441,663,186,9,415,140,481,109,4444
"37005950300",2443,333,1,5,20,12,42,42,2898
"37007920100",1405,220,973,143,40,20,0,0,2801
"37007920200",790,100,615,129,47,8,0,0,1689
"37007920300",3602,601,1470,470,219,31,32,5,6430
"37007920400",523,180,1504,634,0,91,0,91,3023
"37007920500",2193,381,1608,1177,119,63,230,0,5771
"37007920600",1301,577,1944,1040,6,0,15,373,5256
"37009970200",2320,444,9,6,36,16,14,9,2854
"37009970300",1676,744,0,3,45,8,31,0,2507
"37009970400",2862,1066,12,29,167,19,135,31,4321
"37009970500",4429,1164,28,10,278,350,271,478,7008
"37009970700",5115,572,0,18,112,9,32,3,5861
"37009970800",3936,796,7,17,95,239,55,290,5435
"37011930100",1987,366,23,6,50,25,39,21,2517
"37011930200",2330,332,1,3,121,9,53,59,2908
"37011930301",2506,472,27,23,117,38,190,68,3441
"37011930302",2200,603,0,0,127,8,3,21,2962
"37011930400",3154,260,0,9,251,196,177,166,4213
"37013930100",3118,365,1262,845,14,237,536,251,6628
"37013930200",4238,929,1106,302,83,0,341,228,7227
"37013930300",1755,233,1229,797,0,83,115,78,4290
"37013930400",1921,313,1033,627,143,183,488,150,4858
"37013930501",3015,229,718,146,537,0,574,64,5283
"37013930502",2394,485,792,147,88,0,119,0,4025
"37013930600",2832,203,0,241,42,0,25,0,3343
"37013930700",2312,276,84,52,23,0,0,0,2747
"37013930800",1557,84,589,208,19,0,19,5,2481
"37013930900",2993,193,448,241,55,0,68,16,4014
"37013931000",3109,511,836,678,51,52,352,18,5607
"37015960100",2395,228,1865,585,90,0,21,0,5184
"37015960200",1406,56,1774,681,1,17,13,0,3948
"37015960300",691,91,1888,783,61,0,21,0,3535
"37015960400",1909,277,2817,1548,81,38,238,7,6915
"37017950100",3072,963,795,414,90,178,39,163,5714
"37017950200",1252,316,816,342,252,6,203,111,3298
"37017950300",3269,1010,677,720,233,586,63,1169,7727
"37017950400",2095,428,1754,1557,45,222,0,160,6261
"37017950500",4329,549,1112,722,103,83,179,175,7252
"37017950600",2137,384,2306,720,435,142,267,80,6471
"37019020101",1259,240,795,386,184,42,215,110,3231
"37019020102",1999,360,286,21,281,90,146,86,3269
"37019020103",6038,628,378,478,498,37,594,0,8651
"37019020104",2704,970,693,604,929,254,436,440,7030
"37019020201",2325,284,671,31,276,67,110,119,3883
"37019020202",5457,330,354,315,484,0,171,0,7111
"37019020203",1904,284,255,30,69,14,77,0,2633
"37019020204",4477,590,124,10,582,71,441,0,6295
"37019020303",2077,585,117,81,104,0,0,30,2994
"37019020304",5312,375,63,0,73,0,84,0,5907
"37019020305",2170,239,330,23,46,49,99,11,2967
"37019020306",1804,276,0,0,44,47,0,0,2171
"37019020307",197,8,0,0,0,0,7,0,212
"37019020308",1502,136,0,0,23,0,7,0,1668
"37019020309",2269,258,79,0,59,0,31,0,2696
"37019020310",2109,243,0,0,63,23,67,0,2505
"37019020402",2274,549,29,25,83,23,13,23,3019
"37019020403",2919,652,143,38,147,234,0,216,4349
"37019020404",1976,675,319,51,138,11,156,0,3326
"37019020405",1882,744,173,59,58,0,28,0,2944
"37019020504",1409,0,31,79,28,0,23,0,1570
"37019020505",2046,514,813,610,216,113,241,19,4572
"37019020506",3506,445,224,70,10,0,318,7,4580
"37019020507",5457,818,264,12,134,0,56,0,6741
"37019020508",2130,296,32,21,5,0,99,0,2583
"37019020509",3710,709,62,78,23,0,71,68,4721
"37019020510",1392,400,0,0,52,78,114,125,2161
"37019020511",2114,99,0,0,17,87,105,87,2509
"37019020512",803,43,0,0,9,0,33,9,897
"37019020601",2999,460,628,178,272,87,187,63,4874
"37019020602",3494,591,781,419,82,56,68,14,5505
"37019020603",1151,282,489,522,94,118,113,51,2820
"37019990100",0,0,0,0,0,0,0,0,0
"37021000100",756,257,46,45,28,37,47,21,1237
"37021000200",831,250,131,108,85,13,52,0,1470
"37021000300",1070,402,353,214,65,5,157,39,2305
"37021000400",1972,488,143,39,73,19,20,0,2754
"37021000500",3071,362,52,0,129,0,172,80,3866
"37021000600",1353,402,257,68,125,14,25,49,2293
"37021000700",561,137,417,65,11,7,0,0,1198
"37021000800",2396,235,202,260,198,7,77,0,3375
"37021000900",544,563,935,720,54,96,17,53,2982
"37021001000",2899,449,302,420,335,68,152,118,4743
"37021001100",3631,383,150,231,235,32,145,19,4826
"37021001200",3584,526,72,142,302,20,346,169,5161
"37021001300",2772,784,76,293,187,141,376,186,4815
"37021001400",3903,1164,523,279,688,112,940,298,7907
"37021001500",1687,412,70,1,57,0,193,0,2420
"37021001600",4908,554,162,66,34,16,154,0,5894
"37021001700",1969,240,0,0,83,0,43,0,2335
"37021001801",2269,621,347,0,28,0,26,0,3291
"37021001802",3820,321,82,0,39,0,25,15,4302
"37021001900",2332,492,91,35,175,12,152,251,3540
"37021002000",2871,1004,1296,335,109,99,124,0,5838
"37021002101",1362,59,0,0,46,0,18,0,1485
"37021002102",3230,853,1177,323,191,0,749,246,6769
"37021002203",2785,823,495,319,419,83,545,556,6025
"37021002204",6575,472,93,104,760,0,418,32,8454
"37021002205",6433,105,62,23,151,15,227,0,7016
"37021002206",3666,392,244,107,515,42,239,0,5205
"37021002301",4848,440,234,289,226,0,311,289,6637
"37021002302",6578,721,198,8,365,0,161,238,8269
"37021002401",2724,1046,8,2,47,16,136,179,4158
"37021002402",3752,836,0,88,21,0,167,234,5098
"37021002503",3124,656,0,0,190,88,219,127,4404
"37021002504",3589,720,5,0,149,33,0,5,4501
"37021002505",4141,553,65,2,0,0,124,0,4885
"37021002506",2610,861,113,71,212,137,158,107,4269
"37021002603",3247,717,19,4,42,14,50,0,4093
"37021002604",4645,880,16,42,299,50,399,50,6381
"37021002605",4446,812,236,0,80,110,314,112,6110
"37021002606",2773,878,84,0,271,102,42,204,4354
"37021002607",3441,730,55,2,235,0,349,194,5006
"37021002701",2629,584,15,0,38,0,212,278,3756
"37021002702",3570,392,12,0,131,0,194,15,4314
"37021002703",4781,675,0,0,55,0,65,0,5576
"37021002803",3525,886,11,1,15,32,274,394,5138
"37021002804",4317,352,2,0,222,72,0,80,5045
"37021002900",2738,681,0,0,116,39,8,12,3594
"37021003001",7119,738,171,257,262,42,304,152,9045
"37021003002",5190,760,205,0,141,17,45,163,6521
"37021003102",4624,684,238,173,100,103,43,0,5965
"37021003103",1465,260,24,32,145,0,0,0,1926
"37021003104",4234,1100,11,102,162,0,165,551,6325
"37021003201",1665,79,53,1,36,24,34,0,1892
"37021003202",3494,359,127,0,16,0,57,0,4053
"37021003203",4599,421,587,3,255,91,301,0,6257
"37021003204",4578,330,0,0,398,129,374,0,5809
"37021003205",1577,144,0,0,29,0,20,0,1770
"37023020100",2678,764,187,182,86,311,104,372,4684
"37023020201",4452,506,267,89,288,36,10,0,5648
"37023020202",3073,331,364,31,231,127,66,20,4243
"37023020301",3049,451,674,86,487,24,30,11,4812
"37023020302",5650,861,79,2,535,79,54,1,7261
"37023020500",2075,354,162,229,181,310,302,98,3711
"37023020600",3046,970,274,251,461,546,612,837,6997
"37023020801",3700,724,236,144,122,166,32,85,5209
"37023020802",2353,420,65,19,162,75,124,0,3218
"37023020900",5451,1179,107,77,629,17,28,175,7663
"37023021000",4341,973,44,16,381,24,48,18,5845
"37023021100",4477,1243,31,60,367,58,189,0,6425
"37023021201",2620,836,38,29,101,159,27,11,3821
"37023021202",2937,555,0,0,396,112,158,116,4274
"37023021203",2741,933,75,10,229,15,14,15,4032
"37023021301",3469,560,6,90,125,396,108,152,4906
"37023021302",2425,752,4,0,29,21,2,0,3233
"37023021400",2607,713,335,90,503,271,462,565,5546
"37025040500",7780,1093,1914,170,675,84,1296,645,13657
"37025040600",5300,614,90,4,141,60,0,0,6209
"37025040701",1120,238,84,0,55,0,116,0,1613
"37025040702",3470,632,2007,369,595,65,655,331,8124
"37025040703",881,157,862,220,103,49,180,49,2501
"37025040800",2181,507,589,270,80,44,212,90,3973
"37025040900",1180,369,265,0,274,17,254,18,2377
"37025041000",3193,820,809,625,414,422,450,514,7247
"37025041100",4854,664,995,247,524,60,387,130,7861
"37025041200",4422,776,942,147,350,153,141,200,7131
"37025041301",3297,259,495,171,462,29,242,0,4955
"37025041302",5415,232,1367,20,969,15,485,0,8503
"37025041303",5596,116,1592,0,1591,0,491,0,9386
"37025041501",7338,510,1516,252,753,20,190,20,10599
"37025041502",4320,915,775,0,375,137,211,303,7036
"37025041503",2498,66,404,0,238,18,384,18,3626
"37025041601",6609,484,453,21,406,0,422,0,8395
"37025041602",2658,150,88,13,119,5,154,0,3187
"37025041701",3278,251,107,0,161,15,0,0,3812
"37025041702",3012,357,207,0,29,0,0,0,3605
"37025041901",629,291,651,101,361,136,587,305,3061
"37025041902",1767,912,512,377,367,130,659,592,5316
"37025042000",2727,589,404,175,131,154,266,256,4702
"37025042101",760,97,1317,661,248,301,719,287,4390
"37025042102",2506,521,280,489,61,119,285,245,4506
"37025042200",5705,313,452,21,535,1,978,0,8005
"37025042300",2648,549,594,204,208,262,386,464,5315
"37025042401",2819,435,213,19,148,10,240,0,3884
"37025042402",2211,318,1185,481,799,63,761,206,6024
"37025042501",3866,120,153,22,317,90,58,0,4626
"37025042502",1638,108,546,189,15,28,258,0,2782
"37025042503",2713,182,295,242,493,69,373,101,4468
"37025042504",1221,64,113,0,23,0,0,0,1421
"37025042601",4065,88,438,1,366,0,110,0,5068
"37025042602",2601,440,530,211,390,278,729,389,5568
"37025042603",5567,285,904,130,168,0,273,0,7327
"37025042604",3427,176,653,0,334,0,145,7,4742
"37027030100",2812,590,655,567,52,409,78,345,5508
"37027030200",3065,1415,358,167,311,297,375,178,6166
"37027030300",2188,487,516,283,166,19,120,138,3917
"37027030400",2765,736,34,7,555,10,507,0,4614
"37027030500",3762,394,118,4,72,28,147,0,4525
"37027030600",3906,676,2,14,184,24,206,0,5012
"37027030700",4974,1067,0,0,42,18,34,0,6135
"37027030800",6712,1219,110,88,312,291,317,120,9169
"37027030900",2975,1239,190,78,60,30,30,0,4602
"37027031000",2514,230,22,0,62,6,131,0,2965
"37027031100",3222,453,44,0,61,10,18,0,3808
"37027031201",4144,803,107,35,166,23,65,0,5343
"37027031202",3223,805,78,116,21,13,8,79,4343
"37027031300",7044,1060,14,8,336,34,229,19,8744
"37027031401",2493,515,30,33,65,162,13,141,3452
"37027031402",2201,605,1,8,153,105,182,104,3359
"37027031403",1687,487,4,4,230,93,247,93,2845
"37029950101",3797,306,798,124,132,17,94,17,5285
"37029950102",4037,243,364,113,230,0,149,0,5136
"37031970101",820,181,0,0,0,0,0,25,1026
"37031970102",2218,244,127,45,31,0,0,0,2665
"37031970103",2418,534,0,0,23,9,0,0,2984
"37031970200",1481,134,0,0,12,2,8,0,1637
"37031970301",3070,360,495,181,36,102,45,42,4331
"37031970302",544,187,104,159,12,109,0,26,1141
"37031970303",578,68,55,4,0,0,16,0,721
"37031970304",1231,356,115,285,31,78,11,33,2140
"37031970401",861,229,236,11,59,171,188,34,1789
"37031970402",859,412,99,151,58,49,3,8,1639
"37031970403",932,125,0,0,0,0,0,0,1057
"37031970501",1723,544,244,89,46,41,146,166,2999
"37031970502",1706,137,49,0,16,0,48,0,1956
"37031970503",1632,129,303,150,30,46,0,5,2295
"37031970504",1168,365,32,0,185,0,306,163,2219
"37031970601",1044,286,0,0,54,53,86,0,1523
"37031970602",949,5,0,0,95,0,0,0,1049
"37031970603",1224,252,82,17,55,42,42,0,1714
"37031970604",2019,84,11,0,57,0,15,0,2186
"37031970605",1086,92,82,0,27,40,5,0,1332
"37031970701",900,273,37,15,34,0,80,0,1339
"37031970702",2563,135,170,252,395,43,199,247,4004
"37031970703",4012,400,242,13,394,39,109,0,5209
"37031970704",1738,469,0,0,181,83,93,6,2570
"37031970801",2020,254,64,4,62,1,87,0,2492
"37031970802",1428,75,23,0,97,0,28,0,1651
"37031970803",1455,122,0,0,16,0,88,0,1681
"37031970804",2739,232,119,9,47,5,60,0,3211
"37031970805",1291,282,6,27,37,11,47,48,1749
"37031970901",1070,82,0,0,0,0,19,0,1171
"37031970902",1103,220,10,0,5,0,71,0,1409
"37031970903",1067,97,0,0,54,0,60,0,1278
"37031971001",469,37,0,0,0,0,0,0,506
"37031971002",1379,79,5,0,24,6,51,0,1544
"37031971101",914,118,0,0,7,43,0,0,1082
"37031971102",401,72,12,0,29,0,11,0,525
"37031980100",0,0,0,0,0,0,0,0,0
"37031990100",0,0,0,0,0,0,0,0,0
"37031990200",0,0,0,0,0,0,0,0,0
"37033930100",1212,18,844,303,49,61,41,0,2528
"37033930200",1933,420,1416,997,289,49,133,15,5252
"37033930300",2317,921,639,86,142,171,116,229,4621
"37033930400",979,499,757,24,4,52,2,0,2317
"37033930500",2021,151,855,122,33,23,47,23,3275
"37033930600",3150,458,851,268,35,11,57,39,4869
"37035010101",5223,587,22,197,371,198,61,163,6822
"37035010102",3065,166,243,109,290,150,243,23,4289
"37035010201",3683,524,59,137,352,135,345,0,5235
"37035010202",4900,1122,488,130,1348,247,310,489,9034
"37035010301",4051,414,62,32,527,99,467,239,5891
"37035010302",4047,312,273,104,496,63,169,109,5573
"37035010303",3020,654,56,33,289,403,106,851,5412
"37035010304",2522,350,23,30,1145,364,1074,329,5837
"37035010401",4389,939,476,55,430,281,526,332,7428
"37035010402",1963,729,415,233,184,240,375,365,4504
"37035010501",3180,81,79,34,172,0,228,0,3774
"37035010502",2973,270,48,0,55,0,21,0,3367
"37035010600",3549,701,173,324,358,296,298,266,5965
"37035010700",1161,505,106,95,118,108,226,59,2378
"37035010900",522,428,1697,723,265,36,242,54,3967
"37035011000",915,203,302,313,506,58,477,39,2813
"37035011101",2361,135,421,81,304,227,321,227,4077
"37035011102",4698,856,633,59,802,135,614,93,7890
"37035011200",3326,529,685,192,369,0,352,9,5462
"37035011300",3462,1270,586,409,986,305,618,496,8132
"37035011401",2620,368,304,53,128,86,98,77,3734
"37035011402",2978,322,87,0,46,0,21,0,3454
"37035011501",4513,286,198,65,78,8,92,8,5248
"37035011503",3444,137,0,80,96,46,18,8,3829
"37035011504",5120,244,129,0,113,0,55,0,5661
"37035011601",3055,358,200,23,493,254,234,176,4793
"37035011602",4457,766,27,56,42,174,97,290,5909
"37035011701",3449,431,104,190,503,15,299,53,5044
"37035011702",4828,654,466,65,522,32,97,37,6701
"37035011801",5938,299,312,2,72,105,52,105,6885
"37035011802",4611,701,23,158,205,241,274,132,6345
"37037020103",3087,208,127,13,895,158,973,155,5616
"37037020104",4787,177,77,0,17,0,0,0,5058
"37037020105",2803,275,91,30,156,40,198,162,3755
"37037020106",3465,285,294,77,365,22,186,0,4694
"37037020200",5636,898,671,9,219,63,296,286,8078
"37037020300",1969,216,428,87,111,32,26,97,2966
"37037020401",3054,689,1003,207,923,66,1841,530,8313
"37037020402",1419,970,1091,115,539,582,1120,1214,7050
"37037020500",2869,625,427,52,0,19,0,0,3992
"37037020600",3747,450,572,639,198,37,390,10,6043
"37037020701",5088,388,268,0,457,0,245,0,6446
"37037020702",3182,247,274,102,114,0,51,19,3989
"37037020800",5424,650,1025,332,484,281,304,394,8894
"37039930100",3138,748,45,67,304,99,146,88,4635
"37039930200",1557,345,0,0,161,0,0,0,2063
"37039930300",1628,438,0,3,137,32,14,0,2252
"37039930400",4277,1222,110,55,140,80,163,121,6168
"37039930500",3797,803,10,56,79,12,68,0,4825
"37039930601",2504,428,0,0,18,103,30,19,3102
"37039930602",3401,767,9,0,13,61,68,32,4351
"37041930101",1935,671,1191,1240,99,1,40,0,5177
"37041930102",1244,233,513,220,53,62,53,0,2378
"37041930200",4314,673,1056,691,152,41,253,134,7314
"37043950100",3730,941,0,0,13,0,22,16,4722
"37043950200",4576,1126,1,40,38,128,134,143,6186
"37045950101",3883,943,41,18,130,6,82,44,5147
"37045950102",1937,189,146,39,10,74,7,0,2402
"37045950200",2902,517,777,147,96,12,8,15,4474
"37045950301",2661,360,585,320,219,82,68,0,4295
"37045950302",4687,751,423,320,23,35,143,132,6514
"37045950400",4229,779,843,109,163,132,195,0,6450
"37045950500",2264,566,493,250,155,54,195,33,4010
"37045950601",2791,650,152,26,153,13,0,0,3785
"37045950602",3629,1000,736,283,384,38,102,0,6172
"37045950700",4766,276,984,766,76,0,128,0,6996
"37045950800",2599,608,1182,311,86,12,420,150,5368
"37045950900",556,178,1095,804,28,24,0,39,2724
"37045951000",1475,347,687,799,17,63,24,52,3464
"37045951100",1054,200,404,618,275,24,195,6,2776
"37045951200",2505,928,992,808,123,127,114,365,5962
"37045951300",2299,233,147,194,36,14,57,15,2995
"37045951400",4913,816,853,339,76,14,39,7,7057
"37045951501",3515,623,50,49,124,18,77,68,4524
"37045951502",997,129,79,24,15,23,4,42,1313
"37045951503",2021,260,203,108,45,0,8,0,2645
"37045951601",2337,309,1330,486,0,9,0,0,4471
"37045951602",3013,664,643,238,99,0,92,32,4781
"37047930100",1947,170,1479,244,139,164,313,160,4616
"37047930200",934,86,327,229,486,163,29,86,2340
"37047930300",1551,148,167,163,430,123,32,17,2631
"37047930400",1645,498,1007,611,463,89,218,104,4635
"37047930500",2602,271,861,475,95,15,16,15,4350
"37047930600",1959,545,504,357,138,21,80,91,3695
"37047930700",2111,328,1541,668,84,98,26,52,4908
"37047930800",2308,310,623,342,637,62,567,62,4911
"37047930900",1334,461,1086,1209,61,314,39,121,4625
"37047931000",3482,778,524,341,39,31,0,164,5359
"37047931100",2607,571,37,596,35,0,0,50,3896
"37047931200",3092,724,1189,747,112,176,44,139,6223
"37047931300",3401,470,459,168,182,2,139,61,4882
"37049960101",3504,113,93,0,24,0,123,0,3857
"37049960102",3826,486,167,70,73,0,128,0,4750
"37049960200",4413,999,1573,547,191,207,116,147,8193
"37049960300",3403,821,1381,842,360,60,361,516,7744
"37049960401",3019,128,940,18,28,65,61,0,4259
"37049960402",1766,82,1236,199,256,215,8,26,3788
"37049960403",3990,132,24,0,64,0,81,0,4291
"37049960404",2686,189,113,11,63,19,9,29,3119
"37049960500",4028,482,2023,652,563,494,593,442,9277
"37049960600",2096,228,1034,91,848,165,120,0,4582
"37049960700",1350,60,137,4,214,111,48,0,1924
"37049960800",444,98,891,1371,35,27,33,14,2913
"37049960900",943,226,231,1042,33,274,125,1,2875
"37049961001",8423,448,680,537,641,15,416,0,11160
"37049961002",2971,336,275,85,49,147,41,300,4204
"37049961100",6158,570,1180,172,941,1,857,1,9880
"37049961201",2914,191,309,68,221,38,415,34,4190
"37049961202",706,94,43,0,157,10,178,20,1208
"37049961301",2364,646,799,37,560,0,341,384,5131
"37049961302",2799,461,1058,522,219,185,458,278,5980
"37049961303",2252,112,1000,452,114,9,169,9,4117
"37051000200",207,84,640,1054,35,79,19,43,2161
"37051000500",756,300,317,534,193,141,123,134,2498
"37051000600",3104,305,861,713,296,77,255,65,5676
"37051000701",4248,118,523,52,590,90,379,64,6064
"37051000702",1222,158,322,224,84,88,35,15,2148
"37051000800",1525,274,347,395,145,41,195,11,2933
"37051000900",3682,281,758,255,284,99,411,16,5786
"37051001000",212,180,1335,910,111,42,102,38,2930
"37051001100",106,53,2277,964,32,76,12,53,3573
"37051001200",1159,192,2107,1437,328,72,185,56,5536
"37051001400",2507,242,1908,825,366,174,281,69,6372
"37051001500",1332,316,692,229,125,74,74,79,2921
"37051001601",4002,567,1812,349,829,175,506,170,8410
"37051001603",2148,308,673,501,267,124,253,47,4321
"37051001604",2645,398,2181,1124,696,147,570,192,7953
"37051001700",3656,969,2621,725,846,136,529,145,9627
"37051001800",1118,350,337,191,296,62,186,54,2594
"37051001901",1072,171,345,282,236,107,126,146,2485
"37051001902",1888,516,1229,360,606,161,517,173,5450
"37051001903",1985,540,899,381,324,73,369,101,4672
"37051002001",1360,204,678,155,398,16,466,125,3402
"37051002002",2482,417,1556,454,289,132,828,144,6302
"37051002100",1847,202,899,310,572,82,359,154,4425
"37051002200",530,56,409,164,100,18,157,15,1449
"37051002300",995,244,1925,886,416,170,511,105,5252
"37051002401",260,58,781,662,57,47,149,108,2122
"37051002402",589,143,1573,660,279,102,150,54,3550
"37051002501",2262,386,3527,571,734,118,492,96,8186
"37051002502",2965,354,1921,614,543,135,429,66,7027
"37051002503",2636,39,1518,249,515,16,443,0,5416
"37051002504",2896,339,1634,395,543,248,340,176,6571
"37051002600",2337,396,821,239,209,22,57,11,4092
"37051002700",5528,426,1531,193,676,129,286,125,8894
"37051002800",4539,660,745,64,375,163,17,118,6681
"37051002900",2338,463,805,376,372,21,345,0,4720
"37051003001",7592,641,2114,142,1748,196,1517,86,14036
"37051003002",1709,249,415,203,149,55,213,18,3011
"37051003102",2717,370,746,99,375,121,570,35,5033
"37051003103",3130,425,1389,30,482,150,368,113,6087
"37051003104",3423,498,1233,287,611,238,698,167,7155
"37051003201",7314,507,2831,233,1463,177,1146,178,13849
"37051003203",1610,363,1736,680,870,117,732,212,6320
"37051003204",3587,489,2800,641,770,207,835,87,9416
"37051003205",2107,112,2445,350,566,74,658,40,6352
"37051003302",1424,243,2420,684,232,89,257,143,5492
"37051003304",2931,285,2442,457,617,92,717,383,7924
"37051003305",1918,282,2228,543,446,206,445,125,6193
"37051003307",1427,95,1741,339,518,136,445,145,4846
"37051003309",2839,359,1544,235,787,12,719,59,6554
"37051003310",2054,435,1321,386,426,0,661,199,5482
"37051003311",1164,94,782,108,272,57,293,0,2770
"37051003312",2505,316,2276,716,632,51,607,15,7118
"37051003313",1923,233,2916,383,749,12,754,122,7092
"37051003314",2300,503,2705,960,641,121,818,264,8312
"37051003401",2124,192,366,218,314,20,557,52,3843
"37051003402",0,0,0,0,0,0,0,0,0
"37051003403",2122,278,401,88,878,134,557,117,4575
"37051003404",0,0,0,0,0,0,0,0,0
"37051003405",919,173,250,20,206,190,423,22,2203
"37051003406",776,0,47,50,12,10,55,10,960
"37051003407",492,267,77,26,208,85,198,222,1575
"37051003408",2751,391,899,28,695,151,716,203,5834
"37051003500",1574,258,1488,819,1084,453,784,287,6747
"37051003600",1972,408,1658,483,677,377,526,164,6265
"37051003700",4324,717,1454,257,257,9,339,127,7484
"37051003800",197,85,937,933,147,80,32,38,2449
"37051980100",0,0,0,0,0,0,0,0,0
"37051980200",0,0,0,0,0,0,0,0,0
"37053110101",696,85,0,0,7,0,4,0,792
"37053110102",1396,118,0,0,9,0,19,0,1542
"37053110200",5606,351,355,203,408,0,488,66,7477
"37053110301",3398,583,89,51,69,0,0,0,4190
"37053110302",2075,332,261,84,49,18,10,91,2920
"37053110401",2734,344,95,4,55,34,29,14,3309
"37053110402",4037,243,319,27,169,20,124,0,4939
"37053990100",0,0,0,0,0,0,0,0,0
"37055970101",3517,95,0,4,166,0,105,0,3887
"37055970102",3081,230,0,0,24,0,27,0,3362
"37055970200",3640,336,31,0,183,95,188,48,4521
"37055970300",5681,649,38,0,454,60,322,0,7204
"37055970400",2363,254,25,3,130,0,129,0,2904
"37055970501",1101,124,7,0,230,50,317,5,1834
"37055970502",3532,313,0,0,507,30,609,2,4993
"37055970601",4500,360,541,86,495,115,442,86,6625
"37055970602",1548,72,0,0,9,9,99,0,1737
"37055990100",0,0,0,0,0,0,0,0,0
"37055990200",0,0,0,0,0,0,0,0,0
"37057060101",4276,126,1043,39,333,0,385,0,6202
"37057060102",6136,523,123,2,56,14,158,0,7012
"37057060201",4022,323,300,28,204,29,266,43,5215
"37057060202",2293,225,51,5,44,0,159,27,2804
"37057060203",4649,858,111,0,286,0,371,0,6275
"37057060301",3712,431,479,18,52,0,22,70,4784
"37057060302",3179,163,26,18,183,0,85,0,3654
"37057060303",3466,363,0,34,29,73,98,0,4063
"37057060304",3010,455,15,2,13,30,39,30,3594
"37057060400",3999,654,289,0,352,113,64,87,5558
"37057060500",4773,407,0,0,40,73,105,15,5413
"37057060601",3651,439,11,60,238,31,48,169,4647
"37057060602",2461,167,48,0,0,14,181,88,2959
"37057060700",2093,721,1218,676,74,42,397,412,5633
"37057060800",1371,469,1039,988,91,65,321,118,4462
"37057060900",3140,844,713,83,173,1,531,80,5565
"37057061000",3374,502,308,690,425,169,869,110,6447
"37057061100",5602,798,216,0,29,54,235,160,7094
"37057061201",3793,1464,550,66,873,49,361,527,7683
"37057061202",2808,191,11,11,91,21,266,0,3399
"37057061300",1039,229,276,180,84,36,117,10,1971
"37057061400",960,738,498,436,48,14,612,125,3431
"37057061500",2812,844,968,823,185,139,764,236,6771
"37057061600",1510,683,317,330,65,33,302,250,3490
"37057061701",4511,673,20,0,28,0,110,0,5342
"37057061702",5315,793,193,51,21,18,275,0,6666
"37057061703",3182,431,225,32,140,0,192,67,4269
"37057061802",5647,1275,153,0,399,45,265,30,7814
"37057061803",2169,388,490,204,378,95,200,39,3963
"37057061804",5078,675,255,0,79,24,0,0,6111
"37057061901",4967,1059,0,0,180,0,108,25,6339
"37057061902",4539,354,0,3,46,11,17,12,4982
"37057062001",3776,679,17,0,60,0,92,0,4624
"37057062002",3002,706,0,3,23,30,25,2,3791
"37059080100",6080,1441,301,23,548,0,455,342,9190
"37059080200",4459,400,50,38,364,0,249,0,5560
"37059080300",7683,555,250,15,231,0,215,0,8949
"37059080400",4244,434,34,60,49,0,20,2,4843
"37059080500",2795,711,540,178,163,128,306,107,4928
"37059080600",2277,360,463,104,215,1,325,1,3746
"37059080700",3937,601,401,119,623,42,569,33,6325
"37061090100",4901,2254,287,42,752,1199,1216,2780,13431
"37061090200",2247,348,565,333,446,323,1065,517,5844
"37061090300",1941,280,1252,1107,335,321,529,287,6052
"37061090400",2436,186,2432,718,485,319,864,285,7725
"37061090501",4018,1305,298,70,34,243,149,255,6372
"37061090502",2518,630,822,374,135,22,212,238,4951
"37061090600",2545,429,632,43,15,226,0,147,4037
"37061090701",1968,337,707,501,273,48,459,64,4357
"37061090702",3583,530,1242,645,473,174,599,245,7491
"37061090801",899,427,576,255,411,357,720,665,4310
"37061090802",2197,477,856,657,669,426,679,511,6472
"37063000101",731,45,888,569,294,363,221,356,3467
"37063000102",1987,653,711,682,139,71,553,537,5333
"37063000200",1317,308,603,311,424,59,672,214,3908
"37063000301",1039,457,644,155,95,153,244,388,3175
"37063000302",2316,307,377,126,244,108,602,100,4180
"37063000401",2600,114,37,19,56,56,116,12,3010
"37063000402",1280,352,77,27,239,39,128,43,2185
"37063000500",673,385,998,653,138,143,124,76,3190
"37063000600",3033,585,942,984,491,113,831,166,7145
"37063000700",1638,208,896,316,384,38,307,0,3787
"37063000900",233,375,866,561,98,38,294,388,2853
"37063001001",314,466,1793,943,421,371,302,442,5052
"37063001002",1008,1165,1525,1468,342,417,1159,1263,8347
"37063001100",367,398,977,1254,275,62,423,379,4135
"37063001301",202,48,653,331,36,22,186,34,1512
"37063001303",178,25,992,319,24,4,177,21,1740
"37063001304",65,123,1263,1149,146,52,127,117,3042
"37063001400",20,1,910,1116,109,263,128,55,2602
"37063001501",7,40,0,0,0,8,3,9,67
"37063001502",1047,1329,1347,710,1117,634,589,940,7713
"37063001503",0,0,0,0,0,0,0,0,0
"37063001601",3232,177,1474,111,689,24,675,35,6417
"37063001603",4216,165,1469,106,219,80,417,32,6704
"37063001604",5466,138,874,21,237,41,64,0,6841
"37063001705",2813,418,1364,3,99,16,370,209,5292
"37063001706",2080,363,1132,141,614,478,88,359,5255
"37063001707",5306,279,309,12,815,84,448,48,7301
"37063001708",629,305,3436,446,391,185,510,289,6191
"37063001709",864,408,3121,1490,295,148,371,331,7028
"37063001710",1359,469,1604,277,389,62,548,414,5122
"37063001711",1469,288,1700,363,543,253,773,386,5775
"37063001801",2852,520,3297,620,557,157,862,546,9411
"37063001802",1215,681,3004,842,840,270,1339,1119,9310
"37063001806",2255,611,2470,272,57,0,252,279,6196
"37063001807",2699,433,4536,734,494,215,866,486,10463
"37063001808",3840,49,2322,10,886,11,737,11,7866
"37063001809",2494,767,1839,313,580,97,575,516,7181
"37063001900",2418,113,274,0,165,41,66,0,3077
"37063002007",2847,126,1381,44,280,161,229,161,5229
"37063002008",2632,0,300,0,137,0,36,0,3105
"37063002009",170,163,3335,523,126,85,235,184,4821
"37063002013",2869,155,969,214,372,104,244,140,5067
"37063002015",3009,404,1097,371,416,70,1075,229,6671
"37063002016",1629,941,1489,434,809,531,1081,972,7886
"37063002017",5379,267,595,64,957,188,334,19,7803
"37063002018",5613,344,811,501,892,17,448,100,8726
"37063002019",3440,408,481,0,228,193,281,0,5031
"37063002020",4297,267,1385,6,939,3,104,3,7004
"37063002021",2408,403,956,232,433,44,219,274,4969
"37063002022",2154,410,1458,242,337,15,296,0,4912
"37063002023",2107,41,597,14,226,16,218,0,3219
"37063002024",3922,198,1157,113,729,20,379,0,6518
"37063002025",2361,502,2958,110,539,113,216,332,7131
"37063002026",1051,17,3602,1120,522,0,686,0,6998
"37063002027",3883,389,2251,1143,1067,151,1518,169,10571
"37063002028",3125,180,2201,293,1243,41,327,14,7424
"37063002100",4790,328,789,0,83,45,39,29,6103
"37063002200",933,230,269,192,102,32,4,9,1771
"37063002300",39,117,356,294,55,8,61,111,1041
"37063980100",0,0,0,0,0,0,0,0,0
"37065020200",693,313,2600,2246,148,69,9,41,6119
"37065020300",386,234,2955,1688,57,170,10,63,5563
"37065020400",155,48,2881,1474,21,0,0,0,4579
"37065020600",585,145,1429,439,82,87,102,122,2991
"37065020700",509,56,717,564,85,42,9,0,1982
"37065020800",1160,373,1771,215,0,7,0,0,3526
"37065020900",197,16,1769,912,17,0,0,0,2911
"37065021000",1061,39,1226,615,128,5,0,0,3074
"37065021100",1714,477,764,207,496,242,632,535,5067
"37065021200",2568,146,1569,485,157,17,104,0,5046
"37065021300",2726,130,948,467,407,37,258,26,4999
"37065021400",2491,696,463,264,7,0,84,0,4005
"37065021500",1328,441,858,507,0,0,0,138,3272
"37065021600",2095,136,389,198,219,3,96,0,3136
"37067000100",818,173,163,128,44,64,10,7,1407
"37067000200",303,298,104,395,10,0,7,80,1197
"37067000301",84,63,1068,865,11,17,63,30,2201
"37067000302",32,202,812,490,5,61,32,246,1880
"37067000400",272,277,1757,944,317,185,351,470,4573
"37067000500",37,264,900,1071,96,54,119,187,2728
"37067000600",25,118,840,945,24,115,15,219,2301
"37067000700",5,25,673,1095,10,7,0,0,1815
"37067000801",17,279,120,217,97,122,29,259,1140
"37067000802",289,316,395,673,66,61,210,397,2407
"37067000900",1233,733,458,333,148,178,152,490,3725
"37067001000",2469,1289,531,175,112,242,627,975,6420
"37067001100",1134,245,238,242,38,7,14,67,1985
"37067001200",1682,54,121,19,70,0,42,8,1996
"37067001300",957,523,220,131,71,0,39,32,1973
"37067001400",464,459,1567,496,140,219,334,549,4228
"37067001500",871,588,1400,688,378,380,720,575,5600
"37067001601",16,69,2799,1015,146,40,106,65,4256
"37067001602",121,189,1046,1834,111,22,144,119,3586
"37067001700",867,413,2614,1369,125,260,277,602,6527
"37067001800",256,543,1735,1179,423,59,494,355,5044
"37067001901",291,579,314,189,70,182,154,495,2274
"37067001902",1041,228,179,116,0,14,73,72,1723
"37067002001",632,379,732,285,155,276,269,474,3202
"37067002002",1303,723,750,201,121,69,417,713,4297
"37067002100",1465,164,104,42,96,4,118,0,1993
"37067002200",3053,282,377,62,143,31,435,0,4383
"37067002501",2446,75,18,0,58,0,65,0,2662
"37067002502",2725,20,46,0,148,0,35,0,2974
"37067002601",2309,254,192,0,0,42,15,7,2819
"37067002603",3790,411,934,196,577,87,559,133,6687
"37067002604",4664,209,179,209,454,125,553,238,6631
"37067002701",2249,1373,1664,617,102,123,1144,1108,8380
"37067002702",1642,645,2332,1161,148,0,744,347,7019
"37067002703",2323,1190,1647,927,479,22,1166,245,7999
"37067002801",3319,223,392,0,31,33,0,0,3998
"37067002804",2674,288,500,367,219,0,1065,147,5260
"37067002806",1066,253,937,119,142,48,423,104,3092
"37067002807",3287,484,1086,378,201,49,684,312,6481
"37067002808",2807,153,177,47,181,9,83,0,3457
"37067002809",1474,114,433,63,29,0,41,0,2154
"37067002901",2518,500,1246,149,111,27,416,100,5067
"37067002903",2011,804,807,194,41,0,317,360,4534
"37067002904",1993,227,23,21,14,18,19,69,2384
"37067003002",1694,339,1571,566,68,62,139,0,4439
"37067003003",1956,260,519,20,26,0,56,0,2837
"37067003004",3060,391,276,24,123,0,98,22,3994
"37067003103",4784,199,347,0,32,0,204,26,5592
"37067003105",2787,192,634,171,73,122,82,122,4183
"37067003106",2511,78,116,19,107,13,35,13,2892
"37067003107",2991,399,224,164,271,58,294,88,4489
"37067003108",2295,529,201,194,276,80,611,515,4701
"37067003201",3547,241,328,109,298,156,168,124,4971
"37067003202",2297,765,179,67,127,188,395,471,4489
"37067003307",2567,293,462,26,232,33,68,0,3681
"37067003308",6200,83,841,66,236,0,544,0,7970
"37067003309",2036,584,940,934,436,91,419,398,5838
"37067003310",2212,486,1085,219,231,100,276,146,4755
"37067003311",1354,68,277,20,100,0,167,10,1996
"37067003312",2221,159,287,2,20,19,0,1,2709
"37067003313",1209,203,9,17,0,41,9,87,1575
"37067003314",2466,308,90,113,152,19,170,0,3318
"37067003315",2811,298,357,13,57,10,138,0,3684
"37067003402",1802,330,51,0,51,132,140,165,2671
"37067003403",967,1087,549,399,134,377,309,1224,5046
"37067003404",877,723,1082,745,203,588,322,942,5482
"37067003500",2535,350,1454,619,372,164,1130,228,6852
"37067003600",3318,1394,1137,287,298,212,460,1173,8279
"37067003701",2353,1543,1290,350,223,134,874,1150,7917
"37067003702",2593,182,1286,145,152,80,410,0,4848
"37067003703",3653,231,1981,266,651,0,678,19,7479
"37067003803",3224,261,1389,194,115,0,211,63,5457
"37067003804",2226,243,1263,292,674,82,102,49,4931
"37067003805",2381,1060,1651,766,537,0,483,655,7533
"37067003806",2107,234,366,167,230,34,223,111,3472
"37067003903",1825,503,1187,177,300,393,334,369,5088
"37067003904",3928,440,717,210,1133,0,254,258,6940
"37067003905",2135,237,263,125,264,100,109,119,3352
"37067003906",3144,162,38,8,180,0,69,0,3601
"37067003908",2823,99,26,0,50,0,34,0,3032
"37067003909",3716,94,135,35,280,0,321,0,4581
"37067004005",4494,215,126,3,115,26,101,0,5080
"37067004007",6420,221,348,43,508,0,279,0,7819
"37067004009",3541,154,135,0,112,12,96,46,4096
"37067004010",2883,111,366,33,280,0,48,0,3721
"37067004011",4771,245,641,0,190,0,100,32,5979
"37067004012",3450,385,625,39,534,92,311,27,5463
"37067004013",2360,446,29,0,358,56,259,304,3812
"37067004014",2358,315,70,0,89,0,0,15,2847
"37067004015",3509,182,361,9,173,33,124,33,4424
"37067004102",2650,378,174,38,86,36,22,0,3384
"37067004103",3095,166,394,11,238,25,79,15,4023
"37067004104",2943,364,387,0,203,0,84,0,3981
"37069060100",2120,480,1370,415,35,70,13,254,4757
"37069060200",2065,317,397,218,233,347,302,379,4258
"37069060301",2110,227,1579,797,83,21,252,0,5069
"37069060302",489,199,900,423,0,105,0,77,2193
"37069060401",1409,229,398,146,202,83,297,77,2841
"37069060402",2028,628,1279,604,281,33,355,307,5515
"37069060501",4522,319,1263,41,405,3,441,3,6997
"37069060502",6277,440,1033,81,524,135,282,42,8814
"37069060600",6080,811,742,28,647,342,397,113,9160
"37069060700",3415,723,1458,142,181,0,45,171,6135
"37069060801",2168,265,726,309,158,42,412,218,4298
"37069060802",3513,504,637,76,281,0,437,8,5456
"37071030101",2766,316,204,24,159,75,60,0,3604
"37071030102",2420,353,831,36,147,27,14,59,3887
"37071030203",1889,331,51,14,33,28,0,0,2346
"37071030204",2194,206,270,0,22,71,213,71,3047
"37071030205",3250,513,10,12,60,9,0,0,3854
"37071030301",2255,435,33,13,47,44,19,63,2909
"37071030302",2171,698,13,4,61,9,12,0,2968
"37071030401",3534,344,15,17,104,143,73,112,4342
"37071030402",2910,530,283,8,113,0,137,0,3981
"37071030501",2172,209,38,0,171,0,109,0,2699
"37071030502",2548,442,168,213,61,42,74,30,3578
"37071030601",2346,349,89,21,173,0,143,0,3121
"37071030602",1479,263,92,14,89,13,85,0,2035
"37071030700",1840,198,590,11,197,0,46,0,2882
"37071030801",937,241,61,33,0,17,0,5,1294
"37071030802",2688,937,182,157,61,209,41,242,4517
"37071030901",1558,266,165,101,136,61,116,0,2403
"37071030902",1464,411,770,138,323,25,268,25,3424
"37071031001",2353,673,15,0,267,28,0,0,3336
"37071031003",3335,308,90,0,103,23,50,0,3909
"37071031004",1954,260,82,0,128,0,48,0,2472
"37071031101",1451,307,334,90,43,0,21,0,2246
"37071031102",1401,295,171,41,35,78,109,9,2139
"37071031201",2066,228,189,16,681,108,452,94,3834
"37071031202",1398,301,107,3,33,1,78,14,1935
"37071031301",2253,295,607,94,342,36,377,0,4004
"37071031302",2716,603,550,26,620,436,584,520,6055
"37071031401",1076,481,471,349,221,137,214,169,3118
"37071031402",2067,247,117,1,151,14,0,0,2597
"37071031500",1105,749,839,304,25,308,166,308,3804
"37071031600",2552,800,379,349,40,8,47,0,4175
"37071031701",2412,562,86,11,50,77,121,50,3369
"37071031703",1723,423,450,55,33,0,116,38,2838
"37071031704",2406,752,217,62,67,156,12,9,3681
"37071031800",1066,596,1131,269,327,201,436,281,4307
"37071031900",204,74,896,934,13,127,51,0,2299
"37071032000",555,257,653,623,96,14,101,0,2299
"37071032100",987,227,813,216,89,240,116,217,2905
"37071032200",2932,552,264,22,211,265,129,50,4425
"37071032301",1776,274,255,62,72,0,80,0,2519
"37071032302",1785,466,90,7,78,8,90,69,2593
"37071032401",3478,487,256,37,173,118,161,0,4710
"37071032402",3832,200,57,0,538,56,127,0,4810
"37071032502",2947,178,124,0,168,0,9,0,3426
"37071032505",1681,91,1435,204,447,13,171,10,4052
"37071032506",1331,59,607,135,566,28,467,0,3193
"37071032507",2668,106,274,148,685,82,531,115,4609
"37071032508",2175,88,88,2,59,20,45,0,2477
"37071032600",2965,197,563,1,288,27,155,0,4196
"37071032702",1253,147,224,0,197,31,89,1,1942
"37071032703",1245,157,263,119,91,6,16,0,1897
"37071032704",2775,131,836,358,218,35,202,46,4601
"37071032800",3328,564,834,874,166,354,105,150,6375
"37071032900",1828,687,907,456,34,24,46,0,3982
"37071033100",1242,240,505,115,260,231,246,258,3097
"37071033202",1508,215,86,33,229,231,199,0,2501
"37071033203",923,111,731,230,251,320,503,272,3341
"37071033204",1256,325,921,595,459,235,438,253,4482
"37071033303",2867,65,58,0,71,12,74,0,3147
"37071033304",3499,424,492,26,281,0,324,13,5059
"37071033305",3160,323,242,49,271,126,109,162,4442
"37071033306",1085,144,18,14,75,29,43,0,1408
"37071033307",1700,226,173,16,66,20,64,0,2265
"37071033400",1309,541,297,139,31,106,17,127,2567
"37071033500",3704,450,466,56,444,0,222,0,5342
"37073970100",2768,260,818,347,53,16,89,16,4367
"37073970200",2373,181,1203,294,67,5,113,0,4236
"37073970300",1701,213,909,335,120,0,0,0,3278
"37075920100",2091,378,7,0,3,17,4,0,2500
"37075920200",2131,693,0,0,92,0,0,0,2916
"37075920300",1692,618,28,4,658,174,81,42,3297
"37077970101",2281,471,1329,571,1,141,1,114,4909
"37077970102",2109,129,971,198,105,68,103,17,3700
"37077970200",2033,488,1214,363,233,6,263,302,4902
"37077970300",2170,255,576,451,23,94,35,110,3714
"37077970400",1083,52,1543,1125,55,141,62,6,4067
"37077970500",1526,136,1516,380,127,284,285,340,4594
"37077970601",4120,362,967,3,415,1,311,1,6180
"37077970602",5626,708,827,133,475,36,382,18,8205
"37077970603",4018,112,1346,381,352,0,200,0,6409
"37077970701",3535,366,816,72,423,31,393,21,5657
"37077970702",932,503,629,245,207,174,329,267,3286
"37077970703",1476,243,555,177,438,43,390,68,3390
"37077970704",0,0,0,0,0,0,0,0,0
"37079950101",1704,556,901,216,185,448,234,717,4961
"37079950102",1605,196,543,692,135,127,186,173,3657
"37079950200",2426,475,1139,195,251,329,402,399,5616
"37079950300",3200,823,2084,792,139,113,375,461,7987
"37081010100",204,121,877,452,140,17,71,7,1889
"37081010200",1529,369,1130,638,408,178,334,103,4689
"37081010300",439,103,743,212,667,406,248,120,2938
"37081010401",1320,103,7,4,91,54,19,0,1598
"37081010403",1269,78,126,79,88,1,45,1,1687
"37081010404",2184,77,98,0,90,198,32,0,2679
"37081010500",1912,228,37,71,61,0,26,0,2335
"37081010601",1807,522,87,251,210,56,93,148,3174
"37081010602",1869,1017,359,212,184,111,117,85,3954
"37081010701",1226,372,53,27,114,28,18,6,1844
"37081010702",645,580,14,44,77,42,29,62,1493
"37081010800",1344,199,188,212,21,21,50,20,2055
"37081010900",728,129,296,692,194,72,13,24,2148
"37081011000",0,58,725,512,46,7,46,58,1452
"37081011101",233,126,2329,1306,202,110,55,153,4514
"37081011102",8,10,2100,775,55,0,12,0,2960
"37081011200",412,339,1982,1539,105,122,0,9,4508
"37081011300",14,181,1934,850,125,5,26,148,3283
"37081011400",258,162,1343,2973,142,36,170,116,5200
"37081011500",797,390,531,432,121,6,168,161,2606
"37081011601",1010,220,813,143,273,80,278,25,2842
"37081011602",1243,262,834,456,302,348,819,319,4583
"37081011904",1070,226,2281,612,304,93,119,43,4748
"37081011905",1108,159,1711,1045,272,178,159,202,4834
"37081012503",3181,259,399,122,460,48,241,0,4710
"37081012504",1449,295,1084,495,233,76,480,126,4238
"37081012505",4083,67,104,37,242,0,166,0,4699
"37081012508",2695,203,182,43,171,0,47,0,3341
"37081012509",1982,49,148,0,120,14,19,14,2346
"37081012510",2734,77,158,17,165,10,41,0,3202
"37081012511",4636,85,135,10,80,38,20,38,5042
"37081012601",2709,354,1526,771,316,69,1160,162,7067
"37081012604",1188,183,2435,539,442,317,311,118,5533
"37081012607",1119,39,829,36,114,11,358,0,2506
"37081012608",746,298,784,280,508,146,877,339,3978
"37081012609",2484,321,2591,1306,1403,155,723,404,9387
"37081012610",752,180,998,445,746,209,266,153,3749
"37081012611",792,446,1665,560,385,51,437,346,4682
"37081012612",1278,162,3557,542,91,661,0,598,6889
"37081012617",682,144,1574,337,533,157,314,116,3857
"37081012703",2350,174,1352,405,318,45,92,0,4736
"37081012704",706,175,1228,406,531,540,149,454,4189
"37081012705",41,42,2012,1125,33,204,9,121,3587
"37081012706",104,105,1536,1192,216,56,26,98,3333
"37081012707",218,152,1199,628,16,169,200,262,2844
"37081012803",1898,813,3966,669,85,134,212,446,8223
"37081012804",279,203,2778,698,186,34,145,139,4462
"37081012805",289,157,1955,396,306,0,24,26,3153
"37081013601",277,31,416,319,25,10,27,4,1109
"37081013602",1326,400,1300,524,111,112,197,145,4115
"37081013700",2900,258,257,177,149,83,168,34,4026
"37081013800",659,208,1790,1063,296,257,385,264,4922
"37081013900",301,50,1036,2334,35,673,200,184,4813
"37081014000",1195,832,282,436,208,389,326,486,4154
"37081014200",384,537,1168,984,332,337,178,262,4182
"37081014300",553,479,531,568,570,219,346,345,3611
"37081014406",302,175,1445,174,253,0,193,22,2564
"37081014407",4202,495,364,665,650,17,687,0,7080
"37081014408",643,220,713,379,226,208,203,328,2920
"37081014409",2216,171,218,204,130,71,121,0,3131
"37081014410",1946,426,887,254,135,255,84,382,4369
"37081014411",1211,92,2141,603,434,194,643,32,5350
"37081014412",1573,140,476,32,104,21,219,0,2565
"37081014501",653,321,134,75,159,63,258,171,1834
"37081014502",1353,681,1080,281,712,693,448,191,5439
"37081014503",409,477,1231,678,426,494,139,294,4148
"37081015100",2778,551,616,37,328,0,323,0,4633
"37081015200",5771,422,1766,235,484,167,411,54,9310
"37081015300",4497,399,2762,304,367,33,309,19,8690
"37081015401",3165,146,1983,0,107,91,80,117,5689
"37081015402",2841,651,1910,1658,562,804,676,816,9918
"37081015500",1794,469,3200,569,488,101,454,0,7075
"37081015600",8224,442,682,2,403,300,380,285,10718
"37081015703",3890,270,1472,156,417,0,376,0,6581
"37081015704",3730,601,1245,329,600,40,227,76,6848
"37081015705",2059,248,591,142,155,7,46,0,3248
"37081015706",3589,200,1518,33,226,42,124,27,5759
"37081015707",5024,356,946,221,339,0,88,15,6989
"37081015800",7180,137,304,0,371,19,205,0,8216
"37081015901",3887,299,284,18,273,380,313,380,5834
"37081015902",3234,83,323,7,292,0,55,0,3994
"37081016003",3858,99,405,0,254,0,236,0,4852
"37081016005",1349,47,241,0,148,0,39,0,1824
"37081016006",2360,104,1025,64,266,0,277,0,4096
"37081016007",3475,205,870,230,334,79,161,42,5396
"37081016008",5600,331,537,2,488,78,377,0,7413
"37081016009",2585,74,840,64,234,32,70,14,3913
"37081016010",1737,149,172,66,443,0,434,0,3001
"37081016011",2431,277,1957,285,1035,0,455,0,6440
"37081016101",2999,336,378,150,157,20,58,20,4118
"37081016102",1602,343,1248,704,395,42,240,18,4592
"37081016103",2844,307,1063,421,351,78,525,39,5628
"37081016201",4833,200,131,0,611,0,411,10,6196
"37081016203",2693,177,575,0,406,47,54,24,3976
"37081016204",2446,71,281,14,519,12,59,0,3402
"37081016205",2443,171,474,90,628,138,162,28,4134
"37081016303",2791,119,224,167,167,0,133,0,3601
"37081016304",3054,40,174,5,288,153,164,153,4031
"37081016305",2244,90,611,53,338,8,31,0,3375
"37081016306",2599,176,1323,379,475,52,150,0,5154
"37081016405",611,94,835,134,103,7,29,7,1820
"37081016406",1832,137,1117,49,316,131,240,0,3822
"37081016407",3010,25,777,0,840,242,108,0,5002
"37081016408",1539,44,132,17,157,0,31,0,1920
"37081016409",2149,42,334,153,9,25,105,0,2817
"37081016410",2593,330,1971,435,593,347,192,0,6461
"37081016502",4390,238,808,192,284,23,349,46,6330
"37081016503",1954,153,1436,268,445,115,41,31,4443
"37081016505",3621,56,1580,191,381,9,72,0,5910
"37081016506",3139,246,861,18,346,33,261,29,4933
"37081016600",2025,79,64,35,399,0,161,0,2763
"37081016701",1677,445,2407,404,579,100,192,499,6303
"37081016702",2823,362,32,2,77,1,276,27,3600
"37081016800",3736,977,1498,236,231,138,392,391,7599
"37081016900",3392,258,169,10,107,8,54,0,3998
"37081017000",3848,303,162,5,147,0,143,17,4625
"37081017100",5167,447,769,55,424,15,187,55,7119
"37081017200",4233,589,1704,31,375,74,418,12,7436
"37081980100",0,0,0,0,0,0,0,0,0
"37083930100",755,212,1082,1141,9,0,6,11,3216
"37083930200",3720,81,823,211,141,0,175,0,5151
"37083930300",2711,715,907,646,155,26,122,2,5284
"37083930400",1691,171,739,571,111,72,25,72,3452
"37083930501",1479,414,1012,830,43,100,100,84,4062
"37083930502",2185,303,1707,603,48,320,35,18,5219
"37083930600",1117,224,1287,1150,124,16,99,0,4017
"37083930700",1822,226,1517,387,75,106,21,0,4154
"37083930800",477,96,1953,1084,1306,771,109,86,5882
"37083930900",506,63,2893,1392,54,91,0,0,4999
"37083931000",492,24,1216,404,163,0,6,1,2306
"37083931100",1309,142,2548,856,66,212,149,212,5494
"37085070100",2323,360,819,701,304,57,388,35,4987
"37085070200",1226,327,811,568,186,182,221,127,3648
"37085070300",2720,702,834,623,158,240,211,366,5854
"37085070401",2705,580,338,17,468,45,508,161,4822
"37085070402",4409,934,318,380,608,468,513,672,8302
"37085070500",4007,710,620,350,164,74,285,217,6427
"37085070600",1784,251,1709,323,177,83,205,0,4532
"37085070700",2167,296,988,549,153,47,178,32,4410
"37085070801",1418,298,82,112,223,111,166,236,2646
"37085070802",2064,477,316,109,254,80,198,1,3499
"37085070901",2008,67,464,90,152,7,399,7,3194
"37085070902",2098,212,168,14,182,0,292,53,3019
"37085070903",1777,406,154,56,94,205,229,334,3255
"37085070904",2060,257,585,29,234,108,303,140,3716
"37085071001",3900,622,675,99,132,0,316,161,5905
"37085071002",2856,250,8,72,273,157,348,130,4094
"37085071101",2375,498,172,183,395,229,442,384,4678
"37085071102",3060,306,731,250,147,174,194,128,4990
"37085071201",1341,271,361,123,209,123,179,83,2690
"37085071202",2038,606,1088,250,514,327,421,311,5555
"37085071203",914,250,361,227,279,16,111,73,2231
"37085071204",3727,600,737,199,553,66,586,119,6587
"37085071301",1771,446,560,80,174,328,214,84,3657
"37085071302",3327,243,1039,53,450,112,333,130,5687
"37085071303",5820,440,1848,195,1199,0,790,0,10292
"37085071401",2021,426,951,340,268,51,146,88,4291
"37085071402",4681,811,1599,716,1815,450,1564,404,12040
"37087920101",2912,847,0,0,30,0,78,51,3918
"37087920102",2969,661,0,0,47,11,0,45,3733
"37087920200",4938,771,1,1,113,0,360,0,6184
"37087920300",2551,533,165,0,122,229,53,6,3659
"37087920400",1955,179,8,0,16,0,120,0,2278
"37087920500",4517,1314,8,40,231,105,256,145,6616
"37087920600",3618,883,0,0,27,0,59,56,4643
"37087920700",2594,705,28,10,117,2,35,1,3492
"37087920800",2486,523,0,0,46,10,68,15,3148
"37087920900",1467,333,31,11,51,33,146,10,2082
"37087921000",2451,517,66,1,85,67,110,40,3337
"37087921100",2140,399,49,28,76,31,55,0,2778
"37087921200",4082,756,23,1,151,1,87,1,5102
"37087921301",3654,430,0,0,87,0,155,0,4326
"37087921302",4457,593,6,31,117,0,83,73,5360
"37087980100",0,0,0,0,0,0,0,0,0
"37089930100",3704,600,50,24,166,54,552,52,5202
"37089930200",5895,802,1,0,960,79,1178,189,9104
"37089930300",5158,414,125,0,94,391,944,323,7449
"37089930401",1772,701,72,0,72,317,157,640,3731
"37089930402",1788,809,65,0,53,59,134,487,3395
"37089930501",3327,530,134,16,518,40,507,207,5279
"37089930502",4478,234,185,105,244,0,81,0,5327
"37089930600",4446,301,34,1,137,1,140,19,5079
"37089930701",3328,157,36,43,16,9,35,0,3624
"37089930702",4121,251,0,0,318,0,72,0,4762
"37089930703",5031,311,0,0,92,0,0,80,5514
"37089930800",4518,419,183,0,45,0,199,0,5364
"37089930900",2691,234,49,8,488,59,597,27,4153
"37089931000",3504,1342,126,161,450,148,774,603,7108
"37089931100",940,464,260,399,192,41,50,162,2508
"37089931200",1003,453,256,145,159,295,98,200,2609
"37089931300",2412,526,151,10,204,0,337,208,3848
"37089931400",2381,1105,140,11,42,15,473,239,4406
"37089931500",3225,266,4,0,57,57,28,0,3637
"37089931600",4071,604,2,2,49,80,137,222,5167
"37089931700",2532,268,55,2,244,0,188,0,3289
"37089931801",2947,172,61,81,106,15,0,0,3382
"37089931802",3750,283,151,24,190,8,296,0,4702
"37089931901",2814,394,0,25,0,0,30,26,3289
"37089931902",2781,171,0,0,12,0,27,14,3005
"37089932000",3797,444,64,0,23,4,26,8,4366
"37089980100",0,0,0,0,0,0,0,0,0
"37091950100",1821,315,2254,1502,273,60,64,0,6289
"37091950200",1168,302,2135,832,229,62,25,20,4773
"37091950300",1581,167,1366,261,274,21,69,38,3777
"37091950401",1387,87,664,515,136,34,29,0,2852
"37091950402",983,125,1545,1076,116,116,33,128,4122
"37093970101",3411,640,2729,568,1018,266,840,382,9854
"37093970102",5223,938,3104,530,1550,348,1038,655,13386
"37093970103",4451,481,2113,267,746,432,804,394,9688
"37093970201",2035,419,977,365,607,107,349,72,4931
"37093970202",1534,291,1042,432,338,328,348,168,4481
"37093970300",1247,290,1568,1192,160,599,22,633,5711
"37093970401",1106,390,705,131,1200,504,96,18,4150
"37093970402",403,303,760,415,703,811,115,359,3869
"37093980100",0,0,0,0,0,0,0,0,0
"37095920100",2896,554,1212,336,24,0,150,128,5300
"37095990100",0,0,0,0,0,0,0,0,0
"37095990200",0,0,0,0,0,0,0,0,0
"37097060100",3118,678,764,413,74,145,638,69,5899
"37097060200",354,112,1007,660,14,170,177,137,2631
"37097060300",715,344,713,322,170,66,320,146,2796
"37097060400",1244,460,839,1207,361,157,213,282,4763
"37097060500",1920,356,876,550,158,184,369,239,4652
"37097060601",2220,373,1378,868,221,12,143,210,5425
"37097060602",1817,33,50,38,44,8,79,1,2070
"37097060603",1108,384,174,43,173,14,197,102,2195
"37097060701",2139,176,316,47,239,68,378,75,3438
"37097060702",2859,556,592,72,191,33,224,56,4583
"37097060703",2460,255,152,8,70,7,119,7,3078
"37097060801",2331,995,205,65,161,48,285,366,4456
"37097060802",2848,297,230,59,18,68,228,89,3837
"37097060901",2806,218,0,68,120,0,124,0,3336
"37097060902",3137,514,128,0,35,15,39,15,3883
"37097061001",3548,292,125,20,184,0,241,0,4410
"37097061002",3522,404,186,94,195,140,344,202,5087
"37097061003",2710,143,450,120,357,431,177,431,4819
"37097061101",2180,241,157,0,201,0,0,59,2838
"37097061102",2246,226,495,0,150,97,197,0,3411
"37097061103",2414,225,113,101,133,0,54,7,3047
"37097061104",1446,226,180,5,50,45,41,50,2043
"37097061201",2943,403,89,11,60,0,151,210,3867
"37097061202",3703,283,531,39,159,98,54,66,4933
"37097061203",2983,629,336,13,530,0,354,0,4845
"37097061204",2766,119,0,0,155,0,32,9,3081
"37097061205",3125,635,72,0,44,0,0,0,3876
"37097061301",1343,728,176,27,112,61,131,77,2655
"37097061302",2727,442,494,340,39,0,12,76,4130
"37097061303",4034,264,212,0,113,18,188,0,4829
"37097061304",3537,415,607,58,259,118,292,0,5286
"37097061401",3715,300,59,0,164,0,129,0,4367
"37097061402",4347,425,49,0,295,0,153,79,5348
"37097061403",2616,254,163,0,132,0,69,11,3245
"37097061404",1585,121,73,7,153,14,15,0,1968
"37097061405",3168,159,37,0,177,0,253,47,3841
"37097061406",4317,190,31,0,33,0,239,10,4820
"37097061407",3633,126,13,0,72,0,45,0,3889
"37097061408",3107,188,255,120,40,0,42,0,3752
"37097061501",2523,59,357,176,90,19,161,9,3394
"37097061502",3084,237,27,0,408,0,208,13,3977
"37097061503",3191,263,239,62,119,0,146,0,4020
"37097061601",1802,410,621,291,477,16,839,14,4470
"37097061602",4970,663,461,26,1159,0,436,63,7778
"37099940200",2068,511,58,12,2614,990,136,84,6473
"37099950200",1343,265,0,0,153,8,19,13,1801
"37099950300",4399,665,69,66,192,84,126,5,5606
"37099950400",3420,612,107,5,179,115,155,83,4676
"37099950500",4170,657,0,334,205,0,0,292,5658
"37099950600",3498,1795,49,89,33,260,0,414,6138
"37099950700",2026,688,27,0,34,34,21,175,3005
"37099950800",1789,410,0,0,95,181,137,209,2821
"37099950900",2232,340,0,0,145,18,145,0,2880
"37101040100",3979,1201,691,155,105,10,232,171,6544
"37101040201",3276,1105,996,573,47,36,354,781,7168
"37101040202",4821,966,634,0,314,44,500,563,7842
"37101040203",12161,316,812,0,1055,0,1532,91,15967
"37101040301",1641,476,283,430,333,572,609,849,5193
"37101040302",2063,1063,1478,151,779,279,954,1064,7831
"37101040400",3129,612,258,178,131,127,386,409,5230
"37101040500",5039,910,251,384,62,72,194,87,6999
"37101040600",1690,612,620,338,325,79,305,291,4260
"37101040700",1608,363,643,208,367,72,58,64,3383
"37101040800",2260,478,229,442,53,245,78,500,4285
"37101040901",7676,892,1196,573,513,142,1451,363,12806
"37101040902",5013,412,976,793,474,0,427,306,8401
"37101041001",4437,524,2204,244,498,133,878,297,9215
"37101041002",5811,456,1848,99,278,109,423,56,9080
"37101041101",5552,629,1115,280,336,133,453,314,8812
"37101041102",8000,572,1419,154,610,45,565,95,11460
"37101041103",10661,565,1437,168,138,0,1028,0,13997
"37101041201",2552,695,265,254,136,126,239,551,4818
"37101041202",3457,1274,218,148,152,137,726,972,7084
"37101041300",3768,1127,392,200,412,21,376,456,6752
"37101041400",4589,669,688,183,129,586,196,1006,8046
"37101041501",5140,321,522,29,159,319,182,164,6836
"37101041502",6616,361,639,0,258,191,827,137,9029
"37101041503",6323,887,259,8,299,130,750,64,8720
"37103920100",1808,264,1159,494,79,22,75,25,3926
"37103920200",1466,365,613,375,53,29,45,171,3117
"37103920300",2225,466,418,147,122,11,107,0,3496
"37105030101",2554,444,425,136,369,17,425,88,4458
"37105030102",4743,64,281,2,548,41,480,0,6159
"37105030200",1015,1179,737,446,626,180,1073,795,6051
"37105030300",606,109,924,847,55,111,385,74,3111
"37105030401",1749,374,961,266,234,416,884,691,5575
"37105030402",2820,764,1391,496,983,293,1614,558,8919
"37105030501",2744,303,137,2,323,70,392,39,4010
"37105030502",1569,454,285,45,254,101,760,310,3778
"37105030503",4331,784,989,87,277,537,720,723,8448
"37105030601",2882,28,299,66,99,0,0,0,3374
"37105030602",3715,259,543,123,320,158,265,172,5555
"37105030701",3105,431,892,165,379,117,280,215,5584
"37105030702",2926,492,231,63,357,63,334,90,4556
"37107010100",1688,210,1767,618,0,52,32,52,4419
"37107010200",92,0,1567,1046,10,41,0,0,2756
"37107010300",4,0,459,1194,38,49,0,14,1758
"37107010400",0,48,295,376,0,0,0,62,781
"37107010500",125,291,1998,1455,14,91,1,232,4207
"37107010600",1422,208,1284,190,104,7,5,33,3253
"37107010700",620,209,470,658,112,48,103,32,2252
"37107010800",2112,322,1616,437,182,12,81,105,4867
"37107010900",1335,271,1080,366,319,90,84,244,3789
"37107011001",2926,306,647,300,183,96,145,27,4630
"37107011002",2762,249,334,176,225,58,348,8,4160
"37107011100",2713,459,1681,396,109,0,121,0,5479
"37107011200",4911,696,946,420,176,361,363,920,8793
"37107011300",3381,436,989,46,80,0,516,300,5748
"37107011400",3192,978,346,29,31,106,99,222,5003
"37109070100",2623,1015,284,390,181,52,330,133,5008
"37109070201",2400,700,363,485,368,101,533,670,5620
"37109070202",2760,303,119,14,243,0,132,0,3571
"37109070300",2935,457,126,12,187,109,321,214,4361
"37109070400",4605,1161,118,43,399,0,442,54,6822
"37109070500",4099,582,5,0,71,24,124,0,4905
"37109070600",3402,839,26,60,99,218,43,233,4920
"37109070700",2783,227,0,1,96,0,104,0,3211
"37109070800",3954,795,729,244,173,597,641,244,7377
"37109070901",2408,556,0,9,38,25,45,43,3124
"37109070902",4998,624,244,42,670,0,373,28,6979
"37109071001",3632,791,321,69,96,18,115,0,5042
"37109071002",1714,461,112,92,70,0,9,119,2577
"37109071101",5047,400,78,18,28,28,378,0,5977
"37109071102",4956,297,22,29,102,0,6,0,5412
"37109071201",1728,38,23,0,25,0,8,0,1822
"37109071202",2987,238,17,0,108,0,56,89,3495
"37109071203",3852,69,0,2,95,8,96,13,4135
"37111970100",3859,815,4,9,324,0,359,161,5531
"37111970200",3910,921,124,2,116,138,328,179,5718
"37111970300",2143,344,175,143,378,142,159,136,3620
"37111970400",1748,907,60,10,128,460,97,460,3870
"37111970500",2934,673,295,66,62,158,60,0,4248
"37111970600",2887,239,97,71,147,9,136,0,3586
"37111970700",3681,731,158,22,95,169,140,189,5185
"37111970800",2883,752,0,35,47,28,0,0,3745
"37111970901",4800,1124,4,98,19,10,0,0,6055
"37111970902",3972,809,51,2,0,10,32,48,4924
"37113970100",2355,370,0,0,71,23,115,28,2962
"37113970200",2966,553,0,23,2,80,2,74,3700
"37113970301",2190,911,128,20,230,498,251,543,4771
"37113970302",2801,775,3,58,101,199,93,148,4178
"37113970400",2943,614,14,0,131,120,22,138,3982
"37113970501",1228,69,9,0,26,0,15,0,1347
"37113970502",1867,198,1,6,55,10,0,2,2139
"37113970600",4381,831,0,0,425,0,375,0,6012
"37113970700",4914,1011,60,0,260,32,438,6,6721
"37115010100",2250,455,0,3,2,6,39,20,2775
"37115010200",1601,465,24,0,49,93,17,102,2351
"37115010400",1416,163,0,0,83,6,0,0,1668
"37115010500",3852,881,10,9,83,36,73,36,4980
"37115010600",4520,817,14,65,71,9,43,41,5580
"37115010700",2365,579,26,0,0,29,104,0,3103
"37117970100",2412,623,998,253,86,231,150,210,4963
"37117970200",1406,225,1348,616,162,0,121,0,3878
"37117970300",1501,141,1763,423,42,29,0,84,3983
"37117970400",963,189,1133,444,98,2,54,2,2885
"37117970500",3246,863,989,279,0,10,89,10,5486
"37117970600",790,217,1565,417,31,45,48,72,3185
"37119000100",3050,333,244,16,355,44,223,0,4265
"37119000300",313,53,33,94,37,0,4,0,534
"37119000400",1588,180,237,179,173,15,43,9,2424
"37119000500",2416,417,559,461,361,0,124,33,4371
"37119000600",1320,182,826,339,101,0,66,20,2854
"37119000700",298,17,291,105,4,15,20,12,762
"37119000800",166,97,1322,781,61,75,21,7,2530
"37119000900",425,43,774,454,37,0,52,0,1785
"37119001000",1951,179,183,41,172,0,115,0,2641
"37119001100",1756,131,142,9,116,4,37,0,2195
"37119001200",2800,388,724,456,401,544,537,740,6590
"37119001300",1384,301,852,727,292,235,295,27,4113
"37119001400",1586,164,314,363,106,115,224,90,2962
"37119001504",808,60,2752,2166,1321,276,1359,249,8991
"37119001505",1144,154,1338,39,341,373,386,363,4138
"37119001507",733,270,1312,874,617,272,1174,637,5889
"37119001508",2146,251,2434,426,593,93,718,198,6859
"37119001509",304,23,1695,333,426,417,582,155,3935
"37119001510",297,216,1826,255,327,33,256,55,3265
"37119001603",1917,586,1017,344,355,354,818,659,6050
"37119001605",561,192,432,94,369,420,422,333,2823
"37119001606",1548,303,772,424,803,443,1015,403,5711
"37119001607",858,423,858,341,506,219,643,435,4283
"37119001608",747,211,1068,447,838,461,828,493,5093
"37119001609",677,158,1024,353,525,235,510,294,3776
"37119001701",1237,342,748,395,805,814,680,179,5200
"37119001702",1593,885,879,612,1162,432,818,902,7283
"37119001801",789,19,173,184,97,45,170,0,1477
"37119001802",1368,184,615,115,234,223,16,78,2833
"37119001910",1490,790,1522,713,836,353,1492,1137,8333
"37119001911",1960,381,2117,575,879,237,891,319,7359
"37119001912",1082,1184,2179,870,896,663,837,1449,9160
"37119001914",1482,207,636,278,787,445,959,416,5210
"37119001915",2322,525,1845,968,536,455,1161,614,8426
"37119001916",1140,95,1421,297,485,113,528,125,4204
"37119001917",1762,689,708,249,496,555,681,980,6120
"37119001918",1072,345,1513,555,105,62,131,216,3999
"37119001919",1150,341,1217,822,492,416,396,474,5308
"37119001920",945,391,1461,779,821,176,635,443,5651
"37119001921",843,124,674,352,368,39,455,63,2918
"37119001922",897,631,1777,469,982,94,771,565,6186
"37119001923",914,209,1337,903,566,504,721,550,5704
"37119002002",4848,520,548,25,432,15,109,28,6525
"37119002003",4488,245,266,300,129,104,143,46,5721
"37119002004",3234,483,897,12,178,95,440,300,5639
"37119002100",1214,361,690,150,42,65,123,160,2805
"37119002200",4121,201,130,18,275,1,101,1,4848
"37119002300",152,167,994,1622,45,52,34,110,3176
"37119002400",2323,373,195,85,168,0,0,22,3166
"37119002500",1351,155,130,14,104,10,70,0,1834
"37119002600",476,78,163,89,106,0,41,25,978
"37119002701",1989,89,5,0,16,0,95,0,2194
"37119002702",4879,214,111,0,112,0,35,20,5371
"37119002800",3531,32,11,40,131,6,21,0,3772
"37119002903",3218,109,103,108,109,7,71,0,3725
"37119002904",5040,349,645,125,485,50,56,158,6908
"37119002905",2791,98,53,6,166,1,85,0,3200
"37119002906",3449,393,87,61,306,24,31,8,4359
"37119003006",3769,174,67,23,252,24,81,11,4401
"37119003007",5672,200,741,213,289,0,150,0,7265
"37119003008",4157,117,303,16,1035,0,403,12,6043
"37119003011",5357,193,77,15,165,110,352,0,6269
"37119003012",4009,190,48,0,346,0,767,83,5443
"37119003013",4678,184,397,0,267,0,232,60,5818
"37119003015",3783,162,163,21,275,0,324,7,4735
"37119003016",3525,134,485,10,350,9,246,11,4770
"37119003017",2680,146,187,226,145,18,78,6,3486
"37119003018",2091,118,176,3,358,8,211,8,2973
"37119003102",2608,477,267,59,542,376,539,613,5481
"37119003103",3453,361,351,199,430,100,378,116,5388
"37119003105",3487,24,95,21,93,0,169,0,3889
"37119003106",2068,627,296,74,224,143,705,724,4861
"37119003108",1225,420,710,356,150,240,442,527,4070
"37119003109",1223,352,1063,471,503,195,1051,392,5250
"37119003201",1437,612,59,158,315,0,594,547,3722
"37119003203",1359,650,409,90,228,72,195,377,3380
"37119003204",2669,126,207,92,208,188,54,0,3544
"37119003300",1918,327,276,182,125,168,73,153,3222
"37119003400",4368,247,17,5,131,0,28,0,4796
"37119003500",2259,60,45,12,134,0,78,0,2588
"37119003600",735,176,1716,1020,120,0,19,158,3944
"37119003700",767,38,613,1202,321,0,242,0,3183
"37119003802",182,346,1906,1057,14,41,90,347,3983
"37119003805",450,113,200,216,1016,19,34,10,2058
"37119003806",3189,623,3226,710,1842,389,2418,775,13172
"37119003807",722,597,1733,565,445,489,810,914,6275
"37119003808",2086,1104,1298,508,754,302,2380,1360,9792
"37119003902",47,5,2611,1570,500,247,33,71,5084
"37119003903",104,92,317,960,27,108,62,137,1807
"37119004000",962,226,2307,806,62,0,168,37,4568
"37119004100",1177,126,1371,566,210,41,9,26,3526
"37119004200",334,39,1383,1205,74,168,0,30,3233
"37119004302",1040,316,1870,1196,238,51,274,260,5245
"37119004303",786,102,1021,460,283,17,220,143,3032
"37119004304",724,60,2025,421,419,10,15,50,3724
"37119004305",1172,98,2102,824,1193,168,1221,225,7003
"37119004400",552,138,3261,394,662,73,540,49,5669
"37119004500",136,90,1489,1149,374,9,30,0,3277
"37119004600",56,58,2067,1136,11,67,0,0,3395
"37119004700",59,29,455,504,8,0,0,15,1070
"37119004800",105,122,2124,808,128,6,109,117,3519
"37119004900",13,21,426,119,8,6,0,0,593
"37119005000",83,3,872,689,2,25,2,55,1731
"37119005100",20,99,1183,987,218,32,20,12,2571
"37119005200",176,182,1051,1012,15,49,87,86,2658
"37119005301",619,281,1163,962,642,401,763,511,5342
"37119005305",224,415,2689,1066,455,0,488,290,5627
"37119005306",326,44,934,494,290,151,502,158,2899
"37119005307",466,296,1334,681,387,144,816,334,4458
"37119005308",668,577,533,632,431,244,998,711,4794
"37119005401",741,0,4559,1522,215,196,419,0,7652
"37119005403",1073,156,1941,644,451,114,841,50,5270
"37119005404",930,436,2353,903,229,0,314,394,5559
"37119005508",2594,340,1117,117,211,0,188,7,4574
"37119005509",2647,192,1942,0,377,71,618,0,5847
"37119005510",1264,781,2896,549,322,6,683,699,7200
"37119005511",1409,86,1961,98,666,64,404,24,4712
"37119005512",1098,152,2741,528,216,127,397,112,5371
"37119005513",1991,38,1475,62,426,108,236,13,4349
"37119005514",3317,341,2676,165,430,54,241,187,7411
"37119005515",1588,109,408,77,226,23,68,23,2522
"37119005516",1394,18,151,7,264,4,86,4,1928
"37119005517",2849,51,1481,8,180,0,255,0,4824
"37119005518",2539,55,1751,72,770,5,536,0,5728
"37119005519",2705,157,1833,61,366,0,333,58,5513
"37119005520",1377,134,1789,93,1050,81,533,0,5057
"37119005521",2071,658,3314,300,953,355,463,88,8202
"37119005522",1088,150,2002,287,900,0,256,0,4683
"37119005523",1162,367,1027,212,1327,569,132,0,4796
"37119005524",1670,170,3740,781,1820,203,967,32,9383
"37119005604",346,563,101,155,150,266,49,65,1695
"37119005605",1385,1025,2110,392,208,415,224,172,5931
"37119005609",413,1052,851,446,272,590,185,99,3908
"37119005610",1011,315,1231,610,527,162,134,80,4070
"37119005611",986,232,1004,225,202,28,190,26,2893
"37119005612",1209,208,2146,59,920,221,639,174,5576
"37119005613",487,71,882,290,267,0,331,21,2349
"37119005614",2012,171,3696,102,550,0,690,141,7362
"37119005615",496,21,490,61,90,44,54,44,1300
"37119005616",545,174,571,28,597,60,689,106,2770
"37119005617",398,0,909,196,306,154,111,122,2196
"37119005618",1725,81,1692,0,170,0,165,36,3869
"37119005619",1607,116,1607,315,516,40,609,10,4820
"37119005620",2425,223,2982,567,664,154,833,137,7985
"37119005621",2066,158,1513,218,358,231,339,133,5016
"37119005706",4476,645,871,12,719,35,756,259,7773
"37119005709",3025,144,518,29,351,0,306,23,4396
"37119005710",1107,382,1473,201,848,89,620,48,4768
"37119005711",4960,776,392,94,140,172,104,166,6804
"37119005712",3247,111,314,11,215,5,201,0,4104
"37119005713",3367,57,172,0,289,0,200,0,4085
"37119005714",3992,292,482,0,320,21,268,0,5375
"37119005715",2314,155,89,0,58,10,114,34,2774
"37119005716",2085,52,1153,147,630,181,757,213,5218
"37119005717",3020,365,1902,299,679,179,560,71,7075
"37119005811",3400,114,251,50,197,0,166,46,4224
"37119005812",3892,564,1337,110,609,108,244,111,6975
"37119005815",3002,59,323,62,300,24,206,10,3986
"37119005816",3371,85,277,0,389,66,244,0,4432
"37119005817",3425,131,182,18,413,0,350,0,4519
"37119005823",6748,62,394,19,910,0,284,5,8422
"37119005824",1225,436,1151,306,119,90,805,514,4646
"37119005825",2480,628,968,585,268,20,665,142,5756
"37119005826",1987,151,221,82,314,152,610,98,3615
"37119005827",1057,249,1363,163,163,0,583,0,3578
"37119005828",3673,194,97,9,73,0,45,0,4091
"37119005829",1199,140,593,174,105,29,246,0,2486
"37119005830",2826,197,174,101,164,40,556,54,4112
"37119005831",3629,182,934,17,259,45,190,0,5256
"37119005832",2261,112,131,29,354,37,208,0,3132
"37119005833",4241,226,97,0,178,0,35,0,4777
"37119005834",2814,329,508,101,562,94,208,7,4623
"37119005835",2424,88,68,9,230,14,60,14,2907
"37119005836",2990,325,459,7,291,0,825,83,4980
"37119005837",4937,88,198,62,1462,93,826,13,7679
"37119005838",4919,326,729,0,1928,0,543,262,8707
"37119005839",2035,193,182,0,334,0,62,31,2837
"37119005840",2019,32,120,0,327,0,111,0,2609
"37119005841",4828,301,421,0,705,80,438,246,7019
"37119005842",4800,111,451,0,1307,0,301,45,7015
"37119005843",2300,54,195,41,593,0,147,0,3330
"37119005844",5832,137,465,0,1565,11,306,31,8347
"37119005845",2663,29,271,0,1398,25,175,0,4561
"37119005846",3188,90,210,0,401,26,7,17,3939
"37119005847",3403,132,209,0,465,260,244,52,4765
"37119005848",4687,19,415,0,427,29,189,9,5775
"37119005906",2038,603,463,329,255,289,513,352,4842
"37119005907",2754,47,1364,39,745,56,701,95,5801
"37119005908",1140,46,197,0,107,0,0,0,1490
"37119005909",2754,120,2529,559,1354,315,1585,206,9422
"37119005910",2465,135,1758,90,782,14,938,28,6210
"37119005911",3060,437,1021,10,495,70,288,6,5387
"37119005912",1907,381,1653,182,650,178,722,460,6133
"37119005913",3113,204,1743,255,1163,140,1639,98,8355
"37119005914",2704,234,1855,50,684,381,863,390,7161
"37119005915",946,39,729,100,291,47,250,6,2408
"37119005916",514,91,754,433,236,150,367,158,2703
"37119005917",3438,66,1719,163,525,0,829,99,6839
"37119005918",1851,155,1005,20,477,218,540,143,4409
"37119006005",1190,100,1083,12,129,203,134,155,3006
"37119006006",2532,791,1918,335,789,91,1196,56,7708
"37119006007",3076,155,2785,405,782,29,511,10,7753
"37119006008",1798,79,1473,212,250,0,192,0,4004
"37119006009",1221,63,1022,217,155,9,49,0,2736
"37119006010",2326,107,3170,806,128,414,473,432,7856
"37119006103",2443,62,881,124,224,0,196,0,3930
"37119006104",3440,411,3996,784,631,0,113,0,9375
"37119006105",1318,73,1226,236,258,17,302,17,3447
"37119006106",1990,61,1431,8,133,20,288,0,3931
"37119006107",1912,134,1618,234,725,211,364,216,5414
"37119006108",1005,37,2559,267,652,28,365,14,4927
"37119006109",247,21,1724,675,98,0,294,0,3059
"37119006203",4538,145,186,26,18,0,28,0,4941
"37119006204",6914,82,74,0,140,40,364,0,7614
"37119006208",2106,113,426,0,129,0,161,12,2947
"37119006209",3181,283,259,0,170,0,212,35,4140
"37119006210",3816,19,227,33,211,41,47,0,4394
"37119006211",5187,99,377,49,315,21,132,33,6213
"37119006212",2319,159,388,0,420,0,167,6,3459
"37119006213",4957,140,444,41,462,95,175,24,6338
"37119006214",3738,106,491,0,105,0,166,0,4606
"37119006215",3254,372,756,26,99,58,465,162,5192
"37119006302",4969,161,1185,25,557,1,558,4,7460
"37119006303",4045,492,408,98,240,0,225,0,5508
"37119006304",4993,459,284,0,419,10,372,110,6647
"37119006403",3028,362,546,71,205,10,380,113,4715
"37119006404",4833,111,120,0,206,0,394,0,5664
"37119006405",2490,295,220,10,354,19,113,21,3522
"37119006406",5115,474,317,109,306,17,549,306,7193
"37119006407",3225,42,308,28,164,233,92,0,4092
"37119980100",0,0,0,0,0,0,0,0,0
"37119980200",0,0,0,0,0,0,0,0,0
"37119980300",0,0,0,0,0,0,0,0,0
"37121950100",1922,342,0,0,17,3,17,0,2301
"37121950200",2990,853,0,8,36,23,56,35,4001
"37121950300",3088,1050,0,7,45,100,161,212,4663
"37121950400",3930,384,0,5,18,135,88,106,4666
"37123960100",4773,609,247,299,165,106,1382,326,7907
"37123960200",3843,1248,581,786,53,157,204,125,6997
"37123960300",3442,446,0,0,5,23,14,23,3953
"37123960401",810,131,787,283,70,28,0,0,2109
"37123960402",1246,253,291,301,281,5,164,0,2541
"37123960500",2646,1499,632,466,163,76,1031,821,7334
"37125950100",2316,731,58,70,56,0,33,219,3483
"37125950200",5511,1504,90,94,343,12,870,745,9169
"37125950301",4456,369,546,136,118,137,279,37,6078
"37125950302",4615,134,260,52,193,3,54,3,5314
"37125950401",2771,491,101,41,39,16,61,50,3570
"37125950402",3119,653,699,343,65,44,179,11,5113
"37125950501",3903,941,287,230,322,197,74,280,6234
"37125950502",6077,736,232,227,360,41,229,404,8306
"37125950601",3350,65,153,0,10,0,28,0,3606
"37125950602",5463,138,486,552,166,113,465,80,7463
"37125950701",3866,111,125,298,80,0,119,0,4599
"37125950702",2085,61,106,0,76,0,51,0,2379
"37125950801",2014,272,1329,849,170,159,132,0,4925
"37125950802",3114,132,93,121,19,113,10,113,3715
"37125950900",1511,263,326,113,12,61,104,50,2440
"37125951000",4364,412,83,41,126,0,74,0,5100
"37125951100",5453,600,1540,77,294,593,307,43,8907
"37125951200",2758,769,912,540,332,153,360,235,6059
"37127010200",647,150,2373,1697,134,0,89,0,5090
"37127010300",2163,185,2633,787,323,52,247,0,6390
"37127010400",597,56,1512,641,155,21,25,73,3080
"37127010502",2978,334,2315,910,536,24,156,0,7253
"37127010503",1484,118,799,191,316,41,226,41,3216
"37127010504",3452,344,1387,1055,172,0,67,82,6559
"37127010601",1158,61,866,128,302,97,120,0,2732
"37127010602",1912,356,1792,554,243,213,352,312,5734
"37127010700",888,80,1262,191,144,2,86,0,2653
"37127010800",5126,322,1316,268,21,31,57,13,7154
"37127010900",2547,357,1609,551,393,29,60,112,5658
"37127011000",2081,258,1257,582,163,171,226,157,4895
"37127011101",3097,246,1896,165,182,60,226,58,5930
"37127011102",3619,912,1012,908,132,45,9,22,6659
"37127011200",4391,421,926,337,451,0,246,0,6772
"37127011300",3435,217,357,159,573,387,874,326,6328
"37127011400",2433,126,713,364,522,263,682,232,5335
"37127011500",3255,876,910,615,389,183,638,212,7078
"37129010100",776,64,723,544,20,18,0,0,2145
"37129010200",1319,348,1044,822,148,11,115,32,3839
"37129010300",1864,534,1688,981,94,0,89,0,5250
"37129010400",2398,249,154,68,55,10,63,0,2997
"37129010501",1882,1117,770,628,177,48,374,495,5491
"37129010502",3631,2226,770,748,213,581,160,174,8503
"37129010600",3521,225,132,44,0,29,14,0,3965
"37129010700",1590,497,1062,606,254,100,42,100,4251
"37129010800",1047,722,187,117,162,262,383,571,3451
"37129010900",1666,281,265,33,92,25,160,0,2522
"37129011000",915,267,389,769,8,112,31,50,2541
"37129011100",122,35,1220,998,40,36,14,0,2465
"37129011200",976,257,397,254,30,12,39,11,1976
"37129011300",945,306,40,209,89,64,15,63,1731
"37129011400",214,139,756,541,30,37,17,48,1782
"37129011500",4933,1305,1219,159,414,76,289,747,9142
"37129011603",4770,696,1096,136,201,77,146,16,7138
"37129011605",3453,509,675,122,269,16,477,0,5521
"37129011606",3584,432,593,34,114,27,348,190,5322
"37129011607",8588,634,1157,37,420,24,508,33,11401
"37129011608",5153,223,776,35,273,0,82,0,6542
"37129011701",4053,770,0,0,172,0,229,137,5361
"37129011703",3581,309,15,0,123,0,0,165,4193
"37129011705",6740,787,114,1,248,9,205,24,8128
"37129011800",2015,457,0,0,26,0,15,13,2526
"37129011902",3892,1860,462,15,70,29,328,153,6809
"37129011903",2379,1802,141,535,54,92,246,0,5249
"37129011904",1638,90,109,0,61,0,0,0,1898
"37129012001",5800,376,347,21,120,155,778,179,7776
"37129012004",3312,254,32,0,192,0,0,32,3822
"37129012006",2995,504,260,12,231,0,32,0,4034
"37129012007",3636,388,33,29,133,17,186,58,4480
"37129012008",3955,583,445,139,186,189,296,0,5793
"37129012009",6005,307,376,14,240,15,67,106,7130
"37129012010",4550,294,154,22,218,0,78,6,5322
"37129012101",5334,1304,667,130,767,261,357,353,9173
"37129012103",3683,181,146,0,54,0,133,0,4197
"37129012104",4401,663,372,3,140,35,261,72,5947
"37129012105",8940,1284,691,640,418,256,361,206,12796
"37129012201",2414,420,0,0,39,0,54,8,2935
"37129012202",2519,236,52,80,172,0,60,0,3119
"37129012203",2065,173,10,0,20,18,16,0,2302
"37129012300",6234,403,382,39,88,0,173,0,7319
"37129980100",0,0,0,0,0,0,0,0,0
"37129990100",0,0,0,0,0,0,0,0,0
"37131920100",2807,273,991,786,80,31,128,12,5108
"37131920200",1181,412,1398,1133,50,80,5,4,4263
"37131920300",983,89,2669,1372,4,236,20,0,5373
"37131920401",1035,172,2052,724,9,95,88,107,4282
"37131920402",896,159,266,92,23,4,0,8,1448
"37133000102",7505,912,174,183,317,52,544,72,9759
"37133000103",4369,482,576,240,500,16,350,7,6540
"37133000201",7533,658,779,544,787,488,1385,464,12638
"37133000202",7120,925,737,24,440,133,799,145,10323
"37133000301",4239,648,421,233,402,217,257,0,6417
"37133000302",6280,1092,939,367,359,93,625,104,9859
"37133000401",5263,657,162,12,175,61,271,28,6629
"37133000402",5367,1119,58,70,115,175,218,185,7307
"37133000403",1206,150,27,11,54,0,24,28,1500
"37133000500",0,0,0,0,0,0,0,0,0
"37133000600",0,0,0,0,0,0,0,0,0
"37133000700",4232,406,1393,40,1143,118,1033,78,8443
"37133000800",772,81,148,28,61,0,77,0,1167
"37133000900",3295,439,451,219,738,190,925,149,6406
"37133001000",482,165,18,33,107,45,160,19,1029
"37133001101",3219,786,307,265,363,78,230,76,5324
"37133001102",2786,251,590,209,115,4,400,22,4377
"37133001200",6485,871,2027,470,592,352,775,178,11750
"37133001300",8482,936,3669,393,1349,447,2042,503,17821
"37133001400",3816,195,429,215,481,11,504,30,5681
"37133001500",1468,135,480,374,211,113,270,65,3116
"37133001700",1617,92,457,143,177,54,246,47,2833
"37133001800",1004,174,157,119,145,0,149,0,1748
"37133002100",3831,339,1209,296,848,39,843,121,7526
"37133002201",3340,258,791,62,730,1,675,12,5869
"37133002202",2017,588,996,252,458,191,554,309,5365
"37133002300",2404,407,1012,121,582,43,515,27,5111
"37133002400",3328,514,1097,388,866,289,687,325,7494
"37133002500",1769,629,92,111,298,171,228,86,3384
"37133002600",1038,294,880,869,284,86,260,45,3756
"37133002800",7285,803,279,105,827,47,914,140,10400
"37133990100",0,0,0,0,0,0,0,0,0
"37135010701",1195,131,405,156,131,11,115,75,2219
"37135010703",2980,699,482,152,1523,596,1192,403,8027
"37135010704",3574,435,475,60,824,350,589,299,6606
"37135010705",2955,566,560,140,393,14,342,220,5190
"37135010706",3047,72,0,1,332,42,90,9,3593
"37135010801",3124,410,1009,122,166,55,180,33,5099
"37135010802",3837,197,457,46,83,0,98,0,4718
"37135010901",4657,545,393,19,200,274,482,424,6994
"37135010902",2957,524,352,0,407,143,552,288,5223
"37135011000",5307,378,634,158,268,56,196,49,7046
"37135011101",4859,211,1892,856,552,54,719,26,9169
"37135011102",4269,432,615,379,313,40,226,292,6566
"37135011202",5570,417,547,39,609,299,272,157,7910
"37135011203",4580,350,410,169,85,21,181,0,5796
"37135011204",2415,203,249,0,395,179,196,249,3886
"37135011205",4025,259,414,324,2439,67,659,86,8273
"37135011300",795,1470,244,277,243,90,8,49,3176
"37135011400",1654,1513,48,78,171,172,72,31,3739
"37135011500",1369,233,61,20,163,29,154,11,2040
"37135011601",0,10,0,90,0,0,0,0,100
"37135011602",233,252,8,28,370,138,13,11,1053
"37135011700",1368,1134,158,22,300,91,40,18,3131
"37135011800",1885,675,149,342,231,208,168,43,3701
"37135011901",3164,609,511,318,734,15,162,123,5636
"37135011902",2663,140,299,0,478,65,107,32,3784
"37135012100",4723,682,490,204,1026,155,293,46,7619
"37135012201",2175,111,61,0,239,80,72,49,2787
"37135012202",4152,282,106,52,861,0,417,65,5935
"37137950101",2201,470,233,19,122,102,9,0,3156
"37137950102",1377,252,840,304,121,5,119,0,3018
"37137950201",2908,123,446,129,286,27,260,8,4187
"37137950202",1854,232,218,11,26,0,0,0,2341
"37137990100",0,0,0,0,0,0,0,0,0
"37139960100",535,275,484,165,40,0,133,53,1685
"37139960200",1847,114,676,684,66,0,8,0,3395
"37139960300",282,202,1176,1159,66,81,191,81,3238
"37139960400",1410,432,1202,779,28,7,42,174,4074
"37139960501",2034,114,425,212,53,0,44,0,2882
"37139960502",2892,290,658,24,303,0,152,16,4335
"37139960503",1186,664,780,71,0,55,56,0,2812
"37139960600",3895,509,2269,70,260,197,74,0,7274
"37139960701",3178,539,1432,362,368,62,275,443,6659
"37139960702",2439,91,420,22,53,76,27,0,3128
"37141920101",332,16,0,0,7,1,2,1,359
"37141920102",870,154,0,0,91,31,68,12,1226
"37141920103",4098,579,164,0,138,239,91,28,5337
"37141920201",4572,449,113,2,101,0,106,3,5346
"37141920202",5911,998,54,0,94,12,184,0,7253
"37141920203",3235,289,387,71,77,258,19,200,4536
"37141920204",760,196,365,275,13,40,13,4,1666
"37141920300",2486,547,628,318,75,20,99,51,4224
"37141920401",1160,115,411,453,108,83,108,83,2521
"37141920402",1376,497,635,68,94,155,118,127,3070
"37141920403",1999,383,833,78,55,191,30,191,3760
"37141920501",1997,336,1582,530,256,135,305,142,5283
"37141920502",1234,163,294,199,105,8,48,1,2052
"37141920601",1855,91,395,330,527,112,733,112,4155
"37141920602",3802,961,299,350,276,192,208,327,6415
"37141990100",0,0,0,0,0,0,0,0,0
"37143920100",4599,444,1162,284,187,53,85,4,6818
"37143920201",1307,519,601,358,94,0,44,82,3005
"37143920202",2487,469,298,499,31,0,93,0,3877
"37145920100",3520,867,1659,603,175,12,15,1,6852
"37145920200",4815,505,1071,398,143,70,315,70,7387
"37145920300",1846,799,1121,1394,318,115,225,169,5987
"37145920400",1207,148,747,471,71,176,144,92,3056
"37145920500",5477,543,1347,48,123,31,115,31,7715
"37145920601",3010,635,682,442,82,28,209,186,5274
"37145920602",3057,245,473,178,128,0,58,0,4139
"37147000100",1145,1929,466,835,122,54,64,77,4692
"37147000201",2138,1554,835,557,103,161,83,155,5586
"37147000202",1305,386,523,160,262,253,195,170,3254
"37147000301",2143,107,230,115,22,52,37,14,2720
"37147000302",4476,1903,1518,677,495,334,355,108,9866
"37147000400",1202,303,0,95,60,79,55,4,1798
"37147000501",3023,201,1384,518,404,36,199,0,5765
"37147000502",3222,2120,1363,500,279,501,0,331,8316
"37147000601",1401,703,2832,1029,511,51,92,76,6695
"37147000602",1389,643,2058,1369,119,166,66,36,5846
"37147000603",5524,496,2996,753,663,252,372,233,11289
"37147000701",347,308,1261,2026,72,34,55,115,4218
"37147000702",81,94,1157,1629,0,0,92,8,3061
"37147000800",529,266,1283,850,339,131,308,227,3933
"37147000900",3070,1250,1519,1283,391,451,436,178,8578
"37147001001",1225,248,271,266,90,128,97,123,2448
"37147001002",4753,116,1367,13,420,246,399,260,7574
"37147001003",4126,233,1059,105,118,34,28,34,5737
"37147001100",3850,378,603,236,511,206,717,173,6674
"37147001200",3713,1278,477,154,648,161,537,209,7177
"37147001301",2212,83,945,344,246,0,64,9,3903
"37147001302",2745,90,1587,610,255,56,153,41,5537
"37147001303",6069,162,924,160,394,163,167,100,8139
"37147001401",2298,180,1076,1096,15,6,71,27,4769
"37147001402",909,348,433,412,118,134,0,126,2480
"37147001500",1831,163,711,411,173,8,235,8,3540
"37147001600",4237,715,2518,330,473,12,296,20,8601
"37147001700",2206,228,652,63,180,131,130,130,3720
"37147001800",2917,480,1600,807,181,43,144,87,6259
"37147001900",1844,277,664,164,26,16,23,74,3088
"37147002001",1328,758,1632,1626,345,114,578,493,6874
"37147002002",2094,488,1550,1032,45,17,40,39,5305
"37149920101",2660,346,85,74,36,0,379,0,3580
"37149920103",2203,364,64,0,13,145,0,145,2934
"37149920104",2937,274,23,6,159,61,207,111,3778
"37149920200",3736,601,87,305,80,26,142,0,4977
"37149920301",1072,82,0,11,29,1,28,1,1224
"37149920303",1705,169,0,0,131,18,115,18,2156
"37149920304",2067,171,166,136,5,0,5,0,2550
"37151030100",2554,813,520,256,204,163,481,359,5350
"37151030201",2137,561,266,21,184,0,340,148,3657
"37151030202",3844,1013,93,16,187,12,1152,577,6894
"37151030301",4263,1085,329,205,439,137,1660,412,8530
"37151030302",838,219,659,544,155,148,234,144,2941
"37151030400",2043,499,200,671,405,213,994,544,5569
"37151030502",2867,618,94,128,271,106,197,229,4510
"37151030503",4458,530,16,2,201,30,273,0,5510
"37151030504",4808,922,10,0,268,0,116,0,6124
"37151030600",5674,644,0,15,287,467,478,309,7874
"37151030700",5150,659,1,0,142,13,240,39,6244
"37151030801",5319,1193,263,26,212,26,734,30,7803
"37151030802",4875,837,479,8,326,50,625,62,7262
"37151030900",2926,553,174,179,96,184,72,57,4241
"37151031000",4689,956,594,182,214,339,273,441,7688
"37151031100",4702,984,357,30,160,28,601,153,7015
"37151031200",3281,765,375,118,205,87,432,96,5359
"37151031303",3431,761,20,0,36,0,0,0,4248
"37151031304",3825,546,153,5,298,0,7,120,4954
"37151031305",3004,537,21,37,127,0,31,0,3757
"37151031306",5688,454,64,22,396,30,605,30,7289
"37151031400",5354,1474,356,0,533,583,329,790,9419
"37151031501",4418,1011,47,0,251,39,83,106,5955
"37151031503",2453,439,113,31,174,45,127,23,3405
"37151031504",4158,182,200,41,371,35,88,11,5086
"37151031505",2975,205,189,0,25,0,93,0,3487
"37151031601",3081,610,169,0,71,244,266,160,4601
"37151031602",1032,137,0,43,68,4,100,22,1406
"37153970100",1589,540,751,218,190,16,230,425,3959
"37153970200",2536,873,996,437,142,5,218,293,5500
"37153970300",2241,415,855,256,53,0,77,16,3913
"37153970400",2507,335,567,465,137,26,90,14,4141
"37153970500",1071,202,767,509,155,0,142,12,2858
"37153970600",1911,431,658,649,120,11,371,0,4151
"37153970700",1150,976,334,215,14,433,42,540,3704
"37153970800",2654,561,1205,388,383,23,201,45,5460
"37153970900",3848,146,429,236,237,94,49,0,5039
"37153971000",1209,346,1281,1130,35,92,11,0,4104
"37153971100",1793,670,986,690,258,77,0,0,4474
"37155960101",1426,426,903,558,415,385,464,274,4851
"37155960102",2123,598,706,188,1072,396,258,327,5668
"37155960201",2200,368,1428,378,898,653,457,7,6389
"37155960202",601,522,393,153,2141,848,419,624,5701
"37155960300",1009,669,1369,1450,1272,856,334,487,7446
"37155960401",234,392,90,99,4787,2171,0,61,7834
"37155960402",379,29,112,56,1994,881,96,65,3612
"37155960501",48,128,27,292,2289,723,20,6,3533
"37155960502",190,368,248,603,1086,1203,3,4,3705
"37155960503",144,98,105,13,1204,207,26,0,1797
"37155960600",886,168,388,63,3356,1379,257,32,6529
"37155960701",1190,502,280,68,2420,1222,683,685,7050
"37155960702",674,209,218,128,1561,704,165,297,3956
"37155960801",98,180,1189,1160,328,417,1,87,3460
"37155960802",130,79,933,577,97,91,31,34,1972
"37155960900",1130,129,169,72,266,101,71,90,2028
"37155961000",789,211,296,204,259,315,80,60,2214
"37155961100",470,363,258,361,375,209,120,109,2265
"37155961200",1282,367,609,294,242,224,101,148,3267
"37155961301",1628,311,752,18,903,555,117,117,4401
"37155961302",1901,351,1211,745,781,1155,896,911,7951
"37155961400",1810,481,483,295,749,282,326,76,4502
"37155961500",2334,480,544,123,910,1022,97,304,5814
"37155961601",1602,378,558,244,720,262,168,65,3997
"37155961602",1834,215,575,351,392,267,35,19,3688
"37155961700",1413,289,1260,996,850,436,43,312,5599
"37155961801",172,132,497,287,2867,1362,0,0,5317
"37155961802",543,105,835,271,2233,864,37,0,4888
"37155961900",999,223,1690,648,1311,533,107,81,5592
"37155962001",449,90,1068,921,851,579,14,22,3994
"37155962002",440,63,315,110,1445,586,50,5,3014
"37157040101",2685,549,366,150,208,45,136,22,4161
"37157040102",1500,451,345,106,1,113,0,34,2550
"37157040200",1768,570,789,170,287,442,207,318,4551
"37157040300",2243,225,441,196,191,74,109,34,3513
"37157040400",2821,1441,801,698,192,142,199,47,6341
"37157040501",1746,548,604,277,78,53,56,46,3408
"37157040502",1955,282,383,100,113,0,110,22,2965
"37157040601",2871,394,299,34,317,4,448,11,4378
"37157040602",3298,398,257,228,401,560,509,674,6325
"37157040700",3549,495,213,41,26,24,3,0,4351
"37157040800",794,162,460,315,95,5,27,0,1858
"37157040900",1741,588,111,200,50,8,27,3,2728
"37157041001",4215,656,290,3,394,17,295,15,5885
"37157041002",4540,308,421,3,216,1,227,12,5728
"37157041100",4776,520,708,118,159,0,95,0,6376
"37157041200",1754,202,2057,973,222,226,35,77,5546
"37157041300",3550,804,1394,491,319,72,716,55,7401
"37157041400",1376,587,835,288,72,36,163,103,3460
"37157041500",4737,338,660,404,123,14,167,58,6501
"37157041601",2561,248,171,25,41,2,83,18,3149
"37157041602",3976,384,191,63,83,97,25,136,4955
"37159050201",2063,401,840,610,192,50,85,42,4283
"37159050202",2068,506,1195,783,145,0,190,58,4945
"37159050300",1801,416,1027,508,41,70,168,59,4090
"37159050400",115,320,1105,485,61,18,20,204,2328
"37159050500",1832,105,339,169,131,90,115,10,2791
"37159050700",1501,307,742,267,191,191,216,158,3573
"37159050800",769,147,1117,817,0,43,63,114,3070
"37159050901",3507,658,113,0,51,0,34,0,4363
"37159050903",4088,637,253,34,43,172,36,191,5454
"37159050904",1986,261,1,0,35,12,0,0,2295
"37159051001",5729,701,57,32,61,130,50,152,6912
"37159051002",4433,611,147,58,41,47,154,44,5535
"37159051101",5374,705,221,30,201,30,319,0,6880
"37159051102",2610,716,16,62,250,471,275,518,4918
"37159051201",4683,814,432,223,395,13,721,334,7615
"37159051202",2455,328,368,49,320,50,632,129,4331
"37159051204",2483,308,421,75,221,288,485,372,4653
"37159051301",1291,263,156,62,209,21,141,21,2164
"37159051302",3132,268,842,297,218,51,141,24,4973
"37159051303",2771,489,1133,349,289,40,347,117,5535
"37159051400",5571,610,381,109,453,82,959,148,8313
"37159051501",2171,287,566,14,258,139,495,139,4069
"37159051502",2479,426,0,0,48,170,210,170,3503
"37159051600",4359,1102,512,414,116,34,260,2,6799
"37159051700",5969,943,123,467,361,352,397,250,8862
"37159051801",4037,571,0,0,172,0,286,0,5066
"37159051802",3493,314,190,62,43,15,162,15,4294
"37159051901",3514,418,176,62,54,70,447,37,4778
"37159051902",4132,950,717,252,128,2,113,24,6318
"37159052000",680,226,673,369,68,76,108,33,2233
"37161960100",4721,1351,61,8,78,0,65,7,6291
"37161960200",5573,1363,226,3,227,0,35,31,7458
"37161960300",2081,209,54,23,81,0,4,0,2452
"37161960400",2635,441,130,0,195,0,0,0,3401
"37161960500",5410,535,526,229,544,29,402,0,7675
"37161960600",2308,165,832,541,99,18,58,18,4039
"37161960700",2458,609,676,131,149,93,132,70,4318
"37161960800",1988,909,701,775,77,400,207,447,5504
"37161960900",3369,1133,481,5,79,9,349,0,5425
"37161961000",5518,1344,172,135,157,38,46,0,7410
"37161961101",4145,1274,331,51,197,295,188,265,6746
"37161961102",2320,287,163,159,11,26,40,0,3006
"37161961200",3793,471,14,0,133,18,169,18,4616
"37163970100",2961,794,1588,389,666,531,865,817,8611
"37163970200",4330,818,660,109,662,278,828,604,8289
"37163970301",3968,960,700,176,322,19,206,426,6777
"37163970302",3417,811,651,89,349,242,401,716,6676
"37163970400",2628,1038,596,259,304,93,200,67,5185
"37163970500",2557,645,1485,707,540,307,397,174,6812
"37163970600",1966,316,717,892,273,123,213,109,4609
"37163970700",3088,529,1334,908,403,301,607,514,7684
"37163970800",2819,945,1390,585,778,627,1255,1095,9494
"37163970900",1699,203,635,545,267,127,517,105,4098
"37163971000",1613,599,1135,569,479,516,729,507,6147
"37165010101",2144,141,529,203,378,185,93,54,3727
"37165010102",2467,333,818,1128,364,117,148,0,5375
"37165010200",549,225,1063,1412,337,234,0,85,3905
"37165010300",995,283,1376,991,253,205,60,23,4186
"37165010400",1398,243,227,181,615,355,55,24,3098
"37165010500",3169,550,969,681,610,570,57,13,6619
"37165010600",2501,811,1779,1257,588,399,15,196,7546
"37167930101",2811,447,156,45,359,14,54,0,3886
"37167930102",2283,533,578,130,89,15,15,0,3643
"37167930200",2467,332,381,52,289,21,29,10,3581
"37167930300",3057,571,67,45,168,130,84,40,4162
"37167930500",1835,635,206,148,279,39,19,138,3299
"37167930700",3786,919,2,8,24,0,26,248,5013
"37167930801",3707,497,26,35,124,57,115,21,4582
"37167930802",4357,478,2,0,56,23,260,155,5331
"37167930900",4692,862,251,46,88,55,117,287,6398
"37167931000",3961,995,255,11,42,159,49,0,5472
"37167931100",4060,530,561,365,185,19,64,89,5873
"37167931201",2709,950,1202,719,248,13,308,0,6149
"37167931202",2431,314,219,90,164,54,78,0,3350
"37169070100",4441,1019,231,23,322,20,351,28,6435
"37169070200",2908,467,0,6,46,56,30,122,3635
"37169070300",3475,1014,124,7,94,23,15,0,4752
"37169070400",4247,914,7,2,77,32,33,32,5344
"37169070501",5032,1286,133,0,43,50,32,114,6690
"37169070503",4817,549,113,11,156,0,68,17,5731
"37169070504",3106,399,0,2,38,11,177,99,3832
"37169070600",4356,699,42,0,29,0,52,0,5178
"37169070700",3402,828,806,370,221,38,97,35,5797
"37171930101",1536,470,83,41,21,45,104,114,2414
"37171930102",3791,787,0,2,94,9,266,252,5201
"37171930201",2632,595,80,41,102,87,105,10,3652
"37171930202",2931,390,36,0,18,8,279,16,3678
"37171930301",1511,120,81,133,91,92,21,70,2119
"37171930302",2403,526,249,82,270,0,328,8,3866
"37171930400",1493,849,99,194,160,70,394,180,3439
"37171930501",2408,328,83,0,42,0,181,0,3042
"37171930502",2262,424,187,29,9,114,25,51,3101
"37171930600",2387,563,130,86,96,19,260,170,3711
"37171930700",3401,590,115,0,47,0,46,82,4281
"37171930801",3737,631,16,29,133,18,72,142,4778
"37171930802",2308,680,19,5,61,1,176,34,3284
"37171930901",3101,462,202,159,242,90,654,91,5001
"37171930902",1343,53,41,0,95,0,34,0,1566
"37171931001",1643,651,0,0,129,39,132,75,2669
"37171931002",3309,872,12,55,141,229,404,482,5504
"37171931003",2241,1374,59,17,48,0,485,1029,5253
"37171931101",2358,543,12,0,0,0,261,0,3174
"37171931102",2805,517,21,2,143,54,128,13,3683
"37171931103",1534,253,56,4,0,13,26,13,1899
"37171931200",3028,677,97,48,43,25,12,106,4036
"37173940100",1159,177,8,45,2190,1605,82,152,5418
"37173960200",2047,559,0,144,206,63,34,0,3053
"37173960301",2399,559,0,3,131,42,4,4,3142
"37173960302",1946,137,0,0,429,75,65,0,2652
"37173980200",0,0,0,0,0,0,0,0,0
"37175960100",3484,720,337,2,369,71,259,70,5312
"37175960200",3159,353,278,341,410,167,74,165,4947
"37175960300",5253,647,11,0,286,23,34,0,6254
"37175960401",3517,310,64,1,88,1,109,0,4090
"37175960402",3832,133,30,0,47,17,82,0,4141
"37175960500",4519,820,0,8,124,116,52,140,5779
"37175960600",1892,287,11,0,103,0,11,0,2304
"37177960100",1960,311,536,378,292,90,268,103,3938
"37179020100",5436,572,161,33,10,139,37,23,6411
"37179020202",5538,366,195,81,234,0,132,0,6546
"37179020203",3246,251,125,0,392,19,315,56,4404
"37179020204",3352,328,33,0,144,0,100,0,3957
"37179020305",4232,182,477,0,204,2,408,2,5507
"37179020306",4099,1417,1047,38,281,88,420,992,8382
"37179020307",5303,592,731,8,305,0,555,0,7494
"37179020308",4383,179,394,102,467,27,549,13,6114
"37179020309",2037,208,11,55,50,0,60,0,2421
"37179020310",4584,163,596,0,394,95,395,72,6299
"37179020311",4587,453,358,35,224,78,282,99,6116
"37179020312",2491,351,1086,37,298,40,540,63,4906
"37179020313",1812,175,95,4,265,0,143,23,2517
"37179020314",4227,492,298,0,431,29,403,89,5969
"37179020315",4608,143,269,0,105,0,123,6,5254
"37179020316",3665,74,360,35,200,25,67,0,4426
"37179020317",4109,42,1366,16,231,19,447,19,6249
"37179020401",4715,110,592,112,413,30,692,1,6665
"37179020403",3210,812,474,147,217,93,392,470,5815
"37179020404",2803,1066,951,782,566,522,935,1151,8776
"37179020501",2853,499,954,256,598,292,1062,625,7139
"37179020502",2182,47,790,146,750,31,710,31,4687
"37179020601",2402,601,741,560,200,0,1238,338,6080
"37179020602",1853,1023,698,433,313,433,800,827,6380
"37179020701",2156,368,1412,183,238,420,987,589,6353
"37179020702",2618,246,651,270,99,46,575,93,4598
"37179020800",3292,361,925,566,69,3,309,73,5598
"37179020901",3751,454,493,41,329,0,255,32,5355
"37179020902",5162,270,455,19,419,18,359,0,6702
"37179021004",4034,246,282,0,155,0,214,0,4931
"37179021005",3205,735,374,121,71,0,240,26,4772
"37179021006",5493,97,109,0,203,17,224,14,6157
"37179021007",4832,116,441,27,1070,0,304,0,6790
"37179021008",6247,258,761,0,999,47,624,0,8936
"37179021009",2300,29,293,15,197,0,286,0,3120
"37179021010",6981,114,121,0,277,0,333,0,7826
"37179021011",5690,242,370,0,453,0,801,0,7556
"37179021012",3070,150,14,0,76,297,44,303,3954
"37179021013",3750,213,692,14,197,0,306,0,5172
"37179021014",2304,133,59,33,5,0,95,0,2629
"37179021015",3828,259,235,0,119,0,0,0,4441
"37181960100",1863,239,1457,626,342,11,361,3,4902
"37181960200",1427,274,1754,531,96,8,82,29,4201
"37181960300",2514,322,1713,460,185,68,116,108,5486
"37181960400",2410,155,1032,240,197,29,0,0,4063
"37181960500",613,126,1992,1329,0,1,43,26,4130
"37181960600",271,91,496,308,84,0,131,0,1381
"37181960700",186,193,1962,1691,10,139,106,30,4317
"37181960800",326,216,745,427,29,57,72,52,1924
"37181960900",3643,692,1893,921,977,322,1327,378,10153
"37181961000",3235,492,1434,756,116,340,68,224,6665
"37183050100",1525,215,209,236,127,21,15,8,2356
"37183050300",1788,184,300,221,85,49,7,15,2649
"37183050400",1077,67,198,48,4,26,0,0,1420
"37183050500",2187,306,352,793,95,0,61,27,3821
"37183050600",649,64,858,918,94,19,33,0,2635
"37183050700",584,31,1558,1003,237,68,318,106,3905
"37183050800",209,385,765,946,13,131,212,443,3104
"37183050900",195,44,635,897,116,101,121,50,2159
"37183051000",1579,235,119,170,126,40,67,34,2370
"37183051101",214,255,353,419,174,81,80,34,1610
"37183051102",40,19,0,1,1,0,4,0,65
"37183051200",2319,829,89,49,132,122,31,69,3640
"37183051400",2936,1126,90,172,438,94,178,0,5034
"37183051501",2597,197,74,16,121,0,19,0,3024
"37183051502",2061,113,49,28,207,207,39,0,2704
"37183051600",4260,254,11,1,25,24,0,24,4599
"37183051700",3019,120,12,0,66,0,9,0,3226
"37183051800",3602,122,349,301,86,21,80,21,4582
"37183051900",1427,171,2094,1127,198,10,368,192,5587
"37183052001",1182,439,1274,983,255,20,1130,417,5700
"37183052002",80,580,2941,1536,6,41,25,729,5938
"37183052101",545,487,4913,920,477,226,288,395,8251
"37183052102",812,144,3409,1470,100,41,692,205,6873
"37183052301",3000,1281,854,295,401,515,212,75,6633
"37183052302",3074,1861,770,653,734,389,137,89,7707
"37183052401",1888,305,622,53,127,126,201,0,3322
"37183052404",2513,884,96,153,631,289,246,199,5011
"37183052406",2948,912,1553,665,814,130,940,246,8208
"37183052407",1712,842,630,314,189,141,226,328,4382
"37183052408",1015,684,318,560,96,146,66,60,2945
"37183052409",895,801,262,148,839,569,295,256,4065
"37183052503",4839,320,443,209,392,48,173,33,6457
"37183052504",4247,385,267,182,223,18,555,232,6109
"37183052505",3756,260,500,179,782,0,510,0,5987
"37183052506",1650,68,119,6,80,18,43,20,2004
"37183052507",2252,123,294,309,127,21,358,16,3500
"37183052601",2541,92,160,2,131,48,0,1,2975
"37183052602",3181,182,409,149,100,138,55,128,4342
"37183052603",2199,104,141,71,93,66,78,56,2808
"37183052701",3007,191,596,159,1139,655,975,728,7450
"37183052704",1238,917,2071,1024,1225,639,1191,1327,9632
"37183052705",2384,673,772,79,402,65,542,395,5312
"37183052706",1941,477,1147,46,481,105,964,546,5707
"37183052707",3374,409,1255,806,775,17,1049,204,7889
"37183052801",4772,114,1569,259,105,42,162,0,7023
"37183052802",3449,331,1589,579,352,118,971,254,7643
"37183052803",1711,555,5903,1262,487,226,394,583,11121
"37183052806",2525,1949,10537,496,1207,74,1053,1722,19563
"37183052807",2107,567,2309,175,377,14,420,434,6403
"37183052808",5111,693,2770,205,452,8,778,235,10252
"37183052809",2019,254,580,21,218,55,200,50,3397
"37183052901",1848,195,281,11,10,0,99,0,2444
"37183052902",4393,346,675,61,240,0,186,67,5968
"37183052903",2252,118,427,80,104,0,90,2,3073
"37183052904",5769,371,782,139,401,17,499,18,7996
"37183053003",3949,622,950,10,760,253,111,42,6697
"37183053004",2156,55,90,0,346,10,30,0,2687
"37183053005",4193,142,102,0,517,0,189,0,5143
"37183053006",2774,31,25,0,159,0,264,0,3253
"37183053007",2776,36,95,0,181,0,29,0,3117
"37183053008",5403,495,1084,218,1171,105,460,0,8936
"37183053009",4683,1370,1129,2,435,455,1045,1419,10538
"37183053105",2947,278,426,48,161,89,204,229,4382
"37183053106",1895,55,434,829,403,0,450,0,4066
"37183053107",7069,680,1218,925,820,0,872,321,11905
"37183053108",5634,477,346,108,403,104,292,257,7621
"37183053109",6383,847,964,56,415,41,1069,353,10128
"37183053110",4462,290,452,65,264,56,522,56,6167
"37183053111",3739,984,652,192,409,19,399,795,7189
"37183053201",10193,171,888,16,574,266,965,231,13304
"37183053202",4149,45,291,28,160,0,63,0,4736
"37183053203",5782,147,875,44,839,64,272,8,8031
"37183053204",3211,93,1108,29,452,0,291,0,5184
"37183053205",1560,53,92,184,38,3,7,0,1937
"37183053206",2735,153,720,163,495,31,154,74,4525
"37183053207",6408,422,649,27,317,0,435,27,8285
"37183053405",4055,63,330,0,359,0,187,0,4994
"37183053408",3179,49,40,0,1139,38,69,0,4514
"37183053409",5128,46,345,115,1499,83,283,0,7499
"37183053410",3014,80,227,0,1964,30,254,0,5569
"37183053411",4749,320,239,0,1924,0,133,0,7365
"37183053412",5319,77,142,0,1224,35,476,0,7273
"37183053413",4631,136,473,11,478,34,250,107,6120
"37183053414",6881,171,272,159,995,102,787,111,9478
"37183053415",2518,43,169,0,679,41,305,5,3760
"37183053416",4450,171,992,30,784,0,311,46,6784
"37183053417",1589,217,923,7,132,0,116,54,3038
"37183053418",4640,286,342,130,542,205,478,146,6769
"37183053419",2767,12,108,0,90,0,27,0,3004
"37183053420",4395,558,838,0,427,0,872,197,7287
"37183053421",4253,78,307,24,670,18,637,0,5987
"37183053422",2127,10,60,0,315,0,37,0,2549
"37183053423",1762,93,56,13,135,5,68,0,2132
"37183053424",3207,134,303,9,910,0,138,0,4701
"37183053425",1629,33,120,10,1061,51,66,6,2976
"37183053505",2981,192,307,33,108,0,47,12,3680
"37183053506",4424,190,109,6,356,0,207,21,5313
"37183053507",2665,343,554,184,194,58,575,76,4649
"37183053509",4333,159,133,0,619,0,399,34,5677
"37183053512",4348,102,605,0,1006,0,237,13,6311
"37183053513",2317,378,624,144,594,62,528,127,4774
"37183053516",2156,200,941,82,589,22,769,122,4881
"37183053517",2660,724,346,83,1103,382,1725,824,7847
"37183053518",3288,205,85,3,110,0,47,30,3768
"37183053519",2257,651,586,338,364,473,485,623,5777
"37183053520",3206,182,1083,119,912,450,578,83,6613
"37183053521",2949,91,188,15,530,0,201,0,3974
"37183053522",2997,18,493,0,2153,72,174,0,5907
"37183053523",3983,49,404,28,1235,77,166,40,5982
"37183053524",2707,244,184,19,485,35,96,0,3770
"37183053525",2109,12,150,0,188,5,214,5,2683
"37183053601",4461,144,896,305,3076,19,565,123,9589
"37183053602",2028,21,705,0,2710,87,310,0,5861
"37183053603",2976,31,134,11,1109,26,138,0,4425
"37183053604",3073,21,27,0,1306,39,128,0,4594
"37183053605",1333,11,147,0,577,0,18,0,2086
"37183053606",1584,28,441,16,403,0,55,8,2535
"37183053607",3418,207,535,0,4138,368,509,0,9175
"37183053608",1489,22,540,36,1157,137,116,0,3497
"37183053609",314,53,124,0,215,0,21,0,727
"37183053610",6031,94,1889,52,1335,440,207,430,10478
"37183053707",4638,147,1339,78,96,82,106,0,6486
"37183053709",4590,328,1351,73,577,146,263,136,7464
"37183053711",4542,59,492,72,407,28,383,0,5983
"37183053712",2315,96,263,0,148,0,124,12,2958
"37183053713",2088,366,1206,42,140,8,262,0,4112
"37183053714",3333,147,440,338,279,59,70,0,4666
"37183053715",2626,191,356,18,249,11,103,10,3564
"37183053716",2166,159,1029,89,292,118,145,25,4023
"37183053717",1700,87,331,13,435,25,231,11,2833
"37183053718",2866,44,295,1,151,0,259,7,3623
"37183053719",3612,46,93,7,293,12,196,0,4259
"37183053720",3464,109,109,0,436,7,173,21,4319
"37183053721",2980,12,152,0,235,6,44,0,3429
"37183053722",3737,248,95,0,366,8,49,45,4548
"37183053723",2469,249,301,0,345,0,352,0,3716
"37183053724",4678,220,283,0,1292,15,448,0,6936
"37183053725",3738,177,701,79,452,0,156,0,5303
"37183053726",1773,42,667,332,563,0,487,0,3864
"37183053803",3335,85,452,0,94,0,76,0,4042
"37183053804",3188,12,271,1,38,0,251,0,3761
"37183053805",1739,98,66,0,79,0,28,0,2010
"37183053806",2976,44,62,3,137,0,62,0,3284
"37183053807",3407,50,90,11,298,0,84,0,3940
"37183053808",4595,84,267,0,317,0,145,0,5408
"37183053900",6966,548,527,0,189,0,383,0,8613
"37183054001",2995,549,1131,37,269,165,272,516,5934
"37183054004",3207,311,1322,27,114,416,485,527,6409
"37183054006",2131,159,359,72,244,410,259,176,3810
"37183054007",2751,88,914,39,133,24,200,19,4168
"37183054008",1638,836,2406,614,956,392,1246,938,9026
"37183054011",2414,117,186,85,107,0,80,88,3077
"37183054012",3193,27,326,29,358,15,205,5,4158
"37183054013",10432,382,803,460,1164,48,535,0,13824
"37183054014",5454,828,3358,1532,2365,19,2415,555,16526
"37183054015",1265,92,630,99,344,35,447,17,2929
"37183054016",4595,124,733,50,236,16,156,0,5910
"37183054017",1723,80,804,56,60,121,150,120,3114
"37183054018",1049,58,1335,567,423,241,252,224,4149
"37183054104",4519,168,3623,636,1830,56,2598,132,13562
"37183054105",6627,223,4621,656,353,120,1099,3,13702
"37183054106",1642,816,4329,200,1014,168,1145,713,10027
"37183054108",2708,462,1981,490,1082,52,1393,295,8463
"37183054109",2223,256,1121,12,128,107,160,155,4162
"37183054110",5271,199,1865,363,1498,0,674,0,9870
"37183054111",1234,140,375,59,131,16,126,22,2103
"37183054112",1706,277,1318,160,380,116,665,344,4966
"37183054113",1547,67,781,72,40,52,374,41,2974
"37183054114",2820,204,1412,6,446,12,839,70,5809
"37183054115",4417,161,2669,129,488,120,886,29,8899
"37183054203",3214,0,102,0,238,91,251,91,3987
"37183054204",3292,528,611,188,144,37,199,0,4999
"37183054205",2985,352,598,481,198,54,156,46,4870
"37183054206",4617,366,274,262,184,8,56,29,5796
"37183054207",6324,239,1434,0,656,95,789,45,9582
"37183054208",5747,191,562,197,368,13,341,72,7491
"37183054209",5974,105,2759,25,975,2,633,0,10473
"37183054210",7190,339,1602,111,402,34,526,0,10204
"37183054211",8418,648,1072,54,593,0,655,383,11823
"37183054301",3336,822,1263,113,197,0,141,505,6377
"37183054302",3629,498,1613,305,222,289,858,298,7712
"37183054402",3410,993,875,29,168,118,695,443,6731
"37183054403",2096,514,484,164,223,76,477,342,4376
"37183054404",3062,49,1071,196,1033,184,1086,0,6681
"37183054500",3554,1542,1779,666,546,78,831,1119,10115
"37183980100",28,0,0,0,0,0,0,0,28
"37183980200",99,0,0,0,2,0,0,0,101
"37185950101",1658,128,305,56,239,0,89,0,2475
"37185950102",600,96,214,28,9,6,53,0,1006
"37185950103",560,32,823,335,614,404,29,0,2797
"37185950200",2075,255,2213,841,30,120,18,34,5586
"37185950300",902,230,1487,1000,188,139,136,110,4192
"37185950400",841,311,1870,678,115,33,159,100,4107
"37187950100",2003,418,1586,613,446,19,410,50,5545
"37187950200",2151,237,2396,1229,34,41,42,85,6215
"37187950300",968,71,205,109,4,0,0,0,1357
"37189920100",3802,937,12,29,71,68,59,7,4985
"37189920200",3513,400,3,0,106,0,54,0,4076
"37189920300",1962,432,0,3,84,76,211,64,2832
"37189920400",3450,5128,105,49,71,372,118,213,9506
"37189920500",847,1314,0,4,10,5,8,26,2214
"37189920601",2008,2443,35,10,64,129,49,57,4795
"37189920602",1150,734,4,6,59,68,1,71,2093
"37189920701",1644,109,8,9,57,0,44,0,1871
"37189920702",2534,355,0,0,51,19,47,0,3006
"37189920703",4087,681,33,11,196,120,194,103,5425
"37189920800",2236,406,0,0,40,0,22,60,2764
"37189920900",3254,633,8,0,151,121,52,109,4328
"37189921000",530,55,2,0,12,0,10,0,609
"37191000101",5015,771,943,107,186,17,410,110,7559
"37191000102",4611,347,1242,0,367,10,132,0,6709
"37191000200",2014,210,551,176,181,119,146,84,3481
"37191000302",3218,832,1949,246,305,142,144,189,7025
"37191000303",3917,662,1195,167,654,40,121,118,6874
"37191000304",3614,926,965,125,101,0,173,109,6013
"37191000401",3814,618,915,7,99,437,71,247,6208
"37191000402",1845,592,686,519,400,722,170,665,5599
"37191000500",1283,177,223,0,282,25,139,10,2139
"37191000601",1257,341,1459,494,516,533,549,480,5629
"37191000602",3288,853,910,234,1697,1812,2163,2117,13074
"37191000700",670,64,1307,420,125,223,133,223,3165
"37191000800",808,203,401,245,136,503,148,493,2937
"37191000901",2361,317,477,585,665,714,522,616,6257
"37191000902",1982,448,1395,596,150,180,138,306,5195
"37191001000",3157,600,387,2,204,205,181,291,5027
"37191001101",4258,1289,404,153,48,178,38,178,6546
"37191001102",2437,167,237,37,14,0,0,0,2892
"37191001200",1723,59,1198,629,210,22,158,0,3999
"37191001301",2810,162,2801,185,444,0,480,0,6882
"37191001302",1552,192,1007,283,177,188,103,0,3502
"37191001400",1438,196,2820,1869,370,29,372,151,7245
"37191001500",254,78,1414,839,3,55,36,41,2720
"37191001800",404,249,846,880,33,23,0,43,2478
"37191001900",929,240,1563,1154,114,140,24,48,4212
"37191002000",179,32,529,143,74,0,74,0,1031
"37193960100",5753,986,173,4,68,40,243,139,7406
"37193960200",2749,807,17,0,7,11,59,15,3665
"37193960300",4743,1303,28,65,148,10,133,127,6557
"37193960400",5984,1640,52,0,47,118,101,89,8031
"37193960500",1929,719,335,135,171,145,208,142,3784
"37193960600",1096,762,84,141,35,320,49,339,2826
"37193960700",1796,906,72,8,37,345,95,258,3517
"37193960801",2847,1269,0,0,193,117,265,143,4834
"37193960802",3059,904,5,1,19,128,45,119,4280
"37193960900",3452,1240,0,0,0,0,0,20,4712
"37193961001",4115,414,113,131,178,116,355,35,5457
"37193961002",3875,606,358,32,123,16,141,146,5297
"37193961100",1851,490,519,172,257,89,181,118,3677
"37193961200",5228,1478,442,0,43,123,345,56,7715
"37195000100",332,163,1075,979,43,304,140,310,3346
"37195000200",9,71,129,491,116,9,116,78,1019
"37195000300",277,28,1104,937,257,285,289,293,3470
"37195000400",3127,244,2238,827,581,201,224,245,7687
"37195000501",3138,143,271,11,31,8,11,8,3621
"37195000502",2701,122,1776,188,310,0,104,0,5201
"37195000600",3710,255,1896,1149,362,27,140,51,7590
"37195000700",377,426,1740,1794,431,554,637,210,6169
"37195000801",41,21,580,753,81,171,113,171,1931
"37195000802",698,357,1241,774,392,296,349,487,4594
"37195000900",2475,424,554,148,103,26,120,117,3967
"37195001000",810,135,576,174,140,11,172,11,2029
"37195001100",713,152,770,86,0,1,6,0,1728
"37195001200",1807,127,978,427,135,357,172,249,4252
"37195001300",3001,285,1118,479,315,75,264,65,5602
"37195001400",5174,383,2473,565,403,636,194,626,10454
"37195001500",3600,363,736,116,823,340,849,391,7218
"37195001600",1737,322,483,454,341,60,310,15,3722
"37195001700",2417,411,594,99,213,231,253,236,4454
"37197050101",3972,1241,189,2,286,3,377,96,6166
"37197050102",3435,570,38,34,0,20,380,40,4517
"37197050200",3399,542,308,37,50,38,69,142,4585
"37197050300",4362,1367,248,40,226,209,297,269,7018
"37197050400",4765,608,3,23,0,18,276,0,5693
"37197050501",4746,1057,107,134,132,700,543,946,8365
"37197050502",3698,676,15,89,55,235,184,356,5308
"37199960101",3032,795,0,0,12,75,71,128,4113
"37199960102",1685,682,0,0,15,9,118,0,2509
"37199960200",2679,809,167,0,113,50,54,68,3940
"37199960300",2554,626,8,12,0,80,67,281,3628
"37199960400",3342,617,0,0,30,20,0,36,4045
"38001965600",1930,198,31,0,103,22,26,0,2310
"38003967900",1639,126,0,0,19,2,0,4,1790
"38003968000",2477,157,11,0,37,41,54,11,2788
"38003968200",2062,273,53,0,259,23,38,0,2708
"38003968300",3103,167,20,9,30,43,41,0,3413
"38005940100",382,44,0,0,856,1219,64,6,2571
"38005940200",282,84,0,0,1041,723,47,23,2200
"38005956500",1066,108,0,0,17,8,5,3,1207
"38005956600",832,74,0,0,8,0,1,0,915
"38007963100",807,81,8,0,54,19,39,3,1011
"38009952300",1794,143,0,0,226,9,38,0,2210
"38009952400",2103,126,0,0,35,15,0,1,2280
"38009952500",1582,247,16,0,37,0,27,39,1948
"38011965200",1579,164,0,0,83,5,108,4,1943
"38011965300",1214,58,2,1,34,6,30,0,1345
"38013953300",1871,290,1,0,35,11,34,83,2325
"38015010100",2338,517,46,0,160,66,130,2,3259
"38015010200",3965,431,86,0,165,260,51,0,4958
"38015010300",6006,387,17,26,112,0,43,0,6591
"38015010400",3359,193,61,0,126,0,108,6,3853
"38015010500",4143,322,41,73,179,0,11,14,4783
"38015010600",3415,194,43,0,151,608,46,21,4478
"38015010700",3846,313,7,0,64,58,59,6,4353
"38015010800",3003,415,0,0,233,185,24,0,3860
"38015010900",3516,234,32,33,109,34,76,42,4076
"38015011001",4154,610,103,0,454,39,100,0,5460
"38015011002",5829,80,44,0,373,0,119,0,6445
"38015011101",4278,379,45,0,275,357,194,5,5533
"38015011103",3103,72,30,0,120,59,28,9,3421
"38015011104",4513,52,0,0,236,18,41,0,4860
"38015011105",3967,65,0,0,143,0,17,0,4192
"38015011200",4955,304,0,0,263,0,93,57,5672
"38015011300",5948,120,3,0,143,235,72,0,6521
"38015011400",2303,94,0,0,80,11,15,0,2503
"38015011500",1469,102,0,0,31,0,8,21,1631
"38017000100",4678,95,3,0,143,44,0,0,4963
"38017000201",3046,265,0,0,158,48,81,21,3619
"38017000202",2263,666,80,39,290,38,180,0,3556
"38017000300",1233,254,34,83,177,249,10,0,2040
"38017000400",2713,471,33,14,80,173,34,0,3518
"38017000501",2562,580,28,0,106,159,19,26,3480
"38017000502",1435,1142,95,42,116,147,49,10,3036
"38017000600",3277,1056,72,104,395,340,12,21,5277
"38017000700",989,597,158,93,20,65,0,0,1922
"38017000801",2484,440,0,0,259,14,145,0,3342
"38017000802",3482,417,50,229,318,134,142,0,4772
"38017000901",4395,347,191,4,159,139,35,99,5369
"38017000903",2615,673,80,104,201,168,22,197,4060
"38017000904",3437,301,0,21,64,154,12,0,3989
"38017001001",4257,676,66,44,301,346,177,198,6065
"38017001002",2076,366,71,0,74,20,129,4,2740
"38017010106",2937,747,199,159,735,75,239,23,5114
"38017010107",1943,479,252,44,238,242,177,50,3425
"38017010108",4570,466,106,370,288,0,34,4,5838
"38017010109",3291,403,12,0,247,195,138,31,4317
"38017010201",4923,169,0,0,228,0,9,0,5329
"38017010203",2417,207,50,65,86,38,34,0,2897
"38017010204",6310,205,269,247,284,182,0,0,7497
"38017010303",5204,353,48,14,446,0,189,0,6254
"38017010305",5252,367,484,156,368,88,175,97,6987
"38017010306",3208,286,89,141,163,91,119,197,4294
"38017010307",2130,38,11,0,48,4,0,10,2241
"38017040100",1895,106,0,0,6,0,9,0,2016
"38017040200",2255,103,10,0,41,5,7,0,2421
"38017040300",3052,155,0,0,63,0,0,8,3278
"38017040400",3694,149,72,44,75,35,28,1,4098
"38017040500",27549,1027,372,41,1081,85,456,0,30611
"38017040600",2880,134,5,0,35,6,50,7,3117
"38019950900",1615,108,0,0,49,0,0,0,1772
"38019951100",1838,72,2,0,94,0,0,0,2006
"38021973200",2156,109,20,0,37,0,135,0,2457
"38021973300",1150,115,6,0,0,5,0,0,1276
"38021973400",1056,156,25,0,39,15,6,7,1304
"38023954500",1993,164,11,0,71,14,0,4,2257
"38025962200",3062,383,4,0,533,134,116,0,4232
"38027959200",1865,251,0,0,96,60,53,26,2351
"38029966500",2962,339,0,0,60,47,4,0,3412
"38031959600",2911,300,0,4,65,12,32,7,3331
"38033962900",1590,145,0,0,0,32,17,18,1802
"38035010100",2206,748,108,0,163,11,156,93,3485
"38035010200",3149,873,25,6,179,91,132,73,4528
"38035010300",660,1035,118,141,102,191,0,15,2262
"38035010400",3381,1326,9,66,548,370,134,158,5992
"38035010600",1552,315,88,0,40,40,13,5,2053
"38035010700",1648,213,11,17,36,0,117,0,2042
"38035010801",3429,590,0,37,197,164,18,0,4435
"38035010803",3371,1188,288,288,581,128,183,47,6074
"38035010804",2861,847,0,0,647,124,286,0,4765
"38035010900",1470,82,0,0,84,10,45,0,1691
"38035011000",2087,95,55,0,221,213,93,0,2764
"38035011100",4801,45,20,0,128,0,73,0,5067
"38035011200",5429,1004,0,0,575,91,59,0,7158
"38035011400",1975,215,3,0,51,8,12,129,2393
"38035011700",4866,214,22,0,126,49,144,13,5434
"38035011800",1249,78,0,0,9,0,1,0,1337
"38035011900",1465,84,206,0,229,31,122,16,2153
"38035012000",2451,157,10,8,96,30,125,19,2896
"38037965900",1935,330,2,6,42,10,19,1,2345
"38039968600",2008,156,14,15,37,8,6,3,2247
"38041964700",994,125,0,0,10,12,23,0,1164
"38041964800",1227,80,0,0,11,0,26,0,1344
"38043966800",2166,185,0,0,77,0,98,24,2550
"38045972100",1354,157,0,0,0,0,11,4,1526
"38045972200",2231,226,5,0,44,0,11,0,2517
"38047972500",1687,145,0,6,30,0,28,0,1896
"38049955600",2261,293,4,3,97,4,43,21,2726
"38049955900",2590,437,0,0,38,1,59,13,3138
"38051972900",2283,278,9,0,48,33,16,9,2676
"38053940100",77,20,10,0,892,762,33,20,1814
"38053962300",1994,134,0,0,51,90,58,6,2333
"38053962400",3578,232,61,0,147,1,73,54,4146
"38053962500",1374,66,5,0,33,4,18,3,1503
"38055960800",3651,446,8,0,94,4,56,85,4344
"38055961000",3842,458,0,0,553,164,41,0,5058
"38057961600",2354,148,0,0,116,39,68,0,2725
"38057961700",2870,283,0,0,13,0,101,0,3267
"38057961800",2269,208,2,0,156,15,23,0,2673
"38059020100",4395,476,0,18,460,115,0,51,5515
"38059020200",6350,320,147,0,413,81,236,38,7585
"38059020300",7797,691,0,0,401,172,150,0,9211
"38059020400",2894,110,0,0,143,7,40,0,3194
"38059020500",2990,273,12,0,147,7,122,16,3567
"38061940300",656,81,6,0,526,149,61,6,1485
"38061940400",835,83,3,0,1609,477,258,11,3276
"38061955200",3993,382,0,0,256,54,163,33,4881
"38063959000",2630,227,22,20,63,2,49,6,3019
"38065961200",1585,95,6,0,57,42,15,35,1835
"38067950100",1177,50,6,0,48,7,15,0,1303
"38067950200",1318,180,0,0,81,13,43,28,1663
"38067950300",1127,47,0,0,96,9,45,0,1324
"38067950400",1362,78,0,0,20,8,7,0,1475
"38067950500",1291,62,0,0,62,0,91,0,1506
"38069956100",1218,187,13,0,11,17,17,0,1463
"38069956200",2235,482,0,0,34,7,21,0,2779
"38071957600",3270,255,0,0,482,238,74,0,4319
"38071957700",2526,129,0,0,76,4,129,5,2869
"38071957800",3288,271,7,0,315,221,38,0,4140
"38073968900",1362,232,18,0,4,8,3,4,1631
"38073969000",1440,83,14,0,22,0,33,0,1592
"38073969100",1872,160,0,0,63,7,24,23,2149
"38075952900",2286,179,4,0,30,7,63,0,2569
"38077970700",1859,35,0,0,4,50,0,0,1948
"38077970800",1916,158,0,0,25,16,39,4,2158
"38077970900",2525,299,27,0,145,49,83,0,3128
"38077971000",3002,454,0,0,225,90,108,96,3975
"38077971100",1157,73,0,0,127,5,4,3,1369
"38077971400",2421,386,0,0,102,18,37,3,2967
"38079941800",107,22,6,0,3657,2347,23,1,6163
"38079951600",668,104,4,51,363,256,0,0,1446
"38079951700",659,114,4,0,2206,1679,12,20,4694
"38079951900",1042,128,4,4,451,349,3,0,1981
"38081974000",1418,43,11,0,19,6,25,0,1522
"38081974200",2050,158,19,12,79,3,57,17,2395
"38083960200",1111,203,0,0,17,6,4,0,1341
"38085940800",344,86,0,0,731,483,56,0,1700
"38085940900",126,10,0,0,1542,945,49,49,2721
"38087965000",589,68,4,0,12,0,0,2,675
"38089963300",1519,126,0,0,55,3,51,0,1754
"38089963400",3638,160,8,0,171,7,144,7,4135
"38089963500",4750,256,43,0,233,127,178,0,5587
"38089963600",1911,219,22,24,32,7,113,7,2335
"38089963700",3519,245,115,11,215,56,162,0,4323
"38089963800",4198,290,62,0,478,44,345,44,5461
"38089963900",2979,146,13,0,238,49,135,1,3561
"38089964000",1780,91,0,0,43,5,2,1,1922
"38091968700",1796,143,0,0,7,0,29,2,1977
"38093967000",2435,90,0,0,27,2,19,0,2573
"38093967200",2076,237,0,0,34,7,16,0,2370
"38093967300",1751,194,0,0,9,25,0,0,1979
"38093967400",4115,401,18,0,317,33,272,0,5156
"38093967500",3267,287,0,10,121,0,0,0,3685
"38093967800",2945,743,0,47,263,54,0,62,4114
"38095951500",1849,176,0,0,90,140,9,27,2291
"38097970100",2127,171,0,0,75,14,0,0,2387
"38097970200",1637,299,13,24,46,46,11,15,2091
"38097970300",1479,53,0,0,14,2,49,0,1597
"38097970400",1462,184,6,0,9,11,100,57,1829
"38099957800",1334,76,4,0,253,4,306,0,1977
"38099957900",1177,177,0,0,89,28,276,70,1817
"38099958000",1866,375,0,0,316,50,167,90,2864
"38099958100",2007,85,0,0,121,0,163,0,2376
"38099958200",1254,186,9,8,71,19,45,32,1624
"38099958300",1071,81,5,0,43,23,16,0,1239
"38101010100",1993,462,76,58,308,7,129,5,3038
"38101010200",3916,365,203,0,142,79,27,23,4755
"38101010301",3265,76,38,0,520,68,163,13,4143
"38101010302",5572,298,62,0,308,90,400,0,6730
"38101010400",4018,410,59,8,662,293,299,61,5810
"38101010500",6356,223,373,20,354,16,211,0,7553
"38101010600",6521,552,357,27,507,20,142,20,8146
"38101010700",7041,583,159,0,403,88,164,94,8532
"38101010800",3501,132,28,0,102,76,137,4,3980
"38101010900",3250,174,368,17,728,237,667,172,5613
"38101011000",1502,140,0,3,76,0,99,0,1820
"38101011200",3223,96,0,0,30,0,21,0,3370
"38101011300",4091,243,20,2,265,56,68,2,4747
"38103959800",1683,136,0,0,32,6,7,0,1864
"38103960000",2140,84,0,0,38,0,22,0,2284
"38105953400",1503,79,0,0,100,0,111,9,1802
"38105953500",1216,113,10,0,358,51,61,15,1824
"38105953600",2178,183,51,0,136,47,2,37,2634
"38105953700",8473,749,0,0,579,318,250,418,10787
"38105953800",2371,234,67,0,312,133,108,10,3235
"38105953900",3282,82,32,0,12,0,14,0,3422
"38105954100",4856,516,32,350,399,58,95,26,6332
"39001770100",3387,1054,40,15,66,36,60,8,4666
"39001770200",3572,1171,0,0,20,126,34,43,4966
"39001770300",5607,1319,0,0,64,0,27,0,7017
"39001770400",3165,1226,5,29,0,0,0,0,4425
"39001770500",2296,860,0,3,50,92,0,0,3301
"39001770600",2529,869,0,0,117,32,36,28,3611
"39003010100",3503,347,48,29,67,20,45,47,4106
"39003010200",3675,309,11,0,31,0,52,0,4078
"39003010300",1404,118,0,0,0,4,51,4,1581
"39003010600",4186,555,33,13,184,29,14,11,5025
"39003010800",7206,125,160,19,158,0,190,0,7858
"39003010900",3000,390,350,81,255,36,131,66,4309
"39003011000",3400,1137,508,165,361,40,193,45,5849
"39003011200",988,151,31,6,15,0,51,55,1297
"39003011300",6317,483,113,3,256,67,106,23,7368
"39003011400",2716,245,0,0,8,0,50,1,3020
"39003011500",2201,429,0,0,96,0,88,72,2886
"39003011600",2456,181,21,10,32,8,18,0,2726
"39003011800",2176,83,182,30,91,6,89,0,2657
"39003011900",2420,343,31,0,143,44,0,0,2981
"39003012000",2051,70,63,0,59,0,10,12,2265
"39003012100",2787,274,173,1,218,10,14,5,3482
"39003012200",1837,544,633,292,222,31,27,6,3592
"39003012300",2497,742,146,255,130,76,23,145,4014
"39003012400",1283,707,263,196,145,36,0,43,2673
"39003012600",1204,318,186,43,70,59,39,72,1991
"39003012700",502,613,257,387,94,39,0,6,1898
"39003012900",528,356,77,279,157,17,12,48,1474
"39003013000",2710,806,499,15,177,87,76,141,4511
"39003013100",1794,174,157,149,73,0,177,41,2565
"39003013200",981,177,430,178,129,19,3,44,1961
"39003013300",610,24,293,167,135,10,5,3,1247
"39003013400",463,1050,383,392,98,52,31,45,2514
"39003013600",499,131,211,435,3,11,3,0,1293
"39003013700",242,207,407,263,15,31,0,20,1185
"39003013800",674,315,1020,604,116,98,0,19,2846
"39003013900",3010,273,26,1,16,21,74,0,3421
"39003014000",2858,278,156,0,0,0,20,0,3312
"39003014100",477,487,542,392,80,15,84,14,2091
"39005970100",6146,2031,0,0,115,0,113,12,8417
"39005970200",4951,724,6,9,78,2,72,2,5844
"39005970300",3154,663,17,0,72,0,0,0,3906
"39005970400",2532,953,0,0,105,67,67,25,3749
"39005970500",1947,616,16,6,117,1,51,10,2764
"39005970600",3396,233,0,0,138,2,90,0,3859
"39005970700",4891,125,85,69,135,0,46,0,5351
"39005970800",3125,435,49,17,112,44,28,0,3810
"39005970900",4584,479,3,0,42,11,34,4,5157
"39005971000",4458,441,3,1,20,12,27,0,4962
"39005971100",3048,616,8,3,18,9,4,6,3712
"39007000101",2273,649,17,55,13,30,149,4,3190
"39007000102",2512,624,24,6,47,0,31,0,3244
"39007000103",2588,982,44,0,55,30,0,22,3721
"39007000200",3662,255,63,4,141,0,100,22,4247
"39007000300",1588,271,54,1,33,79,37,0,2063
"39007000400",1069,554,44,8,15,33,8,0,1731
"39007000500",3114,990,111,0,71,70,101,6,4463
"39007000601",1428,549,261,29,83,83,0,118,2551
"39007000602",2511,470,12,8,65,52,25,22,3165
"39007000603",3104,660,133,0,286,28,132,38,4381
"39007000701",1654,797,225,320,67,189,204,87,3543
"39007000702",2007,366,82,0,46,0,277,18,2796
"39007000703",1621,1281,232,197,157,108,162,155,3913
"39007000704",2488,1173,93,99,221,53,118,427,4672
"39007000801",1493,321,0,0,23,9,87,4,1937
"39007000802",4505,631,0,0,250,37,292,230,5945
"39007000900",3861,304,0,12,48,0,101,19,4345
"39007001001",4688,585,37,25,27,0,41,0,5403
"39007001002",2705,456,1,2,29,15,69,12,3289
"39007001101",1949,100,0,0,0,0,15,0,2064
"39007001102",5178,503,0,0,51,0,95,0,5827
"39007001200",5522,1840,43,45,52,0,37,0,7539
"39007001301",2481,625,10,0,36,220,6,13,3391
"39007001302",2864,961,0,7,2,182,68,141,4225
"39007001400",6435,1275,44,8,150,0,71,0,7983
"39007990000",0,0,0,0,0,0,0,0,0
"39009972600",2814,1394,8,29,110,38,33,0,4426
"39009972700",2957,946,2,23,38,0,32,0,3998
"39009972800",2164,1077,0,110,35,25,0,9,3420
"39009972900",2672,1809,79,0,410,275,44,221,5510
"39009973000",2241,1321,4,33,83,55,85,0,3822
"39009973101",394,1662,20,18,30,112,11,0,2247
"39009973200",2861,1565,10,141,221,126,74,56,5054
"39009973300",2484,437,103,95,391,266,73,43,3892
"39009973400",2410,976,12,0,67,131,27,30,3653
"39009973500",2822,474,170,0,158,0,40,0,3664
"39009973600",3002,485,0,1,15,18,0,0,3521
"39009973700",2965,617,53,10,75,65,0,0,3785
"39009973800",4293,595,21,12,17,60,21,3,5022
"39009973901",132,681,12,3,115,525,11,70,1549
"39009973902",576,1817,0,69,44,167,56,21,2750
"39011040100",3561,304,2,0,145,4,58,4,4078
"39011040200",3714,537,1,0,51,0,57,64,4424
"39011040300",2900,720,27,50,19,6,22,64,3808
"39011040400",5627,302,9,0,192,0,170,0,6300
"39011040500",4445,249,1,0,47,30,9,0,4781
"39011040600",2975,322,0,3,157,11,7,0,3475
"39011040900",3448,240,0,0,59,4,78,4,3833
"39011041000",3398,131,4,0,25,22,5,23,3608
"39011041100",3969,148,7,0,101,0,12,0,4237
"39011041201",1557,309,61,6,14,0,18,0,1965
"39011041202",4588,568,0,0,53,44,20,0,5273
"39013010100",3047,768,218,11,68,25,1,7,4145
"39013010200",2889,634,176,117,57,10,3,4,3890
"39013010300",2906,292,5,3,15,2,2,2,3227
"39013010600",3208,334,5,3,22,21,1,51,3645
"39013010700",2343,256,0,0,48,0,3,0,2650
"39013010802",1875,344,0,0,71,58,0,0,2348
"39013010900",5548,692,41,94,91,25,3,25,6519
"39013011000",3856,859,1,0,125,1,15,0,4857
"39013011200",3354,346,0,0,15,0,15,0,3730
"39013011300",3254,358,0,0,14,40,0,0,3666
"39013011400",3800,610,5,0,0,0,0,0,4415
"39013011500",1217,171,38,28,28,0,0,0,1482
"39013011600",711,526,0,0,8,7,0,0,1252
"39013011700",726,486,134,35,24,0,0,7,1412
"39013011900",2380,327,89,56,41,0,40,0,2933
"39013012000",1820,576,92,6,50,235,0,30,2809
"39013012100",759,251,16,7,2,167,3,0,1205
"39013012200",2702,330,0,3,67,0,47,0,3149
"39013012300",3562,231,85,0,98,0,16,0,3992
"39013012400",3990,196,256,0,33,12,13,0,4500
"39015951201",3916,375,0,0,35,10,30,8,4374
"39015951202",4024,539,0,0,144,40,113,0,4860
"39015951300",6591,963,0,64,102,15,127,0,7862
"39015951400",3217,867,0,0,76,41,0,0,4201
"39015951500",4687,610,0,0,64,0,11,0,5372
"39015951600",2589,682,7,14,78,27,35,12,3444
"39015951700",1995,479,122,22,43,24,0,0,2685
"39015951800",3799,1005,123,3,22,39,12,0,5003
"39015951900",5179,584,0,39,22,0,0,0,5824
"39017000100",3967,617,97,46,82,36,55,0,4900
"39017000200",3343,774,233,17,175,31,229,13,4815
"39017000300",1018,232,771,750,185,301,240,108,3605
"39017000400",1445,801,136,711,316,133,393,267,4202
"39017000500",2812,915,139,42,277,114,80,38,4417
"39017000600",3115,1507,26,170,81,52,93,119,5163
"39017001001",3941,695,378,0,102,0,34,0,5150
"39017001002",4641,534,271,32,211,16,0,51,5756
"39017001100",3063,1123,43,134,173,0,72,0,4608
"39017001300",4014,239,51,0,103,0,46,0,4453
"39017010101",1433,4194,13,133,211,285,40,45,6354
"39017010102",2191,365,78,58,53,50,80,31,2906
"39017010103",4085,1238,52,112,122,306,146,87,6148
"39017010104",10,78,9,12,0,0,0,0,109
"39017010201",39,0,0,0,0,0,0,0,39
"39017010202",3714,195,20,0,42,0,10,0,3981
"39017010203",5258,277,0,0,21,23,0,0,5579
"39017010301",3974,376,0,0,161,3,26,0,4540
"39017010302",3381,122,7,0,32,0,144,0,3686
"39017010500",1796,463,25,59,31,0,48,79,2501
"39017010600",3101,316,2,2,136,103,120,3,3783
"39017010800",6261,95,1,0,81,0,21,0,6459
"39017010901",3478,365,122,33,278,28,390,23,4717
"39017010903",4096,125,453,0,316,0,35,0,5025
"39017010904",3007,149,128,116,178,24,90,33,3725
"39017010906",3861,943,1697,492,402,42,622,592,8651
"39017010907",2132,110,160,0,111,0,8,0,2521
"39017010908",3808,268,948,5,65,0,171,0,5265
"39017010909",2925,213,1161,183,419,123,388,123,5535
"39017010910",4030,55,322,78,162,0,176,11,4834
"39017010911",3758,148,72,0,121,0,28,0,4127
"39017011002",11371,201,1125,2,138,0,139,0,12976
"39017011003",5470,369,203,0,148,0,15,0,6205
"39017011004",3494,1100,611,198,231,24,140,805,6603
"39017011109",3498,275,149,138,54,86,151,26,4377
"39017011110",4562,162,234,6,224,0,52,0,5240
"39017011111",5515,318,116,0,748,82,38,0,6817
"39017011112",4181,278,424,0,573,0,56,0,5512
"39017011116",6664,192,471,0,949,18,88,36,8418
"39017011117",9093,605,701,11,943,172,371,339,12235
"39017011118",2872,95,137,0,234,0,59,0,3397
"39017011120",5421,91,764,320,618,162,0,0,7376
"39017011121",6797,244,343,0,358,84,129,49,8004
"39017011122",3833,20,713,151,1033,26,414,26,6216
"39017011123",2145,863,676,563,180,363,471,917,6178
"39017011125",3057,40,90,0,270,67,72,0,3596
"39017011126",3538,772,393,58,744,348,309,94,6256
"39017011127",3895,72,237,6,433,82,122,0,4847
"39017011128",2554,77,185,0,454,0,109,0,3379
"39017011129",3081,202,258,31,335,35,297,0,4239
"39017011130",3895,56,530,0,344,238,293,219,5575
"39017011131",2467,93,229,0,113,7,119,0,3028
"39017011200",6654,293,283,28,318,126,128,76,7906
"39017011300",4416,372,107,36,324,0,406,192,5853
"39017011800",5094,265,118,0,144,0,221,0,5842
"39017012100",2613,506,0,0,17,0,0,0,3136
"39017012200",1711,968,279,42,112,6,23,0,3141
"39017012300",1714,469,30,52,21,2,0,12,2300
"39017012400",2088,43,85,0,11,4,12,0,2243
"39017012500",3725,215,189,0,446,0,69,0,4644
"39017012600",2025,167,210,28,126,50,45,0,2651
"39017012700",2452,367,138,13,9,65,118,0,3162
"39017013000",286,163,565,203,240,40,226,50,1773
"39017013100",518,359,713,269,28,114,45,119,2165
"39017013200",2135,851,106,203,237,164,239,58,3993
"39017013300",1705,203,9,0,31,0,36,0,1984
"39017013400",1327,401,133,154,5,83,10,0,2113
"39017013500",1814,488,134,168,251,158,21,17,3051
"39017013600",2998,1608,228,230,227,124,492,352,6259
"39017013900",1910,668,9,0,31,145,21,0,2784
"39017014000",754,758,338,334,90,103,127,327,2831
"39017014100",1177,652,75,196,141,55,72,0,2368
"39017014300",4296,274,0,9,9,24,0,0,4612
"39017014400",779,464,32,71,12,11,18,51,1438
"39017014600",314,370,73,28,13,48,20,59,925
"39017014700",2957,597,79,289,67,17,106,18,4130
"39017014800",5517,601,262,223,155,94,226,0,7078
"39017014900",4527,223,55,23,22,21,24,0,4895
"39017015000",6823,475,107,0,37,20,166,20,7648
"39017015100",5261,1201,121,366,380,62,198,0,7589
"39019720100",2869,498,0,29,108,4,81,0,3589
"39019720200",2777,680,68,0,159,0,71,0,3755
"39019720300",4254,607,19,1,72,33,22,0,5008
"39019720400",3546,384,85,3,0,0,25,0,4043
"39019720500",4127,1036,4,27,36,8,56,0,5294
"39019720600",2874,567,0,0,14,6,29,0,3490
"39019720700",2505,434,0,0,126,0,11,22,3098
"39021010100",1896,51,0,0,22,9,13,0,1991
"39021010200",6231,788,32,4,165,6,31,43,7300
"39021010400",2900,898,60,11,146,13,222,39,4289
"39021010500",2609,630,112,86,209,156,22,53,3877
"39021010600",2919,365,183,30,117,32,10,0,3656
"39021011001",2265,461,0,0,20,0,3,0,2749
"39021011501",3689,317,0,0,6,0,12,9,4033
"39021011504",4322,376,94,2,269,0,8,0,5071
"39021011505",2665,351,17,30,92,12,7,0,3174
"39021011506",2547,111,0,0,93,17,74,0,2842
"39023000200",309,199,482,352,80,98,52,79,1651
"39023000300",625,466,128,67,23,8,12,4,1333
"39023000400",1015,570,204,101,228,127,130,218,2593
"39023000500",765,480,53,7,57,139,8,0,1509
"39023000600",1229,578,451,186,27,213,23,0,2707
"39023000700",539,620,44,121,39,172,14,129,1678
"39023000901",1060,730,274,254,144,64,36,49,2611
"39023000902",138,169,549,140,40,28,10,0,1074
"39023001000",732,97,329,100,73,39,0,0,1370
"39023001101",267,231,372,200,36,141,17,75,1339
"39023001102",675,172,1440,420,47,88,0,0,2842
"39023001200",1080,1279,694,1126,112,360,23,41,4715
"39023001300",2443,813,148,23,132,116,63,101,3839
"39023001400",2231,506,207,286,221,0,100,0,3551
"39023001500",3042,1018,210,46,298,116,133,41,4904
"39023001600",3049,766,104,0,55,40,22,0,4036
"39023001700",1361,373,132,108,101,85,14,4,2178
"39023001900",2208,514,21,0,130,19,0,0,2892
"39023002000",2021,129,7,0,8,0,7,0,2172
"39023002100",971,252,41,0,42,24,38,4,1372
"39023002200",3739,255,142,0,116,0,62,0,4314
"39023002301",2732,449,0,0,7,0,0,0,3188
"39023002403",3210,280,121,45,241,129,94,107,4227
"39023002404",2393,204,335,15,91,0,59,0,3097
"39023002501",1730,160,15,9,8,5,2,7,1936
"39023002502",2413,412,55,0,85,50,10,0,3025
"39023002601",3469,240,3,0,51,0,2,0,3765
"39023002602",3330,561,9,4,77,12,34,12,4039
"39023002605",3610,126,66,6,109,0,9,0,3926
"39023002606",6664,370,0,1,233,0,35,49,7352
"39023002701",2768,554,110,0,67,0,513,111,4123
"39023002702",1733,299,1,0,193,14,244,35,2519
"39023002800",4149,144,0,0,109,1,3,0,4406
"39023002901",2767,615,33,0,310,94,89,107,4015
"39023002902",3336,772,0,0,237,96,298,184,4923
"39023003001",2628,130,31,0,88,0,68,0,2945
"39023003002",3162,154,40,81,82,0,74,0,3593
"39023003101",2355,83,33,0,102,0,45,0,2618
"39023003102",1610,246,0,0,57,25,15,0,1953
"39023003200",2370,172,24,0,27,0,43,4,2640
"39023003301",3123,256,0,0,95,26,152,10,3662
"39023003302",2154,421,0,0,67,2,0,0,2644
"39023003400",1978,1155,202,39,114,97,90,0,3675
"39023003700",3788,226,365,8,116,0,33,0,4536
"39025040101",4096,691,30,22,30,0,35,0,4904
"39025040102",2751,288,0,0,35,0,10,18,3102
"39025040202",2017,256,0,0,32,15,40,15,2375
"39025040203",5713,455,0,0,200,0,176,0,6544
"39025040204",5796,698,29,43,54,0,247,4,6871
"39025040301",3236,21,27,0,446,0,97,21,3848
"39025040302",2952,139,9,0,146,10,91,0,3347
"39025040303",7116,215,58,0,259,69,118,0,7835
"39025040401",2860,284,218,0,69,163,8,0,3602
"39025040403",2329,234,99,0,25,103,35,0,2825
"39025040404",3319,10,36,7,113,0,89,0,3574
"39025040405",2333,251,0,28,126,0,116,0,2854
"39025040500",3536,1205,48,55,129,24,42,0,5039
"39025040600",6375,196,58,0,164,0,70,0,6863
"39025040701",5846,644,126,101,47,0,69,0,6833
"39025040702",3445,351,31,0,93,10,205,108,4243
"39025040800",5170,475,11,8,315,0,49,0,6028
"39025040900",4335,1375,4,49,36,0,6,3,5808
"39025041000",6144,672,55,52,157,25,10,28,7143
"39025041101",2395,174,58,7,36,25,23,0,2718
"39025041102",2978,1080,95,120,90,169,36,109,4677
"39025041103",7304,837,81,0,525,14,258,0,9019
"39025041200",7630,415,76,0,189,59,82,13,8464
"39025041303",4575,384,21,0,109,297,0,351,5737
"39025041304",40,0,0,0,0,0,0,0,40
"39025041305",4625,298,58,2,194,9,40,9,5235
"39025041306",3323,314,41,24,307,45,16,24,4094
"39025041307",4194,226,12,0,286,0,97,0,4815
"39025041403",3540,621,0,0,119,9,28,0,4317
"39025041404",3917,487,26,0,99,31,0,11,4571
"39025041405",4613,726,78,12,13,0,11,11,5464
"39025041406",4558,48,0,0,229,9,24,0,4868
"39025041501",5934,432,250,0,99,0,87,42,6844
"39025041502",7165,405,12,0,184,54,0,21,7841
"39025041600",4088,980,30,6,70,0,7,35,5216
"39025041701",3414,962,61,0,40,0,43,0,4520
"39025041702",2871,376,12,0,41,25,42,25,3392
"39025041800",3225,597,0,11,36,8,8,10,3895
"39025041900",4433,786,371,0,8,0,0,0,5598
"39025042000",5505,799,8,0,139,0,114,17,6582
"39027964300",2641,992,3,0,73,44,70,0,3823
"39027964400",4783,393,36,0,25,10,184,0,5431
"39027964500",5521,684,45,114,130,37,14,0,6545
"39027964600",1319,547,236,64,120,115,0,99,2500
"39027964700",3347,936,281,98,7,34,42,152,4897
"39027964800",4284,502,7,0,37,7,0,0,4837
"39027964900",3950,680,0,0,213,15,0,0,4858
"39027965000",3570,403,0,0,109,0,42,0,4124
"39027965100",3279,691,8,0,78,59,35,0,4150
"39029950100",4664,1005,10,0,39,46,9,3,5776
"39029950200",3925,402,21,0,14,0,47,0,4409
"39029950300",4612,470,18,0,62,18,80,0,5260
"39029950400",3641,623,6,0,31,14,13,14,4342
"39029950500",4726,1000,56,0,28,0,247,0,6057
"39029950600",4072,724,19,0,107,12,99,0,5033
"39029950700",3804,1024,0,2,219,0,104,2,5155
"39029950800",3739,496,0,0,16,0,20,0,4271
"39029950900",3575,239,28,27,39,2,14,0,3924
"39029951000",4822,608,148,0,125,20,56,0,5779
"39029951100",3399,978,6,15,42,1,69,0,4510
"39029951200",3717,756,0,0,114,35,51,0,4673
"39029951300",3367,286,12,0,53,18,13,0,3749
"39029951400",4282,633,0,16,141,5,14,50,5141
"39029951500",3730,448,0,81,130,23,54,96,4562
"39029951600",5023,331,0,1,35,20,0,0,5410
"39029951700",4466,429,0,35,33,0,28,0,4991
"39029951800",1978,995,35,69,72,118,0,69,3336
"39029951900",2911,654,38,41,20,11,0,0,3675
"39029952000",2012,493,26,0,31,8,0,0,2570
"39029952100",941,330,59,23,31,0,0,0,1384
"39029952200",1221,471,105,133,60,54,3,0,2047
"39029952300",1849,833,73,124,61,95,26,32,3093
"39029952400",3398,338,47,58,120,39,2,0,4002
"39031960900",4215,416,0,0,46,11,0,0,4688
"39031961000",4069,755,124,0,44,11,23,0,5026
"39031961100",3473,710,90,1,41,58,41,0,4414
"39031961200",2348,285,0,0,0,0,3,0,2636
"39031961300",2465,1177,34,0,75,42,84,0,3877
"39031961400",2192,799,6,31,22,0,0,0,3050
"39031961500",1780,454,42,28,83,23,16,13,2439
"39031961600",2131,237,0,3,63,29,0,0,2463
"39031961700",2591,158,0,0,33,0,118,0,2900
"39031961800",4381,550,4,0,79,57,30,0,5101
"39033974100",3134,296,0,1,96,5,121,13,3666
"39033974200",3779,385,0,0,21,0,24,0,4209
"39033974300",2149,395,3,0,120,13,69,6,2755
"39033974400",2769,571,3,0,43,2,11,0,3399
"39033974500",3086,726,0,33,14,62,35,0,3956
"39033974600",2056,502,17,0,0,44,0,29,2648
"39033974700",3429,215,80,0,81,0,31,0,3836
"39033974800",1446,464,3,15,49,156,3,0,2136
"39033974900",2521,697,0,36,58,0,12,0,3324
"39033975000",3235,509,0,0,29,11,28,24,3836
"39033975100",1988,602,0,52,31,16,47,0,2736
"39033975200",2259,207,0,0,28,0,39,0,2533
"39033975300",2402,829,4,0,105,44,87,0,3471
"39035101101",302,404,357,297,111,326,136,126,2059
"39035101102",2773,266,1007,117,229,124,59,60,4635
"39035101200",1023,697,274,338,197,106,337,258,3230
"39035101300",630,347,283,243,137,99,97,135,1971
"39035101400",902,398,253,136,201,42,236,163,2331
"39035101501",847,313,288,506,186,347,388,286,3161
"39035101603",690,627,325,614,270,34,366,360,3286
"39035101700",943,378,580,377,139,208,501,248,3374
"39035101800",841,556,167,415,20,134,155,236,2524
"39035101901",769,247,219,205,149,117,290,199,2195
"39035102101",1234,514,322,542,297,16,453,73,3451
"39035102102",1142,363,659,140,360,100,585,209,3558
"39035102200",1543,342,384,183,267,79,460,305,3563
"39035102300",981,407,415,199,175,67,304,400,2948
"39035102401",938,682,104,276,116,155,327,548,3146
"39035102402",1219,515,435,707,367,195,593,110,4141
"39035102700",1392,1130,605,778,266,214,867,419,5671
"39035102800",406,699,175,463,165,33,256,464,2661
"39035102900",1068,524,66,140,174,131,692,373,3168
"39035103100",490,348,98,47,59,173,91,311,1617
"39035103300",601,82,439,1186,51,109,31,133,2632
"39035103400",975,600,275,371,89,41,405,326,3082
"39035103500",1028,324,140,73,133,84,275,127,2184
"39035103602",1485,493,318,420,171,130,141,70,3228
"39035103800",887,288,210,74,123,146,274,203,2205
"39035103900",632,538,152,235,256,206,440,422,2881
"39035104100",345,185,52,91,86,127,191,241,1318
"39035104200",531,106,161,309,46,21,39,72,1285
"39035104300",1374,189,66,203,39,33,63,0,1967
"39035104400",681,404,21,146,41,78,38,21,1430
"39035104600",328,283,211,62,153,52,186,162,1437
"39035104800",809,392,162,220,141,144,388,298,2554
"39035104900",857,552,91,185,227,297,513,534,3256
"39035105100",1945,779,299,208,241,106,691,350,4619
"39035105300",897,1105,100,36,332,390,562,867,4289
"39035105400",1534,523,454,205,411,377,811,416,4731
"39035105500",955,564,149,135,45,187,315,220,2570
"39035105602",730,389,438,375,191,303,377,223,3026
"39035105700",2367,841,335,214,330,231,272,204,4794
"39035105900",2357,551,78,78,244,41,301,198,3848
"39035106100",2444,382,254,129,485,19,722,141,4576
"39035106200",2258,385,145,111,405,369,462,229,4364
"39035106300",1743,455,194,80,310,101,465,44,3392
"39035106400",746,120,97,6,59,83,123,83,1317
"39035106500",1945,253,104,0,223,0,384,28,2937
"39035106600",2303,849,142,38,197,231,301,232,4293
"39035106800",975,620,182,354,272,250,404,368,3425
"39035106900",2533,647,146,35,207,95,288,148,4099
"39035107000",1389,68,33,3,119,0,158,18,1788
"39035107101",1642,293,230,206,73,44,90,27,2605
"39035107701",1066,337,322,239,195,137,18,21,2335
"39035107802",682,837,293,1141,589,411,125,25,4103
"39035108201",699,237,198,109,190,79,32,42,1586
"39035108301",279,130,149,212,561,216,127,15,1689
"39035108400",190,185,122,212,396,90,0,141,1336
"39035108701",61,110,1024,2986,39,93,4,61,4378
"39035109301",7,100,496,647,6,60,1,76,1393
"39035109701",0,0,350,1492,0,34,0,0,1876
"39035109801",0,0,475,1506,0,24,0,0,2005
"39035110501",148,204,92,110,142,21,127,26,870
"39035110801",405,163,376,187,11,18,159,54,1373
"39035110901",918,619,499,1176,133,33,96,82,3556
"39035111202",176,62,408,357,206,38,99,23,1369
"39035111401",8,0,562,469,34,0,0,0,1073
"39035111500",140,97,264,288,22,17,8,11,847
"39035111600",77,46,265,546,9,29,9,10,991
"39035111700",104,40,391,481,12,39,31,129,1227
"39035111800",8,7,398,315,15,0,20,0,763
"39035111902",22,23,293,375,6,0,0,0,719
"39035112100",4,26,613,1052,46,17,12,0,1770
"39035112200",3,11,581,484,2,16,2,38,1137
"39035112301",0,0,469,554,0,20,0,20,1063
"39035112400",25,13,816,155,27,8,44,14,1102
"39035112500",19,0,611,541,29,0,0,0,1200
"39035112600",41,5,294,643,0,47,0,0,1030
"39035112800",6,27,525,404,16,50,5,18,1051
"39035113101",0,0,266,237,6,0,6,0,515
"39035113500",0,0,567,631,0,20,0,0,1218
"39035113600",0,0,453,261,17,0,0,0,731
"39035113801",21,71,649,1004,13,7,0,28,1793
"39035114100",0,5,492,432,0,0,30,0,959
"39035114300",0,0,219,1423,0,6,0,0,1648
"39035114501",0,33,552,433,1,0,0,1,1020
"39035114600",341,204,419,228,0,8,0,0,1200
"39035114700",0,26,168,262,23,0,0,35,514
"39035114900",462,362,294,675,45,42,41,175,2096
"39035115100",393,211,198,463,23,20,77,76,1461
"39035115200",179,119,191,366,11,72,0,120,1058
"39035115300",117,42,275,428,7,11,7,0,887
"39035115400",534,362,407,297,45,14,50,0,1709
"39035115700",347,304,345,388,36,59,11,45,1535
"39035115800",927,621,607,807,32,8,134,0,3136
"39035115900",1224,315,1489,771,46,39,81,0,3965
"39035116100",0,5,517,395,8,11,0,3,939
"39035116200",5,0,534,455,11,20,0,6,1031
"39035116300",11,0,1066,658,4,0,0,0,1739
"39035116400",35,26,1377,1571,41,59,0,22,3131
"39035116500",0,0,1206,688,27,0,1,0,1922
"39035116600",2,2,1439,906,3,67,3,31,2453
"39035116700",25,0,905,673,11,36,22,14,1686
"39035116800",83,0,1614,602,7,0,0,0,2306
"39035116900",5,42,683,512,21,89,0,0,1352
"39035117101",411,54,1326,641,149,0,32,25,2638
"39035117102",31,12,621,527,0,0,0,0,1191
"39035117201",315,115,765,1688,0,17,0,17,2917
"39035117202",154,102,1012,572,0,24,0,68,1932
"39035117300",66,45,1024,1152,28,43,28,49,2435
"39035117400",127,46,636,715,5,25,0,0,1554
"39035117500",344,78,1636,754,126,0,0,0,2938
"39035117600",562,143,1613,368,82,68,79,0,2915
"39035117700",1896,244,1589,416,116,14,19,16,4310
"39035117800",222,250,1049,654,29,8,5,0,2217
"39035117900",65,13,1533,625,118,5,0,5,2364
"39035118101",78,0,918,940,85,8,5,0,2034
"39035118200",14,17,990,626,29,6,11,0,1693
"39035118301",104,0,1202,847,125,0,0,0,2278
"39035118400",10,10,1007,473,12,37,0,0,1549
"39035118500",0,56,581,227,11,4,0,0,879
"39035118602",1,14,533,1065,10,37,10,0,1670
"39035118700",314,430,223,355,36,175,0,40,1573
"39035118800",1048,656,184,37,237,397,19,213,2791
"39035118900",100,32,770,702,45,16,29,17,1711
"39035119100",61,19,38,0,0,4,0,0,122
"39035119202",118,26,358,288,10,22,0,0,822
"39035119300",0,77,1395,2088,20,35,0,72,3687
"39035119401",190,83,1112,200,279,57,43,7,1971
"39035119402",24,15,1086,604,13,18,5,1,1766
"39035119501",743,113,1221,401,147,42,33,0,2700
"39035119502",231,91,1241,220,61,1,101,12,1958
"39035119600",90,30,1272,607,1,0,60,0,2060
"39035119701",44,15,847,467,87,53,29,13,1555
"39035119702",1,1,784,919,27,26,27,26,1811
"39035119800",0,3,1844,1360,9,23,0,1,3240
"39035119900",0,43,1177,441,42,31,0,6,1740
"39035120200",0,65,1409,1065,45,25,25,39,2673
"39035120400",13,24,1444,793,18,7,16,39,2354
"39035120500",27,0,1271,1146,138,16,0,0,2598
"39035120600",0,11,1948,647,0,11,0,0,2617
"39035120701",4,12,757,665,0,0,0,2,1440
"39035120702",21,8,1077,541,21,0,7,0,1675
"39035120801",5,0,1462,543,32,0,80,9,2131
"39035120802",0,10,1348,679,0,15,0,0,2052
"39035121100",0,1,1296,1229,0,0,0,0,2526
"39035121200",0,4,1088,616,18,6,0,0,1732
"39035121300",57,19,1298,759,12,51,0,9,2205
"39035121401",0,0,1100,673,15,18,0,0,1806
"39035121403",12,15,1700,782,16,0,0,26,2551
"39035121500",8,35,2314,738,40,14,0,111,3260
"39035121700",6,11,2632,892,80,0,80,0,3701
"39035121800",8,14,1269,473,50,14,6,0,1834
"39035121900",0,18,873,381,0,0,0,0,1272
"39035122100",3,81,2641,342,28,47,0,0,3142
"39035122200",9,0,1132,486,34,53,47,0,1761
"39035122300",37,18,1177,456,62,0,28,19,1797
"39035123100",2156,205,34,0,128,51,9,0,2583
"39035123200",2514,381,126,0,143,0,138,0,3302
"39035123400",3066,323,75,0,247,18,419,48,4196
"39035123501",1687,620,600,350,142,81,154,77,3711
"39035123502",1631,349,208,139,318,146,265,147,3203
"39035123601",2424,216,164,31,211,39,268,77,3430
"39035123602",1938,308,88,133,213,84,136,57,2957
"39035123603",2806,252,55,74,125,8,142,31,3493
"39035123700",2059,192,36,29,185,50,328,91,2970
"39035123800",590,558,374,687,51,137,23,279,2699
"39035123900",1708,279,124,59,299,80,322,20,2891
"39035124100",2220,926,579,473,658,89,701,437,6083
"39035124201",1891,221,185,309,192,0,431,0,3229
"39035124202",943,251,113,34,89,79,125,81,1715
"39035124300",1891,262,845,697,530,214,549,420,5408
"39035124500",2342,616,357,119,251,113,296,42,4136
"39035124600",1989,901,340,145,233,78,435,236,4357
"39035126100",44,58,1888,690,95,0,0,0,2775
"39035127501",118,123,1865,1084,30,23,0,18,3261
"39035130103",4201,8,51,0,93,0,9,0,4362
"39035130104",3958,128,12,3,68,0,0,0,4169
"39035130105",3170,143,11,3,63,0,89,0,3479
"39035130106",3140,242,13,0,7,0,52,0,3454
"39035131102",1770,129,562,30,503,0,84,0,3078
"39035131103",3655,46,143,4,346,0,5,14,4213
"39035131104",2894,86,185,0,477,0,16,0,3658
"39035132100",1404,230,2689,301,126,25,167,0,4942
"39035132200",1505,62,1100,52,82,44,36,0,2881
"39035132301",1222,132,1729,220,75,23,11,55,3467
"39035132302",864,112,520,272,36,25,15,0,1844
"39035133103",355,169,2151,596,147,11,0,0,3429
"39035133104",735,93,1282,261,79,76,169,67,2762
"39035134100",863,88,185,6,72,17,71,0,1302
"39035134203",2929,171,63,2,219,0,113,10,3507
"39035134204",3242,600,71,34,0,92,0,28,4067
"39035134205",2539,34,141,0,123,0,195,1,3033
"39035134206",2550,358,32,0,93,14,14,0,3061
"39035134300",1678,195,217,3,58,0,1,0,2152
"39035135103",2107,31,35,0,32,0,44,0,2249
"39035135104",3997,16,25,0,148,13,34,0,4233
"39035135105",5232,287,41,9,149,0,0,0,5718
"39035135106",1231,49,0,0,5,0,0,0,1285
"39035136101",4695,339,51,0,636,13,157,0,5891
"39035136102",5911,103,628,18,884,47,285,0,7876
"39035136103",5176,264,0,2,331,0,0,2,5775
"39035137101",1510,277,218,77,239,37,256,0,2614
"39035137102",3049,580,380,3,446,63,409,169,5099
"39035137103",3082,352,82,0,487,82,442,9,4536
"39035138105",843,101,84,103,61,0,34,68,1294
"39035138106",2589,476,122,158,88,0,83,213,3729
"39035138107",1833,151,69,0,16,0,35,5,2109
"39035138108",3534,322,65,3,192,0,134,8,4258
"39035138109",3514,243,156,0,186,0,223,0,4322
"39035138110",3318,200,109,2,287,36,200,41,4193
"39035140100",151,79,982,195,61,0,0,0,1468
"39035140301",91,18,1463,769,22,17,5,0,2385
"39035140302",863,230,1115,218,95,39,35,0,2595
"39035140400",922,51,1349,170,123,0,81,0,2696
"39035140500",1033,149,1542,633,135,0,99,0,3591
"39035140600",380,55,367,8,87,0,57,0,954
"39035140701",669,47,727,870,153,36,37,0,2539
"39035140702",663,62,949,172,46,39,0,5,1936
"39035140800",1532,467,1123,177,260,135,7,6,3707
"39035140900",521,27,1136,433,26,0,12,30,2185
"39035141000",254,40,344,544,21,0,0,8,1211
"39035141100",1991,649,302,386,702,156,138,14,4338
"39035141200",2066,299,360,16,271,103,55,26,3196
"39035141300",1543,151,146,252,140,36,82,0,2350
"39035141400",1967,24,96,112,185,35,92,0,2511
"39035141500",1234,118,159,68,78,27,5,29,1718
"39035141601",1303,55,109,23,100,0,46,0,1636
"39035141602",429,49,677,203,38,13,0,0,1409
"39035141700",944,34,327,8,97,0,42,0,1452
"39035150100",11,61,1607,561,9,0,11,0,2260
"39035150300",13,34,834,911,9,31,0,0,1832
"39035150400",0,11,726,702,7,33,0,26,1505
"39035151100",9,18,786,450,0,9,0,16,1288
"39035151200",36,8,668,773,59,0,0,0,1544
"39035151300",217,160,782,624,16,25,16,0,1840
"39035151400",25,100,992,405,28,0,0,0,1550
"39035151500",6,3,778,371,27,8,4,0,1197
"39035151600",26,17,699,562,28,17,0,0,1349
"39035151700",26,97,545,339,0,66,24,31,1128
"39035151800",11,6,851,925,41,0,0,0,1834
"39035152101",1814,49,382,123,20,1,22,0,2411
"39035152102",1777,208,1464,729,125,8,33,0,4344
"39035152201",812,106,1647,375,37,34,71,0,3082
"39035152202",1901,160,1504,547,101,0,32,0,4245
"39035152301",921,91,1302,137,173,9,12,0,2645
"39035152302",2199,245,1472,467,137,0,86,20,4626
"39035152303",1791,204,1197,460,130,0,40,0,3822
"39035152400",712,90,734,184,48,0,26,14,1808
"39035152501",1264,170,1583,267,137,8,79,0,3508
"39035152502",579,151,1056,539,136,0,45,22,2528
"39035152603",166,40,490,266,35,31,16,0,1044
"39035152604",1446,145,1376,1088,0,133,80,15,4283
"39035152701",89,0,1207,677,25,10,13,0,2021
"39035152702",296,31,1242,468,68,20,9,11,2145
"39035152703",520,96,1031,25,36,3,13,0,1724
"39035153103",2616,100,0,20,24,0,0,7,2767
"39035153104",2504,314,43,0,199,18,159,14,3251
"39035153105",3164,311,170,43,115,25,84,0,3912
"39035153106",3079,262,0,0,143,62,108,196,3850
"39035153107",2741,305,51,37,183,20,128,20,3485
"39035154100",911,278,495,257,38,71,44,66,2160
"39035154200",658,175,329,185,7,0,40,0,1394
"39035154300",15,21,768,303,25,0,4,0,1136
"39035154400",1124,146,859,521,116,89,35,8,2898
"39035154501",1962,223,496,478,94,11,51,1,3316
"39035154502",1882,49,814,247,131,0,76,0,3199
"39035154601",2397,305,1214,365,90,48,25,0,4444
"39035154603",2007,228,852,185,66,0,69,0,3407
"39035154604",2449,159,995,157,125,11,73,0,3969
"39035154700",95,0,1615,657,9,26,26,0,2428
"39035155101",4582,70,60,1,495,45,102,13,5368
"39035155102",2751,194,88,9,37,0,35,79,3193
"39035156101",1231,51,28,0,35,0,63,0,1408
"39035156102",5546,178,0,1,74,0,14,0,5813
"39035160100",1737,82,21,0,30,6,73,19,1968
"39035160200",1755,106,191,15,158,0,85,0,2310
"39035160300",1660,70,21,0,42,113,83,10,1999
"39035160400",2279,567,152,0,170,74,68,9,3319
"39035160500",2988,402,64,52,71,0,141,36,3754
"39035160601",3830,582,445,47,131,11,238,153,5437
"39035160602",1651,445,313,163,143,133,20,34,2902
"39035160700",1119,402,93,8,0,21,46,29,1718
"39035160800",872,149,0,4,34,9,16,0,1084
"39035160900",3335,242,20,85,148,0,153,47,4030
"39035161000",1369,206,54,6,98,25,105,37,1900
"39035161100",3190,347,45,115,35,7,259,78,4076
"39035161200",2135,278,96,122,261,0,58,0,2950
"39035161300",1934,521,130,84,111,56,38,10,2884
"39035161400",2495,300,105,72,182,10,58,10,3232
"39035161500",2792,694,189,57,37,29,24,46,3868
"39035161600",1466,291,54,83,118,19,33,33,2097
"39035161700",1081,563,163,129,187,73,168,51,2415
"39035161800",443,369,60,74,153,61,17,40,1217
"39035170101",2058,70,485,35,74,0,33,0,2755
"39035170102",4299,167,264,458,28,1,103,1,5321
"39035170201",1931,53,53,6,47,0,14,0,2104
"39035170202",3278,86,80,26,82,22,18,0,3592
"39035171102",667,84,3339,535,71,91,36,36,4859
"39035171103",538,79,2240,804,229,0,74,0,3964
"39035171104",407,23,2622,1412,42,210,49,52,4817
"39035171203",1122,179,969,236,22,16,0,0,2544
"39035171204",494,129,890,360,22,0,53,66,2014
"39035171205",790,152,1311,157,91,0,62,0,2563
"39035171206",1002,58,971,195,103,1,23,0,2353
"39035172101",2087,118,111,6,164,0,43,0,2529
"39035172102",2869,283,281,50,121,9,108,8,3729
"39035172103",2642,497,1000,41,677,73,194,0,5124
"39035172201",3236,144,160,0,296,21,19,0,3876
"39035172202",2901,215,468,17,80,221,37,0,3939
"39035173103",2381,108,32,0,153,0,159,9,2842
"39035173104",3540,227,27,19,224,0,255,49,4341
"39035173105",2219,130,21,0,197,0,78,0,2645
"39035173106",2014,173,119,0,1380,108,122,39,3955
"39035173107",2190,35,5,0,35,0,92,0,2357
"39035174103",2441,343,25,0,126,9,146,0,3090
"39035174104",1913,274,30,0,71,0,117,12,2417
"39035174105",2373,286,32,0,222,0,88,0,3001
"39035174106",2415,182,27,0,219,8,24,0,2875
"39035174107",3473,371,0,0,112,0,0,0,3956
"39035174203",2737,90,134,0,166,0,35,0,3162
"39035174204",3373,165,35,10,330,16,158,38,4125
"39035174205",4240,194,111,1,243,13,351,12,5165
"39035174206",1586,127,26,13,203,0,111,10,2076
"39035174207",2484,399,86,2,135,7,119,7,3239
"39035175103",5865,434,209,0,292,0,201,0,7001
"39035175104",5144,390,198,0,471,0,108,0,6311
"39035175105",4363,114,0,2,214,1,23,16,4733
"39035175106",2819,100,0,0,118,0,0,0,3037
"39035175201",5618,148,30,1,146,343,173,0,6459
"39035175202",2674,197,38,19,79,7,29,0,3043
"39035176100",2117,52,0,2,5,10,49,0,2235
"39035176200",5073,187,30,4,157,0,114,18,5583
"39035177101",2606,556,284,77,216,198,150,48,4135
"39035177103",2686,588,132,32,251,163,200,134,4186
"39035177104",2730,502,0,7,48,89,58,55,3489
"39035177201",3424,296,5,28,316,54,246,31,4400
"39035177202",2675,388,212,0,94,48,321,0,3738
"39035177302",2106,172,0,0,129,0,151,0,2558
"39035177303",3818,491,96,0,201,145,335,137,5223
"39035177304",2176,492,104,68,146,158,237,170,3551
"39035177403",2823,147,0,0,150,0,161,0,3281
"39035177404",2543,106,10,8,95,4,111,20,2897
"39035177405",4128,180,32,56,99,0,53,0,4548
"39035177406",3127,568,221,2,256,0,260,82,4516
"39035177501",3356,660,15,1,142,1,254,69,4498
"39035177503",2994,269,38,13,141,0,156,0,3611
"39035177504",3376,367,34,51,48,23,12,12,3923
"39035177505",4318,118,0,0,74,0,65,0,4575
"39035177604",1896,123,35,9,38,5,13,5,2124
"39035177605",2488,173,16,0,84,0,93,0,2854
"39035177606",3072,225,19,45,89,0,260,21,3731
"39035177607",3174,413,30,14,298,11,146,8,4094
"39035177608",4352,505,313,18,192,79,87,13,5559
"39035177609",1712,98,4,4,37,0,45,0,1900
"39035178101",2026,240,52,104,302,0,83,22,2829
"39035178102",3523,476,279,222,340,12,51,103,5006
"39035178201",2948,182,22,14,192,8,118,18,3502
"39035178204",3414,764,137,0,123,22,170,23,4653
"39035178205",1668,136,0,0,132,7,34,9,1986
"39035178206",2466,222,2,2,128,20,133,0,2973
"39035179101",2384,104,162,0,325,5,57,0,3037
"39035179102",2388,30,82,0,358,8,77,0,2943
"39035180102",1921,196,1225,182,400,44,110,0,4078
"39035180103",1671,165,1536,74,186,11,25,0,3668
"39035180104",759,31,1358,322,141,69,143,0,2823
"39035181100",5702,187,15,0,121,0,30,0,6055
"39035181201",4974,457,175,27,124,0,135,101,5993
"39035181203",2911,111,78,0,5,0,48,13,3166
"39035181204",4712,175,51,16,124,0,174,0,5252
"39035182103",2328,109,31,0,81,0,0,0,2549
"39035182104",2255,84,19,1,82,0,121,0,2562
"39035182105",3234,168,122,0,123,0,6,0,3653
"39035182106",2860,104,1,2,95,9,19,0,3090
"39035183100",1483,139,401,85,577,152,10,36,2883
"39035183200",1926,12,181,14,250,14,68,0,2465
"39035183300",3484,46,379,56,284,0,130,18,4397
"39035183401",1418,31,304,53,242,56,38,58,2200
"39035183402",232,18,873,100,75,4,4,0,1306
"39035183501",1690,172,1013,58,354,4,143,9,3443
"39035183502",2339,79,611,214,320,30,94,0,3687
"39035183603",36,53,865,481,67,0,12,0,1514
"39035183604",480,81,1313,156,55,28,31,54,2198
"39035183605",1178,19,1070,72,401,0,50,0,2790
"39035183606",530,24,827,103,140,47,7,0,1678
"39035184103",3231,135,215,0,343,17,47,0,3988
"39035184104",1183,6,249,48,238,0,75,0,1799
"39035184105",3098,49,437,31,1034,12,67,8,4736
"39035184106",1471,204,358,30,245,21,80,11,2420
"39035184108",5388,135,630,10,1257,0,158,0,7578
"39035185101",520,30,1640,75,268,0,0,0,2533
"39035185102",1177,161,1317,0,107,0,0,0,2762
"39035185103",1153,122,759,9,100,0,0,43,2186
"39035185104",2482,130,879,269,264,0,60,0,4084
"39035185201",297,83,1276,64,46,0,19,0,1785
"39035185202",2167,107,2057,328,218,0,223,0,5100
"39035185203",2184,387,508,30,143,0,74,15,3341
"39035186103",3817,95,45,0,179,0,94,0,4230
"39035186104",2427,143,35,11,19,0,12,0,2647
"39035186105",3189,129,121,13,86,0,54,0,3592
"39035186106",3543,491,177,251,462,70,330,13,5337
"39035186107",5019,200,74,2,358,0,0,0,5653
"39035186201",5121,202,52,12,415,0,293,0,6095
"39035186202",4011,66,128,15,364,2,145,2,4733
"39035186203",3294,52,160,0,138,0,155,0,3799
"39035186205",4607,37,23,0,362,13,45,0,5087
"39035186206",3645,18,19,0,544,0,20,0,4246
"39035187103",1060,327,1125,243,55,36,14,0,2860
"39035187104",2253,260,536,82,91,17,62,0,3301
"39035187105",1377,177,289,25,18,26,102,6,2020
"39035187106",2622,399,310,42,208,26,125,20,3752
"39035188103",91,1,2459,816,105,22,21,8,3523
"39035188104",83,5,1263,266,5,0,5,0,1627
"39035188105",107,14,2470,669,61,10,10,0,3341
"39035188106",88,25,1900,353,8,3,0,0,2377
"39035188107",355,41,1611,393,20,0,0,0,2420
"39035189105",3703,145,10,5,215,31,99,1,4209
"39035189107",4140,214,0,4,329,0,14,64,4765
"39035189108",4196,260,9,15,409,3,246,4,5142
"39035189109",2987,100,35,0,51,8,18,5,3204
"39035189110",3310,227,288,0,268,34,337,0,4464
"39035189111",5643,262,93,0,716,48,113,116,6991
"39035189112",3233,82,57,6,519,0,25,0,3922
"39035190502",1897,131,0,0,17,0,0,0,2045
"39035190503",1621,22,26,2,28,0,91,4,1794
"39035190504",9623,413,170,0,446,45,207,35,10939
"39035192300",1426,68,15,4,5,8,38,0,1564
"39035192800",912,67,117,13,37,7,3,0,1156
"39035192900",1793,89,5,42,27,0,11,3,1970
"39035193800",71,33,527,172,12,3,12,4,834
"39035193900",57,23,319,190,9,11,9,9,627
"39035194100",1901,82,108,6,39,1,0,0,2137
"39035194300",3014,65,17,0,286,30,26,0,3438
"39035194500",1915,126,26,19,78,15,55,0,2234
"39035194800",91,68,538,75,109,44,41,19,985
"39035194900",2519,27,294,100,301,47,75,0,3363
"39035195600",725,47,3118,302,403,16,83,5,4699
"39035195700",1278,316,2299,219,319,23,0,84,4538
"39035195800",3076,147,306,0,314,0,43,0,3886
"39035195900",3894,129,0,0,86,0,36,0,4145
"39035196000",426,67,985,38,35,0,8,4,1563
"39035196100",1684,284,160,280,116,88,62,21,2695
"39035196200",190,57,2091,1456,51,25,38,0,3908
"39035196300",3509,118,97,3,282,0,159,0,4168
"39035196400",663,238,1046,798,90,25,428,151,3439
"39035196500",19,6,760,763,16,0,6,0,1570
"39035980100",0,0,0,0,0,0,0,0,0
"39035980500",0,0,0,0,0,0,0,0,0
"39035981100",0,0,0,0,0,0,0,0,0
"39035990000",0,0,0,0,0,0,0,0,0
"39037500100",3767,280,2,3,12,2,5,2,4073
"39037510100",2982,733,17,6,56,20,301,60,4175
"39037520100",2738,568,8,0,18,6,34,6,3378
"39037530100",3943,384,0,0,18,0,4,0,4349
"39037540100",2994,389,0,0,12,10,35,6,3446
"39037550100",3090,263,9,0,7,11,29,0,3409
"39037555000",4925,702,8,27,95,11,16,54,5838
"39037555101",2769,540,14,133,119,70,49,0,3694
"39037555102",3078,824,11,1,107,50,16,24,4111
"39037560100",6164,898,31,34,105,23,47,6,7308
"39037570101",2655,214,0,10,36,4,0,0,2919
"39037570102",4902,616,2,0,88,14,4,28,5654
"39039958100",3828,329,6,0,185,0,200,0,4548
"39039958200",4265,680,24,14,37,5,69,24,5118
"39039958300",3382,425,0,0,201,39,257,22,4326
"39039958400",3457,450,33,2,172,28,374,57,4573
"39039958500",2589,688,171,7,238,69,330,73,4165
"39039958600",2992,516,34,35,192,50,221,52,4092
"39039958700",3651,340,85,15,182,249,502,249,5273
"39039958800",2099,761,78,36,83,68,476,167,3768
"39039958900",4263,218,56,47,469,0,520,0,5573
"39041010100",3193,461,103,13,103,17,144,8,4042
"39041010200",4714,356,41,2,63,35,43,0,5254
"39041010420",2223,325,72,16,131,0,63,0,2830
"39041010421",2101,200,56,0,67,0,45,0,2469
"39041010422",5320,336,61,10,264,50,100,0,6141
"39041010520",4754,132,512,46,284,21,37,0,5786
"39041010530",1591,758,273,88,211,34,45,14,3014
"39041011101",2473,457,0,0,37,3,56,19,3045
"39041011102",5093,113,54,36,158,0,49,0,5503
"39041011200",2948,149,24,0,24,7,24,7,3183
"39041011411",2608,40,57,0,295,22,62,0,3084
"39041011412",3958,21,85,0,495,20,155,0,4734
"39041011413",5972,138,181,6,793,18,123,0,7231
"39041011421",5748,43,337,31,616,0,104,10,6889
"39041011423",6294,12,73,0,562,46,12,0,6999
"39041011430",2477,59,37,0,184,0,125,0,2882
"39041011520",3052,97,278,141,479,3,172,0,4222
"39041011530",2985,206,41,0,623,13,198,0,4066
"39041011540",5041,72,89,0,728,46,91,0,6067
"39041011550",6850,657,290,4,1280,0,252,152,9485
"39041011560",7289,81,341,12,650,0,186,47,8606
"39041011561",3419,320,271,63,555,6,257,0,4891
"39041011604",5376,108,109,3,189,2,121,22,5930
"39041011710",5223,185,342,0,344,0,45,0,6139
"39041011730",5765,113,422,0,418,0,354,0,7072
"39041011740",5254,53,236,0,355,0,61,20,5979
"39041011750",6428,32,194,0,413,12,54,0,7133
"39041011760",4225,251,40,0,54,0,18,0,4588
"39041011762",5017,142,150,0,240,0,36,0,5585
"39041011900",4395,208,259,0,689,0,67,36,5654
"39041012000",5215,275,0,0,48,0,241,43,5822
"39041012100",6509,223,202,0,480,0,77,0,7491
"39041012200",4084,251,87,58,242,0,18,6,4746
"39041012300",3970,236,51,0,77,0,40,21,4395
"39041012400",3751,207,397,0,986,84,273,94,5792
"39043040100",5078,475,37,0,98,0,250,92,6030
"39043040200",3386,307,0,0,129,0,114,0,3936
"39043040300",5641,372,0,55,132,99,37,38,6374
"39043040400",4941,268,20,0,84,8,20,0,5341
"39043040500",3617,913,57,0,168,141,90,0,4986
"39043040600",770,27,0,0,20,0,1,0,818
"39043040700",2382,438,599,173,160,212,113,49,4126
"39043040800",2130,751,526,300,184,150,40,105,4186
"39043040900",2448,351,75,293,82,24,53,65,3391
"39043041000",1662,243,855,152,215,94,228,62,3511
"39043041100",2026,578,614,154,201,97,151,167,3988
"39043041200",1067,263,652,135,169,86,86,51,2509
"39043041300",1892,508,636,508,80,146,112,168,4050
"39043041400",2083,96,121,43,83,0,32,11,2469
"39043041500",3069,157,45,0,128,0,98,85,3582
"39043041600",5099,103,130,27,318,0,184,10,5871
"39043041700",5660,456,50,0,246,35,138,156,6741
"39043041800",5712,89,38,2,181,4,118,0,6144
"39043990100",0,0,0,0,0,0,0,0,0
"39045030100",3351,326,6,0,63,16,148,0,3910
"39045030200",2704,316,27,0,28,0,11,0,3086
"39045030300",2636,642,0,0,39,0,28,64,3409
"39045030400",4393,176,25,0,88,7,15,7,4711
"39045030600",7433,278,1149,97,734,121,239,0,10051
"39045030700",2936,79,164,0,200,14,18,5,3416
"39045030800",4859,202,2,0,183,0,82,0,5328
"39045030900",7760,207,32,0,164,3,187,0,8353
"39045031000",5125,454,44,0,32,20,40,0,5715
"39045031100",5106,795,23,10,12,105,29,0,6080
"39045031200",4651,362,7,1,39,2,27,1,5090
"39045031300",2293,510,1,22,50,45,0,0,2921
"39045031400",5176,987,84,4,220,82,85,33,6671
"39045031500",2309,416,0,111,15,6,35,9,2901
"39045031600",4755,1314,51,0,224,35,87,64,6530
"39045031700",2705,1482,0,1,122,20,0,118,4448
"39045032000",2020,746,0,32,68,14,82,13,2975
"39045032100",2976,445,37,8,139,28,43,0,3676
"39045032200",2037,1226,24,0,46,67,28,51,3479
"39045032300",3346,599,11,25,27,0,0,13,4021
"39045032500",4334,222,0,0,58,5,20,0,4639
"39045032600",6349,371,2,0,24,48,78,0,6872
"39045032701",2784,85,957,22,436,7,61,0,4352
"39045032702",3729,256,2068,515,1092,9,663,0,8332
"39045032800",3503,34,193,0,82,0,123,0,3935
"39045032900",8491,271,915,7,508,0,61,0,10253
"39045033000",3545,251,479,45,89,0,0,0,4409
"39045033100",6625,288,1418,163,584,53,238,0,9369
"39047925800",3169,536,15,10,55,137,81,215,4218
"39047925900",2735,598,65,0,268,7,6,20,3699
"39047926000",3038,747,33,33,37,10,36,0,3934
"39047926100",3219,1210,47,24,147,32,31,27,4737
"39047926200",3316,838,197,34,86,42,44,0,4557
"39047926300",2659,452,0,0,104,38,32,9,3294
"39047926400",3664,414,9,13,57,10,14,0,4181
"39049000110",3296,144,19,0,160,16,38,0,3673
"39049000120",2922,97,15,13,192,0,82,0,3321
"39049000210",3067,97,75,3,245,0,57,15,3559
"39049000220",3628,85,51,0,113,0,61,0,3938
"39049000310",1849,292,579,346,78,67,43,33,3287
"39049000320",1851,179,203,15,96,29,10,14,2397
"39049000330",1099,608,305,155,220,34,101,42,2564
"39049000410",2178,52,48,7,163,0,28,0,2476
"39049000420",2858,185,60,11,177,50,21,0,3362
"39049000500",3319,232,56,42,360,468,166,14,4657
"39049000600",2786,853,161,39,493,273,36,29,4670
"39049000710",1311,507,397,684,112,317,48,197,3573
"39049000720",338,165,750,447,147,207,9,5,2068
"39049000730",165,115,1686,1191,170,60,81,28,3496
"39049000810",1415,136,567,121,164,26,138,19,2586
"39049000820",1015,243,677,533,68,108,15,152,2811
"39049000910",528,176,1512,906,89,198,10,0,3419
"39049000920",306,65,578,424,62,233,11,0,1679
"39049001000",2994,1567,19,275,140,315,76,35,5421
"39049001110",686,1525,0,52,80,427,0,22,2792
"39049001121",26,114,0,0,4,4,8,4,160
"39049001122",541,393,34,64,226,212,68,22,1560
"39049001200",890,2245,47,89,108,313,57,62,3811
"39049001300",901,3249,208,140,113,132,58,158,4959
"39049001400",126,88,474,620,134,52,0,15,1509
"39049001500",28,48,455,1138,121,154,9,0,1953
"39049001600",373,269,131,478,25,65,32,81,1454
"39049001700",623,886,158,246,175,172,124,162,2546
"39049001810",590,2027,16,101,207,248,90,51,3330
"39049001820",1577,489,213,126,277,97,115,30,2924
"39049001901",1688,294,100,37,91,7,108,0,2325
"39049001902",2784,345,0,74,151,51,84,10,3499
"39049002000",2477,300,72,65,259,1,75,1,3250
"39049002100",1312,141,81,4,76,11,44,0,1669
"39049002200",1364,249,95,27,202,0,77,9,2023
"39049002300",42,116,658,406,14,59,10,27,1332
"39049002510",335,201,1696,593,143,79,15,52,3114
"39049002520",382,160,1111,831,59,62,0,0,2605
"39049002600",842,212,918,773,489,410,608,319,4571
"39049002710",317,105,678,528,182,80,119,51,2060
"39049002730",373,33,742,645,211,190,152,139,2485
"39049002740",1822,134,312,161,35,0,7,20,2491
"39049002750",664,228,750,719,70,0,186,6,2623
"39049002760",1510,240,934,596,109,87,87,74,3637
"39049002770",353,60,806,454,195,170,92,134,2264
"39049002780",1285,81,847,35,96,1,49,1,2395
"39049002800",289,217,952,340,78,102,22,9,2009
"39049002900",113,132,497,1641,11,244,60,68,2766
"39049003000",1888,289,167,408,227,120,35,54,3188
"39049003200",1858,312,122,27,155,8,100,10,2592
"39049003600",268,89,606,260,166,19,56,2,1466
"39049003700",661,223,1425,866,172,34,28,9,3418
"39049003800",855,191,553,367,121,20,20,0,2127
"39049004000",1788,462,391,260,274,40,58,26,3299
"39049004200",104,129,53,268,0,36,0,0,590
"39049004300",3266,1128,266,183,201,54,138,0,5236
"39049004500",2199,1190,206,383,372,23,142,71,4586
"39049004610",2254,399,187,4,149,81,179,99,3352
"39049004620",863,805,224,222,73,146,38,63,2434
"39049004700",1798,1206,949,670,46,196,438,259,5562
"39049004810",1960,846,106,95,66,157,79,179,3488
"39049004820",1003,792,161,226,51,115,114,227,2689
"39049004900",1921,1250,797,1048,160,307,38,57,5578
"39049005000",1805,1032,255,750,151,263,76,87,4419
"39049005100",329,489,89,596,11,90,6,56,1666
"39049005200",2414,96,196,0,113,14,24,0,2857
"39049005300",494,217,1042,759,260,112,104,0,2988
"39049005410",164,88,480,687,48,206,48,22,1743
"39049005420",80,112,1159,678,133,79,0,14,2255
"39049005500",329,148,2179,1435,188,124,95,17,4515
"39049005610",359,112,660,419,98,88,21,0,1757
"39049005620",907,440,459,522,105,160,13,73,2679
"39049005700",2571,423,73,0,105,60,63,0,3295
"39049005810",2083,249,125,6,36,13,44,6,2562
"39049005820",1293,451,79,15,49,25,13,0,1925
"39049005900",512,146,823,810,88,34,41,14,2468
"39049006000",833,300,211,417,91,71,32,0,1955
"39049006100",869,897,346,221,154,131,157,178,2953
"39049006220",6260,131,129,53,882,87,491,0,8033
"39049006230",9792,332,450,87,4620,44,270,0,15595
"39049006236",5266,137,15,0,627,0,332,12,6389
"39049006310",4157,99,21,8,239,9,117,24,4674
"39049006321",3938,63,21,0,545,20,129,0,4716
"39049006323",2872,226,0,158,239,78,45,0,3618
"39049006330",4228,452,20,17,183,35,84,0,5019
"39049006340",2711,56,16,0,178,29,27,0,3017
"39049006351",3040,257,132,20,414,21,235,0,4119
"39049006352",1632,429,232,45,437,174,95,7,3051
"39049006353",3199,380,212,20,559,14,34,0,4418
"39049006371",5141,626,296,88,987,152,239,0,7529
"39049006372",3637,934,564,38,1190,197,656,65,7281
"39049006383",6695,510,625,41,1044,259,761,188,10123
"39049006384",5582,77,256,17,829,18,390,29,7198
"39049006386",3027,152,71,22,944,84,481,51,4832
"39049006387",4558,354,310,15,485,324,342,311,6699
"39049006391",4675,59,64,14,404,0,76,14,5306
"39049006392",3890,25,72,0,482,0,81,0,4550
"39049006393",4299,87,275,194,796,80,109,52,5892
"39049006394",2160,74,374,0,170,0,12,13,2803
"39049006395",2282,273,93,0,657,51,96,38,3490
"39049006396",3371,376,308,4,490,248,42,0,4839
"39049006410",2442,110,35,27,211,0,37,0,2862
"39049006430",3934,126,48,0,544,0,369,29,5050
"39049006500",3225,147,0,0,45,0,0,67,3484
"39049006600",3532,324,74,0,100,10,39,0,4079
"39049006710",2270,159,70,0,233,0,121,0,2853
"39049006721",3177,11,0,2,116,11,47,11,3375
"39049006722",2514,146,44,0,155,23,54,0,2936
"39049006810",2109,37,0,0,58,0,82,0,2286
"39049006821",2229,520,190,113,313,71,221,8,3665
"39049006822",1930,93,8,0,54,0,27,29,2141
"39049006910",1526,4,13,0,93,0,0,0,1636
"39049006921",1974,572,555,211,266,148,110,300,4136
"39049006923",1802,291,876,117,207,55,90,80,3518
"39049006924",1791,144,1144,229,319,108,255,0,3990
"39049006931",1753,269,2052,1168,1047,124,320,156,6889
"39049006932",2167,234,2082,874,670,113,416,0,6556
"39049006933",1094,285,2142,1457,269,153,392,30,5822
"39049006942",545,47,533,69,139,18,85,0,1436
"39049006943",2113,107,828,956,429,63,216,47,4759
"39049006944",2927,164,679,225,86,38,58,0,4177
"39049006945",1534,667,2048,792,540,384,453,681,7099
"39049006950",2506,107,0,1,110,0,21,23,2768
"39049006990",4840,336,889,280,396,265,433,55,7494
"39049007010",1643,300,173,222,138,0,172,0,2648
"39049007020",5312,355,115,0,349,105,39,26,6301
"39049007041",1584,57,69,0,250,0,38,5,2003
"39049007043",3168,373,569,158,498,86,697,238,5787
"39049007044",3906,34,460,0,1666,117,220,0,6403
"39049007047",2400,437,467,35,409,41,145,123,4057
"39049007048",4414,121,739,80,1008,74,126,0,6562
"39049007112",2448,323,2283,693,455,44,117,32,6395
"39049007113",2064,336,1742,357,255,76,229,73,5132
"39049007114",2294,370,1392,410,174,123,6,8,4777
"39049007115",2309,302,1338,350,356,16,431,14,5116
"39049007120",3699,181,531,49,390,73,103,0,5026
"39049007132",5650,145,1540,77,879,17,532,24,8864
"39049007193",5917,121,157,13,266,20,184,0,6678
"39049007194",5176,183,333,164,236,73,0,44,6209
"39049007198",2037,176,271,96,189,18,84,0,2871
"39049007199",3590,120,1420,67,487,0,225,0,5909
"39049007201",549,47,8,0,30,0,0,0,634
"39049007202",1937,150,1127,45,222,64,61,14,3620
"39049007203",2810,240,293,0,696,0,46,0,4085
"39049007205",3878,0,318,0,241,0,15,0,4452
"39049007207",3786,109,266,48,469,95,41,0,4814
"39049007209",5168,154,327,281,838,0,149,0,6917
"39049007210",7719,109,98,0,1073,44,147,0,9190
"39049007393",7256,145,911,166,460,83,20,0,9041
"39049007394",2451,18,57,0,82,0,94,0,2702
"39049007395",7666,696,3227,283,913,44,222,44,13095
"39049007396",6383,384,1837,1347,575,66,69,0,10661
"39049007424",3568,373,675,461,390,55,55,21,5598
"39049007425",2100,267,223,4,90,29,5,0,2718
"39049007426",2418,292,219,6,32,0,42,0,3009
"39049007427",4231,338,948,183,419,49,224,0,6392
"39049007492",4727,81,972,0,301,0,38,0,6119
"39049007494",3432,287,445,54,174,54,91,0,4537
"39049007511",155,60,802,616,43,20,23,12,1731
"39049007512",242,114,2447,1181,50,77,16,28,4155
"39049007520",491,310,959,1301,121,272,300,27,3781
"39049007531",708,163,783,934,83,129,210,54,3064
"39049007532",354,152,1043,501,182,9,273,90,2604
"39049007533",212,161,1125,219,158,28,171,43,2117
"39049007534",257,269,1271,1142,77,53,21,101,3191
"39049007550",356,77,1435,501,104,36,111,0,2620
"39049007551",1034,266,4328,2430,767,40,356,125,9346
"39049007710",1685,393,1284,614,125,238,26,131,4496
"39049007721",1490,404,1096,664,950,1025,490,82,6201
"39049007722",1624,524,599,152,130,259,132,14,3434
"39049007730",1836,223,761,45,203,43,64,8,3183
"39049007740",1225,235,158,50,60,7,15,62,1812
"39049007811",2887,384,72,21,108,90,71,48,3681
"39049007812",2943,590,160,135,176,118,125,17,4264
"39049007820",1192,586,70,156,967,586,65,7,3629
"39049007830",1533,392,90,44,353,107,31,84,2634
"39049007921",7485,248,173,269,1060,0,50,0,9285
"39049007922",3989,80,68,0,433,59,116,0,4745
"39049007931",3987,211,32,99,239,0,323,0,4891
"39049007933",7134,335,112,0,723,0,241,0,8545
"39049007941",2194,153,104,0,371,10,134,0,2966
"39049007951",8244,237,424,38,850,0,209,0,10002
"39049007952",6445,369,39,47,409,0,188,0,7497
"39049007953",5176,467,219,16,614,149,151,0,6792
"39049007954",4928,1302,413,624,708,297,295,591,9158
"39049008000",4779,220,47,13,322,0,124,0,5505
"39049008110",2833,467,346,228,195,41,255,151,4516
"39049008120",2529,773,92,76,213,14,500,196,4393
"39049008132",4802,982,486,110,408,390,879,305,8362
"39049008141",6890,447,203,271,929,0,752,0,9492
"39049008142",5220,546,405,68,833,21,727,19,7839
"39049008161",5099,966,833,355,437,75,470,200,8435
"39049008162",6566,897,310,358,722,151,596,518,10118
"39049008163",2007,1154,157,42,165,117,378,588,4608
"39049008164",2289,1189,334,242,200,56,415,820,5545
"39049008210",961,746,193,36,167,97,20,481,2701
"39049008230",700,350,381,112,149,142,595,167,2596
"39049008241",1137,474,228,183,36,81,36,158,2333
"39049008242",4399,259,336,0,519,168,60,107,5848
"39049008311",2644,474,329,1265,306,128,263,485,5894
"39049008312",1978,965,245,1022,340,270,80,400,5300
"39049008321",1548,435,125,88,179,207,38,123,2743
"39049008322",2420,821,260,153,339,95,124,48,4260
"39049008330",1113,444,6,4,39,0,0,16,1622
"39049008340",3243,800,666,245,566,83,123,0,5726
"39049008350",3230,998,414,1840,510,174,765,273,8204
"39049008360",4206,655,627,193,550,0,316,0,6547
"39049008370",5901,1022,255,34,466,0,27,0,7705
"39049008380",3490,295,343,11,171,59,90,45,4504
"39049008400",2855,46,26,0,180,11,14,0,3132
"39049008500",4313,169,0,21,223,0,86,0,4812
"39049008710",455,133,1575,388,278,0,0,0,2829
"39049008720",761,215,1039,195,573,198,314,167,3462
"39049008730",177,162,487,581,91,132,110,124,1864
"39049008811",1085,552,208,17,36,6,8,13,1925
"39049008812",735,73,1607,423,134,59,113,0,3144
"39049008813",317,83,1276,764,104,18,7,0,2569
"39049008821",1977,490,67,0,61,27,6,54,2682
"39049008822",2438,669,550,373,198,256,93,0,4577
"39049008825",4913,943,415,138,250,56,142,0,6857
"39049008900",3184,557,184,70,231,9,121,11,4367
"39049009000",2713,244,175,0,27,0,0,0,3159
"39049009100",4133,210,191,14,316,8,174,0,5046
"39049009210",1440,221,1544,712,417,358,414,96,5202
"39049009220",1000,223,282,188,151,81,122,0,2047
"39049009230",2244,537,985,476,524,172,778,267,5983
"39049009240",1264,258,153,20,217,97,188,90,2287
"39049009250",973,282,299,52,126,151,89,60,2032
"39049009311",950,123,966,629,255,56,119,186,3284
"39049009312",629,135,1273,495,271,81,123,0,3007
"39049009321",491,97,764,227,594,240,309,235,2957
"39049009322",1059,95,1606,392,418,260,250,116,4196
"39049009323",534,96,1458,842,335,143,347,142,3897
"39049009325",626,495,1493,997,0,42,55,358,4066
"39049009326",206,99,828,380,81,55,59,65,1773
"39049009331",124,32,320,355,46,92,25,54,1048
"39049009332",285,67,2348,143,147,84,27,0,3101
"39049009333",409,106,1041,264,449,67,135,28,2499
"39049009334",467,90,1494,484,52,269,76,53,2985
"39049009336",744,184,1324,422,140,99,32,65,3010
"39049009337",396,15,2393,1269,48,56,98,0,4275
"39049009340",1056,228,1013,443,330,47,353,26,3496
"39049009350",917,118,1147,55,402,50,375,116,3180
"39049009361",2525,213,1945,838,151,16,87,16,5791
"39049009362",4569,869,1056,565,134,0,302,478,7973
"39049009371",1328,404,3030,480,339,82,39,33,5735
"39049009372",1108,210,2061,556,337,30,313,0,4615
"39049009373",1538,156,2354,1915,473,155,144,68,6803
"39049009374",3843,412,2837,920,415,40,283,0,8750
"39049009381",2935,400,1381,365,779,0,527,0,6387
"39049009382",1902,192,223,175,316,101,40,137,3086
"39049009383",1421,233,475,234,201,5,47,3,2619
"39049009384",1324,139,335,122,302,0,212,0,2434
"39049009385",2339,128,717,49,165,14,46,8,3466
"39049009386",1093,319,1070,487,102,14,495,56,3636
"39049009390",3540,381,1040,0,888,0,141,62,6052
"39049009410",1407,463,696,276,0,0,52,20,2914
"39049009420",3604,366,1181,145,521,16,161,16,6010
"39049009430",4069,268,2028,1022,516,279,432,23,8637
"39049009440",3360,202,824,42,150,0,32,17,4627
"39049009450",7381,132,1428,0,467,0,236,0,9644
"39049009495",2640,561,897,182,439,25,290,0,5034
"39049009497",1546,81,1,1,72,0,41,6,1748
"39049009520",3231,473,321,229,47,33,22,59,4415
"39049009590",3881,656,516,48,151,57,109,0,5418
"39049009600",2981,444,330,239,142,48,92,28,4304
"39049009711",3542,519,135,7,118,8,86,0,4415
"39049009712",2401,202,50,1,30,0,0,0,2684
"39049009720",5143,807,40,29,159,276,53,182,6689
"39049009740",13208,404,486,46,765,29,75,0,15013
"39049009751",4936,377,8,42,217,0,0,0,5580
"39049009752",5231,374,231,42,341,0,244,0,6463
"39049009800",5791,845,40,51,118,68,19,0,6932
"39049009900",591,73,604,133,117,30,273,58,1879
"39049010000",3979,215,577,45,451,38,73,0,5378
"39049010100",307,14,478,4,88,5,0,0,896
"39049010200",9850,587,4496,1204,901,205,591,0,17834
"39049010300",1565,697,357,161,134,68,126,5,3113
"39049010400",5731,264,32,0,1494,82,271,0,7874
"39049010500",6616,166,201,0,1499,18,442,26,8968
"39049010601",4070,163,117,0,830,83,69,0,5332
"39049010602",5430,295,174,0,469,0,239,61,6668
"39049010700",1161,169,71,89,36,9,87,4,1626
"39049980000",0,0,0,0,0,0,0,0,0
"39051040100",2825,248,16,14,175,0,105,0,3383
"39051040200",4039,426,30,0,20,6,285,0,4806
"39051040300",4248,203,0,0,35,0,94,28,4608
"39051040400",3193,535,52,4,87,4,163,74,4112
"39051040500",4730,183,0,0,44,20,158,25,5160
"39051040600",3745,521,0,35,43,0,290,0,4634
"39051040700",5855,628,4,5,546,439,881,374,8732
"39051040800",3938,614,26,1,120,68,171,86,5024
"39051040900",3388,307,0,22,347,249,458,271,5042
"39053953500",3819,549,196,12,39,0,156,0,4771
"39053953600",3314,823,31,0,51,33,18,0,4270
"39053953700",2368,1382,56,97,130,32,112,0,4177
"39053953800",3101,694,0,8,32,25,0,0,3860
"39053953900",5379,1090,62,38,149,14,0,0,6732
"39053954000",2797,850,37,63,146,36,0,38,3967
"39053954100",1629,428,36,33,157,7,9,0,2299
"39055310100",1902,307,15,0,34,6,0,0,2264
"39055310200",1782,130,0,0,71,6,6,0,1995
"39055310600",6236,246,0,0,40,0,108,16,6646
"39055310700",3548,244,0,0,10,0,10,0,3812
"39055310800",6025,207,28,11,131,0,80,0,6482
"39055310900",2536,487,34,28,72,13,3,41,3214
"39055311000",3270,251,35,0,30,0,0,0,3586
"39055311300",3936,293,18,13,34,40,41,5,4380
"39055311400",4674,605,52,2,137,0,18,0,5488
"39055311500",5109,123,0,0,99,19,71,0,5421
"39055311600",3746,47,0,0,45,0,36,0,3874
"39055311700",3713,101,400,61,81,0,44,0,4400
"39055311800",6601,167,237,0,92,0,109,0,7206
"39055311900",5984,341,0,1,163,0,13,0,6502
"39055312000",2470,285,13,7,6,26,5,14,2826
"39055312100",3383,777,0,1,0,0,0,0,4161
"39055312201",4725,332,0,182,113,32,159,0,5543
"39055312202",4046,99,32,0,141,48,70,48,4484
"39055312203",4106,367,29,0,157,0,134,0,4793
"39055312300",3822,638,0,14,96,20,138,0,4728
"39055312400",2066,392,0,0,10,0,13,0,2481
"39057200101",2061,423,68,80,55,101,88,43,2919
"39057200103",2202,396,188,178,638,82,331,20,4035
"39057200104",1315,1386,394,214,88,284,42,70,3793
"39057200300",2421,892,51,69,84,75,13,0,3605
"39057200400",1452,442,58,49,109,10,15,5,2140
"39057200500",3926,1148,0,282,299,97,0,157,5909
"39057200600",2802,310,50,166,151,0,89,7,3575
"39057200700",1859,890,339,216,419,388,97,217,4425
"39057200900",4784,287,78,19,481,26,62,11,5748
"39057210100",3483,318,433,12,729,148,242,0,5365
"39057210200",7078,468,190,6,423,0,205,0,8370
"39057210300",3068,137,62,24,182,4,20,23,3520
"39057210401",4018,346,140,0,551,21,96,21,5193
"39057210402",4455,91,43,0,488,8,0,0,5085
"39057210500",5211,21,8,11,253,0,117,0,5621
"39057210601",6867,352,357,76,732,113,356,0,8853
"39057210602",4853,153,12,2,338,206,189,66,5819
"39057210603",5615,168,148,0,435,55,230,55,6706
"39057220100",7328,134,0,0,430,7,169,0,8068
"39057220200",6534,417,175,187,270,87,101,0,7771
"39057230100",2509,140,0,0,0,0,0,0,2649
"39057240100",2120,579,285,44,129,7,48,0,3212
"39057240200",2886,1103,198,119,75,153,30,53,4617
"39057240301",5997,1397,846,64,143,261,86,3,8797
"39057240302",2072,846,199,245,48,60,72,31,3573
"39057240500",3382,422,314,120,83,47,67,22,4457
"39057240600",1326,495,845,536,71,88,61,0,3422
"39057240700",1602,238,79,41,8,6,0,0,1974
"39057255000",2438,431,426,29,87,53,40,43,3547
"39057260100",3528,460,25,0,47,22,22,4,4108
"39057270100",3157,484,17,0,53,1,7,10,3729
"39057280101",2417,135,28,0,29,0,44,0,2653
"39057280102",2022,147,0,9,14,34,6,2,2234
"39057280200",1298,50,37,0,54,0,23,0,1462
"39057280300",1437,117,170,0,63,0,178,0,1965
"39059977100",3487,854,76,0,96,12,12,0,4537
"39059977200",4421,685,0,4,16,128,0,1,5255
"39059977300",2107,1078,17,45,26,49,24,0,3346
"39059977400",2867,586,58,21,10,41,19,41,3643
"39059977500",2336,523,0,49,86,67,18,0,3079
"39059977600",2072,922,25,28,98,158,97,49,3449
"39059977700",3245,316,10,1,20,7,56,0,3655
"39059977800",3048,372,0,18,33,4,25,0,3500
"39059977900",3155,1142,135,0,46,0,10,0,4488
"39059978000",3641,664,46,1,117,9,3,0,4481
"39061000200",9,20,395,451,39,3,13,0,930
"39061000700",1028,125,115,40,178,15,100,18,1619
"39061000900",517,367,162,344,33,88,13,157,1681
"39061001000",691,164,244,336,104,5,38,0,1582
"39061001100",232,57,207,512,21,3,0,0,1032
"39061001600",99,67,132,591,43,16,0,2,950
"39061001700",162,72,195,495,4,64,0,0,992
"39061001800",809,135,130,272,93,4,37,3,1483
"39061001900",896,73,412,194,86,12,73,13,1759
"39061002000",951,81,447,123,79,12,34,13,1740
"39061002200",288,256,1019,466,53,77,24,25,2208
"39061002300",188,52,145,573,69,21,0,0,1048
"39061002500",885,1152,225,118,44,115,7,56,2602
"39061002600",1050,1827,240,303,201,101,51,98,3871
"39061002700",714,339,182,321,82,86,27,20,1771
"39061002800",666,181,168,163,37,56,29,56,1356
"39061002900",1674,1059,452,3,435,633,0,31,4287
"39061003000",245,440,91,46,179,159,21,30,1211
"39061003200",263,447,223,202,262,138,21,5,1561
"39061003300",294,452,232,250,96,161,8,6,1499
"39061003600",9,38,421,718,29,18,20,0,1253
"39061003700",67,30,427,1084,55,86,0,0,1749
"39061003800",34,52,1196,915,0,56,0,0,2253
"39061003900",108,119,1003,564,13,0,0,0,1807
"39061004000",495,55,928,564,129,4,55,36,2266
"39061004100",638,62,393,332,64,32,5,16,1542
"39061004200",1306,52,282,134,89,0,69,0,1932
"39061004500",975,92,0,0,17,0,32,0,1116
"39061004602",3987,167,98,203,218,10,274,13,4970
"39061004603",2507,147,99,16,138,1,108,0,3016
"39061004604",2874,327,137,35,43,74,119,0,3609
"39061004605",2056,199,174,0,66,51,8,12,2566
"39061004701",2691,75,24,22,82,8,33,0,2935
"39061004702",456,345,0,11,10,0,0,6,828
"39061004800",3047,68,0,0,91,19,102,0,3327
"39061004900",5537,355,144,80,440,29,88,0,6673
"39061005000",3747,182,324,76,476,47,162,61,5075
"39061005100",2185,142,54,21,112,0,82,3,2599
"39061005200",2839,186,176,156,180,12,115,0,3664
"39061005301",2079,383,190,26,142,18,42,0,2880
"39061005302",2406,174,121,105,140,17,59,26,3048
"39061005400",705,43,163,43,29,0,72,0,1055
"39061005500",1224,135,1265,960,159,102,81,11,3937
"39061005600",2891,476,1702,538,24,111,0,0,5742
"39061005701",2043,286,441,258,72,0,73,0,3173
"39061005702",2557,47,1095,520,149,87,19,3,4477
"39061005800",1918,242,2081,776,159,18,102,0,5296
"39061005900",548,110,320,226,88,16,6,64,1378
"39061006000",2528,338,2189,430,81,162,194,125,6047
"39061006100",1445,775,305,188,136,15,552,51,3467
"39061006300",317,22,2604,489,157,0,33,0,3622
"39061006400",82,4,1912,903,83,14,31,0,3029
"39061006500",1339,151,1711,639,120,17,23,0,4000
"39061006600",212,113,1075,605,89,51,0,0,2145
"39061006800",75,72,1969,1053,8,0,0,0,3177
"39061006900",61,29,1456,985,36,0,29,0,2596
"39061007000",1064,430,424,236,130,184,21,5,2494
"39061007100",2471,264,192,155,195,95,105,13,3490
"39061007200",1313,278,154,55,174,137,108,0,2219
"39061007300",638,152,752,277,65,83,22,71,2060
"39061007400",1000,128,244,196,31,0,67,0,1666
"39061007500",1034,288,285,214,81,0,30,0,1932
"39061007700",36,24,1016,1636,0,155,0,22,2889
"39061007800",1265,316,438,262,99,31,34,0,2445
"39061007900",651,176,436,275,60,38,28,0,1664
"39061008000",416,182,980,2963,6,219,113,11,4890
"39061008100",358,18,1576,558,170,33,154,10,2877
"39061008201",1167,194,2011,386,169,12,0,0,3939
"39061008202",976,210,1380,806,102,10,8,0,3492
"39061008300",1587,431,1429,505,123,45,64,197,4381
"39061008400",777,25,298,861,33,10,0,0,2004
"39061008501",414,115,455,2111,113,5,61,0,3274
"39061008502",14,108,204,1269,6,65,0,42,1708
"39061008601",141,109,1008,965,107,45,37,0,2412
"39061008800",239,181,1161,1706,34,76,81,69,3547
"39061009200",796,586,468,1309,315,123,293,70,3960
"39061009300",921,528,603,478,45,24,100,73,2772
"39061009400",378,448,226,403,32,256,0,186,1929
"39061009500",982,773,312,447,101,46,157,319,3137
"39061009600",2032,496,501,419,238,48,65,0,3799
"39061009700",2424,1548,893,838,101,152,198,0,6154
"39061009800",537,414,501,484,69,217,37,174,2433
"39061009901",2944,505,568,34,104,33,0,0,4188
"39061009902",1873,648,388,261,179,11,103,11,3474
"39061010002",729,295,2440,1606,103,40,0,5,5218
"39061010003",1363,215,1908,603,114,390,21,311,4925
"39061010004",532,151,2994,1141,282,327,42,292,5761
"39061010005",796,131,469,278,20,0,4,0,1698
"39061010100",1682,580,1607,774,64,132,49,25,4913
"39061010201",2968,861,916,325,132,30,43,0,5275
"39061010202",1434,126,667,196,204,0,79,0,2706
"39061010300",658,398,174,228,0,0,18,0,1476
"39061010400",908,155,23,5,28,8,0,0,1127
"39061010500",879,421,25,5,22,16,12,144,1524
"39061010600",1156,179,1,1,39,22,0,0,1398
"39061010700",1239,188,117,50,60,60,39,0,1753
"39061010800",348,14,241,61,125,20,0,0,809
"39061010900",1258,351,530,305,178,36,10,0,2668
"39061011000",220,95,1548,1134,42,154,0,0,3193
"39061011100",1183,89,1602,178,104,0,7,0,3163
"39061020401",4286,591,32,19,92,15,73,0,5108
"39061020403",4883,522,0,0,122,69,169,15,5780
"39061020404",4831,135,37,0,96,0,40,0,5139
"39061020501",2133,105,41,63,42,0,0,0,2384
"39061020502",4183,134,259,34,300,10,50,0,4970
"39061020504",2595,130,442,71,378,0,29,0,3645
"39061020505",3188,184,1010,94,113,5,46,9,4649
"39061020601",5589,324,32,0,288,0,99,0,6332
"39061020602",6531,325,272,0,88,30,105,0,7351
"39061020701",5491,942,405,84,379,15,62,279,7657
"39061020705",1981,217,629,276,301,15,0,1,3420
"39061020707",4556,254,41,0,88,0,77,0,5016
"39061020741",1934,125,703,301,126,208,0,11,3408
"39061020742",2360,483,1246,100,204,41,313,114,4861
"39061020761",4266,709,844,45,541,0,47,46,6498
"39061020762",1571,683,454,238,110,36,12,36,3140
"39061020802",5076,351,205,6,121,23,0,0,5782
"39061020811",4469,289,1318,145,195,0,16,0,6432
"39061020812",3702,218,42,68,103,0,0,0,4133
"39061020901",2657,380,206,99,112,72,118,30,3674
"39061020902",3323,1298,443,101,69,71,8,0,5313
"39061021001",2433,163,48,90,34,0,0,0,2768
"39061021002",3157,380,0,0,49,13,38,0,3637
"39061021003",2716,308,0,0,22,0,0,0,3046
"39061021101",4533,332,0,0,71,2,58,0,4996
"39061021102",6012,195,0,0,183,0,0,0,6390
"39061021201",1935,85,0,0,5,0,15,0,2040
"39061021202",4621,145,119,53,200,1,0,0,5139
"39061021302",5466,233,0,0,47,1,0,0,5747
"39061021303",4339,140,108,1,69,0,85,0,4742
"39061021304",3998,388,28,42,91,37,3,0,4587
"39061021401",4026,761,102,45,55,77,37,120,5223
"39061021421",4190,122,25,0,132,0,0,0,4469
"39061021422",2385,275,8,0,187,100,181,0,3136
"39061021501",1901,152,1744,210,380,70,58,149,4664
"39061021504",1501,159,3305,582,177,118,456,78,6376
"39061021505",792,31,1678,251,102,17,32,0,2903
"39061021506",448,17,1990,317,304,83,10,0,3169
"39061021508",3947,121,1225,70,128,20,112,20,5643
"39061021509",3126,229,1381,1528,219,139,26,0,6648
"39061021571",1524,98,1109,412,369,40,90,0,3642
"39061021572",1325,546,3460,699,169,56,477,260,6992
"39061021602",537,12,1638,834,104,53,10,0,3188
"39061021603",1575,93,1181,435,125,0,43,61,3513
"39061021604",1097,14,1335,796,208,1,49,0,3500
"39061021701",1312,317,831,165,239,0,54,141,3059
"39061021702",1274,601,1184,654,175,91,13,1,3993
"39061021801",2734,467,1852,895,209,0,112,16,6285
"39061021802",1303,37,1384,319,87,15,0,0,3145
"39061021900",445,53,382,433,0,0,0,25,1338
"39061022000",2915,200,284,183,75,0,129,2,3788
"39061022101",2789,160,594,362,71,0,0,31,4007
"39061022102",3620,121,1610,322,658,0,86,0,6417
"39061022200",3130,186,920,92,91,17,199,0,4635
"39061022301",2940,1244,1146,509,303,57,728,950,7877
"39061022302",4088,403,266,40,356,242,259,417,6071
"39061022400",1688,90,204,8,130,0,11,8,2139
"39061022500",960,183,2111,125,181,123,63,46,3792
"39061022601",4917,78,398,13,504,1,0,0,5911
"39061022602",1660,82,647,0,192,23,150,0,2754
"39061022700",0,55,1938,1256,116,0,45,0,3410
"39061023001",2428,520,757,352,395,51,92,107,4702
"39061023002",3862,280,541,10,351,0,0,0,5044
"39061023100",2277,45,225,0,211,0,0,0,2758
"39061023201",2137,503,125,79,17,21,0,0,2882
"39061023210",3760,713,517,183,173,54,48,0,5448
"39061023222",2313,192,211,3,33,0,34,0,2786
"39061023300",3404,102,317,20,95,21,85,21,4065
"39061023400",637,125,2212,442,175,17,32,0,3640
"39061023501",3094,67,136,9,941,65,185,0,4497
"39061023521",1924,77,208,81,140,23,110,0,2563
"39061023522",4701,244,490,65,397,127,29,0,6053
"39061023600",3119,453,126,195,73,9,21,8,4004
"39061023701",2197,141,151,75,125,17,16,0,2722
"39061023702",2328,183,64,0,205,0,118,0,2898
"39061023800",1976,179,1978,422,427,0,14,0,4996
"39061023901",3228,240,167,0,932,12,140,62,4781
"39061023902",4263,156,15,2,337,0,80,19,4872
"39061024001",3661,276,402,45,582,70,156,0,5192
"39061024002",2162,128,24,11,167,2,16,11,2521
"39061024100",6288,316,14,0,145,3,227,2,6995
"39061024200",1777,11,231,216,162,46,16,19,2478
"39061024301",2261,143,304,303,796,0,117,22,3946
"39061024303",5612,599,102,154,284,0,40,22,6813
"39061024321",6629,287,77,0,615,23,121,0,7752
"39061024322",7071,185,200,0,813,47,547,0,8863
"39061024400",6317,295,339,17,693,0,106,0,7767
"39061024700",1446,89,24,27,43,4,24,0,1657
"39061024800",3086,71,0,0,255,11,67,0,3490
"39061024901",834,260,0,0,14,0,128,0,1236
"39061024902",7333,85,29,0,222,33,357,23,8082
"39061025001",5057,715,32,155,112,13,88,53,6225
"39061025002",6042,445,0,63,63,0,0,0,6613
"39061025101",4820,52,0,0,311,0,73,0,5256
"39061025102",6486,644,54,0,456,11,81,0,7732
"39061025103",5648,669,135,15,284,2,15,0,6768
"39061025104",1898,59,1,8,41,3,30,0,2040
"39061025200",2813,630,189,85,143,13,29,0,3902
"39061025300",2067,490,30,38,340,28,410,17,3420
"39061025401",1430,319,70,17,11,12,36,12,1907
"39061025402",2175,196,14,208,51,43,11,75,2773
"39061025500",2887,839,364,302,67,0,275,9,4743
"39061025600",2045,878,98,64,91,46,16,21,3259
"39061025700",1030,406,258,60,26,129,4,122,2035
"39061025800",2967,422,415,414,138,0,37,8,4401
"39061026001",4760,226,11,0,99,13,95,21,5225
"39061026002",4490,228,40,0,177,0,98,0,5033
"39061026101",7182,492,0,2,36,37,0,61,7810
"39061026102",2690,201,56,0,0,0,0,0,2947
"39061026200",1040,501,0,0,34,0,14,182,1771
"39061026300",240,468,56,149,15,49,0,71,1048
"39061026400",261,36,1049,953,36,0,0,0,2335
"39061026500",1415,128,282,584,52,0,115,10,2586
"39061026600",1075,214,96,55,40,9,7,0,1496
"39061026700",107,64,654,702,101,7,3,0,1638
"39061026800",1438,84,29,0,46,2,12,0,1611
"39061026900",94,235,638,758,66,27,0,0,1818
"39061027000",121,178,1091,1993,68,73,32,62,3618
"39061027100",420,119,1998,960,59,19,19,19,3613
"39061027200",477,238,674,753,71,31,31,5,2280
"39061027300",2405,130,62,0,15,7,62,0,2681
"39061027400",2131,397,901,593,267,79,402,43,4813
"39063000100",3316,488,9,5,143,60,137,85,4243
"39063000200",5186,89,51,20,124,0,94,0,5564
"39063000300",7677,478,18,0,217,50,203,53,8696
"39063000400",6106,623,9,2,224,261,329,176,7730
"39063000500",3243,1649,76,46,202,75,350,169,5810
"39063000600",4982,1002,45,65,606,285,283,292,7560
"39063000700",4677,333,161,11,264,25,153,0,5624
"39063000800",2447,568,161,40,260,49,138,7,3670
"39063000900",3234,1511,20,24,352,129,543,137,5950
"39063001000",5661,706,27,55,80,0,134,32,6695
"39063001100",3277,503,8,21,222,36,121,113,4301
"39063001200",5026,651,8,33,86,28,51,15,5898
"39063001300",4785,274,9,0,74,26,95,5,5268
"39065000100",2903,370,21,0,23,0,17,0,3334
"39065000200",3574,856,8,27,122,0,140,0,4727
"39065000300",3252,416,4,12,38,8,13,8,3751
"39065000400",3446,822,1,54,198,84,85,20,4710
"39065000500",3190,717,57,12,17,58,11,28,4090
"39065000600",2762,792,0,0,85,120,59,62,3880
"39065000700",4134,1129,12,6,64,8,13,0,5366
"39067975600",2814,935,31,4,154,19,3,2,3962
"39067975700",2924,567,0,0,42,13,104,0,3650
"39067975800",1936,348,0,0,34,0,0,3,2321
"39067975900",1889,221,0,0,0,0,0,0,2110
"39067976000",2648,464,156,86,56,0,15,0,3425
"39069000100",4354,201,19,24,64,9,195,2,4868
"39069000200",3596,52,0,1,51,6,108,1,3815
"39069000300",4152,577,0,39,156,56,156,63,5199
"39069000400",2369,579,14,6,236,127,173,135,3639
"39069000500",2597,418,4,12,191,5,226,15,3468
"39069000600",2789,502,3,0,190,50,259,52,3845
"39069000700",3389,397,11,4,185,79,414,164,4643
"39071954400",2809,945,91,43,17,42,0,0,3947
"39071954500",2910,1179,0,0,20,5,36,0,4150
"39071954600",4563,838,11,0,24,25,14,0,5475
"39071954700",5190,898,0,0,17,0,4,0,6109
"39071954800",2770,1128,27,42,50,191,11,58,4277
"39071954900",2653,460,159,61,254,13,0,12,3612
"39071955000",2871,1159,37,15,0,45,0,9,4136
"39071955100",4931,1064,73,0,234,0,153,0,6455
"39071955200",4226,451,0,0,33,0,49,0,4759
"39073964900",3757,447,0,1,58,0,27,0,4290
"39073965000",2424,568,0,0,84,0,35,0,3111
"39073965100",4098,572,7,0,56,0,0,0,4733
"39073965200",3610,821,35,15,40,24,33,95,4673
"39073965300",2782,661,0,5,31,17,0,16,3512
"39073965400",3093,1042,31,10,63,0,20,0,4259
"39073965500",3030,643,0,68,99,0,2,0,3842
"39075976301",3874,672,0,0,3,12,16,12,4589
"39075976302",5345,586,12,0,27,0,0,0,5970
"39075976400",8283,698,0,0,20,0,67,0,9068
"39075976500",4598,673,0,0,19,0,0,113,5403
"39075976600",3806,714,0,3,125,0,11,8,4667
"39075976700",3145,517,15,0,78,97,145,13,4010
"39075976801",4329,573,0,0,32,20,9,0,4963
"39075976802",3417,814,0,0,0,19,0,0,4250
"39077915400",4157,480,0,0,76,0,65,0,4778
"39077915500",4781,660,0,2,474,44,311,58,6330
"39077915600",3719,478,1,95,189,67,146,34,4729
"39077915700",3059,787,105,1,184,21,383,193,4733
"39077915800",3838,760,79,82,12,25,98,234,5128
"39077915900",3966,269,0,0,8,0,35,10,4288
"39077916000",3526,279,0,0,10,49,87,17,3968
"39077916100",3243,215,0,0,103,35,74,39,3709
"39077916200",3489,1052,13,0,276,89,505,253,5677
"39077916300",2178,658,83,22,260,125,371,314,4011
"39077916400",4576,581,2,2,195,16,93,15,5480
"39077916500",4363,318,0,13,0,23,38,9,4764
"39077916600",3079,583,126,18,121,4,127,0,4058
"39079957200",4062,1024,0,0,38,147,0,0,5271
"39079957300",2451,824,5,0,26,48,7,0,3361
"39079957400",3757,1250,54,0,121,0,10,0,5192
"39079957500",4346,1100,0,70,30,0,119,65,5730
"39079957600",1848,699,0,19,18,21,6,66,2677
"39079957700",3714,1063,0,0,92,53,0,0,4922
"39079957800",4164,1186,0,0,66,133,33,0,5582
"39081000200",319,476,244,233,19,150,28,23,1492
"39081000400",1285,970,617,277,66,40,8,17,3280
"39081000600",1771,168,38,31,85,4,0,8,2105
"39081000800",256,168,146,292,39,9,0,1,911
"39081001000",2136,139,129,1,0,0,19,0,2424
"39081001200",3898,741,307,94,25,86,25,125,5301
"39081001300",783,341,38,49,28,68,0,0,1307
"39081001400",2931,448,138,62,42,0,66,0,3687
"39081001700",998,361,172,230,67,38,0,62,1928
"39081011000",1429,137,1,0,22,3,0,0,1592
"39081011100",2753,418,19,1,9,0,0,0,3200
"39081011200",1309,605,0,72,54,10,17,1,2068
"39081011300",2112,354,0,0,85,14,26,8,2599
"39081011401",3268,677,77,4,41,95,0,0,4162
"39081011402",3246,423,0,0,70,36,26,207,4008
"39081011500",4549,333,47,15,30,0,0,4,4978
"39081011700",3725,291,80,0,74,19,11,0,4200
"39081011800",2632,380,131,28,77,108,0,28,3384
"39081011900",2925,618,0,9,14,0,0,0,3566
"39081012000",2572,274,29,32,74,69,24,0,3074
"39081012100",2498,337,9,0,9,0,2,0,2855
"39081012200",1640,301,3,0,7,0,2,0,1953
"39081012300",1799,384,12,3,16,7,0,0,2221
"39083006700",4268,793,0,7,87,9,100,0,5264
"39083006801",5090,433,28,4,124,0,13,0,5692
"39083006802",3596,538,10,0,122,0,70,27,4363
"39083006900",5360,749,33,0,31,36,26,11,6246
"39083007000",2569,176,0,0,177,0,104,0,3026
"39083007100",2716,762,0,54,78,168,12,104,3894
"39083007200",3758,902,2,45,96,21,0,0,4824
"39083007300",3558,747,54,25,169,0,28,0,4581
"39083007400",4681,993,78,0,40,3,51,0,5846
"39083007500",2615,698,80,19,0,0,61,0,3473
"39083007600",3891,809,43,0,56,47,0,0,4846
"39083007700",5361,707,44,8,10,72,104,0,6306
"39085200100",1361,181,120,13,65,21,61,23,1845
"39085200200",2165,148,31,16,145,31,171,9,2716
"39085200300",2911,213,0,0,28,1,13,0,3166
"39085200400",2857,384,91,0,31,0,17,0,3380
"39085200500",2794,142,31,0,271,0,39,0,3277
"39085200600",3145,141,0,0,86,46,20,0,3438
"39085200700",3195,232,302,69,126,22,70,0,4016
"39085200800",2938,159,131,56,119,38,49,0,3490
"39085200900",1285,144,65,0,63,0,3,0,1560
"39085201000",3262,152,1079,186,120,0,121,0,4920
"39085201100",3274,382,374,0,573,16,64,0,4683
"39085201200",2759,220,249,7,245,82,118,15,3695
"39085201300",3045,261,23,0,109,0,29,0,3467
"39085201400",3443,169,14,0,9,0,23,0,3658
"39085201500",1870,8,0,37,46,0,38,0,1999
"39085201600",2980,156,158,126,349,0,18,0,3787
"39085201700",4782,360,208,330,91,0,79,0,5850
"39085201800",3338,131,145,0,72,0,6,0,3692
"39085201900",2503,137,107,0,0,0,71,13,2831
"39085202000",5468,428,0,0,135,0,51,0,6082
"39085202100",1629,430,131,0,36,11,186,0,2423
"39085202400",2829,192,0,0,0,0,87,12,3120
"39085202500",3576,547,25,0,142,31,73,0,4394
"39085202600",3431,182,0,0,47,1,27,0,3688
"39085202700",5739,261,9,38,88,0,27,0,6162
"39085202800",5415,490,0,2,147,0,0,0,6054
"39085202900",6302,465,1,0,50,0,14,0,6832
"39085203000",6574,88,0,0,10,43,47,0,6762
"39085203200",2628,637,89,49,82,0,58,0,3543
"39085203400",3498,369,20,111,172,0,11,0,4181
"39085203500",6382,247,20,18,175,0,128,0,6970
"39085203700",2997,100,0,2,6,0,14,0,3119
"39085204000",2442,610,19,10,10,1,0,187,3279
"39085204200",2301,347,346,346,543,249,1376,82,5590
"39085204301",1644,132,78,0,55,0,146,0,2055
"39085204302",3640,842,496,675,584,73,1113,243,7666
"39085204400",2199,515,180,60,146,165,679,371,4315
"39085204500",1643,754,216,60,326,64,913,176,4152
"39085204700",3688,532,75,0,101,0,125,66,4587
"39085204800",4452,463,204,35,38,0,203,28,5423
"39085204900",5106,358,163,74,368,31,61,85,6246
"39085205001",5345,433,66,0,31,14,0,0,5889
"39085205002",5403,186,0,2,125,0,127,0,5843
"39085205100",6101,50,2,2,240,0,0,0,6395
"39085205200",2863,164,8,0,79,0,20,0,3134
"39085205300",2268,72,49,24,19,59,0,0,2491
"39085205400",1451,112,0,6,47,11,3,2,1632
"39085205701",4173,411,0,16,107,0,226,57,4990
"39085205702",2712,96,14,5,100,0,0,2,2929
"39085205800",1247,41,14,0,149,0,0,0,1451
"39085205900",711,54,7,25,52,0,0,0,849
"39085206000",4660,569,0,0,56,0,124,0,5409
"39085206100",2830,301,29,6,8,0,43,0,3217
"39085206200",1234,173,132,8,19,0,42,6,1614
"39085206300",4212,317,144,30,126,5,286,25,5145
"39085206400",4532,110,0,1,56,0,80,0,4779
"39085206500",2370,162,24,0,156,19,46,0,2777
"39085206600",3783,552,27,72,190,0,11,0,4635
"39085990000",0,0,0,0,0,0,0,0,0
"39087050100",1686,476,28,46,0,14,0,0,2250
"39087050200",2148,268,23,0,16,17,0,0,2472
"39087050300",1249,304,422,106,106,18,18,0,2223
"39087050400",2369,694,37,1,11,25,90,25,3252
"39087050500",5651,656,0,0,231,22,42,0,6602
"39087050600",1160,138,13,7,0,0,0,0,1318
"39087050700",2758,778,0,0,18,0,0,0,3554
"39087050800",2541,1115,0,51,43,90,51,0,3891
"39087050900",1726,460,14,0,18,0,18,0,2236
"39087051001",3399,513,116,0,124,212,48,98,4510
"39087051002",3325,1361,0,0,84,0,13,0,4783
"39087051100",5332,1062,55,0,89,0,0,0,6538
"39087051200",3958,1128,3,311,84,13,82,0,5579
"39087051300",2839,643,0,0,17,0,0,26,3525
"39087051401",5085,239,0,0,118,0,0,0,5442
"39087051402",2842,340,14,9,119,18,0,2,3344
"39089750700",2405,813,19,32,45,179,0,0,3493
"39089751000",1434,588,29,45,94,46,67,0,2303
"39089751300",2561,841,130,7,132,40,32,26,3769
"39089751600",2670,585,89,10,143,0,39,29,3565
"39089751900",3039,1000,18,18,134,71,17,10,4307
"39089752200",3441,846,123,52,65,57,11,4,4599
"39089752500",1992,1407,107,59,83,187,0,16,3851
"39089752800",6251,473,114,3,278,79,64,24,7286
"39089753100",4008,606,99,11,122,119,16,6,4987
"39089753300",5242,1158,192,226,314,51,56,21,7260
"39089753600",1576,306,0,6,11,10,12,0,1921
"39089753900",4054,294,97,14,63,93,22,0,4637
"39089754101",5560,1042,113,53,380,91,160,26,7425
"39089754102",2281,35,4,0,38,0,0,0,2358
"39089754400",5319,756,45,0,258,0,0,0,6378
"39089754700",5384,768,0,0,197,98,202,82,6731
"39089755000",6297,105,4,7,108,12,80,0,6613
"39089755300",6741,274,12,15,25,70,176,58,7371
"39089755600",4751,424,0,6,79,14,57,0,5331
"39089755900",5744,376,686,16,82,0,85,0,6989
"39089756201",1599,232,556,35,16,10,4,3,2455
"39089756202",4968,557,1798,36,592,40,390,0,8381
"39089756500",3212,568,35,38,182,0,0,0,4035
"39089756800",6893,595,90,0,177,71,53,0,7879
"39089757100",4011,113,43,0,16,0,0,0,4183
"39089757400",5809,294,57,0,120,0,249,7,6536
"39089757700",5118,239,0,0,94,0,101,0,5552
"39089758300",2027,582,0,0,105,78,116,100,3008
"39089758600",6587,523,16,0,243,0,39,0,7408
"39089758900",5139,959,20,16,127,86,17,95,6459
"39089759000",1997,743,57,83,4,62,0,0,2946
"39089759100",6484,472,17,0,270,0,57,0,7300
"39091003800",3396,469,18,13,70,37,6,0,4009
"39091003900",4139,424,16,0,73,2,76,11,4741
"39091004000",2235,322,0,6,9,0,9,0,2581
"39091004100",2357,445,0,2,21,15,0,0,2840
"39091004200",1134,338,11,3,10,28,0,0,1524
"39091004300",4791,1278,39,0,128,50,38,0,6324
"39091004400",3279,984,157,40,72,213,75,38,4858
"39091004500",3010,865,198,15,128,108,15,107,4446
"39091004600",4292,410,125,57,75,24,21,47,5051
"39091004700",4713,129,124,0,147,0,79,0,5192
"39091004800",3526,165,4,19,72,26,81,0,3893
"39093010200",3941,9,0,0,93,64,138,64,4309
"39093010300",4685,169,0,0,370,0,109,17,5350
"39093010400",2469,179,74,0,104,21,38,0,2885
"39093013100",9479,98,18,3,302,14,217,3,10134
"39093013200",9786,268,658,394,363,11,404,0,11884
"39093021100",2759,201,42,5,172,8,144,20,3351
"39093021200",4807,824,35,24,157,0,282,0,6129
"39093022100",1562,97,170,8,48,21,151,22,2079
"39093022200",1694,426,157,51,163,40,337,117,2985
"39093022400",1863,840,377,518,226,126,564,287,4801
"39093022500",1129,102,53,13,125,57,230,40,1749
"39093022601",1062,473,342,164,178,43,103,89,2454
"39093022800",1611,801,634,567,267,226,857,560,5523
"39093023000",2853,1442,273,693,313,165,607,291,6637
"39093023100",1560,566,245,389,400,415,1342,786,5703
"39093023200",1615,614,438,197,73,115,925,429,4406
"39093023300",1036,410,435,288,247,72,547,218,3253
"39093023400",1497,205,138,9,109,24,357,0,2339
"39093023500",1310,287,97,57,95,43,277,129,2295
"39093023600",1417,483,216,27,521,94,1100,335,4193
"39093023700",3327,1035,359,533,489,328,1144,1276,8491
"39093023800",808,389,8,46,266,112,345,270,2244
"39093023900",983,250,254,15,46,134,327,153,2162
"39093024000",1254,208,122,111,152,59,237,82,2225
"39093024100",1822,546,387,57,221,82,657,201,3973
"39093024200",3089,393,269,114,293,65,815,103,5141
"39093028100",3476,42,228,42,180,36,335,0,4339
"39093030100",5228,847,0,1,186,14,124,1,6401
"39093050100",3078,58,50,0,92,0,96,0,3374
"39093050200",3152,330,0,0,96,1,169,9,3757
"39093050300",6746,633,38,0,189,8,290,8,7912
"39093050400",2133,94,5,162,60,0,99,6,2559
"39093057100",3286,339,34,0,53,10,168,4,3894
"39093060100",1832,348,689,118,446,163,163,102,3861
"39093060200",1864,607,446,34,46,34,12,14,3057
"39093070101",2959,123,173,16,241,0,179,16,3707
"39093070102",4095,531,506,249,302,207,486,120,6496
"39093070200",1502,143,44,9,152,1,221,19,2091
"39093070300",2086,468,324,23,41,34,13,0,2989
"39093070400",2505,704,879,262,128,262,175,49,4964
"39093070500",1502,850,247,206,150,163,65,102,3285
"39093070600",3317,645,228,14,136,15,41,33,4429
"39093070700",1630,610,261,20,33,53,72,33,2712
"39093070800",374,244,21,205,14,17,35,15,925
"39093070901",300,492,305,326,138,335,3,215,2114
"39093070902",2585,302,209,311,130,15,67,0,3619
"39093071000",654,483,144,123,113,112,86,12,1727
"39093071100",3339,435,143,85,273,133,175,63,4646
"39093071201",3318,613,526,151,145,71,218,74,5116
"39093071202",3227,195,424,78,364,27,123,0,4438
"39093071300",3667,395,0,349,314,31,195,47,4998
"39093071400",1303,356,475,799,100,175,109,189,3506
"39093071500",1480,138,9,9,65,0,35,0,1736
"39093077100",3121,193,142,0,0,0,168,0,3624
"39093080101",2068,83,7,6,62,14,100,0,2340
"39093080103",3788,328,41,11,109,27,141,27,4472
"39093080104",3311,163,42,0,132,0,69,0,3717
"39093080500",5518,115,307,1,260,1,318,1,6521
"39093080600",4603,589,34,2,161,208,191,15,5803
"39093080700",8058,414,62,2,202,104,270,16,9128
"39093090100",3219,122,0,3,36,83,68,0,3531
"39093090200",3078,298,0,0,139,0,0,0,3515
"39093091100",2947,293,37,31,144,42,89,0,3583
"39093091200",2273,239,13,0,79,0,24,14,2642
"39093092100",2283,196,8,0,54,29,96,0,2666
"39093093100",2788,271,56,0,41,7,31,0,3194
"39093094100",7376,414,22,0,76,0,37,20,7945
"39093095100",4702,264,4,0,146,0,83,0,5199
"39093096100",5342,535,39,18,153,74,52,41,6254
"39093097100",2929,53,16,0,37,0,29,8,3072
"39093097200",5838,845,452,43,442,121,1129,15,8885
"39093097300",818,614,693,357,149,219,565,372,3787
"39093097400",9804,312,233,23,357,31,199,31,10990
"39093990200",0,0,0,0,0,0,0,0,0
"39095000200",2950,383,526,234,240,88,468,0,4889
"39095000300",2907,188,287,452,65,21,224,0,4144
"39095000400",1927,534,161,153,123,332,65,232,3527
"39095000600",2532,832,762,309,275,108,395,148,5361
"39095000700",3017,434,557,544,261,190,450,107,5560
"39095000800",69,19,581,370,79,8,62,15,1203
"39095000900",701,161,1157,325,152,110,161,18,2785
"39095001000",1289,261,1545,537,264,94,358,103,4451
"39095001100",421,236,962,521,135,447,96,97,2915
"39095001201",1371,268,266,196,203,94,233,59,2690
"39095001202",354,209,99,946,99,315,84,179,2285
"39095001301",2143,108,168,8,49,121,69,0,2666
"39095001302",494,429,383,358,56,180,75,51,2026
"39095001303",1119,119,1052,164,298,10,69,0,2831
"39095001400",100,232,498,549,48,116,24,6,1573
"39095001500",99,47,694,384,40,59,53,45,1421
"39095001600",643,279,1299,421,119,114,8,35,2918
"39095001700",299,199,261,511,49,30,105,33,1487
"39095001800",661,154,942,506,244,110,157,108,2882
"39095001900",136,208,494,376,86,183,127,76,1686
"39095002000",738,437,82,245,145,83,208,58,1996
"39095002100",1004,259,583,645,162,10,53,3,2719
"39095002200",146,63,335,930,0,235,0,122,1831
"39095002300",64,127,715,531,27,16,0,33,1513
"39095002401",752,640,1191,505,177,252,153,29,3699
"39095002402",25,46,895,514,30,0,10,0,1520
"39095002500",15,27,760,985,85,49,0,21,1942
"39095002600",14,6,706,281,39,17,0,0,1063
"39095002700",239,215,138,350,32,68,20,38,1100
"39095002800",292,166,140,340,45,41,48,37,1109
"39095002900",130,304,104,840,114,85,113,158,1848
"39095003000",633,318,115,479,117,92,148,114,2016
"39095003100",44,57,590,249,4,27,79,0,1050
"39095003200",29,14,586,675,7,19,0,19,1349
"39095003300",39,33,798,663,33,29,46,3,1644
"39095003400",28,91,194,535,17,46,4,36,951
"39095003500",64,88,702,507,50,5,4,89,1509
"39095003600",11,55,541,560,6,19,0,7,1199
"39095003700",295,70,196,628,37,12,18,23,1279
"39095003900",2549,617,450,516,418,501,286,292,5629
"39095004000",716,440,385,185,123,75,169,145,2238
"39095004200",513,330,148,255,132,81,134,130,1723
"39095004400",1796,996,395,212,189,426,144,224,4382
"39095004501",2208,177,250,163,44,6,261,0,3109
"39095004503",2074,309,13,92,68,57,66,10,2689
"39095004504",3099,67,115,0,185,53,169,9,3697
"39095004600",1557,692,23,66,196,40,285,55,2914
"39095004701",1212,726,177,220,280,184,351,172,3322
"39095004702",1877,830,52,437,315,572,474,580,5137
"39095004800",1219,871,172,167,121,299,166,349,3364
"39095004900",1537,702,101,140,280,190,327,215,3492
"39095005000",1063,423,23,92,197,238,317,133,2486
"39095005100",1417,1069,374,664,310,388,366,206,4794
"39095005200",2048,956,210,0,242,166,438,169,4229
"39095005300",626,698,89,53,239,270,325,311,2611
"39095005400",1200,472,112,429,366,202,555,145,3481
"39095005501",1924,441,0,192,130,48,46,13,2794
"39095005502",2880,287,18,9,17,4,45,0,3260
"39095005503",1972,202,13,7,140,0,123,13,2470
"39095005600",4171,396,57,174,289,34,428,0,5549
"39095005701",2401,764,212,327,42,252,126,360,4484
"39095005702",3873,523,183,187,179,120,67,56,5188
"39095005703",1886,628,38,0,176,40,202,21,2991
"39095005801",2657,500,345,100,65,97,194,0,3958
"39095005802",3468,556,283,44,63,128,166,92,4800
"39095005901",2297,84,72,2,107,0,125,0,2687
"39095005902",2632,728,182,161,286,103,258,174,4524
"39095006000",1757,130,202,26,351,22,49,0,2537
"39095006100",2423,152,368,8,202,19,152,2,3326
"39095006200",2093,273,109,47,151,0,97,0,2770
"39095006300",2261,313,230,82,79,104,199,55,3323
"39095006400",1798,193,98,227,87,23,115,0,2541
"39095006500",1298,359,365,147,131,57,10,0,2367
"39095006600",414,159,1285,641,46,103,1,47,2696
"39095006700",281,391,641,275,81,7,50,37,1763
"39095006800",1500,924,618,838,345,342,134,154,4855
"39095006900",2386,97,112,42,40,0,160,9,2846
"39095007001",3734,255,0,0,23,0,156,18,4186
"39095007002",1874,59,21,0,4,0,47,0,2005
"39095007101",3540,263,213,76,140,181,135,14,4562
"39095007102",3267,320,0,0,35,24,61,12,3719
"39095007202",2340,202,494,185,176,44,114,16,3571
"39095007203",3397,169,633,23,227,0,130,42,4621
"39095007204",2841,437,717,214,195,45,218,13,4680
"39095007205",2676,446,1184,571,435,155,307,0,5774
"39095007301",3272,396,879,143,381,0,301,12,5384
"39095007302",866,248,1148,352,299,78,147,34,3172
"39095007303",860,468,1345,1127,215,334,28,125,4502
"39095007400",1315,1027,2206,766,562,111,417,35,6439
"39095007500",1855,551,952,341,203,311,89,0,4302
"39095007600",3831,121,97,9,490,7,32,0,4587
"39095007700",2648,549,66,13,128,13,62,6,3485
"39095007800",2985,397,84,90,130,26,86,23,3821
"39095007901",1973,163,0,0,12,7,147,7,2309
"39095007902",4225,691,392,80,202,121,114,11,5836
"39095008000",3326,285,109,168,78,0,153,0,4119
"39095008100",2885,451,137,33,216,216,142,92,4172
"39095008201",4279,222,7,0,236,0,107,0,4851
"39095008202",5078,252,103,29,108,0,16,0,5586
"39095008203",5978,421,329,55,371,112,77,80,7423
"39095008301",4235,639,250,0,377,51,159,77,5788
"39095008302",1522,116,91,0,35,0,25,0,1789
"39095008400",3523,269,495,105,239,0,127,32,4790
"39095008500",2428,228,465,435,146,48,115,1,3866
"39095008600",3630,547,582,315,268,100,94,109,5645
"39095008700",4404,1724,686,525,427,457,403,193,8819
"39095008800",5716,507,352,69,487,40,344,2,7517
"39095008901",4800,297,0,47,142,0,133,19,5438
"39095008902",5442,239,25,0,275,0,122,0,6103
"39095009000",10872,426,480,7,341,0,210,6,12342
"39095009101",2987,204,341,3,552,29,60,22,4198
"39095009102",3616,521,463,12,197,124,203,118,5254
"39095009201",7139,393,75,1,577,8,35,8,8236
"39095009202",6110,334,322,0,417,23,181,0,7387
"39095009300",1471,123,15,0,14,0,6,0,1629
"39095009400",1668,221,292,224,81,53,80,29,2648
"39095009500",2416,278,0,8,237,13,290,35,3277
"39095009600",2916,225,0,0,136,19,98,6,3400
"39095009700",2770,193,34,0,67,0,109,0,3173
"39095009800",3548,95,0,0,318,0,321,0,4282
"39095009900",3613,365,50,12,417,46,337,13,4853
"39095010001",3298,422,72,109,187,67,262,147,4564
"39095010002",2645,285,14,65,169,260,162,234,3834
"39095010100",3136,424,42,6,193,18,123,77,4019
"39095010200",1747,585,233,64,40,71,75,119,2934
"39095010300",789,508,177,205,248,330,546,349,3152
"39095010400",125,64,48,0,0,7,17,9,270
"39095990000",0,0,0,0,0,0,0,0,0
"39097040101",2026,107,0,6,82,2,37,2,2262
"39097040102",4569,283,0,0,182,8,67,8,5117
"39097040201",2690,89,14,0,39,51,35,0,2918
"39097040202",2389,245,0,0,34,13,31,0,2712
"39097040400",2455,158,0,0,36,0,2,0,2651
"39097040500",3702,483,13,42,98,61,35,2,4436
"39097040600",4642,467,94,0,269,19,150,0,5641
"39097040700",2151,431,160,129,274,33,73,0,3251
"39097041000",38,0,0,0,4,0,0,0,42
"39097041100",4105,374,58,0,66,20,32,0,4655
"39097041200",2518,434,11,4,8,19,12,2,3008
"39097041300",1907,102,0,0,3,0,25,0,2037
"39099800300",236,77,643,345,8,112,73,8,1502
"39099800400",0,48,743,96,71,13,18,4,993
"39099800500",378,430,553,1099,50,76,114,379,3079
"39099800600",136,174,354,564,93,25,96,302,1744
"39099801000",425,211,300,364,38,115,117,85,1655
"39099801100",657,402,525,605,78,101,243,51,2662
"39099801200",815,214,427,85,26,96,132,42,1837
"39099801300",1024,524,294,480,58,66,103,86,2635
"39099801400",1772,361,82,18,26,0,52,10,2321
"39099801500",940,144,536,257,83,64,97,0,2121
"39099801600",360,317,615,1196,309,185,193,143,3318
"39099801700",167,276,111,373,59,13,33,220,1252
"39099802100",15,23,453,208,30,5,0,7,741
"39099802300",103,136,270,104,34,209,19,209,1084
"39099802400",215,186,1104,723,116,89,60,145,2638
"39099802500",181,146,583,639,0,21,20,83,1673
"39099802600",1001,375,195,183,112,107,89,77,2139
"39099802701",2441,311,147,25,17,19,131,0,3091
"39099802702",2266,190,240,9,104,3,87,0,2899
"39099802800",1692,490,284,34,25,21,107,110,2763
"39099802900",1188,665,290,387,15,47,23,89,2704
"39099803000",1165,320,95,270,39,5,77,16,1987
"39099804000",307,494,614,286,25,22,48,24,1820
"39099804100",266,32,521,196,9,0,9,0,1033
"39099804200",543,100,1094,242,147,125,33,88,2372
"39099804300",228,141,185,298,29,23,45,47,996
"39099810100",2742,457,299,159,85,132,238,165,4277
"39099810200",1200,457,454,107,76,46,348,98,2786
"39099810300",424,340,461,334,112,113,168,163,2115
"39099810600",2122,705,62,14,78,0,175,72,3228
"39099810700",4559,548,3,1,13,70,10,53,5257
"39099810800",1728,381,58,29,5,81,42,78,2402
"39099810900",1811,162,153,13,26,0,40,0,2205
"39099811001",3637,109,72,0,54,0,109,0,3981
"39099811002",6888,493,36,0,201,0,238,0,7856
"39099811100",894,219,10,3,11,4,26,4,1171
"39099811200",2328,67,0,0,6,0,18,0,2419
"39099811300",4728,869,448,140,284,0,518,271,7258
"39099811400",2186,403,337,220,151,21,43,44,3405
"39099811500",5093,217,77,0,73,17,78,57,5612
"39099811600",2912,163,129,60,70,21,90,22,3467
"39099811700",2139,238,132,0,121,0,21,6,2657
"39099811800",1067,226,42,25,47,0,63,15,1485
"39099811901",3826,198,55,62,94,33,133,65,4466
"39099811902",2874,66,1,2,314,29,28,0,3314
"39099812001",4673,347,124,59,179,21,169,0,5572
"39099812002",3591,180,132,0,90,0,41,0,4034
"39099812100",8267,455,163,6,549,50,131,0,9621
"39099812200",5719,331,0,0,376,0,46,0,6472
"39099812301",3018,607,42,186,90,21,125,7,4096
"39099812302",4865,515,401,106,238,0,194,0,6319
"39099812400",2181,539,114,105,65,0,82,111,3197
"39099812500",4329,249,225,28,96,20,60,0,5007
"39099812601",2977,413,395,166,92,92,168,0,4303
"39099812602",4418,210,241,28,66,10,15,0,4988
"39099812603",7295,530,298,0,265,13,70,26,8497
"39099812700",1904,125,0,6,30,3,62,0,2130
"39099812800",2970,596,0,0,52,28,24,39,3709
"39099812900",3708,265,0,1,76,0,65,0,4115
"39099813000",3822,616,10,0,42,4,10,6,4510
"39099813200",3443,608,0,1,0,0,181,0,4233
"39099813300",2551,434,0,0,90,0,0,0,3075
"39099813400",3111,312,0,17,16,2,46,0,3504
"39099813500",6286,519,13,0,20,0,0,0,6838
"39099813600",6975,793,16,0,219,0,165,14,8182
"39099813700",381,666,551,640,47,85,245,301,2916
"39099813800",306,184,1266,609,21,102,85,267,2840
"39099813900",36,77,1001,519,25,7,0,0,1665
"39099814000",247,478,902,960,81,62,60,252,3042
"39099814100",926,503,134,645,42,198,68,25,2541
"39101000100",668,517,17,9,5,0,0,0,1216
"39101000200",1959,1016,59,88,72,68,14,80,3356
"39101000300",1710,386,4,2,0,28,0,11,2141
"39101000400",2586,1051,3,38,22,95,7,28,3830
"39101000501",1558,631,41,26,84,54,25,42,2461
"39101000502",1896,394,19,44,30,0,22,0,2405
"39101000600",3902,174,26,42,351,163,205,0,4863
"39101000700",2175,242,64,10,103,0,44,0,2638
"39101000800",1551,708,31,6,6,48,0,3,2353
"39101000900",2216,1472,218,178,42,33,58,67,4284
"39101001000",2432,218,38,0,57,0,49,0,2794
"39101001100",1567,491,184,4,39,20,92,0,2397
"39101010100",4417,304,9,0,249,0,32,3,5014
"39101010201",4063,734,28,0,201,26,47,26,5125
"39101010202",12,0,0,0,0,0,0,0,12
"39101010300",4007,665,0,14,101,144,139,141,5211
"39101010400",3986,762,10,0,43,30,5,0,4836
"39101010500",5130,152,34,0,122,40,37,40,5555
"39103400100",7333,325,29,6,99,0,73,0,7865
"39103402000",4779,301,0,0,34,7,242,0,5363
"39103403001",2914,357,0,1,22,0,1,0,3295
"39103403002",3048,50,16,0,42,0,45,0,3201
"39103404000",3866,192,16,0,70,0,96,0,4240
"39103405000",4099,338,0,0,114,0,21,0,4572
"39103406000",4683,385,49,3,281,0,42,0,5443
"39103407000",6003,129,50,15,335,110,93,0,6735
"39103408001",2685,232,63,0,46,0,70,0,3096
"39103408002",1718,50,0,0,28,5,103,0,1904
"39103408003",2513,197,30,14,191,0,48,0,2993
"39103408100",5535,460,277,347,106,184,64,147,7120
"39103408201",3283,789,26,117,15,36,108,12,4386
"39103408202",4987,201,44,0,78,0,47,0,5357
"39103408301",3244,156,34,0,100,0,36,0,3570
"39103408302",8882,550,225,37,152,110,139,0,10095
"39103409001",2051,73,6,0,54,6,60,0,2250
"39103409002",3882,407,58,0,152,2,34,1,4536
"39103410000",3631,538,0,0,0,0,141,0,4310
"39103411001",1675,122,0,0,7,6,4,0,1814
"39103411002",2293,509,0,58,21,29,15,26,2951
"39103412000",4129,181,2,2,19,0,15,0,4348
"39103413000",5329,282,5,2,28,0,12,32,5690
"39103415100",3959,164,25,0,31,7,14,0,4200
"39103415200",3927,182,25,0,72,0,198,0,4404
"39103415300",3521,265,16,0,311,14,41,4,4172
"39103415400",4117,414,0,0,168,0,325,8,5032
"39103415800",6143,171,135,0,393,27,183,0,7052
"39103416000",4945,361,9,0,106,34,72,0,5527
"39103416100",4386,414,50,0,47,0,49,0,4946
"39103416200",3277,366,105,38,55,0,29,81,3951
"39103416300",2429,135,57,0,32,0,37,0,2690
"39103416400",2779,504,30,0,142,0,147,0,3602
"39103417000",7285,286,72,46,173,0,124,0,7986
"39103417100",5628,226,48,0,239,36,0,0,6177
"39103417200",6283,445,0,111,158,157,92,12,7258
"39103417300",3682,426,0,84,131,25,0,12,4360
"39105964100",3579,659,61,0,33,9,5,66,4412
"39105964200",3784,1000,0,0,16,0,3,0,4803
"39105964300",3880,633,47,0,51,0,0,0,4611
"39105964400",1715,1192,48,0,44,47,0,0,3046
"39105964500",2016,907,59,32,60,13,2,3,3092
"39105964600",2412,783,6,0,47,10,5,35,3298
"39107967200",3003,570,1,9,8,9,4,15,3619
"39107967300",4035,288,0,0,21,21,0,0,4365
"39107967400",3912,525,3,32,197,33,49,17,4768
"39107967500",4559,249,81,0,152,0,58,0,5099
"39107967600",2308,553,0,0,57,114,41,68,3141
"39107967700",5702,255,0,8,97,2,95,13,6172
"39107967800",1750,257,0,0,27,0,0,0,2034
"39107967900",6041,278,12,7,87,0,194,0,6619
"39107968000",4804,189,0,0,47,0,57,71,5168
"39109300100",3385,501,169,0,109,107,8,0,4279
"39109315001",3240,127,153,24,173,48,119,0,3884
"39109315002",3388,1044,55,46,232,37,3,0,4805
"39109315100",3923,1183,251,193,108,156,0,22,5836
"39109315300",3354,1460,49,39,39,0,66,15,5022
"39109320100",3244,390,0,0,16,0,8,0,3658
"39109325000",2222,498,0,0,0,44,49,0,2813
"39109330100",3099,266,0,2,23,32,34,1,3457
"39109340100",4599,510,0,3,0,8,6,0,5126
"39109345000",4226,424,0,0,136,29,31,0,4846
"39109350100",7217,302,21,0,201,88,44,0,7873
"39109355001",5267,561,69,2,85,2,59,0,6045
"39109355002",1594,60,0,3,23,2,6,2,1690
"39109365000",6678,894,376,21,803,49,91,294,9206
"39109365101",3453,230,50,0,102,38,10,0,3883
"39109365102",4221,653,55,1,106,0,48,33,5117
"39109365200",2699,674,89,8,31,0,5,0,3506
"39109365301",4214,646,224,132,101,125,21,52,5515
"39109365302",5006,387,15,0,246,38,147,0,5839
"39109380100",5852,457,113,28,115,23,242,75,6905
"39109390100",3926,481,3,0,72,0,33,0,4515
"39111966600",2623,548,0,0,42,7,4,0,3224
"39111966700",2901,762,13,0,26,52,15,0,3769
"39111966800",3079,802,15,33,50,0,0,38,4017
"39111966900",2783,561,0,10,36,7,10,0,3407
"39113000100",216,185,1813,502,19,0,0,0,2735
"39113000200",165,115,1166,745,29,39,0,0,2259
"39113000300",93,15,983,743,17,53,56,0,1960
"39113000400",133,64,2511,913,86,42,24,0,3773
"39113000500",646,72,2172,949,44,0,0,0,3883
"39113000600",199,12,1289,247,74,0,7,0,1828
"39113000700",32,31,1175,942,16,7,0,0,2203
"39113000801",596,150,1433,931,105,54,168,0,3437
"39113000802",238,128,1111,598,137,34,24,61,2331
"39113000900",375,353,857,584,41,280,0,0,2490
"39113001000",84,81,383,538,26,23,12,19,1166
"39113001100",806,944,1186,982,131,237,32,253,4571
"39113001200",269,141,266,215,92,28,0,0,1011
"39113001501",1345,577,255,504,49,58,82,42,2912
"39113001600",1244,269,242,332,57,29,9,46,2228
"39113001700",461,254,53,65,4,0,10,12,859
"39113001800",2889,1587,443,685,241,79,28,133,6085
"39113001900",2448,1602,131,160,38,318,124,567,5388
"39113002000",1382,836,603,176,85,160,91,227,3560
"39113002200",1103,1239,138,143,152,217,266,273,3531
"39113002300",1190,1223,35,423,136,178,53,59,3297
"39113002400",1540,919,45,0,0,0,73,431,3008
"39113002500",3308,1108,250,448,180,53,88,361,5796
"39113002600",3520,1512,212,60,180,177,58,108,5827
"39113002700",1590,297,62,49,31,0,9,13,2051
"39113002800",1716,232,79,32,41,28,10,0,2138
"39113002900",3371,461,126,0,53,104,0,0,4115
"39113003000",2332,433,0,15,84,95,51,31,3041
"39113003100",2103,367,57,42,8,11,10,0,2598
"39113003201",2192,671,114,63,152,73,28,102,3395
"39113003300",2757,783,394,525,143,113,110,10,4835
"39113003402",448,768,41,47,46,19,11,23,1403
"39113003403",94,190,0,17,10,0,0,0,311
"39113003404",1031,543,63,179,34,48,63,26,1987
"39113003500",31,0,1077,1252,18,0,0,0,2378
"39113003800",37,105,1650,1049,11,71,0,35,2958
"39113003900",0,15,1480,619,106,118,93,22,2453
"39113004100",3,35,682,1268,3,80,0,0,2071
"39113004200",22,91,945,1289,40,39,0,0,2426
"39113004300",35,150,1023,920,33,0,0,40,2201
"39113004400",34,57,1349,810,0,0,0,0,2250
"39113004600",44,147,629,625,26,23,0,32,1526
"39113010100",1939,31,0,0,54,0,43,0,2067
"39113010200",6576,280,0,0,203,0,12,0,7071
"39113020100",2326,257,53,12,61,77,13,17,2816
"39113020200",2355,298,27,0,40,0,14,4,2738
"39113020300",2418,119,10,0,57,15,153,0,2772
"39113020400",4813,575,325,120,299,75,57,77,6341
"39113020500",1174,110,42,0,61,24,12,6,1429
"39113020601",1589,121,0,0,76,0,98,30,1914
"39113020602",1593,27,0,0,58,0,30,0,1708
"39113020700",2583,217,48,9,89,51,36,0,3033
"39113020800",2035,95,76,32,43,0,11,10,2302
"39113020900",1943,277,67,9,74,69,76,0,2515
"39113021000",1375,223,16,0,79,0,23,0,1716
"39113021100",2094,602,76,41,200,75,60,0,3148
"39113021200",1382,98,40,17,116,51,9,0,1713
"39113021301",2418,415,0,11,28,119,28,0,3019
"39113021302",1644,250,0,0,30,29,41,4,1998
"39113021400",2300,228,0,44,157,15,28,0,2772
"39113021501",2220,376,76,95,120,47,9,13,2956
"39113021502",1258,197,48,30,32,9,39,23,1636
"39113021601",1796,153,54,62,56,58,10,0,2189
"39113021602",3157,151,60,0,57,0,29,0,3454
"39113021700",1936,263,2,10,107,0,15,0,2333
"39113021800",1080,421,146,185,174,149,10,0,2165
"39113021900",1883,134,44,5,121,26,87,0,2300
"39113030100",2587,466,415,640,102,66,73,0,4349
"39113030200",2107,473,243,127,20,16,45,4,3035
"39113040101",1684,17,17,0,60,5,10,0,1793
"39113040102",1907,66,0,0,151,25,30,0,2179
"39113040103",2181,25,20,0,63,23,30,8,2350
"39113040201",2412,182,0,0,156,12,95,0,2857
"39113040203",2066,60,49,0,333,10,64,0,2582
"39113040204",3902,199,412,0,330,33,9,1,4886
"39113040302",4212,258,473,461,135,0,111,41,5691
"39113040303",4478,100,47,0,155,0,78,0,4858
"39113040305",2550,26,22,0,345,0,141,0,3084
"39113040306",4215,166,281,0,300,0,13,0,4975
"39113040401",4235,262,243,54,378,0,87,65,5324
"39113040403",3337,209,116,34,348,0,96,0,4140
"39113040405",3905,482,319,60,715,11,66,29,5587
"39113040406",4952,95,153,2,1263,0,35,0,6500
"39113050101",2720,331,267,168,225,67,49,0,3827
"39113050103",5243,529,594,63,1663,93,365,83,8633
"39113050104",2111,99,86,93,90,7,19,0,2505
"39113050105",3832,325,313,195,209,23,112,50,5059
"39113050301",2125,316,184,33,22,55,80,30,2845
"39113050302",4282,701,329,26,13,0,12,0,5363
"39113050303",2116,620,574,483,286,93,103,90,4365
"39113050401",4444,470,24,0,111,75,61,24,5209
"39113050402",1563,332,108,0,58,0,30,0,2091
"39113050502",2102,636,194,25,108,35,0,40,3140
"39113050503",5524,666,58,78,25,0,137,0,6488
"39113050504",4456,1205,114,62,418,0,86,0,6341
"39113050600",3035,573,18,0,96,14,14,10,3760
"39113060100",2293,133,395,148,60,48,0,87,3164
"39113060200",614,316,643,64,25,17,16,0,1695
"39113060300",113,55,1919,948,30,11,11,2,3089
"39113070101",1422,238,2088,753,76,94,21,0,4692
"39113070102",659,67,1988,554,145,0,49,0,3462
"39113070201",435,232,248,364,92,48,14,20,1453
"39113070202",53,97,1047,745,16,61,0,7,2026
"39113070300",323,172,1186,858,8,111,18,130,2806
"39113070400",601,181,1047,413,183,74,42,61,2602
"39113070500",585,80,2317,889,201,6,7,0,4085
"39113070600",147,17,724,56,53,0,41,0,1038
"39113070700",272,203,1868,676,25,53,46,10,3153
"39113080100",1083,335,3229,1043,218,98,162,107,6275
"39113080200",1224,178,926,280,58,5,46,0,2717
"39113080300",532,147,875,326,41,35,26,30,2012
"39113080400",811,322,961,587,53,108,47,29,2918
"39113080500",3592,589,325,1144,158,266,65,111,6250
"39113080600",1153,368,14,10,29,0,0,0,1574
"39113080700",1494,551,8,0,0,0,0,38,2091
"39113090302",4342,668,560,0,242,84,128,0,6024
"39113090303",2325,122,478,80,396,0,103,8,3512
"39113090304",5011,540,737,72,678,0,148,0,7186
"39113090600",2509,944,61,86,110,21,43,23,3797
"39113090700",1049,209,29,0,51,2,16,24,1380
"39113090800",1121,97,21,45,0,5,11,0,1300
"39113090900",3014,244,89,51,89,0,144,0,3631
"39113091000",2011,275,0,0,78,52,15,0,2431
"39113091100",2146,129,154,0,567,0,553,0,3549
"39113100101",4121,678,765,357,285,295,286,58,6845
"39113100102",4025,285,1030,50,207,102,129,0,5828
"39113100201",3010,446,786,69,161,114,8,0,4594
"39113100202",1750,69,263,93,164,17,79,0,2435
"39113100203",3502,535,412,18,417,89,323,183,5479
"39113100301",2569,446,382,84,576,94,10,0,4161
"39113100302",2369,431,103,0,229,0,66,0,3198
"39113100400",3306,472,626,88,253,90,122,8,4965
"39113110100",1377,37,0,0,12,0,0,0,1426
"39113110201",4197,182,94,0,69,0,43,0,4585
"39113110202",1798,228,561,61,18,17,25,0,2708
"39113115002",3029,444,18,0,75,0,76,0,3642
"39113115011",4417,569,179,88,378,101,44,77,5853
"39113115012",4426,144,651,36,180,39,33,0,5509
"39113120101",4078,203,710,0,159,44,124,34,5352
"39113120102",3276,160,871,287,62,57,65,0,4778
"39113120103",1502,128,860,95,194,31,81,10,2901
"39113125000",5850,338,0,0,66,0,115,0,6369
"39113125101",5269,398,634,36,632,284,0,0,7253
"39113125102",4742,526,544,134,77,42,22,18,6105
"39113130101",2132,191,8,0,49,6,16,0,2402
"39113130102",5766,488,0,22,65,0,76,20,6437
"39113140100",4926,822,0,46,33,148,0,0,5975
"39113150100",5622,415,2,13,152,0,47,0,6251
"39113160100",1871,96,0,0,7,0,0,0,1974
"39113165000",5444,766,0,0,178,13,44,27,6472
"39113165100",53,71,1091,1110,37,29,0,30,2421
"39113165200",605,186,343,393,126,27,25,0,1705
"39113980000",0,0,0,0,0,0,0,0,0
"39115968800",2991,454,0,0,90,0,24,0,3559
"39115968900",2782,759,93,152,56,66,0,0,3908
"39115969000",2815,734,35,13,102,38,39,43,3819
"39115969100",2220,803,190,38,73,54,6,0,3384
"39117965000",3736,461,9,0,56,13,81,0,4356
"39117965100",4022,675,0,0,73,0,66,0,4836
"39117965200",5873,799,38,24,176,22,45,4,6981
"39117965300",4716,864,1,2,165,20,82,7,5857
"39117965400",5568,530,26,0,57,0,4,0,6185
"39117965500",5856,653,0,0,145,0,177,0,6831
"39119911000",3974,742,5,0,78,0,37,0,4836
"39119911100",5187,538,15,0,103,19,54,0,5916
"39119911200",5566,625,0,18,233,8,64,0,6514
"39119911300",5523,487,97,36,36,72,0,0,6251
"39119911400",1654,1081,206,249,160,220,14,0,3584
"39119911500",3635,635,179,43,0,73,38,29,4632
"39119911600",5125,409,301,0,174,130,0,0,6139
"39119911700",2295,695,95,14,44,101,59,0,3303
"39119911800",1963,494,91,15,142,117,21,0,2843
"39119911900",2227,787,142,166,133,0,0,0,3455
"39119912000",2093,950,0,33,67,0,19,18,3180
"39119912100",1453,1274,396,90,157,110,0,0,3480
"39119912200",1801,756,207,34,272,152,20,0,3242
"39119912300",3249,679,97,30,177,43,34,0,4309
"39119912400",3193,641,41,0,152,0,29,0,4056
"39119912500",3343,939,0,0,76,41,0,39,4438
"39119912600",3158,554,0,0,0,0,0,17,3729
"39119912700",4518,1012,0,0,28,0,30,0,5588
"39119912800",3953,409,9,12,87,21,67,11,4569
"39121968300",3338,517,0,0,21,2,1,0,3879
"39121968400",4086,552,1,6,36,7,4,2,4694
"39121968500",2920,437,0,0,32,0,0,0,3389
"39123050100",564,32,4,7,11,7,30,0,655
"39123050201",1736,106,12,7,41,12,92,2,2008
"39123050202",1575,46,9,3,13,5,30,8,1689
"39123050301",2326,306,30,16,8,0,10,0,2696
"39123050302",2186,195,0,0,30,0,23,0,2434
"39123050500",2149,352,13,0,200,92,204,39,3049
"39123050600",2731,591,105,16,34,9,401,42,3929
"39123050700",2833,352,0,0,173,82,85,128,3653
"39123050800",3731,462,0,0,6,0,28,0,4227
"39123050900",5091,265,0,45,73,32,72,46,5624
"39123051000",4010,541,38,0,272,87,197,4,5149
"39123051100",3315,280,0,13,117,0,287,0,4012
"39123051200",2725,388,23,0,47,0,84,115,3382
"39125960100",2491,289,16,0,12,0,16,25,2849
"39125960200",3730,547,42,0,66,38,150,35,4608
"39125960300",3397,445,27,17,105,20,127,31,4169
"39125960400",3047,527,20,54,306,96,286,107,4443
"39125960500",3200,393,6,2,77,8,53,7,3746
"39127965800",6786,464,0,11,257,8,77,0,7603
"39127965900",5833,663,0,0,0,0,0,0,6496
"39127966000",3626,1276,0,0,83,76,0,10,5071
"39127966100",3286,963,0,2,40,0,0,27,4318
"39127966200",4420,1240,14,13,80,72,23,16,5878
"39127966300",4274,2032,34,7,69,49,93,6,6564
"39129020100",1166,376,123,14,65,0,0,0,1744
"39129020200",1939,627,44,7,25,23,0,0,2665
"39129020310",3887,906,0,0,158,0,98,0,5049
"39129020320",2671,431,3,10,47,0,0,0,3162
"39129020400",1989,461,0,20,17,10,0,0,2497
"39129021100",7059,644,1,1,58,0,144,0,7907
"39129021200",6357,781,6,9,415,91,105,96,7860
"39129021300",0,0,0,0,0,0,0,0,0
"39129021401",2919,414,0,0,29,10,18,0,3390
"39129021402",5933,330,4,10,256,12,39,0,6584
"39129021500",3283,95,0,0,39,8,13,0,3438
"39129021600",2747,441,0,0,20,2,3,8,3221
"39129021700",3991,767,24,9,72,0,24,0,4887
"39131952200",3772,1720,155,2,88,2,7,6,5752
"39131952300",3574,1028,0,0,122,71,53,14,4862
"39131952400",2616,398,29,2,125,8,61,0,3239
"39131952500",2890,816,0,7,0,4,0,23,3740
"39131952600",4098,1402,0,0,234,16,62,16,5828
"39131952700",3523,946,1,0,172,14,0,0,4656
"39133600102",2588,154,0,7,16,12,58,5,2840
"39133600103",5272,663,12,0,59,34,4,51,6095
"39133600200",5281,673,22,2,44,33,53,0,6108
"39133600301",7399,233,393,0,609,70,121,0,8825
"39133600302",6129,132,141,20,240,0,106,0,6768
"39133600401",4950,348,650,94,611,9,380,0,7042
"39133600402",4154,350,238,22,152,0,19,0,4935
"39133600403",3505,536,272,42,211,73,226,0,4865
"39133600500",4580,652,0,13,35,0,16,0,5296
"39133600602",2391,409,0,0,24,0,8,0,2832
"39133600603",2625,780,6,58,32,59,47,14,3621
"39133600703",1432,371,0,0,36,0,33,22,1894
"39133600704",1472,156,0,0,12,14,0,0,1654
"39133600705",2361,156,0,0,65,0,19,0,2601
"39133600706",2432,325,84,10,24,0,38,0,2913
"39133600800",2367,462,124,22,111,45,9,33,3173
"39133600901",2495,848,281,37,123,142,11,0,3937
"39133600902",4453,906,9,0,183,51,14,56,5672
"39133601000",1425,476,218,72,128,151,52,92,2614
"39133601100",4438,865,110,26,24,3,24,0,5490
"39133601200",3093,943,39,87,206,165,56,44,4633
"39133601300",5195,1150,202,580,207,549,80,74,8037
"39133601400",3114,1003,197,490,302,45,120,92,5363
"39133601501",1280,734,21,35,81,54,9,6,2220
"39133601502",386,468,137,102,55,207,0,26,1381
"39133601503",1911,1682,7,156,189,261,0,57,4263
"39133601600",3347,544,0,0,165,36,37,29,4158
"39133601701",4236,700,209,96,263,131,0,0,5635
"39133601702",4961,1011,95,1,113,26,85,0,6292
"39133601801",3511,222,33,37,79,19,32,0,3933
"39133601802",3849,322,0,0,75,23,9,6,4284
"39133601901",2479,231,0,0,12,0,91,10,2823
"39133601902",2280,526,0,0,0,0,44,0,2850
"39133602000",4832,327,0,21,83,0,0,0,5263
"39133602100",6543,600,18,0,31,19,0,0,7211
"39135400100",2553,499,27,0,41,33,2,33,3188
"39135410100",1930,242,0,9,23,0,0,0,2204
"39135420100",3981,426,0,8,16,6,0,0,4437
"39135430100",2456,252,5,0,44,0,8,0,2765
"39135440100",3081,512,26,0,128,42,3,5,3797
"39135450100",1771,255,0,0,77,47,4,0,2154
"39135455001",1721,373,4,13,81,25,0,40,2257
"39135455002",4042,1268,0,36,15,0,93,0,5454
"39135460100",2572,312,10,0,12,24,0,35,2965
"39135470101",3325,180,0,0,23,0,0,0,3528
"39135470102",3464,594,19,0,92,0,26,0,4195
"39135480100",3924,319,28,0,62,2,24,0,4359
"39137030100",3438,346,0,5,512,91,624,196,5212
"39137030200",5498,304,12,14,20,15,18,6,5887
"39137030300",6875,358,0,0,452,32,657,77,8451
"39137030400",2899,117,15,22,117,28,62,28,3288
"39137030500",3446,218,5,5,54,8,205,3,3944
"39137030600",3939,138,12,4,22,0,0,0,4115
"39137030700",4528,261,3,0,67,0,52,13,4924
"39139000400",1396,568,119,139,90,62,11,0,2385
"39139000500",1872,885,333,208,135,44,17,0,3494
"39139000600",933,799,521,407,292,246,138,7,3343
"39139000700",735,500,874,551,78,44,75,0,2857
"39139000800",1596,808,89,21,52,40,21,13,2640
"39139000900",3065,1013,6,3,65,34,7,0,4193
"39139001000",2853,1066,153,242,159,465,21,116,5075
"39139001100",2391,268,90,13,78,6,36,0,2882
"39139001200",2935,389,179,134,132,19,13,0,3801
"39139001300",2409,375,155,113,105,38,19,0,3214
"39139001400",1473,278,177,162,20,38,129,0,2277
"39139001500",1234,368,12,53,43,107,8,6,1831
"39139001600",1281,755,46,0,48,67,3,25,2225
"39139001700",320,21,10,0,0,0,0,0,351
"39139001800",2644,398,159,63,104,0,19,10,3397
"39139001900",5243,556,64,0,92,9,97,0,6061
"39139002000",5180,307,0,0,108,0,0,0,5595
"39139002101",4004,404,471,6,405,0,32,5,5327
"39139002102",3996,173,48,0,185,0,47,0,4449
"39139002200",5654,787,44,0,253,70,19,0,6827
"39139002300",5046,594,95,5,265,0,165,0,6170
"39139002400",4444,312,98,17,591,0,99,0,5561
"39139002500",3735,389,0,0,42,6,20,9,4201
"39139002600",3547,806,0,0,166,0,116,0,4635
"39139002700",4136,371,0,0,0,15,0,15,4537
"39139002800",3239,683,0,0,46,42,58,10,4078
"39139002900",3794,411,0,0,65,20,25,20,4335
"39139003001",4661,530,29,0,12,0,74,0,5306
"39139003002",2972,239,0,0,115,182,7,93,3608
"39139003100",426,433,442,215,12,112,0,57,1697
"39141955500",5583,658,2,0,78,23,0,8,6352
"39141955601",1810,343,38,0,4,12,0,0,2207
"39141955602",164,87,29,0,13,0,0,0,293
"39141955603",3124,795,37,28,27,58,67,0,4136
"39141955700",4601,847,44,0,286,5,100,0,5883
"39141955800",5709,888,48,156,130,47,7,0,6985
"39141955900",3382,282,175,19,224,30,85,0,4197
"39141956000",3340,1529,104,77,251,16,109,44,5470
"39141956100",2692,512,201,96,242,16,39,0,3798
"39141956200",1536,283,98,218,144,23,65,11,2378
"39141956300",1781,475,163,6,173,80,62,18,2758
"39141956400",1953,1060,91,54,40,140,0,3,3341
"39141956500",2219,1040,164,95,165,287,74,0,4044
"39141956600",4206,581,14,0,117,54,0,0,4972
"39141956700",3690,427,26,0,133,5,0,0,4281
"39141956800",4463,1246,36,0,123,0,0,0,5868
"39141956900",3746,1059,40,0,34,89,18,0,4986
"39143960800",3117,225,35,30,119,0,71,0,3597
"39143960900",2812,330,34,34,123,16,185,9,3543
"39143961000",3391,347,5,4,327,90,395,93,4652
"39143961100",3244,449,0,2,193,114,328,11,4341
"39143961200",3495,229,62,25,158,16,277,62,4324
"39143961300",3283,364,118,31,171,62,321,186,4536
"39143961400",2075,554,153,62,108,309,529,222,4012
"39143961500",2896,461,250,188,415,0,723,194,5127
"39143961600",1958,851,163,53,243,0,364,63,3695
"39143961700",2041,235,238,42,66,131,288,91,3132
"39143961800",2628,602,89,320,187,164,288,189,4467
"39143961900",3237,320,0,0,127,9,157,0,3850
"39143962000",4766,911,0,0,257,0,295,63,6292
"39143962100",4197,392,9,0,109,0,33,0,4740
"39143962200",3643,486,8,0,103,0,151,0,4391
"39145002100",3723,804,12,0,97,18,0,18,4672
"39145002200",3033,1090,0,0,41,0,23,0,4187
"39145002300",3326,1376,0,21,225,0,161,0,5109
"39145002400",4399,1426,0,10,17,80,15,102,6049
"39145002500",2063,591,0,0,31,10,0,0,2695
"39145002600",3038,887,57,0,40,7,12,28,4069
"39145002700",4627,456,0,0,0,0,8,0,5091
"39145002800",3048,1087,0,0,47,44,0,3,4229
"39145002900",4555,736,2,2,324,96,48,0,5763
"39145003000",2388,1195,0,0,51,17,12,0,3663
"39145003100",2206,1117,0,0,105,13,34,19,3494
"39145003200",1079,564,20,15,91,6,0,0,1775
"39145003300",1678,486,18,10,131,43,0,0,2366
"39145003400",1928,1099,238,85,71,10,0,50,3481
"39145003500",1152,1092,0,15,15,27,0,33,2334
"39145003600",595,867,79,5,0,28,2,0,1576
"39145003700",1089,1244,368,88,111,65,67,19,3051
"39145003800",3650,651,23,39,20,0,18,55,4456
"39145003900",2270,542,0,0,158,17,0,0,2987
"39145004000",3004,659,0,0,69,0,46,24,3802
"39147962500",3513,166,8,0,26,0,68,16,3797
"39147962600",3645,378,0,17,38,10,109,55,4252
"39147962700",3098,267,0,7,58,11,126,12,3579
"39147962800",2620,571,136,141,251,104,353,109,4285
"39147962900",1955,968,113,164,188,188,292,43,3911
"39147963000",2184,830,58,167,82,38,277,13,3649
"39147963100",4132,293,0,7,47,1,22,43,4545
"39147963200",2957,868,22,2,94,0,131,0,4074
"39147963300",2609,609,0,0,23,9,49,126,3425
"39147963400",2772,1035,0,22,91,81,282,45,4328
"39147963500",2713,334,13,25,46,134,0,0,3265
"39147963600",3302,436,7,85,50,38,115,28,4061
"39147963700",3708,405,0,23,74,0,117,75,4402
"39147963800",3242,469,0,0,40,20,31,7,3809
"39149971400",3946,248,3,0,55,6,19,4,4281
"39149971500",4887,303,10,16,143,16,33,16,5424
"39149971600",4541,251,0,0,0,0,23,3,4818
"39149971700",3893,215,26,6,42,0,11,0,4193
"39149971800",3975,885,167,269,180,0,101,67,5644
"39149971900",3748,335,107,24,256,32,207,0,4709
"39149972000",1994,1129,249,117,75,39,75,53,3731
"39149972100",4817,354,238,0,156,0,0,0,5565
"39149972200",4583,479,0,0,228,48,113,0,5451
"39149972300",5066,197,10,0,122,1,14,0,5410
"39151700100",178,317,123,227,17,15,0,21,898
"39151700200",2816,1108,1408,291,307,92,219,11,6252
"39151700300",982,969,334,299,21,125,9,19,2758
"39151700400",2986,510,833,372,155,49,29,0,4934
"39151700500",904,689,603,192,149,310,52,158,3057
"39151700600",1613,329,409,243,41,10,108,74,2827
"39151700700",4198,653,550,20,106,18,94,42,5681
"39151700800",2098,702,597,349,183,173,97,36,4235
"39151701000",1341,399,493,423,146,238,0,103,3143
"39151701100",2363,460,323,9,125,48,167,65,3560
"39151701200",2327,653,258,8,43,48,49,8,3394
"39151701300",2338,1078,205,274,208,320,156,5,4584
"39151701500",1187,599,338,328,196,108,71,22,2849
"39151701700",1186,992,221,260,30,179,103,17,2988
"39151701800",433,525,530,652,73,259,6,23,2501
"39151702100",426,579,1464,668,164,117,19,3,3440
"39151702300",362,1011,694,986,25,299,0,120,3497
"39151702500",1740,892,211,146,145,109,27,7,3277
"39151710200",3045,881,432,241,72,231,60,126,5088
"39151710300",2047,607,294,152,180,0,139,24,3443
"39151710400",234,494,47,68,33,38,33,12,959
"39151710500",1968,1242,373,167,223,95,13,21,4102
"39151710600",3833,565,167,4,177,16,192,0,4954
"39151710700",2150,178,75,0,19,0,0,0,2422
"39151710800",4000,816,94,84,29,1,2,0,5026
"39151710900",3983,181,79,42,72,0,51,0,4408
"39151711000",6777,497,31,8,213,0,34,0,7560
"39151711111",4392,326,13,0,36,0,142,0,4909
"39151711112",4889,116,0,15,99,0,14,0,5133
"39151711121",6222,138,48,3,168,0,192,0,6771
"39151711122",5133,476,34,0,175,14,12,42,5886
"39151711202",3723,230,0,0,117,0,17,0,4087
"39151711211",6231,376,66,4,180,17,34,12,6920
"39151711212",2148,374,0,0,32,29,0,0,2583
"39151711311",7059,355,380,0,316,0,160,0,8270
"39151711312",6104,429,94,0,287,0,139,0,7053
"39151711321",3164,208,211,0,179,0,77,0,3839
"39151711322",2385,288,159,6,151,49,0,5,3043
"39151711402",5436,445,157,67,433,2,31,1,6572
"39151711411",3394,72,0,1,236,0,0,0,3703
"39151711412",3779,262,39,1,51,115,0,0,4247
"39151711501",3229,308,82,2,132,84,163,11,4011
"39151711502",2721,168,141,0,213,0,44,7,3294
"39151711600",4804,787,184,43,293,3,29,248,6391
"39151711700",4047,686,362,40,154,238,85,142,5754
"39151711800",4513,312,126,30,103,3,113,0,5200
"39151711900",3874,313,21,4,187,0,11,0,4410
"39151712000",3762,218,12,0,74,1,44,0,4111
"39151712102",6100,528,104,101,392,63,125,12,7425
"39151712111",5470,233,95,0,100,60,105,0,6063
"39151712112",1666,44,0,27,0,0,20,0,1757
"39151712201",4402,514,180,221,152,19,114,81,5683
"39151712202",5031,234,357,1,141,0,52,0,5816
"39151712300",4924,540,339,54,423,0,63,0,6343
"39151712400",4765,475,81,576,391,112,0,0,6400
"39151712500",1911,105,0,0,0,0,2,5,2023
"39151712601",2051,200,0,0,60,0,22,0,2333
"39151712602",4181,330,0,0,101,33,96,0,4741
"39151712700",4836,339,0,0,82,0,59,0,5316
"39151712800",4237,341,0,0,161,0,17,0,4756
"39151712900",3476,537,0,0,27,16,47,44,4147
"39151713000",3591,114,6,0,61,8,90,8,3878
"39151713100",4366,677,272,42,205,180,3,13,5758
"39151713201",5627,829,254,5,144,51,71,0,6981
"39151713202",1841,142,19,0,16,3,6,2,2029
"39151713300",3787,443,119,26,52,0,21,18,4466
"39151713401",4827,492,21,2,207,53,35,0,5637
"39151713402",3465,596,98,0,49,36,52,0,4296
"39151713501",4609,327,123,15,114,0,92,0,5280
"39151713502",4559,606,16,71,28,0,11,0,5291
"39151713600",2302,142,28,30,43,0,29,0,2574
"39151713700",1547,311,115,117,52,88,0,0,2230
"39151713900",1331,601,73,10,81,18,34,119,2267
"39151714000",3595,557,68,66,15,0,16,0,4317
"39151714100",2554,659,130,67,59,6,87,9,3571
"39151714200",990,820,426,282,78,196,58,84,2934
"39151714302",3317,381,184,125,69,0,67,0,4143
"39151714400",2764,355,146,12,61,38,98,136,3610
"39151714600",3777,301,12,0,66,0,18,0,4174
"39151714701",5319,311,20,57,12,26,17,0,5762
"39151714702",2456,120,0,0,76,0,7,0,2659
"39151714801",5553,614,8,0,154,12,31,0,6372
"39151714802",2438,392,0,0,4,22,5,0,2861
"39151714901",3576,321,0,0,30,13,0,10,3950
"39151714902",3031,392,27,78,42,78,54,5,3707
"39151715000",1869,594,186,75,24,12,70,0,2830
"39153501100",269,174,495,405,88,38,0,0,1469
"39153501700",342,527,108,278,114,19,47,19,1454
"39153501800",61,23,521,348,0,0,12,0,965
"39153501900",134,391,486,1234,52,117,0,68,2482
"39153502101",1083,357,509,172,739,186,143,23,3212
"39153502102",1893,488,1220,177,392,62,0,0,4232
"39153502200",3166,705,602,437,854,369,54,71,6258
"39153502300",2483,762,1363,367,282,192,35,0,5484
"39153502500",353,214,109,271,18,1,0,0,966
"39153502600",1753,402,252,137,75,216,14,20,2869
"39153502700",4895,749,463,438,289,56,51,1,6942
"39153502800",3654,503,229,33,174,37,50,0,4680
"39153503100",608,383,445,220,263,62,0,22,2003
"39153503200",404,171,512,382,165,135,43,22,1834
"39153503300",2802,488,621,984,260,247,0,25,5427
"39153503400",132,79,637,536,2,41,0,26,1453
"39153503500",1157,513,883,515,239,48,6,201,3562
"39153503600",2933,468,178,16,213,113,16,1,3938
"39153503701",4939,472,72,66,66,0,200,0,5815
"39153503702",4541,968,93,21,83,16,45,2,5769
"39153503800",1887,676,493,873,43,114,82,116,4284
"39153504100",419,596,61,143,49,60,0,0,1328
"39153504200",602,507,388,359,150,101,158,46,2311
"39153504400",403,355,359,313,23,29,5,0,1487
"39153504500",662,444,349,383,201,59,68,169,2335
"39153504600",1113,589,923,278,173,310,73,0,3459
"39153504700",2873,379,697,203,314,174,64,27,4731
"39153504800",3863,511,265,37,38,72,16,0,4802
"39153505200",211,103,656,235,85,20,29,0,1339
"39153505300",163,326,349,543,41,37,1,0,1460
"39153505400",2322,352,378,199,160,38,31,0,3480
"39153505500",2005,306,282,152,133,0,8,0,2886
"39153505600",383,192,175,266,203,15,6,0,1240
"39153505700",1037,823,260,252,123,53,45,11,2604
"39153505800",3504,540,426,327,333,109,346,0,5585
"39153505900",1614,602,45,58,58,34,14,0,2425
"39153506100",3035,379,1247,542,209,146,55,0,5613
"39153506200",502,133,2653,464,236,19,60,25,4092
"39153506400",1452,461,367,606,39,143,0,0,3068
"39153506500",152,137,1224,1053,87,35,0,0,2688
"39153506600",1074,380,561,491,110,95,44,25,2780
"39153506700",16,0,729,546,28,67,0,0,1386
"39153506800",126,153,650,486,18,9,22,24,1488
"39153507101",2845,177,785,254,68,46,144,0,4319
"39153507102",2297,151,234,19,104,0,33,0,2838
"39153507201",1517,178,578,167,80,7,19,55,2601
"39153507202",2644,300,126,48,180,34,63,15,3410
"39153507203",3539,162,572,8,134,217,122,0,4754
"39153507300",2295,207,222,64,157,36,10,17,3008
"39153507400",160,112,333,217,38,53,0,0,913
"39153507500",2289,792,1671,668,577,202,195,40,6434
"39153507600",2810,461,425,75,397,168,206,0,4542
"39153508000",3346,314,528,96,59,0,58,0,4401
"39153508301",322,618,166,464,39,190,22,29,1850
"39153508399",1223,508,1484,1191,223,101,0,0,4730
"39153508600",71,138,1727,705,68,63,12,10,2794
"39153508800",205,107,3381,1998,122,70,30,0,5913
"39153508900",487,817,99,323,331,348,0,0,2405
"39153509000",306,361,421,401,88,185,0,0,1762
"39153510100",1793,605,85,62,194,120,50,22,2931
"39153510200",3190,804,0,53,169,24,52,117,4409
"39153510301",2312,850,715,626,169,158,58,104,4992
"39153510302",4993,911,86,56,37,0,21,0,6104
"39153510400",3286,268,21,0,36,0,0,0,3611
"39153510500",3595,578,161,0,143,0,128,0,4605
"39153520103",1582,101,68,0,31,4,0,5,1791
"39153520104",3632,586,203,57,109,102,71,0,4760
"39153520105",3279,577,162,9,88,9,45,24,4193
"39153520106",1847,422,147,0,216,0,55,0,2687
"39153520201",2603,85,20,0,88,26,41,25,2888
"39153520202",3518,696,92,7,83,45,0,17,4458
"39153520301",2546,497,82,60,167,9,196,0,3557
"39153520302",2984,173,64,0,70,0,28,0,3319
"39153520400",4283,218,0,0,139,60,462,0,5162
"39153520500",4060,309,30,35,77,53,124,4,4692
"39153520600",2858,491,9,0,0,131,111,49,3649
"39153530101",4474,53,742,0,437,0,90,0,5796
"39153530103",3535,25,562,0,331,0,28,0,4481
"39153530104",5336,377,1169,52,275,104,199,0,7512
"39153530105",1108,166,343,341,109,65,10,0,2142
"39153530108",2870,109,849,0,550,79,134,0,4591
"39153530401",3154,111,156,47,90,10,35,13,3616
"39153530402",2855,162,65,51,165,40,52,10,3400
"39153530501",4789,229,30,5,32,92,0,83,5260
"39153530502",2931,208,50,19,117,17,35,0,3377
"39153530603",3953,326,70,1,346,0,115,0,4811
"39153530604",2943,67,119,2,240,0,36,0,3407
"39153530605",4661,97,177,34,170,26,69,0,5234
"39153530606",5186,172,142,1,157,22,80,0,5760
"39153530700",2356,53,17,1,91,0,11,0,2529
"39153530800",5864,167,102,0,267,0,70,0,6470
"39153530901",3277,477,140,390,117,174,22,0,4597
"39153530902",4906,791,80,4,48,0,43,0,5872
"39153530903",4670,240,25,23,179,17,70,17,5241
"39153531001",3111,329,3,0,22,10,26,0,3501
"39153531002",5039,624,32,4,109,0,47,0,5855
"39153531101",2723,223,176,0,59,2,0,0,3183
"39153531102",3991,355,6,0,80,6,19,0,4457
"39153531103",2647,377,41,3,71,0,66,39,3244
"39153531401",6540,234,38,0,387,0,103,0,7302
"39153531405",3772,413,101,0,120,60,27,0,4493
"39153531500",7568,487,23,1,131,144,73,0,8427
"39153531601",3910,159,0,44,228,10,0,0,4351
"39153531602",2828,58,0,0,55,0,0,0,2941
"39153531701",3384,272,22,7,36,6,22,3,3752
"39153531702",4232,305,0,7,19,0,42,0,4605
"39153531801",4534,597,68,27,156,9,74,0,5465
"39153531802",3909,290,135,39,111,73,71,0,4628
"39153532001",3299,167,72,0,9,0,35,11,3593
"39153532003",3932,361,0,0,19,47,51,68,4478
"39153532004",3665,239,122,13,59,1,59,0,4158
"39153532202",4826,205,808,46,313,18,49,17,6282
"39153532301",4965,310,51,0,377,0,189,0,5892
"39153532302",4816,228,96,0,184,16,0,0,5340
"39153532501",2879,66,42,0,64,0,59,0,3110
"39153532502",2766,35,17,1,102,1,17,0,2939
"39153532600",2787,66,51,0,99,0,20,0,3023
"39153532701",5498,166,1337,24,529,0,157,0,7711
"39153532702",2535,285,103,46,580,100,66,0,3715
"39153532703",4649,45,707,122,373,0,114,0,6010
"39153532705",6376,198,298,107,96,54,125,0,7254
"39153532706",3298,181,55,0,50,0,99,0,3683
"39153532708",4476,53,397,0,262,0,104,0,5292
"39153532901",1276,152,5,0,17,0,43,0,1493
"39153532902",6339,862,320,259,460,24,120,0,8384
"39153532999",4382,647,247,51,182,98,0,0,5607
"39153533000",1423,126,0,1,32,0,43,0,1625
"39153533101",4323,208,72,0,229,27,34,0,4893
"39153533102",2388,110,64,17,112,19,74,0,2784
"39153533200",4795,225,58,8,298,20,90,0,5494
"39153533400",4150,290,924,138,209,0,99,0,5810
"39153533501",6097,140,605,0,1088,10,155,0,8095
"39153533502",3518,149,208,13,98,0,77,0,4063
"39153534000",5877,110,109,21,417,18,109,0,6661
"39153534100",2542,44,0,0,134,29,39,29,2817
"39155920300",2309,223,198,15,121,57,21,16,2960
"39155920400",1488,389,248,285,64,27,54,11,2566
"39155920500",160,103,134,384,15,19,0,0,815
"39155920600",792,768,857,1209,0,123,12,112,3873
"39155920700",1310,620,712,390,35,8,22,30,3127
"39155920800",562,1024,122,307,17,209,13,74,2328
"39155920900",1288,571,813,605,199,24,15,130,3645
"39155921000",2581,674,1352,370,84,198,11,0,5270
"39155921100",1876,1158,281,502,106,63,0,0,3986
"39155921200",1163,317,62,403,37,41,9,134,2166
"39155921300",1734,343,62,0,0,0,57,61,2257
"39155921400",2807,281,105,0,65,0,61,0,3319
"39155921500",4082,536,142,53,46,11,125,11,5006
"39155921600",1706,1157,661,212,143,92,52,66,4089
"39155930101",2454,562,21,25,59,37,26,0,3184
"39155930102",2262,138,0,0,10,0,76,0,2486
"39155930200",2474,114,0,0,0,15,0,0,2603
"39155930300",3414,219,16,0,51,10,112,0,3822
"39155930400",3752,265,5,16,47,0,64,14,4163
"39155930500",4987,869,89,23,33,12,22,0,6035
"39155930600",3369,247,8,14,0,0,0,0,3638
"39155930700",3799,327,59,0,5,10,84,0,4284
"39155930800",4265,323,68,8,54,0,37,0,4755
"39155930900",6340,477,25,17,78,0,20,0,6957
"39155931000",4895,583,44,12,235,29,0,0,5798
"39155931100",2200,206,4,0,60,0,0,0,2470
"39155931200",3201,645,7,15,21,11,18,95,4013
"39155931300",3857,326,32,2,6,0,0,0,4223
"39155931400",3119,799,164,89,64,31,0,0,4266
"39155931500",3515,162,11,0,29,18,88,0,3823
"39155931601",3364,735,0,37,138,65,40,0,4379
"39155931602",2754,403,0,0,18,0,26,0,3201
"39155931700",1432,328,210,6,16,0,95,12,2099
"39155931900",3407,495,1135,397,372,72,93,40,6011
"39155932000",4696,521,464,6,195,0,0,0,5882
"39155932200",2029,369,60,54,84,109,61,83,2849
"39155932300",4751,733,49,12,30,65,61,14,5715
"39155932500",2659,446,31,0,21,0,5,75,3237
"39155932600",2502,534,45,36,53,0,0,0,3170
"39155932701",4657,758,151,251,113,167,42,0,6139
"39155932702",1895,330,86,6,17,5,36,0,2375
"39155932801",1931,782,202,37,0,0,44,61,3057
"39155932802",2655,837,4,4,104,106,32,15,3757
"39155932900",1914,262,62,6,37,0,27,0,2308
"39155933001",5297,315,2,2,171,0,78,0,5865
"39155933002",3712,292,36,47,50,8,16,16,4177
"39155933100",2128,287,17,0,69,57,30,0,2588
"39155933301",2003,724,17,0,0,0,0,40,2784
"39155933302",3861,391,63,0,10,0,40,0,4365
"39155933400",2949,145,69,0,79,104,39,0,3385
"39155933500",3317,237,18,0,145,0,9,0,3726
"39155933600",4055,736,0,0,27,90,91,82,5081
"39155933700",2278,167,62,62,0,228,3,0,2800
"39155933800",1026,601,300,351,6,74,49,49,2456
"39155933900",1367,445,28,126,84,22,5,0,2077
"39157020100",4737,580,0,0,50,0,23,0,5390
"39157020200",3353,250,0,0,35,27,96,0,3761
"39157020300",3349,120,28,6,17,5,78,0,3603
"39157020400",5055,596,0,0,17,0,0,0,5668
"39157020500",4480,533,0,0,56,0,46,0,5115
"39157020600",4710,153,33,0,160,0,0,0,5056
"39157020700",4790,1136,0,75,14,163,89,163,6430
"39157020800",4866,857,59,16,53,212,495,179,6737
"39157020900",3025,516,92,98,268,181,39,78,4297
"39157021000",3827,800,7,0,7,89,33,155,4918
"39157021100",1854,271,20,100,201,52,309,139,2946
"39157021200",2164,458,21,11,36,0,33,0,2723
"39157021300",4378,314,0,0,60,0,30,0,4782
"39157021400",2055,193,0,0,25,0,6,0,2279
"39157021500",6684,586,0,2,165,30,0,0,7467
"39157021600",3633,841,58,29,48,12,19,6,4646
"39157021700",4272,927,0,27,150,18,55,15,5464
"39157021800",2337,447,0,0,39,0,0,0,2823
"39157021900",2312,309,0,1,6,0,0,0,2628
"39157022001",2677,581,0,5,18,0,0,0,3281
"39157022002",2281,1088,0,0,5,48,0,20,3442
"39159050100",3316,274,0,0,75,6,72,6,3749
"39159050200",4080,631,3,2,146,0,50,0,4912
"39159050301",3421,76,0,0,106,0,50,0,3653
"39159050303",5713,416,57,99,202,0,0,22,6509
"39159050304",2336,39,42,0,20,0,0,0,2437
"39159050400",6031,147,0,4,500,0,169,0,6851
"39159050500",3776,896,0,23,281,170,0,0,5146
"39159050601",3569,180,247,0,912,18,150,0,5076
"39159050602",3235,483,0,0,302,24,140,0,4184
"39159050700",7124,719,15,129,71,8,17,9,8092
"39161020100",3433,199,8,0,52,0,121,11,3824
"39161020200",3929,307,31,0,135,21,99,0,4522
"39161020300",2400,192,0,0,0,34,0,7,2633
"39161020400",2784,287,5,0,21,1,18,10,3126
"39161020500",2895,322,0,0,50,0,0,16,3283
"39161020600",1149,512,18,6,68,25,82,18,1878
"39161020700",1365,282,0,0,42,15,30,0,1734
"39161020800",2983,857,45,72,99,55,125,124,4360
"39161020900",2864,352,29,17,35,44,118,7,3466
"39163953000",4031,870,12,36,125,10,0,0,5084
"39163953100",3896,874,0,0,93,27,12,10,4912
"39163953200",2214,885,0,9,11,2,0,0,3121
"39165030101",4166,163,0,0,55,0,28,6,4418
"39165030102",3305,417,11,38,74,32,16,1,3894
"39165030200",957,249,0,0,22,13,0,7,1248
"39165030501",2884,552,34,31,213,24,0,24,3762
"39165030503",4570,218,178,0,418,0,223,0,5607
"39165030504",4463,31,17,8,124,0,119,8,4770
"39165030600",3357,358,0,0,101,33,0,20,3869
"39165030700",6212,161,43,205,262,0,87,31,7001
"39165030800",6237,82,36,0,135,0,23,0,6513
"39165030900",12410,140,361,0,668,51,235,51,13916
"39165031000",7635,646,0,0,148,14,165,3,8611
"39165031100",3541,291,0,12,128,0,13,0,3985
"39165031200",7398,244,14,0,224,0,201,0,8081
"39165031300",4275,320,0,2,278,0,92,0,4967
"39165031400",3222,673,438,354,361,27,315,0,5390
"39165031500",4190,569,11,1,57,43,0,0,4871
"39165031600",7064,498,207,4,112,0,0,0,7885
"39165031700",5,0,0,0,0,0,0,0,5
"39165031902",8082,409,639,0,1239,96,315,0,10780
"39165031903",12954,59,616,0,3116,22,847,0,17614
"39165031904",5362,356,90,26,552,0,0,0,6386
"39165032003",6215,109,122,0,445,0,91,0,6982
"39165032004",4948,0,239,21,818,0,191,0,6217
"39165032005",6860,364,535,13,2692,0,243,0,10707
"39165032006",3237,99,30,25,458,0,275,43,4167
"39165032007",5519,169,98,1,800,62,388,2,7039
"39165032100",5483,291,171,6,459,0,328,0,6738
"39165032201",18535,934,398,0,153,13,74,76,20183
"39165032202",4840,247,94,0,165,0,170,3,5519
"39165032300",4063,408,3,3,42,8,47,0,4574
"39165032400",4553,295,6,0,33,3,140,0,5030
"39165032501",3032,392,17,0,134,7,33,0,3615
"39165032502",3235,864,6,42,74,37,101,21,4380
"39167020101",3190,420,105,0,128,0,109,0,3952
"39167020102",1357,652,43,44,76,0,0,0,2172
"39167020200",5391,1250,0,0,36,0,0,0,6677
"39167020300",3154,340,11,0,80,0,0,0,3585
"39167020400",1735,295,20,0,21,12,0,0,2083
"39167020500",924,733,14,0,30,16,0,0,1717
"39167020800",3142,677,0,0,95,27,18,0,3959
"39167020900",1641,489,4,3,0,26,0,60,2223
"39167021000",2408,1123,71,49,22,106,0,73,3852
"39167021100",2977,748,48,2,145,82,0,0,4002
"39167021200",4855,928,14,0,9,4,40,7,5857
"39167021300",4133,560,8,0,124,18,17,36,4896
"39167021400",3446,205,0,1,147,23,185,0,4007
"39167021500",1409,29,0,0,7,20,9,0,1474
"39167021600",3429,177,20,0,32,17,0,0,3675
"39167021700",5016,690,78,0,81,11,25,0,5901
"39169000100",2116,910,90,79,126,104,10,18,3453
"39169000200",2687,181,0,0,118,0,47,0,3033
"39169000300",1798,421,62,45,58,26,88,0,2498
"39169000500",2228,567,44,243,168,41,205,13,3509
"39169000600",3783,1220,44,80,56,12,30,22,5247
"39169000700",6238,431,45,12,239,0,99,11,7075
"39169000800",5351,846,79,10,369,40,93,0,6788
"39169000900",3309,545,22,2,21,0,30,0,3929
"39169001000",2359,274,12,11,128,100,70,39,2993
"39169001100",1305,64,42,0,0,0,23,0,1434
"39169001200",1006,154,23,12,16,45,16,30,1302
"39169001300",3158,528,78,23,160,62,18,48,4075
"39169001400",2330,618,44,70,24,9,111,184,3390
"39169001700",6276,1171,0,2,107,0,95,8,7659
"39169001800",3343,541,0,0,0,0,13,0,3897
"39169001900",2729,253,5,0,77,13,34,0,3111
"39169002000",2688,307,18,2,56,29,41,0,3141
"39169002100",2270,556,0,5,26,0,0,0,2857
"39169002200",3255,617,44,0,62,7,23,3,4011
"39169002300",2622,147,14,17,130,0,119,0,3049
"39169002400",3398,311,15,0,41,0,0,7,3772
"39169002500",2266,248,12,0,42,16,7,0,2591
"39169002901",3192,106,80,0,17,62,33,62,3552
"39169002902",4950,188,0,13,52,0,103,0,5306
"39169003000",2030,82,2,6,19,0,4,0,2143
"39169003100",1900,182,0,0,168,0,10,0,2260
"39169003200",3278,70,54,0,23,4,29,13,3471
"39169003300",2461,657,15,0,17,10,0,0,3160
"39169003400",2380,603,27,14,237,0,0,0,3261
"39169003500",3198,227,0,4,47,7,7,0,3490
"39169003700",3191,453,3,15,6,0,29,0,3697
"39169980000",101,28,0,0,0,0,0,0,129
"39171950100",4073,622,11,4,114,50,74,57,5005
"39171950200",3355,519,1,0,37,15,37,2,3966
"39171950300",3388,750,3,5,130,23,142,18,4459
"39171950400",4152,455,10,0,59,29,148,55,4908
"39171950500",2737,183,38,22,178,69,215,100,3542
"39171950600",3086,1335,6,0,82,66,140,93,4808
"39171950700",3673,507,0,3,64,31,130,0,4408
"39171950800",3080,333,0,0,21,25,22,5,3486
"39171950900",2377,327,30,7,37,6,92,24,2900
"39173020100",4636,480,17,0,129,54,364,0,5680
"39173020200",2665,150,77,0,67,57,80,0,3096
"39173020300",4178,276,78,0,110,21,223,33,4919
"39173020401",4457,409,130,0,198,19,39,0,5252
"39173020402",4570,204,36,14,691,0,226,14,5755
"39173020500",1950,157,12,13,48,76,42,7,2305
"39173020601",3159,339,31,0,476,51,351,72,4479
"39173020602",6087,200,88,0,488,0,239,0,7102
"39173020700",5336,1109,141,3,286,93,304,67,7339
"39173020800",3711,339,0,0,38,7,108,0,4203
"39173020900",5987,397,419,79,151,3,333,28,7397
"39173021000",3437,239,0,3,116,73,125,37,4030
"39173021100",3405,367,0,3,67,117,188,57,4204
"39173021200",5342,327,83,0,130,3,193,0,6078
"39173021300",3321,255,6,17,80,10,75,10,3774
"39173021400",2729,301,12,1,170,38,439,47,3737
"39173021500",2281,70,0,0,76,0,163,13,2603
"39173021600",5775,576,113,86,233,49,242,21,7095
"39173021701",1621,1497,51,137,91,107,76,71,3651
"39173021702",2518,1801,68,60,120,263,159,94,5083
"39173021800",50,98,0,2,4,2,7,2,165
"39173021901",3423,279,51,0,288,0,228,1,4270
"39173021902",2456,2374,63,447,151,209,357,215,6272
"39173022100",3531,609,1,8,111,40,182,84,4566
"39173022200",2003,613,42,15,23,8,44,57,2805
"39173022300",3442,312,20,6,151,45,118,48,4142
"39173022400",2983,423,0,0,125,46,227,41,3845
"39173022500",2985,844,143,88,154,43,109,45,4411
"39175938000",3618,343,3,3,0,0,56,0,4023
"39175938100",3900,390,12,2,55,10,80,0,4449
"39175938200",3557,304,0,2,20,0,58,0,3941
"39175938300",3129,596,1,0,34,0,38,0,3798
"39175938400",2353,495,0,0,125,0,154,83,3210
"39175938500",2650,454,8,0,18,2,92,5,3229
"40001376600",1229,347,0,0,735,254,119,17,2701
"40001376700",2109,589,33,0,1773,767,119,110,5500
"40001376800",1553,345,17,2,2047,594,129,48,4735
"40001376900",1187,475,0,0,1892,914,322,272,5062
"40001377000",1223,612,0,12,2221,986,77,104,5235
"40003955600",1042,167,0,0,169,13,50,13,1454
"40003955700",1020,192,0,0,152,19,3,4,1390
"40003956000",1520,194,8,0,179,21,62,4,1988
"40005587600",820,113,11,7,283,34,16,6,1290
"40005587700",1899,840,112,188,502,216,99,54,3910
"40005587800",2244,441,1,6,629,245,94,8,3668
"40005587900",2495,585,17,3,628,116,69,17,3930
"40007951600",1587,278,17,8,485,8,539,15,2937
"40007951700",1168,71,0,0,79,10,89,4,1421
"40007951800",1193,113,0,0,422,4,477,63,2272
"40009966100",5496,1072,127,6,825,191,884,458,9059
"40009966200",5596,236,104,0,604,43,456,0,7039
"40009966500",1486,486,0,0,121,14,42,36,2185
"40009966800",3770,673,93,0,402,56,405,106,5505
"40011958600",1024,98,3,0,107,0,48,43,1323
"40011958700",1040,104,0,0,91,44,57,0,1336
"40011958800",1030,100,0,0,41,52,31,16,1270
"40011958900",1648,608,159,10,304,76,290,29,3124
"40011959000",1032,90,18,0,265,111,110,18,1644
"40013795600",1618,354,0,0,472,158,61,94,2757
"40013795700",2192,527,9,6,663,154,27,16,3594
"40013795900",1033,152,32,13,239,54,14,2,1539
"40013796001",4083,532,22,1,1091,250,270,131,6380
"40013796002",3045,382,47,4,1122,186,56,49,4891
"40013796100",5715,1217,58,24,1515,256,324,18,9127
"40013796200",1842,607,104,83,707,311,308,53,4015
"40013796300",956,257,6,18,294,102,158,21,1812
"40013796400",768,484,22,0,449,360,143,80,2306
"40013796500",1363,301,25,0,362,204,8,47,2310
"40013796600",3694,643,227,29,1017,147,352,50,6159
"40015161600",3809,669,41,22,779,130,639,198,6287
"40015161700",1369,184,0,6,159,99,170,80,2067
"40015161800",1659,446,9,10,874,298,432,76,3804
"40015161900",964,192,9,10,264,105,40,7,1591
"40015162000",2039,203,24,0,907,200,120,76,3569
"40015162100",1910,742,207,138,2692,1700,552,511,8452
"40015162200",1447,53,0,9,608,347,65,54,2583
"40015162300",1948,285,30,1,399,127,48,107,2945
"40017300100",1955,393,9,27,208,211,56,34,2893
"40017300201",4941,263,40,0,518,6,423,13,6204
"40017300202",3457,358,22,53,523,114,182,117,4826
"40017300300",2508,369,51,7,764,252,667,164,4782
"40017300400",239,46,310,33,162,184,113,134,1221
"40017300500",1754,469,169,0,1208,80,503,65,4248
"40017300600",2656,123,0,0,518,132,270,39,3738
"40017300700",3384,317,65,20,574,136,321,3,4820
"40017300801",7886,74,436,26,1660,0,703,0,10785
"40017300802",2255,67,0,0,153,27,36,0,2538
"40017300901",4935,375,126,0,876,0,332,0,6644
"40017300902",1908,93,51,0,411,8,140,0,2611
"40017300904",2538,111,50,55,718,55,427,0,3954
"40017300905",3729,62,181,0,647,26,173,0,4818
"40017301001",176,17,6,0,44,15,0,0,258
"40017301003",4904,234,38,0,761,35,460,0,6432
"40017301006",2182,212,0,0,601,138,299,0,3432
"40017301007",4193,275,235,33,985,31,393,0,6145
"40017301008",4907,211,146,0,1560,0,507,0,7331
"40017301009",2842,256,61,0,409,61,32,61,3722
"40017301100",5447,346,0,0,531,0,178,10,6512
"40017301201",2754,540,57,0,301,51,229,43,3975
"40017301202",2533,210,3,0,181,47,186,29,3189
"40017301300",4321,173,11,0,576,221,321,141,5764
"40017301406",4619,378,26,7,754,3,511,0,6298
"40017301407",4654,276,0,0,669,33,382,54,6068
"40017301408",1426,235,0,0,145,0,37,0,1843
"40017301409",2663,66,18,0,230,5,222,0,3204
"40017301410",3706,308,18,0,638,6,403,0,5079
"40019892100",1557,263,255,70,313,89,25,31,2603
"40019892200",1020,124,38,0,139,16,50,12,1399
"40019892300",2353,491,0,0,211,6,47,55,3163
"40019892400",2559,501,3,0,344,60,44,39,3550
"40019892500",6882,657,132,56,1518,228,325,0,9798
"40019892600",3544,461,544,123,903,174,131,5,5885
"40019892700",3541,310,62,32,698,227,232,7,5109
"40019892800",1757,887,662,285,870,507,310,378,5656
"40019892900",1334,229,209,44,362,15,215,48,2456
"40019893000",4528,584,355,65,1188,205,609,75,7609
"40019893100",1623,344,244,115,603,94,370,68,3461
"40021977600",2274,605,32,16,1967,463,125,186,5668
"40021977700",3019,492,116,4,2683,389,184,39,6926
"40021977800",2367,783,0,21,2610,812,84,134,6811
"40021977900",2194,924,158,18,1886,784,282,143,6389
"40021978000",1455,793,13,20,1123,710,352,412,4878
"40021978100",2216,550,0,13,1714,587,125,223,5428
"40021978201",981,256,15,39,1132,269,132,142,2966
"40021978202",1410,176,0,4,998,197,41,0,2826
"40021978300",3147,519,0,34,2179,948,256,200,7283
"40023966900",1634,451,8,19,480,132,56,27,2807
"40023967000",1729,485,131,39,603,164,75,24,3250
"40023967100",1555,742,213,271,465,241,75,97,3659
"40023967200",583,460,407,455,459,129,37,45,2575
"40023967300",1381,368,88,69,884,272,71,29,3162
"40025950100",834,175,0,0,155,10,91,39,1304
"40025950300",782,162,0,0,124,67,232,126,1493
"40027200100",95,126,0,0,27,3,0,11,262
"40027200200",1018,440,39,0,167,190,128,287,2269
"40027200300",2416,758,185,5,409,76,655,35,4539
"40027200400",1329,340,0,16,150,108,142,77,2162
"40027200500",2500,1129,36,0,175,100,145,19,4104
"40027200601",2542,1156,386,194,1026,652,322,111,6389
"40027200602",2258,944,87,36,292,74,214,138,4043
"40027200700",26,83,0,0,3,18,0,18,148
"40027200800",5064,236,598,51,687,42,285,0,6963
"40027200900",3014,340,33,28,330,22,184,0,3951
"40027201000",4415,431,292,104,416,122,172,56,6008
"40027201101",3894,350,176,0,755,203,289,44,5711
"40027201102",1741,513,112,7,181,187,86,45,2872
"40027201201",626,555,55,144,177,171,67,117,1912
"40027201202",205,273,0,76,19,70,10,17,670
"40027201203",2494,879,202,104,753,288,370,83,5173
"40027201301",4022,1763,375,408,979,451,657,59,8714
"40027201403",4389,818,11,0,597,53,456,149,6473
"40027201404",2434,606,20,44,252,123,143,121,3743
"40027201405",4493,201,0,60,498,0,310,0,5562
"40027201505",4266,538,64,0,606,20,234,144,5872
"40027201507",4830,450,108,85,976,417,118,131,7115
"40027201508",2339,425,29,0,526,63,476,17,3875
"40027201509",2012,63,0,0,636,33,116,0,2860
"40027201510",5519,286,588,0,1144,8,215,8,7768
"40027201602",2312,80,109,0,365,94,81,0,3041
"40027201603",2710,503,92,55,447,61,279,34,4181
"40027201604",2423,231,43,0,219,154,261,0,3331
"40027201607",4020,45,101,121,1105,93,217,0,5702
"40027201609",3107,165,176,0,1044,0,199,0,4691
"40027201610",2742,133,81,0,928,0,545,0,4429
"40027201611",1689,57,68,0,274,70,238,0,2396
"40027201612",3505,405,183,0,685,208,463,369,5818
"40027201700",1773,108,85,0,196,5,89,0,2256
"40027201801",2964,15,46,0,1160,5,210,0,4400
"40027201802",2704,145,73,0,517,10,343,7,3799
"40027201902",2687,443,568,102,749,76,501,180,5306
"40027201903",1563,41,511,71,687,128,211,28,3240
"40027201904",3070,75,663,7,789,11,639,0,5254
"40027202002",3016,399,165,61,354,109,117,0,4221
"40027202004",2254,296,166,44,488,41,336,58,3683
"40027202005",3276,1098,387,42,899,119,249,324,6394
"40027202006",1885,303,387,9,381,58,106,145,3274
"40027202007",2656,417,254,0,487,0,460,312,4586
"40027202008",3400,253,272,0,571,87,87,0,4670
"40027202102",2038,314,38,0,206,85,202,24,2907
"40027202104",1511,267,37,0,608,16,129,17,2585
"40027202105",3213,323,240,36,873,78,545,75,5383
"40027202106",5343,103,84,33,1602,109,633,58,7965
"40027202107",1942,101,202,0,494,8,232,0,2979
"40027202201",3090,97,58,0,611,16,582,0,4454
"40027202203",3033,249,152,0,667,116,368,37,4622
"40027202205",4889,94,0,112,1767,62,676,13,7613
"40027202206",1880,205,151,16,486,134,103,53,3028
"40027202301",4791,453,156,0,321,12,140,14,5887
"40027202302",4293,384,0,0,672,0,180,22,5551
"40027202402",4163,820,76,0,743,126,61,19,6008
"40027202403",3970,308,17,33,732,73,231,43,5407
"40027202404",3640,285,0,0,505,58,125,13,4626
"40027202405",2836,597,0,0,414,46,40,70,4003
"40027202500",4949,756,28,0,762,156,182,181,7014
"40027202600",1945,405,22,9,311,51,228,112,3083
"40029388100",2159,647,28,0,798,191,139,34,3996
"40029388200",1083,227,0,0,469,121,22,11,1933
"40031000100",2220,352,586,260,651,266,490,166,4991
"40031000200",968,493,189,343,347,412,563,308,3623
"40031000300",2670,617,1178,99,745,221,211,152,5893
"40031000401",3041,575,924,260,1387,244,838,90,7359
"40031000402",2540,171,581,140,643,255,535,138,5003
"40031000403",3180,166,420,37,702,43,474,41,5063
"40031000501",3942,211,1620,385,857,251,653,19,7938
"40031000502",4013,528,1710,544,1826,73,1177,66,9937
"40031000600",1325,182,206,217,187,65,303,15,2500
"40031000700",1200,216,204,224,717,15,690,8,3274
"40031000800",1038,445,144,269,318,100,291,8,2613
"40031000900",1166,307,159,7,321,102,161,29,2252
"40031001000",1081,181,144,47,336,85,205,51,2130
"40031001100",847,354,66,281,112,233,120,74,2087
"40031001400",277,237,133,74,122,174,63,164,1244
"40031001500",1330,763,227,397,280,141,215,84,3437
"40031001600",342,313,655,380,99,254,159,48,2250
"40031001700",1251,415,189,71,314,410,406,137,3193
"40031001901",993,240,309,89,226,0,315,33,2205
"40031001902",687,228,365,227,210,31,121,56,1925
"40031002001",2967,228,972,196,965,78,577,34,6017
"40031002003",1667,97,68,0,96,21,120,0,2069
"40031002004",2430,177,590,233,495,35,362,1,4323
"40031002005",1817,168,496,82,625,275,475,131,4069
"40031002100",6142,722,98,0,821,122,438,70,8413
"40031002200",3854,373,228,13,1143,132,372,14,6129
"40031002301",4418,312,312,113,492,155,367,95,6264
"40031002302",3243,397,130,4,901,363,184,92,5314
"40031002401",18,0,4,0,14,0,0,0,36
"40031002403",1070,231,209,0,114,19,348,139,2130
"40031002404",2000,333,340,0,707,102,546,141,4169
"40031002500",999,302,227,294,287,147,83,93,2432
"40033871100",2443,408,23,0,547,202,228,0,3851
"40033871200",1668,271,74,11,186,138,87,113,2548
"40035373100",1961,313,11,0,801,154,141,35,3416
"40035373200",1349,247,6,0,723,112,92,18,2547
"40035373300",1651,460,149,21,727,453,22,0,3483
"40035373400",1461,320,57,29,574,188,77,0,2706
"40035373500",1326,301,11,0,514,61,25,2,2240
"40037020101",1473,213,12,41,331,41,102,8,2221
"40037020102",744,203,0,16,231,105,70,24,1393
"40037020103",2423,150,23,18,414,75,98,34,3235
"40037020601",4234,768,7,0,849,454,282,23,6617
"40037020602",2301,384,37,17,505,133,171,31,3579
"40037020702",2683,402,10,0,565,51,30,21,3762
"40037020704",1050,306,0,2,182,10,19,0,1569
"40037020705",2153,328,0,0,324,20,67,0,2892
"40037020706",3550,544,0,0,604,179,39,50,4966
"40037020707",1402,151,3,0,286,37,46,13,1938
"40037020800",2368,480,13,2,434,65,53,21,3436
"40037020900",1996,420,119,113,303,9,63,0,3023
"40037021000",1821,536,228,91,657,208,55,13,3609
"40037021101",2203,308,87,36,413,89,80,10,3226
"40037021102",2155,613,38,8,797,162,63,6,3842
"40037021201",1659,95,0,0,235,18,147,0,2154
"40037021202",2612,328,212,89,673,192,208,0,4314
"40037021300",1264,423,9,0,245,101,61,49,2152
"40037021400",4318,425,104,94,941,203,201,77,6363
"40037021500",3676,511,44,13,946,191,304,23,5708
"40037021600",1668,271,0,30,267,41,12,9,2298
"40039950800",2337,544,148,49,480,254,1271,422,5505
"40039960400",5293,641,26,61,1029,88,1039,421,8598
"40039960600",2966,1079,18,105,415,310,522,101,5516
"40039960700",6715,505,135,146,567,144,489,41,8742
"40039961000",2449,429,4,0,268,240,70,102,3562
"40041375601",2080,449,13,0,629,183,33,121,3508
"40041375602",2299,347,3,0,476,144,35,10,3314
"40041375700",5185,940,0,1,1027,288,212,3,7656
"40041375801",1991,464,6,0,549,144,35,15,3204
"40041375802",2250,229,0,0,522,99,53,7,3160
"40041375900",1915,549,44,0,927,480,51,52,4018
"40041376000",2137,550,0,16,2033,1103,180,156,6175
"40041376100",1773,227,2,8,2043,1001,70,55,5179
"40041976200",2999,589,28,2,1569,498,196,81,5962
"40043959100",1270,310,0,0,221,41,93,19,1954
"40043959200",1165,248,0,0,86,22,97,35,1653
"40043959300",1070,143,5,0,132,24,42,15,1431
"40045952600",2279,437,0,0,103,35,165,78,3097
"40045952800",1029,121,0,0,89,2,32,15,1288
"40047000100",3419,1193,30,11,811,40,779,11,6294
"40047000200",1988,204,2,0,245,147,48,4,2638
"40047000600",4044,647,505,126,850,64,825,58,7119
"40047000700",3458,974,116,0,964,539,1131,546,7728
"40047001100",2817,250,0,0,253,29,62,18,3429
"40047001200",3033,628,101,0,181,96,137,61,4237
"40047001300",6885,339,151,0,682,0,205,48,8310
"40047001401",2624,201,141,0,567,43,362,9,3947
"40047001402",3338,154,31,0,513,113,203,20,4372
"40047001500",3711,802,273,126,1410,461,935,659,8377
"40047001601",4880,260,64,2,326,195,215,197,6139
"40047001602",3696,145,172,63,298,0,67,0,4441
"40049681100",1776,588,0,0,548,198,49,8,3167
"40049681200",2612,366,10,19,323,120,253,59,3762
"40049681300",1647,508,240,38,371,135,407,211,3557
"40049681400",3466,588,84,12,572,206,386,191,5505
"40049681500",1471,351,126,82,277,116,94,4,2521
"40049681600",1430,410,0,0,263,55,46,29,2233
"40049681700",1467,220,0,0,257,9,35,0,1988
"40049681800",2160,433,12,0,268,70,123,9,3075
"40049681900",2295,404,21,3,361,107,83,41,3315
"40051000100",710,391,12,0,65,48,113,5,1344
"40051000400",2436,570,24,0,354,254,164,99,3901
"40051000500",4814,759,74,40,372,115,331,2,6507
"40051000600",4117,542,114,8,612,161,270,56,5880
"40051000700",5422,992,30,3,794,77,290,68,7676
"40051000800",5502,594,22,0,703,112,162,22,7117
"40051000901",1844,228,0,0,205,27,95,43,2442
"40051000902",4598,527,8,0,1063,88,255,112,6651
"40051000903",8253,463,110,0,814,108,189,27,9964
"40051001000",2021,442,588,57,380,84,348,58,3978
"40053956400",1438,117,1,0,124,45,68,14,1807
"40053956500",2221,205,9,2,186,61,80,16,2780
"40055967100",1241,168,3,0,120,68,97,83,1780
"40055967200",2469,420,43,46,430,33,409,20,3870
"40057967800",1721,181,122,63,428,237,492,252,3496
"40059952100",1547,203,0,0,6,0,261,71,2088
"40059952200",1609,220,0,0,44,97,279,139,2388
"40061279100",1334,335,0,0,328,114,22,19,2152
"40061279200",2489,766,29,19,827,139,69,131,4469
"40061279300",2158,523,38,21,683,181,115,23,3742
"40061279400",1672,241,0,0,671,185,99,23,2891
"40063484600",1304,360,12,9,825,245,59,74,2888
"40063484700",1726,146,7,0,507,78,56,0,2520
"40063484800",1157,349,33,14,447,345,58,3,2406
"40063484900",1444,229,13,16,416,45,138,3,2304
"40063485000",1581,338,18,0,326,70,62,41,2436
"40065968100",2142,248,6,0,171,8,127,59,2761
"40065968200",1107,256,9,0,253,84,153,116,1978
"40065968300",1239,211,0,5,200,138,189,141,2123
"40065968400",3759,397,121,0,476,95,483,0,5331
"40065968500",3080,60,570,79,454,0,450,27,4720
"40065968600",2061,589,353,84,1157,733,1406,883,7266
"40065968700",620,150,134,197,414,169,478,188,2350
"40065968800",1696,535,224,82,570,156,858,151,4272
"40067371600",1250,259,0,2,226,214,84,49,2084
"40067371700",1058,227,7,0,249,71,173,63,1848
"40067371800",1919,450,20,0,120,90,95,108,2802
"40069660198",2084,341,61,12,605,168,66,21,3358
"40069660200",2709,751,46,58,1035,293,231,60,5183
"40069660300",1562,287,4,4,559,156,83,22,2677
"40071000100",3610,817,139,83,770,359,269,192,6239
"40071000201",2237,324,58,40,514,136,199,15,3523
"40071000202",3375,526,43,16,623,49,85,13,4730
"40071000300",3342,136,13,36,508,39,119,7,4200
"40071000400",1209,289,132,88,289,222,126,41,2396
"40071000500",2306,734,32,94,588,441,261,332,4788
"40071000600",2546,224,0,2,446,381,71,20,3690
"40071001100",2584,430,1,2,602,241,214,58,4132
"40071001200",3171,556,6,5,501,140,76,52,4507
"40071001301",2741,534,0,7,566,254,363,212,4677
"40071001302",2916,772,0,9,543,151,352,112,4855
"40073958100",3340,339,54,0,951,97,1340,177,6298
"40073958200",1862,115,10,0,247,33,261,23,2551
"40073958300",4663,284,2,0,622,80,373,30,6054
"40073958400",2077,141,0,0,167,4,18,4,2411
"40075963600",883,221,0,0,141,133,32,11,1421
"40075963700",2310,675,145,24,622,218,406,148,4548
"40075964200",2734,383,95,67,223,162,256,80,4000
"40077087100",1470,149,9,2,787,154,18,7,2596
"40077087200",3099,592,30,7,977,392,162,53,5312
"40077087300",1563,254,36,16,551,267,70,27,2784
"40079040102",2729,843,27,35,626,105,42,0,4407
"40079040198",1161,459,0,6,220,120,20,0,1986
"40079040299",2446,879,46,98,536,105,32,105,4247
"40079040301",3928,1056,21,37,635,211,69,12,5969
"40079040302",2518,493,0,0,639,295,64,11,4020
"40079040303",2026,461,305,118,617,121,83,68,3799
"40079040401",2988,627,34,108,732,185,512,125,5311
"40079040402",2063,545,60,38,577,438,225,343,4289
"40079040500",3345,545,9,0,966,171,88,25,5149
"40079040601",2052,734,0,0,730,395,325,386,4622
"40079040602",2340,757,4,17,863,430,248,324,4983
"40079040700",1407,331,14,37,714,235,33,102,2873
"40081961100",3198,593,10,18,722,63,155,22,4781
"40081961200",3148,783,12,4,351,135,88,37,4558
"40081961300",3239,579,46,11,292,54,101,49,4371
"40081961400",5593,1086,157,7,802,180,128,126,8079
"40081961500",3948,403,34,14,700,81,147,0,5327
"40081961600",2272,371,33,27,294,44,104,6,3151
"40081961700",3431,628,94,75,317,179,10,10,4744
"40083600100",3007,401,955,70,327,76,230,40,5106
"40083600200",1611,399,83,292,198,75,44,23,2725
"40083600300",1604,229,286,226,33,98,52,12,2540
"40083600400",7835,566,0,50,815,107,1157,0,10530
"40083600500",6077,477,151,174,439,54,196,134,7702
"40083600600",1901,393,480,259,221,191,39,50,3534
"40083600700",3564,544,127,16,535,46,95,110,5037
"40083600800",7139,183,128,0,582,17,224,0,8273
"40085094100",1814,507,30,51,415,59,682,245,3803
"40085094200",3726,332,93,0,571,153,305,88,5268
"40085094300",1482,182,0,0,139,8,9,11,1831
"40087400101",5933,439,56,0,878,55,361,19,7741
"40087400102",7532,797,52,0,1308,148,381,40,10258
"40087400201",2700,398,0,5,662,36,172,41,4014
"40087400202",6500,583,5,0,999,131,687,96,9001
"40087400300",3781,776,161,35,775,314,483,420,6745
"40087400400",789,127,2,0,139,100,12,14,1183
"40089098200",1525,284,8,0,750,276,103,50,2996
"40089098300",803,135,32,14,375,150,6,2,1517
"40089098400",2491,905,156,60,848,143,266,14,4883
"40089098500",3453,950,98,33,1138,277,135,6,6090
"40089098600",2593,671,232,101,1161,781,242,209,5990
"40089098700",1522,587,507,636,474,429,172,166,4493
"40089098800",2853,780,420,142,928,448,283,33,5887
"40089098900",1549,286,159,82,250,86,3,49,2464
"40091779600",3407,618,77,6,814,177,105,30,5234
"40091779700",1752,605,254,80,611,274,98,67,3741
"40091779900",1298,246,28,38,685,323,25,0,2643
"40091780100",1314,173,15,36,516,199,14,24,2291
"40091780200",1452,449,71,73,568,331,87,7,3038
"40091780300",2193,438,19,0,641,143,19,9,3462
"40093955100",2633,219,0,0,448,52,388,39,3779
"40093955200",1138,146,0,0,24,82,16,122,1528
"40093955300",2152,483,13,15,110,76,40,82,2971
"40095094698",2389,211,14,10,758,128,217,6,3733
"40095094700",2262,407,119,62,1591,338,1696,198,6673
"40095094801",2266,598,17,0,410,181,38,82,3592
"40095094802",2534,618,4,0,697,92,226,32,4203
"40097040100",2446,1009,0,19,868,362,200,192,5096
"40097040200",2524,683,0,0,1040,308,149,0,4704
"40097040300",2676,207,0,0,967,277,87,0,4214
"40097040400",3140,1098,34,0,1185,592,61,108,6218
"40097040501",1623,292,0,0,781,167,84,20,2967
"40097040502",1606,526,17,0,1174,381,69,13,3786
"40097040600",1802,394,0,0,1116,551,48,30,3941
"40097040700",1899,702,30,13,879,327,102,22,3974
"40097040800",4214,469,11,0,1601,208,83,3,6589
"40099790600",1650,178,23,8,409,33,39,0,2340
"40099790700",3643,406,51,49,990,98,350,0,5587
"40099790800",3392,839,0,20,1132,381,337,28,6129
"40101000100",1313,818,683,377,808,332,15,92,4438
"40101000200",341,352,311,418,116,193,18,43,1792
"40101000300",880,321,925,733,425,170,56,64,3574
"40101000400",322,202,454,190,160,116,70,91,1605
"40101000600",1951,578,334,53,909,378,93,96,4392
"40101000700",2240,816,119,85,978,621,681,325,5865
"40101000801",3018,377,111,37,1076,216,27,131,4993
"40101000802",1323,303,136,34,443,134,184,11,2568
"40101000900",4407,727,310,149,1854,199,300,68,8014
"40101001000",955,264,258,128,242,107,132,77,2163
"40101001100",1942,318,171,52,775,123,38,2,3421
"40101001200",1469,136,209,93,630,47,66,0,2650
"40101001300",3390,559,209,15,1691,392,62,286,6604
"40101001400",3987,552,69,58,1682,435,222,158,7163
"40101001500",3044,804,39,17,1521,598,111,63,6197
"40101001600",2202,777,241,85,884,181,102,81,4553
"40103956600",2000,258,15,3,798,135,165,51,3425
"40103956900",2941,249,34,28,351,37,74,0,3714
"40103957000",1298,380,0,58,81,55,0,0,1872
"40103957100",2203,247,0,27,154,38,57,0,2726
"40105172100",1714,180,4,6,353,114,59,7,2437
"40105172200",822,203,17,4,411,112,10,6,1585
"40105172300",1253,231,0,0,433,115,99,9,2140
"40105172400",2179,534,114,29,1089,400,54,55,4454
"40107080600",1704,266,95,12,639,246,40,0,3002
"40107080700",1260,475,202,131,348,134,43,10,2603
"40107080900",1632,562,51,105,825,356,107,94,3732
"40107081000",1057,227,67,57,607,226,65,62,2368
"40109100100",1867,476,262,172,334,140,188,233,3672
"40109100200",3092,1223,505,103,807,241,215,743,6929
"40109100300",2211,66,74,41,254,71,104,9,2830
"40109100400",8,89,1150,539,106,180,21,13,2106
"40109100500",181,17,1020,606,43,13,51,0,1931
"40109100600",690,61,11,0,70,30,44,11,917
"40109100700",799,204,52,52,130,20,54,30,1341
"40109100800",1136,446,230,38,595,132,324,110,3011
"40109100900",1048,161,95,4,195,22,116,6,1647
"40109101000",480,396,86,64,556,400,142,188,2312
"40109101100",456,111,66,66,59,14,18,0,790
"40109101200",670,222,54,62,317,29,65,0,1419
"40109101300",77,106,1597,1043,105,29,0,84,3041
"40109101400",18,159,540,242,0,32,0,51,1042
"40109101500",345,138,556,215,202,81,4,0,1541
"40109101600",262,25,16,17,57,13,35,0,425
"40109101700",1057,17,10,0,104,40,14,0,1242
"40109101800",1109,101,21,24,163,23,73,0,1514
"40109101900",1683,190,98,123,499,79,404,178,3254
"40109102000",1402,497,425,125,568,55,430,151,3653
"40109102100",1368,257,36,46,407,126,594,259,3093
"40109102200",1278,711,34,84,292,61,517,470,3447
"40109102300",2036,749,128,35,254,228,804,768,5002
"40109102400",1148,854,159,196,918,159,1117,379,4930
"40109102500",185,158,19,19,46,25,8,7,467
"40109102600",26,79,117,155,14,106,4,12,513
"40109102700",28,28,0,8,25,10,0,0,99
"40109102800",281,175,974,620,175,156,83,179,2643
"40109102900",25,0,688,111,65,26,16,14,945
"40109103000",60,4,85,136,9,12,0,0,306
"40109103200",773,125,115,50,215,42,43,0,1363
"40109103300",561,350,119,77,245,214,594,271,2431
"40109103400",85,292,0,20,22,46,0,290,755
"40109103500",145,92,19,19,37,0,150,24,486
"40109103601",162,19,0,0,45,5,14,0,245
"40109103602",88,344,0,211,9,58,0,24,734
"40109103700",87,52,4,10,20,7,28,16,224
"40109103800",592,67,38,0,105,11,27,0,840
"40109103900",1442,1118,176,107,630,396,1676,1125,6670
"40109104000",116,68,61,5,0,4,106,62,422
"40109104100",1055,1126,31,182,229,372,725,857,4577
"40109104200",1011,514,0,0,435,296,1123,626,4005
"40109104300",1613,1046,51,0,394,495,1604,1310,6513
"40109104400",1244,1349,27,77,724,280,1446,1454,6601
"40109104500",1584,1145,0,100,926,111,1911,1113,6890
"40109104600",409,125,8,0,149,88,401,145,1325
"40109104700",548,237,12,41,292,277,631,254,2292
"40109104800",1604,496,5,220,675,392,1653,692,5737
"40109104900",1390,869,93,33,996,377,1647,602,6007
"40109105000",1573,397,53,0,379,96,1559,373,4430
"40109105100",1180,323,89,8,323,75,44,0,2042
"40109105201",50,0,804,564,100,30,0,30,1578
"40109105202",14,2,637,285,30,211,7,0,1186
"40109105300",1226,665,89,328,640,279,981,591,4799
"40109105400",923,355,58,90,342,105,598,343,2814
"40109105500",1578,783,76,22,633,536,1388,1054,6070
"40109105600",1896,1712,148,184,709,372,1769,1461,8251
"40109105700",204,205,11,46,117,62,182,147,974
"40109105800",321,427,21,5,52,55,106,168,1155
"40109105903",1318,316,275,202,363,7,356,99,2936
"40109105904",1966,499,238,122,1082,90,1109,223,5329
"40109105905",1369,480,221,129,182,44,479,291,3195
"40109105906",1878,410,160,40,351,8,582,175,3604
"40109105907",2719,872,190,63,672,136,1715,398,6765
"40109106000",634,57,1304,81,144,36,18,0,2274
"40109106100",250,67,1438,519,207,72,84,0,2637
"40109106200",85,20,1296,141,66,0,20,0,1628
"40109106301",733,334,1193,990,384,217,249,282,4382
"40109106302",689,898,1575,930,591,219,176,624,5702
"40109106303",1985,444,297,428,354,52,637,172,4369
"40109106401",1907,76,34,0,166,6,35,0,2224
"40109106402",2008,142,0,0,137,0,73,9,2369
"40109106403",3414,318,327,109,284,178,127,0,4757
"40109106501",2402,141,49,44,317,44,61,24,3082
"40109106502",2285,315,250,203,721,97,323,100,4294
"40109106503",1030,231,77,5,97,16,86,66,1608
"40109106601",1884,237,127,129,334,76,105,50,2942
"40109106602",1708,298,157,39,241,117,218,12,2790
"40109106604",1010,279,415,95,309,147,113,112,2480
"40109106606",1547,508,21,0,210,3,142,169,2600
"40109106607",2261,546,403,129,593,139,238,294,4603
"40109106608",2069,92,128,12,435,56,161,7,2960
"40109106609",1110,30,59,0,78,0,195,0,1472
"40109106610",932,127,151,35,122,180,27,5,1579
"40109106702",2647,501,145,32,388,58,553,116,4440
"40109106704",1445,285,343,55,135,29,75,176,2543
"40109106705",1339,61,107,66,612,44,247,25,2501
"40109106706",2237,390,607,151,362,31,322,27,4127
"40109106707",3053,814,896,665,898,337,590,85,7338
"40109106708",1585,16,22,0,483,19,24,0,2149
"40109106801",857,212,91,0,94,103,57,39,1453
"40109106802",1181,161,47,4,54,22,96,33,1598
"40109106803",1568,464,40,108,358,529,498,388,3953
"40109106804",2185,500,168,114,554,132,371,137,4161
"40109106902",1671,298,52,12,452,124,391,184,3184
"40109106903",4018,650,432,147,736,47,292,373,6695
"40109106906",2023,347,225,221,269,132,479,351,4047
"40109106907",1409,242,157,76,116,51,425,61,2537
"40109106909",1001,154,201,69,119,107,108,15,1774
"40109106910",1597,341,72,50,137,17,183,27,2424
"40109106911",1349,108,87,12,186,52,376,0,2170
"40109106912",1187,503,655,201,458,58,262,99,3423
"40109106913",1456,552,366,473,397,415,586,298,4543
"40109106914",1906,484,438,79,925,169,882,440,5323
"40109106915",3006,890,630,305,706,1172,1848,1197,9754
"40109107001",2485,945,74,21,1304,1112,2108,1369,9418
"40109107002",1247,419,17,13,342,168,584,364,3154
"40109107101",0,0,0,0,0,0,0,0,0
"40109107103",750,391,66,239,219,183,576,226,2650
"40109107104",1523,671,72,359,361,271,1012,278,4547
"40109107206",2166,449,277,58,686,573,856,540,5605
"40109107207",998,249,137,43,550,116,290,119,2502
"40109107209",2561,1087,218,366,592,645,769,1389,7627
"40109107210",761,49,17,0,192,0,157,14,1190
"40109107211",1634,114,143,0,417,5,387,0,2700
"40109107212",3129,418,381,289,1351,173,684,97,6522
"40109107213",2944,532,283,65,1207,148,1914,264,7357
"40109107214",1496,393,30,56,690,48,917,217,3847
"40109107215",2330,706,142,0,701,392,1273,886,6430
"40109107216",1593,1014,29,59,250,198,1028,643,4814
"40109107217",1001,395,58,0,517,196,852,312,3331
"40109107218",1683,539,16,225,276,528,1180,505,4952
"40109107219",2245,196,0,52,669,317,1686,370,5535
"40109107220",2185,551,0,0,564,332,1698,358,5688
"40109107221",1187,203,116,13,238,196,313,292,2558
"40109107222",875,342,29,62,348,127,474,333,2590
"40109107223",1060,486,108,78,792,183,554,346,3607
"40109107302",1224,684,49,146,227,271,295,475,3371
"40109107303",886,316,79,13,116,84,128,45,1667
"40109107305",575,196,96,178,68,36,271,43,1463
"40109107306",865,644,407,547,496,274,203,332,3768
"40109107401",1572,846,1496,1226,502,272,178,242,6334
"40109107403",3615,300,1140,469,563,42,361,0,6490
"40109107404",1427,170,680,503,426,71,94,16,3387
"40109107405",2629,135,1050,22,955,23,319,0,5133
"40109107500",1132,28,97,0,357,12,388,0,2014
"40109107601",1047,427,402,126,215,25,138,0,2380
"40109107604",1259,239,103,0,282,54,151,18,2106
"40109107605",1649,241,83,57,164,147,58,3,2402
"40109107606",152,16,12,0,28,10,8,0,226
"40109107607",2488,398,528,26,143,54,248,56,3941
"40109107703",2334,495,580,15,351,10,311,0,4096
"40109107704",923,166,204,55,136,0,90,0,1574
"40109107705",1297,193,122,88,300,21,166,0,2187
"40109107706",1704,255,224,61,616,70,455,55,3440
"40109107707",953,210,73,0,124,26,69,27,1482
"40109107801",1430,201,1070,696,229,276,193,102,4197
"40109107804",1661,287,53,133,135,177,75,61,2582
"40109107805",1425,222,556,46,177,167,206,97,2896
"40109107806",2468,457,276,330,456,16,305,81,4389
"40109107807",1591,129,432,0,415,10,373,10,2960
"40109107808",1043,120,381,81,333,16,203,15,2192
"40109107809",1150,256,237,59,88,53,110,22,1975
"40109107810",1382,267,156,169,413,49,140,0,2576
"40109107900",53,31,983,469,87,78,23,11,1735
"40109108003",1074,486,1375,477,250,128,86,43,3919
"40109108005",710,98,1135,231,111,0,60,17,2362
"40109108006",2261,443,566,69,287,31,230,255,4142
"40109108007",2187,112,293,150,149,153,63,6,3113
"40109108008",1932,386,779,489,606,341,284,46,4863
"40109108009",1397,53,1059,26,362,100,221,82,3300
"40109108010",1288,528,690,124,308,125,213,208,3484
"40109108011",858,100,1339,865,419,126,101,0,3808
"40109108101",3301,79,184,0,241,11,185,0,4001
"40109108106",4532,73,111,0,409,0,94,0,5219
"40109108107",2481,8,74,0,312,0,27,0,2902
"40109108109",4845,61,38,0,687,83,205,0,5919
"40109108110",3315,151,99,22,388,11,86,0,4072
"40109108113",3717,226,109,46,636,278,291,101,5404
"40109108114",3304,492,272,186,332,326,174,41,5127
"40109108201",2590,278,271,121,279,171,245,18,3973
"40109108203",2168,451,84,7,590,73,156,46,3575
"40109108204",1396,420,194,81,462,226,470,206,3455
"40109108206",3891,93,162,27,432,90,150,0,4845
"40109108207",368,183,39,32,68,112,5,79,886
"40109108208",1822,688,301,207,470,338,166,15,4007
"40109108213",8215,143,44,0,820,15,211,19,9467
"40109108215",3716,220,319,0,184,11,410,11,4871
"40109108216",2420,218,269,0,354,15,147,0,3423
"40109108217",3075,375,451,22,495,85,139,12,4654
"40109108218",6637,41,628,0,1481,0,424,0,9211
"40109108219",5058,85,397,57,385,21,149,0,6152
"40109108220",4028,409,266,120,638,53,120,9,5643
"40109108221",6434,141,467,30,893,8,354,9,8336
"40109108301",596,61,822,283,222,27,64,32,2107
"40109108302",2944,187,711,315,408,35,100,35,4735
"40109108303",4379,574,209,118,432,206,231,54,6203
"40109108304",3418,400,83,0,325,388,179,394,5187
"40109108307",2261,254,1966,105,417,183,413,28,5627
"40109108309",327,75,932,875,199,45,163,0,2616
"40109108310",750,105,941,266,109,128,30,112,2441
"40109108313",2098,355,1852,397,526,407,250,280,6165
"40109108314",1246,118,649,174,369,117,542,24,3239
"40109108315",3754,212,667,149,745,30,355,0,5912
"40109108316",5112,103,717,101,892,13,318,0,7256
"40109108317",2570,316,276,0,480,136,94,11,3883
"40109108318",3586,116,817,48,947,39,166,7,5726
"40109108402",1027,35,56,0,177,3,0,0,1298
"40109108403",1358,91,289,37,308,3,216,0,2302
"40109108404",1982,163,415,63,304,6,190,28,3151
"40109108504",5432,269,329,87,830,200,215,14,7376
"40109108506",2629,258,504,0,217,32,71,0,3711
"40109108507",975,92,21,13,82,6,39,0,1228
"40109108508",1398,84,221,48,327,9,185,29,2301
"40109108511",5519,713,448,0,1068,68,238,17,8071
"40109108512",4227,104,123,15,640,19,92,1,5221
"40109108513",2509,208,519,13,511,92,234,0,4086
"40109108514",2527,519,1114,545,382,127,241,110,5565
"40109108515",3621,119,395,178,524,60,71,16,4984
"40109108519",2258,97,413,23,245,31,113,5,3185
"40109108520",1739,37,136,36,121,0,37,0,2106
"40109108521",690,94,284,115,157,126,83,30,1579
"40109108523",4008,156,600,17,644,14,247,0,5686
"40109108524",2330,151,231,0,547,109,15,0,3383
"40109108525",1280,110,248,0,549,28,165,0,2380
"40109108526",2605,513,577,314,922,143,411,299,5784
"40109108527",3019,93,458,36,1075,300,174,13,5168
"40109108528",1390,125,229,161,269,48,91,25,2338
"40109108529",2489,34,159,0,315,0,19,0,3016
"40109108530",3001,249,498,16,633,0,197,40,4634
"40109108601",1620,70,166,0,387,54,397,44,2738
"40109108602",859,149,0,8,15,10,83,15,1139
"40109108603",2435,145,140,14,340,27,434,14,3549
"40109108701",2208,126,133,0,154,0,91,0,2712
"40109108703",4706,365,165,45,677,75,245,0,6278
"40109108704",4259,211,18,0,386,132,117,1,5124
"40109108706",1939,95,299,8,396,14,100,0,2851
"40109108707",2531,165,384,0,511,33,102,16,3742
"40109108708",2611,217,0,0,204,19,41,54,3146
"40109108709",2908,106,0,0,345,11,126,0,3496
"40109108801",4875,336,438,296,662,68,337,34,7046
"40109108802",3974,339,128,0,640,44,120,11,5256
"40109108803",71,10,718,221,126,20,17,0,1183
"40109108804",1661,102,489,533,222,62,70,0,3139
"40109108900",2620,289,385,108,370,139,102,166,4179
"40109109001",1633,122,96,41,235,4,55,0,2186
"40109109003",3787,399,37,20,577,45,230,9,5104
"40109109004",2923,191,19,1,257,33,313,9,3746
"40109109100",33,63,17,54,8,7,0,0,182
"40109109201",4522,192,133,49,521,16,217,12,5662
"40109109202",1727,244,41,11,182,15,52,104,2376
"40111000100",437,184,843,328,524,159,5,0,2480
"40111000200",1200,558,259,163,392,267,132,57,3028
"40111000300",1130,423,111,31,403,261,67,66,2492
"40111000400",2361,425,325,175,857,542,163,25,4873
"40111000500",2482,328,174,60,889,96,17,0,4046
"40111000600",4776,540,97,79,1005,297,148,62,7004
"40111000700",2277,358,115,14,847,202,204,28,4045
"40111000800",1788,403,144,81,715,212,75,14,3432
"40111000901",1944,302,18,2,692,216,133,31,3338
"40111000902",2410,730,0,0,814,444,92,56,4546
"40113940001",2472,499,96,19,1135,325,58,15,4619
"40113940002",2259,320,71,0,1404,507,265,26,4852
"40113940003",2985,689,31,18,856,237,139,20,4975
"40113940004",1732,171,2,2,750,42,48,47,2794
"40113940005",2550,327,194,48,569,116,77,30,3911
"40113940006",817,218,3378,967,360,90,130,123,6083
"40113940007",3576,501,96,0,938,119,127,45,5402
"40113940008",1773,385,0,0,559,133,58,0,2908
"40113940009",2536,287,0,0,783,67,81,0,3754
"40113940010",5027,701,0,55,1046,350,31,53,7263
"40113940011",912,116,14,0,221,56,22,20,1361
"40115574100",2332,492,13,2,965,438,96,30,4368
"40115574200",1290,686,7,1,725,260,278,246,3493
"40115574300",1510,320,15,10,574,192,78,32,2731
"40115574400",1352,483,6,8,530,306,95,108,2888
"40115574500",1123,537,15,4,371,233,64,69,2416
"40115574600",2132,580,8,12,841,262,100,80,4015
"40115574700",2952,275,0,4,1167,282,67,0,4747
"40115574800",2275,705,0,15,882,311,43,15,4246
"40115574900",1966,456,10,9,848,229,130,29,3677
"40117957100",2709,375,13,34,578,98,34,0,3841
"40117957200",3281,384,2,0,551,60,151,1,4430
"40117957300",1950,456,45,0,467,154,97,0,3169
"40117957400",2158,212,0,0,330,49,73,2,2824
"40117957500",1202,276,58,4,670,147,69,21,2447
"40119010101",2850,477,140,0,543,141,134,13,4298
"40119010102",2255,1365,148,152,307,642,106,88,5063
"40119010200",2982,1192,228,398,633,282,89,80,5884
"40119010300",645,1034,5,15,47,85,47,53,1931
"40119010400",84,97,26,9,441,206,41,3,907
"40119010500",1237,1162,0,74,299,495,132,45,3444
"40119010600",2089,1545,458,50,517,300,189,84,5232
"40119010700",1527,1373,43,11,147,170,40,177,3488
"40119010800",1079,662,52,41,130,98,82,20,2164
"40119010900",7095,956,32,4,801,297,758,24,9967
"40119011000",4833,623,61,0,483,161,113,0,6274
"40119011101",3918,701,17,13,502,62,68,0,5281
"40119011102",4787,963,121,11,433,304,14,27,6660
"40119011200",1532,376,0,0,380,15,45,3,2351
"40119011301",2665,485,23,45,409,41,187,36,3891
"40119011302",2606,584,67,9,521,176,123,88,4174
"40119011400",2360,489,31,13,234,79,123,61,3390
"40121485600",2108,340,23,0,183,190,0,21,2865
"40121485700",1295,314,22,0,403,172,36,98,2340
"40121485800",2943,587,0,11,825,149,130,25,4670
"40121485900",1416,230,35,0,442,43,9,11,2186
"40121486000",3132,445,142,2,1079,327,122,19,5268
"40121486100",2102,496,379,8,874,434,159,155,4607
"40121486200",2076,462,79,31,603,455,120,287,4113
"40121486300",8,0,11,0,4,0,0,0,23
"40121486400",1093,642,81,25,485,199,116,54,2695
"40121486500",3815,710,38,86,919,251,116,67,6002
"40121486600",2139,163,88,2,550,67,48,0,3057
"40121486700",2757,480,62,30,1154,232,139,47,4901
"40121486800",1172,298,0,0,304,113,30,43,1960
"40123088600",3115,447,59,10,1255,191,183,67,5327
"40123088700",1445,242,26,7,484,72,2,9,2287
"40123088800",4463,605,317,89,1246,369,177,29,7295
"40123088900",1662,730,84,65,673,453,209,107,3983
"40123089000",2324,490,19,0,890,323,57,79,4182
"40123089100",793,527,33,5,398,283,43,53,2135
"40123089200",663,275,34,0,186,225,102,49,1534
"40123089300",2640,342,31,4,913,184,189,52,4355
"40123089598",3366,351,2,2,980,228,202,21,5152
"40123089600",1326,203,0,0,384,47,19,26,2005
"40125500200",1069,1007,128,225,409,381,73,195,3487
"40125500301",2070,310,50,13,808,198,170,0,3619
"40125500302",1511,321,54,71,338,363,161,129,2948
"40125500400",2083,605,75,47,550,266,188,53,3867
"40125500500",1859,605,27,102,494,235,169,135,3626
"40125500600",2275,484,63,41,545,166,201,45,3820
"40125500700",1909,183,114,24,536,161,171,0,3098
"40125500800",3052,115,23,0,431,102,29,0,3752
"40125500900",5033,329,127,18,975,328,175,12,6997
"40125501001",4880,1243,12,17,1092,292,359,125,8020
"40125501003",3522,324,9,8,509,95,145,36,4648
"40125501004",2968,290,66,12,619,142,87,60,4244
"40125501101",3281,712,160,35,1274,297,135,0,5894
"40125501102",5150,845,121,34,1359,286,166,26,7987
"40125501201",1274,249,0,0,202,70,2,18,1815
"40125501300",1919,490,6,22,281,125,41,24,2908
"40127097600",1742,385,39,7,512,184,61,13,2943
"40127097700",3105,1337,54,25,871,353,150,39,5934
"40127097800",1479,273,2,0,527,152,70,16,2519
"40129960000",2987,439,3,0,218,105,186,60,3998
"40131050101",2543,582,68,0,997,366,242,121,4919
"40131050103",1428,54,7,11,697,126,201,36,2560
"40131050104",803,444,91,23,414,178,56,43,2052
"40131050105",3068,216,75,9,844,116,258,8,4594
"40131050201",1653,89,0,0,518,88,126,5,2479
"40131050202",1519,310,62,0,833,135,111,0,2970
"40131050203",974,124,17,0,376,101,33,36,1661
"40131050301",1588,177,6,0,480,115,54,12,2432
"40131050302",1594,276,6,47,596,150,52,23,2744
"40131050303",1914,164,0,0,573,75,59,25,2810
"40131050304",2442,111,32,0,642,29,39,0,3295
"40131050403",4109,171,59,0,1118,8,91,13,5569
"40131050404",4786,147,90,0,795,50,294,38,6200
"40131050405",3321,142,57,0,343,41,66,26,3996
"40131050406",1879,12,0,0,423,15,123,0,2452
"40131050407",1571,89,54,76,593,8,172,33,2596
"40131050408",1888,182,33,0,555,224,179,41,3102
"40131050409",1267,116,0,0,461,50,99,124,2117
"40131050501",2206,77,0,0,730,77,170,0,3260
"40131050502",2002,317,21,14,893,94,55,8,3404
"40131050601",2393,245,0,0,776,32,148,73,3667
"40131050602",2253,152,14,0,889,0,43,0,3351
"40131050603",1923,105,0,0,566,9,43,0,2646
"40131050604",2819,88,0,0,677,88,84,0,3756
"40131050701",1064,341,0,2,522,170,89,28,2216
"40131050702",1902,229,0,3,772,153,5,16,3080
"40131050801",3241,201,18,0,738,38,44,0,4280
"40131050802",2168,309,1,0,635,80,14,0,3207
"40133583100",906,179,50,22,349,95,34,28,1663
"40133583200",2370,366,25,0,623,219,104,74,3781
"40133583300",1613,294,104,22,667,96,177,33,3006
"40133583400",2479,553,145,102,782,267,158,32,4518
"40133583500",847,497,58,31,328,166,101,46,2074
"40133583600",1582,479,305,260,625,567,56,75,3949
"40133583700",1331,192,37,0,380,84,61,2,2087
"40133583800",1675,438,0,5,709,130,73,0,3030
"40133583900",951,201,45,11,402,95,29,8,1742
"40135030101",2128,746,4,3,1504,409,64,43,4901
"40135030103",1354,607,131,77,356,174,106,54,2859
"40135030104",3520,1141,40,7,1463,577,200,44,6992
"40135030201",1484,215,0,0,484,281,39,25,2528
"40135030202",2297,628,202,33,1169,446,26,68,4869
"40135030301",744,407,21,27,604,416,106,125,2450
"40135030302",3549,1100,46,37,1404,504,136,88,6864
"40135030401",2029,380,28,16,958,268,105,47,3831
"40135030402",3465,1043,118,33,1474,686,210,57,7086
"40137000101",4521,379,24,24,534,186,184,80,5932
"40137000102",2392,299,8,34,338,129,220,27,3447
"40137000200",2955,419,68,0,388,47,157,21,4055
"40137000300",1453,288,36,22,171,31,174,37,2212
"40137000400",3235,898,241,22,767,469,569,348,6549
"40137000600",1306,542,197,124,460,261,344,141,3375
"40137000800",3873,258,8,3,346,78,28,93,4687
"40137000901",3801,522,38,9,363,60,66,10,4869
"40137000902",2625,371,0,0,288,374,121,12,3791
"40137001000",1626,214,0,0,227,28,103,2,2200
"40137001100",4459,594,7,0,539,55,271,26,5951
"40139950600",2827,347,49,6,584,293,791,403,5300
"40139950700",1781,320,22,111,531,185,599,236,3785
"40139950800",2710,322,184,18,1593,13,2716,197,7753
"40139950900",3655,632,42,0,3022,389,3656,528,11924
"40139951000",955,63,0,0,379,34,481,48,1960
"40141070100",639,220,0,6,94,65,57,56,1137
"40141070200",660,155,90,20,144,46,156,37,1308
"40141070300",1366,243,67,22,177,291,327,322,2815
"40141070400",1005,312,122,42,223,35,463,193,2395
"40141070500",816,141,108,83,99,69,176,46,1538
"40143000100",961,332,143,65,411,162,372,167,2613
"40143000200",92,30,855,264,162,15,74,31,1523
"40143000300",1034,513,580,894,744,333,692,339,5129
"40143000400",1176,519,521,283,954,957,1006,715,6131
"40143000500",51,145,907,743,114,277,65,73,2375
"40143000600",46,68,634,383,132,141,31,49,1484
"40143000700",68,70,1106,354,130,52,5,33,1818
"40143000800",185,79,743,256,83,50,5,6,1407
"40143000900",463,132,508,213,134,110,43,33,1636
"40143001000",62,79,794,358,90,39,4,0,1426
"40143001200",618,280,98,138,426,356,670,497,3083
"40143001300",752,331,95,50,555,377,626,343,3129
"40143001400",1730,1000,384,222,1219,1087,1458,809,7909
"40143001500",1868,499,243,217,1021,355,555,253,5011
"40143001600",2101,585,193,293,1074,464,1349,340,6399
"40143001700",1594,315,161,67,412,38,165,92,2844
"40143001800",1041,255,51,5,322,139,126,97,2036
"40143001900",933,180,70,8,254,61,158,63,1727
"40143002000",1078,262,43,67,220,146,283,50,2149
"40143002100",661,717,107,223,317,432,401,256,3114
"40143002301",969,416,132,67,600,347,479,365,3375
"40143002500",1000,305,99,107,190,154,84,18,1957
"40143002700",1586,533,209,104,506,187,339,66,3530
"40143002900",1815,366,89,133,405,69,158,27,3062
"40143003000",1152,413,26,46,201,81,198,16,2133
"40143003100",1738,291,154,49,234,55,16,7,2544
"40143003200",999,190,9,12,240,28,46,10,1534
"40143003300",1550,153,0,0,269,8,24,0,2004
"40143003400",1077,321,105,68,235,131,55,82,2074
"40143003500",1442,190,102,10,272,48,47,6,2117
"40143003600",1740,113,39,0,274,35,45,0,2246
"40143003700",1998,148,39,9,383,77,75,0,2729
"40143003800",1376,190,30,6,216,59,67,18,1962
"40143003900",2724,267,101,21,716,136,168,20,4153
"40143004000",3306,395,171,95,479,91,158,0,4695
"40143004101",2130,15,0,0,190,4,14,0,2353
"40143004200",2437,146,50,61,158,50,127,0,3029
"40143004301",1960,26,12,0,167,0,4,0,2169
"40143004302",2919,156,0,0,209,0,75,0,3359
"40143004400",1837,266,98,14,257,54,55,14,2595
"40143004500",2200,190,0,10,144,9,32,9,2594
"40143004600",843,878,306,404,301,473,284,482,3971
"40143004700",1082,148,31,24,430,134,46,48,1943
"40143004800",2371,856,85,0,692,213,236,261,4714
"40143004900",1029,219,136,87,421,66,242,13,2213
"40143005001",1310,249,45,31,252,58,121,26,2092
"40143005002",2270,388,98,74,518,91,190,41,3670
"40143005100",1497,52,56,9,219,14,5,9,1861
"40143005200",2300,139,69,19,445,7,57,7,3043
"40143005300",3695,196,269,61,387,64,164,0,4836
"40143005401",2104,76,16,0,485,51,80,19,2831
"40143005402",5371,512,140,0,1259,271,201,68,7822
"40143005500",2749,435,0,0,367,133,52,17,3753
"40143005600",1575,307,28,0,384,55,71,27,2447
"40143005700",393,127,959,617,184,93,74,39,2486
"40143005801",2952,417,28,0,702,188,417,88,4792
"40143005805",5200,474,177,47,1216,153,357,148,7772
"40143005806",4086,363,108,12,806,88,229,34,5726
"40143005807",10077,433,309,25,2313,214,873,61,14305
"40143005808",2248,83,67,0,668,49,74,35,3224
"40143005900",1076,279,200,96,391,321,660,288,3311
"40143006000",2327,619,232,340,902,373,946,432,6171
"40143006200",91,131,1333,700,175,197,58,19,2704
"40143006506",1974,48,22,0,394,10,98,19,2565
"40143006507",1139,90,71,6,314,58,188,0,1866
"40143006600",1797,205,18,0,530,147,38,41,2776
"40143006701",1325,409,341,428,339,271,243,39,3395
"40143006703",2697,382,167,0,421,47,348,67,4129
"40143006705",3938,284,418,98,775,144,267,0,5924
"40143006707",7257,90,452,98,1289,59,400,44,9689
"40143006708",5980,93,93,0,582,0,237,0,6985
"40143006801",1149,366,237,206,261,283,170,87,2759
"40143006803",1580,149,315,201,241,128,64,41,2719
"40143006804",1450,200,204,176,328,159,385,106,3008
"40143006901",3496,173,261,0,236,36,305,49,4556
"40143006902",1469,43,31,0,71,0,9,0,1623
"40143006903",2991,287,187,25,526,84,226,0,4326
"40143006905",1986,489,613,198,493,375,928,417,5499
"40143006906",1166,207,118,152,387,85,335,92,2542
"40143006907",1741,254,279,138,533,72,305,67,3389
"40143007000",1437,323,264,362,300,127,132,80,3025
"40143007101",1689,580,369,118,501,279,535,321,4392
"40143007102",1051,263,393,164,265,182,168,104,2590
"40143007200",2427,487,127,323,599,211,695,265,5134
"40143007304",2040,462,367,169,524,76,1150,270,5058
"40143007305",3243,631,687,312,1226,560,1251,751,8661
"40143007306",2460,657,316,458,1207,408,1771,578,7855
"40143007308",1921,239,63,147,365,191,264,94,3284
"40143007309",1019,28,108,44,247,31,246,36,1759
"40143007310",2319,286,293,42,854,166,1484,290,5734
"40143007311",1049,466,216,183,555,232,447,203,3351
"40143007312",2214,454,317,296,1125,254,1317,379,6356
"40143007402",1961,229,57,0,393,59,123,5,2827
"40143007407",2367,104,123,53,447,39,150,6,3289
"40143007408",838,111,64,0,201,31,59,0,1304
"40143007409",2508,198,292,78,768,71,461,107,4483
"40143007410",1362,189,292,82,251,97,286,54,2613
"40143007411",1453,150,164,107,416,84,312,36,2722
"40143007412",2458,223,222,0,605,61,442,0,4011
"40143007413",2667,72,277,0,784,0,319,19,4138
"40143007414",1838,345,182,69,271,54,143,113,3015
"40143007415",1178,84,145,17,347,8,56,4,1839
"40143007503",2029,202,30,0,451,93,156,24,2985
"40143007506",2624,175,87,31,442,70,274,53,3756
"40143007507",2647,185,223,0,496,35,204,48,3838
"40143007508",4899,104,302,123,863,99,307,0,6697
"40143007510",3652,303,203,48,819,184,555,204,5968
"40143007511",2344,202,33,45,495,74,182,35,3410
"40143007512",3151,221,106,0,680,53,240,56,4507
"40143007513",3211,316,37,0,675,38,151,46,4474
"40143007515",3704,277,5,0,650,12,107,0,4755
"40143007516",3307,380,50,44,616,280,98,27,4802
"40143007518",2486,122,63,0,1004,0,58,3,3736
"40143007519",2582,16,100,0,363,41,196,0,3298
"40143007520",3845,88,41,0,457,7,157,0,4595
"40143007522",1543,90,127,5,231,28,65,5,2094
"40143007523",2024,134,69,0,279,15,113,16,2650
"40143007524",2158,105,113,0,458,35,193,18,3080
"40143007608",571,440,530,346,216,164,73,50,2390
"40143007609",1618,536,921,561,667,163,272,201,4939
"40143007611",934,98,84,68,131,45,31,4,1395
"40143007612",1488,43,5,18,189,30,52,0,1825
"40143007613",2343,110,115,0,380,37,150,31,3166
"40143007614",1857,116,97,20,380,48,104,0,2622
"40143007615",1472,124,215,12,238,90,56,44,2251
"40143007616",2440,226,176,21,331,97,158,9,3458
"40143007617",2262,361,647,90,617,155,428,184,4744
"40143007618",3796,486,398,136,1419,173,277,182,6867
"40143007619",3091,188,56,20,408,59,357,21,4200
"40143007620",3998,440,234,58,719,105,297,0,5851
"40143007624",2698,244,41,0,537,17,203,6,3746
"40143007625",2912,550,111,224,789,499,536,331,5952
"40143007629",2609,348,226,8,592,83,123,69,4058
"40143007630",3401,196,206,64,805,30,347,12,5061
"40143007631",2827,88,59,0,328,58,129,0,3489
"40143007632",2536,126,129,0,214,24,54,22,3105
"40143007633",2163,55,70,0,294,5,183,4,2774
"40143007634",2827,214,119,0,436,31,138,12,3777
"40143007635",5225,186,49,0,626,35,40,0,6161
"40143007636",3451,219,66,0,331,11,234,0,4312
"40143007637",4704,103,90,0,473,0,137,0,5507
"40143007638",3583,89,28,0,460,9,138,0,4307
"40143007639",3822,152,323,96,699,72,231,28,5423
"40143007641",1582,359,550,345,941,527,435,128,4867
"40143007642",889,227,170,106,398,186,263,31,2270
"40143007701",3789,329,56,9,1107,92,238,8,5628
"40143007702",6115,721,101,7,1198,399,167,106,8814
"40143007801",1810,364,69,0,353,38,208,7,2849
"40143007802",4329,344,104,10,849,90,297,0,6023
"40143007900",180,259,1806,1298,369,238,68,65,4283
"40143008001",212,445,189,660,232,296,98,155,2287
"40143008002",124,41,1583,697,248,181,186,38,3098
"40143008200",1039,479,81,79,489,196,577,244,3184
"40143008300",719,239,47,18,205,50,112,137,1527
"40143008400",2390,285,195,48,459,73,299,41,3790
"40143008501",1660,367,262,31,457,171,313,348,3609
"40143008502",3020,472,349,109,689,106,419,136,5300
"40143008600",2403,572,250,254,539,212,582,303,5115
"40143008700",2276,300,97,71,280,116,242,67,3449
"40143008800",1125,686,50,85,196,205,59,73,2479
"40143008900",1623,588,141,254,642,208,815,344,4615
"40143009003",4537,616,556,18,1230,81,513,75,7626
"40143009004",1901,584,357,364,1240,618,1619,752,7435
"40143009006",3513,298,632,252,1118,407,1575,430,8225
"40143009007",3689,725,722,194,1391,409,1411,483,9024
"40143009008",1311,539,251,183,808,431,1285,573,5381
"40143009009",5910,152,331,22,1556,157,412,170,8710
"40143009101",656,247,691,520,245,118,89,42,2608
"40143009104",1172,282,215,61,286,147,210,69,2442
"40143009200",2199,368,19,0,601,98,44,1,3330
"40143009300",2775,419,58,7,622,261,86,84,4312
"40143009401",3776,300,39,9,627,57,134,19,4961
"40143009402",4272,226,22,0,689,31,127,0,5367
"40143009500",4153,598,71,8,523,114,88,17,5572
"40143011100",249,66,137,25,76,22,70,61,706
"40145030101",2307,526,72,40,872,370,162,8,4357
"40145030102",2555,663,246,216,854,252,132,0,4918
"40145030201",1648,317,0,0,673,71,17,0,2726
"40145030202",1897,223,38,12,798,197,5,34,3204
"40145030300",1110,122,29,38,422,77,71,0,1869
"40145030402",3567,225,17,0,535,12,99,0,4455
"40145030403",1544,115,52,22,405,121,219,15,2493
"40145030405",4211,246,202,0,965,372,345,116,6457
"40145030406",3170,286,412,0,1042,110,252,65,5337
"40145030502",1551,137,43,0,402,6,129,0,2268
"40145030505",1707,23,12,0,215,22,34,0,2013
"40145030506",1146,107,0,0,169,14,62,0,1498
"40145030507",1619,442,23,0,315,126,367,308,3200
"40145030508",1638,46,12,0,287,3,39,0,2025
"40145030509",3233,55,134,0,692,0,350,0,4464
"40145030510",1502,88,43,0,271,59,125,0,2088
"40145030511",1730,24,0,0,274,19,156,10,2213
"40145030512",3218,294,127,0,604,18,113,84,4458
"40145030601",3053,180,218,0,762,59,115,26,4413
"40145030602",4727,714,115,20,1072,345,258,61,7312
"40145030798",2077,189,251,226,522,113,122,24,3524
"40145030800",2647,132,34,0,690,56,92,46,3697
"40147000100",931,348,77,94,280,117,87,90,2024
"40147000200",794,503,18,42,230,311,109,66,2073
"40147000300",1354,492,147,53,163,95,153,22,2479
"40147000400",3189,503,15,32,531,115,191,155,4731
"40147000500",4255,675,179,0,1137,157,238,0,6641
"40147000600",5563,575,61,1,1071,84,399,46,7800
"40147000700",4711,66,25,24,439,46,183,11,5505
"40147000800",2556,289,21,12,583,50,183,56,3750
"40147000900",1107,507,196,180,326,167,99,76,2658
"40147001000",1430,192,0,0,583,92,7,16,2320
"40147001100",3448,395,34,0,892,354,407,42,5572
"40147001200",1665,147,12,0,468,89,7,34,2422
"40147001300",3646,430,69,0,1155,70,90,29,5489
"40149964900",3055,511,3,3,387,106,304,44,4413
"40149965000",1799,297,0,0,105,86,162,126,2575
"40149965100",2802,436,0,0,151,27,128,163,3707
"40149965400",1237,161,0,0,108,98,37,100,1741
"40151954200",2746,426,13,70,201,52,71,52,3631
"40151954300",2056,492,0,19,105,15,85,57,2829
"40151954400",1676,189,6,0,45,20,153,19,2108
"40153953100",2329,333,0,0,55,8,163,0,2888
"40153953200",3215,358,0,2,174,11,90,0,3850
"40153953300",3011,699,10,7,330,18,424,194,4693
"40153953400",2594,591,0,0,241,38,374,146,3984
"40153953500",4931,518,0,0,484,12,690,168,6803
"41001950100",2403,396,14,0,92,10,62,109,3086
"41001950200",2756,408,0,0,78,11,119,54,3426
"41001950300",1989,355,0,0,61,83,23,7,2518
"41001950400",2249,420,0,0,112,4,0,0,2785
"41001950500",1975,379,0,0,75,35,154,52,2670
"41001950600",1297,248,5,0,54,4,15,0,1623
"41003000100",5841,1428,12,0,536,185,842,275,9119
"41003000202",3853,535,103,13,545,141,122,20,5332
"41003000400",5735,863,0,0,833,364,230,81,8106
"41003000500",2529,381,6,0,279,27,86,63,3371
"41003000600",2582,797,151,62,218,317,251,125,4503
"41003000900",3793,848,0,49,443,246,83,76,5538
"41003001001",2410,962,49,14,540,110,609,348,5042
"41003001002",2085,738,1,0,175,214,43,80,3336
"41003001101",718,1516,0,44,53,498,73,117,3019
"41003001102",1967,1714,0,0,77,665,318,60,4801
"41003010100",7836,283,12,0,307,49,395,0,8882
"41003010200",3546,408,58,0,298,38,81,36,4465
"41003010300",2830,310,0,0,123,17,80,0,3360
"41003010400",3262,485,87,2,203,150,181,314,4684
"41003010600",1340,1127,11,0,154,256,54,54,2996
"41003010702",837,484,31,0,193,206,104,12,1867
"41003010800",2649,822,29,0,238,29,160,61,3988
"41003010900",3371,687,10,13,415,42,128,8,4674
"41005020100",3293,270,12,0,297,0,238,0,4110
"41005020200",5159,492,0,0,774,48,14,48,6535
"41005020302",3171,220,0,0,462,21,138,2,4014
"41005020303",4006,411,0,0,397,16,138,0,4968
"41005020304",4476,481,32,0,771,52,211,0,6023
"41005020401",4266,218,10,0,493,15,449,3,5454
"41005020403",2954,59,0,0,255,4,54,3,3329
"41005020404",3370,125,38,0,192,0,200,0,3925
"41005020501",5944,210,56,0,714,99,308,19,7350
"41005020503",1949,161,0,0,120,5,76,0,2311
"41005020504",5411,226,102,16,714,74,112,86,6741
"41005020505",2355,149,0,0,104,156,69,0,2833
"41005020600",6870,443,115,2,781,70,569,125,8975
"41005020700",3539,177,0,0,192,9,91,0,4008
"41005020800",3148,426,41,11,548,94,297,81,4646
"41005020900",2964,471,128,2,203,15,368,13,4164
"41005021000",3500,579,29,57,297,40,441,112,5055
"41005021100",4556,575,145,8,620,42,279,42,6267
"41005021200",2938,585,0,0,314,29,686,59,4611
"41005021300",4881,590,85,3,353,21,343,84,6360
"41005021400",3787,430,112,0,338,42,584,70,5363
"41005021500",4115,297,33,0,429,0,154,0,5028
"41005021601",3638,1647,45,1,432,158,104,730,6755
"41005021602",3784,768,10,23,393,270,538,359,6145
"41005021700",4921,517,231,0,468,118,476,52,6783
"41005021801",5017,225,138,0,401,0,107,37,5925
"41005021802",2612,819,29,0,734,53,569,58,4874
"41005021900",2760,539,0,7,220,73,257,120,3976
"41005022000",5761,499,37,137,437,19,525,58,7473
"41005022101",5189,952,61,0,509,144,678,139,7672
"41005022103",4439,104,18,0,1663,124,402,30,6780
"41005022105",4595,287,98,0,1013,67,503,0,6563
"41005022107",2720,523,165,43,464,82,562,59,4618
"41005022108",2121,532,117,0,66,18,591,0,3445
"41005022201",3310,543,0,36,632,295,1246,354,6416
"41005022205",2520,156,106,0,640,52,228,1,3703
"41005022206",4179,453,84,30,1741,24,73,24,6608
"41005022207",4206,16,53,0,1240,38,281,0,5834
"41005022208",5143,365,152,0,1427,1,116,1,7205
"41005022301",3334,407,0,8,205,52,66,24,4096
"41005022302",4801,328,0,0,297,17,213,0,5656
"41005022400",3303,364,25,6,276,52,193,0,4219
"41005022500",5932,1166,115,21,253,355,522,218,8582
"41005022602",3600,124,69,21,219,25,257,0,4315
"41005022603",2929,402,0,0,447,12,482,21,4293
"41005022605",6099,319,18,0,661,23,672,50,7842
"41005022606",3705,480,11,0,183,75,62,224,4740
"41005022702",5759,221,31,0,661,62,274,0,7008
"41005022707",3678,268,0,0,459,171,416,165,5157
"41005022708",3822,205,137,0,292,52,1043,0,5551
"41005022710",1836,295,0,0,290,36,114,0,2571
"41005022800",3685,166,0,0,73,13,74,18,4029
"41005022901",2759,168,0,0,278,38,164,40,3447
"41005022904",2688,464,12,0,108,247,225,394,4138
"41005022905",3530,276,0,0,410,16,313,202,4747
"41005022906",2294,102,0,0,201,43,477,43,3160
"41005022907",3179,432,1,0,499,401,945,543,6000
"41005023001",2854,237,0,0,186,0,34,0,3311
"41005023002",3148,386,9,0,40,7,313,22,3925
"41005023100",5166,318,46,0,471,0,0,115,6116
"41005023201",3638,241,35,2,114,30,38,5,4103
"41005023202",5694,545,39,0,827,48,423,64,7640
"41005023300",4010,235,0,0,112,104,126,104,4691
"41005023401",3776,396,0,0,403,57,641,150,5423
"41005023403",4372,185,0,0,185,35,154,25,4956
"41005023404",5233,654,16,0,155,69,555,91,6773
"41005023500",4754,591,0,23,118,17,149,17,5669
"41005023600",3281,415,7,0,151,38,155,0,4047
"41005023700",4455,673,5,0,288,24,80,28,5553
"41005023800",6295,176,0,0,266,37,901,19,7694
"41005023901",5122,290,0,0,149,0,689,0,6250
"41005023902",3929,355,0,0,446,150,239,146,5265
"41005024000",2768,134,0,0,7,0,37,0,2946
"41005024100",4638,279,26,0,100,13,143,0,5199
"41005024200",5087,1020,0,14,173,51,304,82,6731
"41005024302",4397,497,13,0,78,0,98,248,5331
"41005024303",3083,263,0,0,51,0,233,0,3630
"41005024304",1864,192,5,0,53,2,31,4,2151
"41005024400",5774,463,61,14,624,351,732,114,8133
"41005980000",52,14,8,0,23,12,18,8,135
"41007950100",2282,323,50,2,206,127,242,10,3242
"41007950200",2624,724,23,0,178,89,63,37,3738
"41007950300",2025,451,50,0,100,137,195,193,3151
"41007950400",3399,234,37,20,132,6,358,16,4202
"41007950500",3609,721,0,2,349,39,419,52,5191
"41007950600",2332,349,0,0,246,55,116,5,3103
"41007950700",1484,303,0,0,39,68,66,54,2014
"41007950900",3104,660,45,0,330,296,336,254,5025
"41007951100",3166,484,1,0,261,150,180,108,4350
"41007951200",2621,334,0,0,98,11,148,6,3218
"41007951300",2008,156,20,0,91,50,36,16,2377
"41007990000",0,0,0,0,0,0,0,0,0
"41009970200",5384,854,68,0,166,137,158,45,6812
"41009970300",3348,479,7,18,325,40,151,0,4368
"41009970400",2082,242,0,0,158,23,30,6,2541
"41009970500",5392,712,0,0,255,16,158,245,6778
"41009970600",5140,252,0,29,201,0,228,19,5869
"41009970700",2707,590,0,0,345,280,103,276,4301
"41009970800",4496,1129,35,0,673,163,204,18,6718
"41009970900",3941,512,0,0,258,19,93,168,4991
"41009971000",3950,585,39,0,140,45,98,88,4945
"41009971100",2883,506,33,0,97,7,69,15,3610
"41011000100",4043,648,33,5,315,36,157,59,5296
"41011000200",1969,435,4,6,151,62,75,15,2717
"41011000300",2219,254,9,10,382,190,153,89,3306
"41011000400",5092,634,0,22,643,150,443,38,7022
"41011000502",1596,678,6,22,80,37,37,1,2457
"41011000503",1928,671,0,100,181,61,109,26,3076
"41011000504",3694,1366,15,377,981,183,296,369,7281
"41011000600",1800,435,60,9,106,81,110,0,2601
"41011000700",5088,757,0,0,534,389,479,234,7481
"41011000800",2351,364,0,0,112,0,16,35,2878
"41011000900",5812,832,0,0,592,119,279,28,7662
"41011001000",5609,1082,16,35,505,61,391,7,7706
"41011001100",4161,1054,0,0,353,145,150,50,5913
"41011990101",0,0,0,0,0,0,0,0,0
"41013950100",5474,1084,0,0,236,102,503,161,7560
"41013950200",3261,786,0,0,156,8,273,5,4489
"41013950300",3755,1337,8,107,575,79,393,66,6320
"41013950400",3189,459,0,0,136,86,87,57,4014
"41015950100",2190,1029,0,0,43,35,49,144,3490
"41015950200",4174,628,0,0,262,16,136,26,5242
"41015950301",3694,399,0,0,320,0,143,0,4556
"41015950302",3784,477,73,0,666,22,573,20,5615
"41015950400",3022,917,0,0,258,159,120,187,4663
"41015990101",0,0,0,0,0,0,0,0,0
"41017000100",1733,97,4,0,58,0,38,0,1930
"41017000200",3063,977,0,0,56,50,39,67,4252
"41017000300",7101,1323,13,0,310,74,175,96,9092
"41017000401",4347,705,0,0,122,0,357,0,5531
"41017000402",2223,243,0,0,12,27,34,0,2539
"41017000500",4914,665,2,0,190,30,310,5,6116
"41017000600",5670,630,20,0,238,129,20,56,6763
"41017000700",6493,805,63,0,515,26,550,83,8535
"41017000800",5040,1563,0,0,124,172,556,378,7833
"41017000900",4533,1951,0,52,267,539,899,793,9034
"41017001001",10621,2164,16,180,682,12,541,130,14346
"41017001002",2133,517,0,0,59,9,395,14,3127
"41017001100",9111,450,38,0,373,155,268,26,10421
"41017001200",5713,805,0,0,239,166,226,62,7211
"41017001300",9958,1026,71,0,704,175,736,180,12850
"41017001400",5005,340,6,0,417,17,83,17,5885
"41017001500",4286,910,1,0,472,17,306,0,5992
"41017001600",3566,1009,57,0,594,103,635,319,6283
"41017001700",6440,1505,66,0,284,17,579,126,9017
"41017001800",5840,1097,0,95,232,140,633,99,8136
"41017001901",1649,103,0,0,108,0,37,0,1897
"41017001902",7378,656,15,26,1191,140,985,64,10455
"41017002000",6389,569,0,0,453,144,612,57,8224
"41017002100",9447,1615,23,0,437,0,649,505,12676
"41019010000",1386,444,0,0,162,56,23,28,2099
"41019020000",2590,612,0,0,131,146,246,36,3761
"41019030000",3096,541,0,0,187,115,36,29,4004
"41019040000",2085,462,0,0,43,66,20,53,2729
"41019050001",3850,398,0,1,110,1,40,0,4400
"41019050002",4390,1692,57,0,338,100,227,393,7197
"41019060000",2991,255,8,0,89,12,112,0,3467
"41019070000",4480,336,0,0,180,25,113,0,5134
"41019080000",6252,474,61,0,356,15,41,0,7199
"41019090000",4447,1552,0,0,280,62,161,143,6645
"41019100000",2136,389,41,0,289,52,55,24,2986
"41019110000",2263,446,0,0,110,27,115,145,3106
"41019120000",5183,1361,0,51,437,141,312,110,7595
"41019130000",3746,1685,31,0,286,123,249,114,6234
"41019140000",4191,648,6,0,164,260,105,215,5589
"41019150000",6054,1140,6,0,353,20,478,20,8071
"41019160000",5351,1855,0,0,259,151,391,185,8192
"41019170000",2447,634,34,0,215,40,26,84,3480
"41019180000",2971,670,0,0,258,229,136,135,4399
"41019190000",2995,966,0,0,184,287,123,213,4768
"41019200000",3736,1080,0,0,427,149,200,34,5626
"41019210000",3418,583,0,0,174,25,210,59,4469
"41019990000",0,0,0,0,0,0,0,0,0
"41021960100",1643,182,14,4,24,0,122,25,2014
"41023960100",1493,371,1,0,68,19,34,0,1986
"41023960200",4268,707,6,8,185,33,171,48,5426
"41025960100",3654,827,18,1,315,74,213,47,5149
"41025960200",1751,317,15,0,102,49,55,5,2294
"41027950100",3032,306,33,0,248,302,518,323,4762
"41027950200",5348,581,60,0,459,57,927,28,7460
"41027950300",4103,1120,0,0,294,257,870,752,7396
"41027950400",4696,551,31,0,948,49,3035,367,9677
"41029000100",653,1134,0,19,137,62,311,369,2685
"41029000201",2000,1009,0,0,119,99,521,433,4181
"41029000202",2391,1061,0,105,258,185,777,368,5145
"41029000203",2919,705,11,9,328,38,898,111,5019
"41029000300",3681,1503,0,8,391,141,711,221,6656
"41029000403",3530,193,0,9,210,22,144,10,4118
"41029000404",4006,381,0,0,277,0,242,41,4947
"41029000405",2982,882,55,26,199,55,355,163,4717
"41029000406",3090,567,0,0,338,361,483,163,5002
"41029000501",2038,792,0,5,6,88,259,138,3326
"41029000502",3221,1253,56,26,244,228,453,67,5548
"41029000601",5482,780,0,0,257,30,261,47,6857
"41029000602",3965,1081,0,0,250,13,173,286,5768
"41029000700",6808,1612,19,87,491,580,528,579,10704
"41029000800",4195,1025,175,0,246,310,218,562,6731
"41029000900",6990,967,38,0,404,0,962,309,9670
"41029001001",5273,801,0,0,179,49,256,68,6626
"41029001002",3377,651,20,0,259,92,284,305,4988
"41029001100",4292,550,0,0,465,0,374,113,5794
"41029001200",3008,1044,0,0,161,44,400,390,5047
"41029001301",3989,1113,1,13,520,299,846,265,7046
"41029001302",7779,938,196,0,996,99,2354,297,12659
"41029001400",7107,1700,0,0,878,241,561,71,10558
"41029001500",4093,380,27,0,138,0,77,2,4717
"41029001601",2795,809,9,0,101,20,616,150,4500
"41029001602",5033,1313,0,0,831,31,1495,392,9095
"41029001700",5193,1457,84,0,318,280,544,230,8106
"41029001800",6065,1482,121,29,428,49,339,57,8570
"41029001900",1162,644,14,0,170,71,155,50,2266
"41029002000",1835,336,36,0,63,24,72,6,2372
"41029002100",2674,398,0,0,256,81,173,0,3582
"41029002200",3501,741,137,0,163,9,32,10,4593
"41029002300",1381,150,0,0,85,33,80,0,1729
"41029002400",1665,150,0,0,155,104,151,46,2271
"41029002500",2167,208,23,0,128,43,36,0,2605
"41029002600",2079,418,0,0,83,47,84,10,2721
"41029002700",5053,1109,53,0,245,61,273,52,6846
"41029002800",4304,492,3,0,236,94,336,255,5720
"41029002900",5927,1095,8,0,303,176,495,149,8153
"41029003001",3282,378,0,0,80,0,114,0,3854
"41029003002",3238,1318,24,0,54,7,42,19,4702
"41031940000",217,16,46,0,2046,1184,304,126,3939
"41031960100",1399,186,0,10,111,45,87,71,1909
"41031960201",2003,402,0,0,543,401,968,406,4723
"41031960202",3189,815,0,0,789,150,826,457,6226
"41031960301",2699,435,0,34,123,0,28,0,3319
"41031960302",3192,497,68,7,474,176,520,356,5290
"41033360100",1634,564,0,3,152,12,59,6,2430
"41033360300",4663,610,0,0,193,90,2,1,5559
"41033360400",3323,448,17,0,158,37,324,39,4346
"41033360500",3390,1886,0,0,701,129,519,146,6771
"41033360600",4831,1030,0,31,363,157,264,57,6733
"41033360701",2729,987,46,18,209,165,255,86,4495
"41033360702",4046,771,19,0,483,193,749,23,6284
"41033360800",3910,860,0,0,66,38,388,75,5337
"41033360900",1727,509,0,0,183,88,138,29,2674
"41033361000",3751,513,0,0,129,49,124,0,4566
"41033361100",7230,1462,0,0,332,326,643,140,10133
"41033361200",5411,1071,14,0,134,64,387,77,7158
"41033361300",6278,1038,2,0,187,15,243,12,7775
"41033361400",1785,478,0,0,189,137,35,47,2671
"41033361500",1779,458,0,0,195,56,55,13,2556
"41033361600",5341,2272,113,8,210,54,556,114,8668
"41035970100",2525,367,0,8,116,160,120,101,3397
"41035970200",2876,662,74,0,589,347,38,37,4623
"41035970300",2417,415,0,0,122,24,91,96,3165
"41035970400",1047,173,10,0,88,9,86,0,1413
"41035970500",1210,239,0,0,91,40,62,31,1673
"41035970600",1222,216,9,0,126,36,431,169,2209
"41035970700",1484,269,6,0,192,13,430,168,2562
"41035970800",1988,332,0,19,47,1,46,118,2551
"41035970900",2961,623,12,29,264,42,94,81,4106
"41035971000",2034,322,0,0,76,19,90,26,2567
"41035971100",4297,585,11,0,278,108,601,53,5933
"41035971200",1379,514,0,51,160,308,91,275,2778
"41035971300",4945,532,0,74,101,55,716,28,6451
"41035971400",4134,444,39,24,241,161,678,123,5844
"41035971500",2611,688,0,16,618,138,403,90,4564
"41035971600",1612,1004,72,25,771,166,503,281,4434
"41035971700",1696,790,7,0,267,173,291,194,3418
"41035971800",1524,628,0,30,162,150,134,53,2681
"41035971900",2350,721,27,0,231,137,227,90,3783
"41035972000",3080,609,25,0,207,46,185,158,4310
"41037960100",2011,376,0,15,106,31,91,10,2640
"41037960200",3454,853,0,19,404,71,329,117,5247
"41039000100",4309,536,12,0,323,87,281,14,5562
"41039000200",4142,536,3,0,258,84,54,18,5095
"41039000300",1831,177,14,17,168,15,94,0,2316
"41039000402",3021,286,9,0,217,0,268,38,3839
"41039000403",4058,769,0,0,101,42,16,35,5021
"41039000404",2423,624,28,0,287,113,232,150,3857
"41039000500",1364,391,6,0,84,19,51,4,1919
"41039000702",2000,375,8,0,116,142,51,0,2692
"41039000705",2976,423,0,2,158,25,60,9,3653
"41039000706",1976,466,0,0,65,53,74,19,2653
"41039000707",3110,534,56,0,174,3,10,3,3890
"41039000708",1382,465,0,0,116,14,11,0,1988
"41039000800",1298,118,7,0,85,13,47,4,1572
"41039000902",3522,618,0,0,275,61,84,0,4560
"41039000903",3721,1022,31,1,431,108,325,129,5768
"41039000904",2058,549,0,4,90,23,43,74,2841
"41039001001",1821,222,0,0,160,20,26,8,2257
"41039001002",3389,393,11,7,378,83,281,98,4640
"41039001101",5006,386,0,0,392,30,293,0,6107
"41039001102",2832,232,0,16,170,123,139,55,3567
"41039001201",3025,352,0,0,152,211,374,272,4386
"41039001202",3187,595,3,0,106,175,242,15,4323
"41039001301",2468,706,0,0,147,108,59,7,3495
"41039001302",3806,763,0,0,208,170,342,39,5328
"41039001400",2069,217,0,0,206,12,109,18,2631
"41039001500",3484,839,0,0,174,3,108,19,4627
"41039001600",3915,834,19,0,177,127,171,6,5249
"41039001700",4714,505,0,0,332,37,62,19,5669
"41039001801",4747,664,19,13,367,76,347,96,6329
"41039001803",3574,563,28,60,243,65,145,60,4738
"41039001804",3041,367,0,0,170,22,155,0,3755
"41039001902",4995,1349,97,43,439,145,818,334,8220
"41039001903",1885,603,0,0,143,98,177,32,2938
"41039001904",3303,613,19,29,585,211,1128,192,6080
"41039002001",2538,529,2,0,207,18,297,120,3711
"41039002002",3911,484,40,0,242,129,279,0,5085
"41039002101",1864,535,0,45,89,26,250,67,2876
"41039002102",4196,1567,0,0,573,312,398,171,7217
"41039002201",3115,272,11,1,261,6,160,8,3834
"41039002202",4622,644,13,0,508,27,137,0,5951
"41039002301",2573,659,0,31,179,206,86,129,3863
"41039002302",3670,617,12,8,506,110,694,121,5738
"41039002401",3057,430,69,0,406,12,101,0,4075
"41039002403",3422,174,39,0,383,8,70,0,4096
"41039002404",3139,456,14,0,542,17,279,23,4470
"41039002501",3718,760,247,43,233,68,294,352,5715
"41039002503",5895,908,201,0,1268,71,983,368,9694
"41039002504",2550,394,0,0,246,115,539,156,4000
"41039002600",4280,622,131,19,697,74,1047,49,6919
"41039002700",2549,874,87,10,446,19,236,96,4317
"41039002800",3314,609,0,3,303,34,353,108,4724
"41039002902",2729,439,44,28,333,180,59,130,3942
"41039002903",2102,124,31,0,252,53,138,7,2707
"41039002904",2368,427,63,5,277,48,23,0,3211
"41039003000",3862,206,69,14,251,23,120,10,4555
"41039003101",3964,957,12,0,771,242,93,119,6158
"41039003102",3493,1603,45,16,575,1098,188,200,7218
"41039003201",1756,802,29,21,183,212,139,229,3371
"41039003202",2595,663,16,57,205,16,386,172,4110
"41039003301",1853,995,0,19,288,78,242,93,3568
"41039003302",1991,752,0,25,232,246,37,288,3571
"41039003400",3443,1038,61,9,518,58,597,228,5952
"41039003500",3443,205,0,0,441,89,290,83,4551
"41039003600",2373,484,21,11,420,87,119,0,3515
"41039003700",641,792,19,81,66,165,14,122,1900
"41039003800",1029,4148,142,0,79,816,18,319,6551
"41039003900",1150,781,39,18,114,312,73,79,2566
"41039004000",1287,787,27,69,161,97,83,189,2700
"41039004100",2930,537,30,0,283,180,162,161,4283
"41039004200",1570,1289,49,37,391,271,418,111,4136
"41039004300",4350,1909,67,43,374,428,777,658,8606
"41039004401",3650,795,150,105,525,73,621,95,6014
"41039004403",2592,1343,0,10,611,254,420,69,5299
"41039004404",2533,289,21,0,295,6,77,0,3221
"41039004405",3840,370,33,0,419,16,188,8,4874
"41039004501",1726,723,0,0,191,153,169,9,2971
"41039004502",2284,963,7,26,159,77,254,194,3964
"41039004600",1952,523,0,0,281,0,118,41,2915
"41039004700",2796,1083,44,10,79,180,174,132,4498
"41039004800",1594,2077,109,118,231,804,156,162,5251
"41039004900",2632,962,43,6,392,247,105,104,4491
"41039005000",3377,808,0,0,498,76,374,4,5137
"41039005100",2068,487,11,165,387,86,257,116,3577
"41039005200",1691,146,0,0,150,24,104,21,2136
"41039005300",2014,180,22,0,143,38,137,15,2549
"41039005400",4726,172,29,0,667,75,333,20,6022
"41039990000",0,0,0,0,0,0,0,0,0
"41041950100",2719,400,0,0,233,47,177,22,3598
"41041950303",1064,213,0,0,55,111,45,17,1505
"41041950304",2225,497,0,10,474,94,462,84,3846
"41041950400",3027,680,0,0,200,79,173,176,4335
"41041950601",1515,397,0,3,244,1,21,1,2182
"41041950602",1970,263,0,0,73,51,51,84,2492
"41041950800",2412,686,13,0,295,65,207,88,3766
"41041950900",2574,301,0,0,639,151,642,139,4446
"41041951000",1216,345,29,24,130,125,170,127,2166
"41041951100",1181,192,0,0,250,0,296,14,1933
"41041951200",1489,181,0,0,65,14,53,0,1802
"41041951300",1695,265,0,0,118,5,79,0,2162
"41041951400",2150,573,0,0,132,4,157,0,3016
"41041951500",2046,430,0,0,77,0,74,8,2635
"41041951600",2669,422,0,0,108,25,146,8,3378
"41041951700",1486,280,0,23,119,70,102,54,2134
"41041951800",2445,406,33,0,894,321,48,68,4215
"41041990100",0,0,0,0,0,0,0,0,0
"41043020100",7000,2105,0,0,726,114,444,1188,11577
"41043020200",1590,228,9,0,82,33,62,6,2010
"41043020300",6229,476,48,0,621,53,414,131,7972
"41043020400",2458,1189,0,0,491,117,448,345,5048
"41043020500",2484,963,0,0,84,131,269,211,4142
"41043020600",7319,792,95,0,136,184,727,208,9461
"41043020700",4080,1244,0,0,560,58,420,79,6441
"41043020801",1474,637,0,7,197,165,359,126,2965
"41043020802",3124,2061,171,27,317,537,792,547,7576
"41043030100",4697,745,10,0,330,101,204,52,6139
"41043030200",5590,751,6,0,291,29,214,96,6977
"41043030300",1667,286,0,0,119,5,142,0,2219
"41043030401",4362,1507,0,24,277,77,228,0,6475
"41043030402",5200,1300,0,0,261,39,81,14,6895
"41043030500",3226,448,18,0,128,3,101,0,3924
"41043030600",5651,813,0,0,285,246,337,445,7777
"41043030700",2943,338,16,0,111,26,230,7,3671
"41043030800",5701,1288,16,0,230,87,47,71,7440
"41043030902",6828,641,33,0,151,14,197,11,7875
"41043030903",4528,1225,0,0,174,86,43,95,6151
"41043030904",3061,948,19,0,341,53,357,25,4804
"41045940000",0,0,0,0,0,0,0,0,0
"41045970200",2821,743,16,0,460,366,756,873,6035
"41045970300",2761,1178,27,0,184,215,885,513,5763
"41045970400",2294,1119,0,26,474,426,1292,892,6523
"41045970500",3453,1078,38,34,360,134,1614,860,7571
"41045970600",3010,900,7,0,336,11,624,240,5128
"41045970700",1278,152,0,0,116,34,221,7,1808
"41045970900",2262,421,14,2,192,26,224,61,3202
"41047000200",1425,435,0,0,143,100,78,36,2217
"41047000300",2683,839,79,18,618,635,609,677,6158
"41047000400",2205,1508,32,19,589,660,982,846,6841
"41047000501",1895,447,163,0,1236,410,1320,225,5696
"41047000502",1725,955,24,53,474,1688,719,1702,7340
"41047000600",3622,596,22,0,324,69,521,138,5292
"41047000701",2720,890,64,109,779,949,1220,586,7317
"41047000900",3129,1348,11,12,1577,192,1912,219,8400
"41047001000",1910,1310,0,0,673,168,627,609,5297
"41047001100",3216,540,65,17,354,178,370,113,4853
"41047001200",2498,706,25,0,164,59,174,77,3703
"41047001300",3158,388,25,0,375,63,239,55,4303
"41047001401",4026,1189,0,10,684,9,719,160,6797
"41047001402",4762,383,88,0,576,133,1255,150,7347
"41047001501",3529,457,24,0,545,78,584,171,5388
"41047001502",3372,786,46,0,800,234,1161,400,6799
"41047001503",2692,674,0,83,598,275,822,387,5531
"41047001601",5099,542,0,0,1142,688,1854,926,10251
"41047001602",3921,1603,45,44,2443,1068,3029,1734,13887
"41047001603",5375,530,64,0,1135,65,2347,107,9623
"41047001604",4388,791,90,177,1905,534,2687,399,10971
"41047001701",3676,1388,0,0,1080,835,1985,1454,10418
"41047001702",2992,931,37,14,1218,206,1567,568,7533
"41047001703",3720,373,12,0,322,94,994,163,5678
"41047001801",3600,897,96,37,1282,575,2089,726,9302
"41047001802",4019,1225,18,254,2311,358,2954,484,11623
"41047001803",2327,503,39,9,239,14,611,165,3907
"41047002000",8204,623,35,54,833,444,1238,122,11553
"41047002101",1783,219,0,0,115,34,132,22,2305
"41047002102",5321,225,23,0,399,172,1149,25,7314
"41047002201",1583,297,39,0,121,8,119,0,2167
"41047002202",5146,547,50,0,637,10,433,3,6826
"41047002301",2585,217,0,0,332,48,145,41,3368
"41047002303",5523,1159,282,0,433,68,279,53,7797
"41047002304",4829,160,19,0,384,101,267,18,5778
"41047002400",3030,373,0,0,127,0,47,0,3577
"41047002501",7530,733,20,0,757,114,822,19,9995
"41047002502",4005,516,25,14,639,124,920,260,6503
"41047002600",1846,202,0,0,11,31,201,78,2369
"41047002700",7662,568,4,0,408,20,611,65,9338
"41047002800",3210,366,44,0,274,92,314,61,4361
"41047010100",1193,121,0,0,165,46,151,55,1731
"41047010201",2137,191,63,0,188,51,501,73,3204
"41047010202",6240,537,0,0,441,419,1380,514,9531
"41047010303",3260,751,8,17,896,222,1954,481,7589
"41047010304",3537,1709,49,0,1099,176,3019,1632,11221
"41047010305",2192,834,12,24,730,366,1776,1098,7032
"41047010306",3676,2690,0,0,1520,1033,2306,3003,14228
"41047010307",4231,704,0,0,653,55,1213,299,7155
"41047010400",3519,433,0,8,659,68,1068,176,5931
"41047010501",5102,306,0,0,86,35,355,22,5906
"41047010502",4849,866,0,0,700,110,530,72,7127
"41047010503",3274,351,30,0,119,47,392,23,4236
"41047010600",1682,187,0,0,279,12,228,2,2390
"41047010701",5898,1277,0,0,670,358,1163,162,9528
"41047010702",4881,671,2,0,459,0,258,31,6302
"41047010801",4735,809,0,0,698,110,797,128,7277
"41047010802",4930,1136,0,0,732,150,885,339,8172
"41049970100",5433,1247,49,0,1184,167,2721,967,11768
"41049970200",2515,416,0,0,117,14,55,31,3148
"41051000100",4928,548,0,0,510,51,241,51,6329
"41051000200",4934,686,14,12,484,288,310,191,6919
"41051000301",3334,774,44,1,350,105,251,68,4927
"41051000302",5933,511,0,0,512,0,210,0,7166
"41051000401",3101,355,30,0,282,14,84,24,3890
"41051000402",2454,224,0,0,403,47,94,0,3222
"41051000501",2511,447,0,0,595,248,114,106,4021
"41051000502",2909,726,133,10,822,195,325,138,5258
"41051000601",3122,964,140,8,914,500,733,470,6851
"41051000602",3475,470,105,99,1355,147,1097,171,6919
"41051000701",3282,314,40,236,605,348,191,182,5198
"41051000702",3047,431,111,94,753,103,263,96,4898
"41051000801",3438,417,142,0,401,74,156,61,4689
"41051000802",3281,649,53,16,507,87,279,107,4979
"41051000901",2894,554,15,0,476,155,74,27,4195
"41051000902",2765,541,123,407,219,303,212,84,4654
"41051001000",4136,961,20,39,333,85,519,55,6148
"41051001101",1078,641,19,46,124,154,26,60,2148
"41051001102",1110,234,16,6,202,23,72,35,1698
"41051001201",3909,688,93,0,230,140,126,92,5278
"41051001202",2763,233,0,16,416,8,92,0,3528
"41051001301",2822,498,19,0,512,30,256,28,4165
"41051001302",2543,143,1,10,348,16,149,0,3210
"41051001400",3785,326,58,122,615,61,295,12,5274
"41051001500",2934,184,0,0,172,8,70,17,3385
"41051001601",4443,357,49,4,543,29,321,72,5818
"41051001602",2308,535,339,226,678,519,373,143,5121
"41051001701",4475,636,113,185,810,248,312,100,6879
"41051001702",2436,514,140,95,737,309,247,97,4575
"41051001801",3081,429,59,47,432,187,199,88,4522
"41051001802",2863,266,18,9,305,99,94,0,3654
"41051001900",4154,218,10,0,323,19,147,0,4871
"41051002000",4064,1131,67,19,546,62,342,78,6309
"41051002100",1430,354,46,21,162,99,59,0,2171
"41051002203",2011,460,316,280,312,41,129,67,3616
"41051002303",1071,393,96,171,224,82,32,49,2118
"41051002401",2440,157,131,4,122,0,54,0,2908
"41051002402",2642,303,52,203,299,53,106,37,3695
"41051002501",4030,165,51,0,386,2,128,16,4778
"41051002502",3391,321,68,0,410,18,423,36,4667
"41051002600",2679,100,39,0,186,9,182,11,3206
"41051002701",2726,220,5,0,406,0,134,0,3491
"41051002702",2272,295,38,57,216,56,160,47,3141
"41051002801",2454,168,50,0,361,0,60,0,3093
"41051002802",2438,162,97,0,303,9,22,10,3041
"41051002901",3588,203,34,8,515,102,347,1,4798
"41051002902",3697,498,284,0,700,73,224,48,5524
"41051002903",2942,443,305,254,746,392,306,126,5514
"41051003000",3525,335,199,0,494,50,145,0,4748
"41051003100",3851,364,129,60,381,87,168,68,5108
"41051003200",2817,452,324,0,282,46,80,20,4021
"41051003301",2086,229,386,94,189,280,266,167,3697
"41051003302",1663,447,492,82,203,71,267,113,3338
"41051003401",1613,450,541,391,290,71,61,105,3522
"41051003402",2272,324,510,304,377,62,364,117,4330
"41051003501",2450,276,137,217,340,103,254,112,3889
"41051003502",1619,240,43,66,186,27,62,14,2257
"41051003601",2646,574,1005,59,300,84,309,28,5005
"41051003602",3712,393,1070,162,432,166,336,114,6385
"41051003603",939,62,189,47,258,10,59,0,1564
"41051003701",2186,326,406,304,653,47,575,23,4520
"41051003702",1855,369,296,50,120,33,34,45,2802
"41051003801",2205,221,80,10,170,249,75,7,3017
"41051003802",2229,353,86,0,428,313,180,296,3885
"41051003803",2595,446,342,256,500,43,407,77,4666
"41051003901",4066,1066,844,514,1100,44,830,79,8543
"41051003902",2576,145,149,17,290,45,52,42,3316
"41051004001",3894,1536,911,950,437,730,1066,720,10244
"41051004002",2843,961,69,23,403,195,225,37,4756
"41051004101",4697,475,214,167,705,348,858,167,7631
"41051004102",3412,689,101,53,625,564,421,595,6460
"41051004200",2240,429,63,101,423,97,315,143,3811
"41051004300",848,59,3,5,116,27,49,0,1107
"41051004500",1838,95,0,0,134,91,100,33,2291
"41051004601",2703,80,9,0,304,39,146,31,3312
"41051004602",1727,108,0,0,134,30,89,0,2088
"41051004700",3752,322,17,50,446,37,344,73,5041
"41051004800",2059,620,33,0,419,19,193,0,3343
"41051004900",2148,512,47,221,245,256,180,143,3752
"41051005000",2399,192,9,0,260,39,122,11,3032
"41051005100",4935,1306,146,212,489,147,313,49,7597
"41051005200",2891,864,150,40,331,211,244,68,4799
"41051005500",1240,780,71,55,454,286,149,55,3090
"41051005600",1997,896,81,67,333,420,223,56,4073
"41051005700",2360,416,90,17,856,108,226,82,4155
"41051005800",3874,667,143,83,602,92,200,0,5661
"41051005900",5196,721,40,134,823,79,254,70,7317
"41051006001",1134,106,15,20,111,35,45,0,1466
"41051006002",1751,146,97,6,206,35,66,0,2307
"41051006100",1979,142,28,3,96,5,63,37,2353
"41051006200",2475,241,38,0,213,55,70,0,3092
"41051006300",3070,352,21,0,357,54,174,18,4046
"41051006402",5071,186,0,0,598,6,166,0,6027
"41051006403",2947,218,331,313,394,60,75,12,4350
"41051006404",2603,142,47,0,485,16,66,10,3369
"41051006501",5156,468,28,52,367,15,68,52,6206
"41051006502",3667,363,0,2,347,104,217,0,4700
"41051006601",2251,148,4,0,129,29,79,0,2640
"41051006602",4042,968,39,0,352,56,236,56,5749
"41051006701",2619,165,28,26,374,11,88,11,3322
"41051006702",2392,317,111,8,405,26,247,11,3517
"41051006801",1796,269,54,6,327,48,121,16,2637
"41051006802",2932,266,27,20,237,0,133,34,3649
"41051006900",2277,114,16,5,255,0,58,0,2725
"41051007000",6001,404,91,0,1690,47,256,0,8489
"41051007100",2018,157,0,0,190,25,39,0,2429
"41051007201",1535,206,35,0,114,12,99,19,2020
"41051007202",1674,208,442,8,766,127,286,23,3534
"41051007300",262,167,9,20,148,30,118,73,827
"41051007400",1485,627,357,586,437,508,241,730,4971
"41051007500",2853,1031,629,94,787,184,465,550,6593
"41051007600",1805,607,105,156,478,327,710,709,4897
"41051007700",1508,205,40,63,364,52,482,29,2743
"41051007800",1124,156,94,92,267,184,205,99,2221
"41051007900",2231,566,371,56,890,239,368,94,4815
"41051008001",2325,395,21,30,551,87,241,222,3872
"41051008002",2099,171,169,0,648,117,156,23,3383
"41051008100",3566,890,580,392,1241,781,1045,457,8952
"41051008201",1745,248,44,0,555,258,239,43,3132
"41051008202",4350,1214,179,413,1601,1312,926,1177,11172
"41051008301",1336,457,368,386,1034,703,241,87,4612
"41051008302",1624,707,23,166,1294,401,490,294,4999
"41051008400",2552,668,167,118,611,404,648,281,5449
"41051008500",2250,825,46,77,751,196,438,131,4714
"41051008600",2555,1070,0,80,358,132,634,634,5463
"41051008700",2684,739,17,27,1041,59,441,91,5099
"41051008800",3415,485,80,2,547,101,446,103,5179
"41051008901",6028,472,279,311,1814,386,488,230,10008
"41051008902",2385,448,24,12,723,177,302,160,4231
"41051009000",4824,1834,385,465,1892,949,1206,598,12153
"41051009101",2526,968,164,207,543,1479,266,818,6971
"41051009102",3743,937,61,103,776,466,460,208,6754
"41051009201",4433,1168,188,190,1348,482,483,90,8382
"41051009202",2679,533,327,90,1110,205,319,158,5421
"41051009301",3902,832,399,122,1240,305,1774,422,8996
"41051009302",2312,400,257,108,1090,173,353,126,4819
"41051009400",4799,705,301,61,1101,146,790,304,8207
"41051009501",2198,552,448,400,892,267,158,255,5170
"41051009502",2041,623,322,401,708,190,439,311,5035
"41051009603",2507,403,92,3,700,124,835,86,4750
"41051009604",2255,1140,155,495,680,641,843,707,6916
"41051009605",2841,1012,818,123,512,283,347,326,6262
"41051009606",2337,1166,249,130,992,697,860,1165,7596
"41051009701",2745,1553,173,115,1080,303,546,305,6820
"41051009702",3671,1702,178,531,1913,391,1222,253,9861
"41051009801",1886,977,59,268,358,679,626,898,5751
"41051009803",4148,1523,266,19,1280,465,1121,1172,9994
"41051009804",2075,671,61,100,253,139,373,323,3995
"41051009903",4556,94,14,0,1186,18,69,1,5938
"41051009904",2485,745,16,18,176,24,132,531,4127
"41051009905",2468,52,13,7,354,153,175,0,3222
"41051009906",2666,250,39,44,200,31,160,49,3439
"41051009907",4077,264,14,12,507,152,555,0,5581
"41051010001",3626,1255,35,23,439,240,718,498,6834
"41051010002",3493,763,53,21,924,68,522,137,5981
"41051010100",6371,955,109,499,953,249,710,681,10527
"41051010200",4057,846,110,7,780,301,677,515,7293
"41051010303",3352,820,222,53,908,34,800,242,6431
"41051010304",2211,1134,164,40,607,523,622,895,6196
"41051010305",3365,384,35,0,209,167,48,10,4218
"41051010306",3518,593,81,115,442,24,264,10,5047
"41051010402",5383,279,73,28,445,56,380,0,6644
"41051010405",4637,573,218,27,455,52,1055,67,7084
"41051010407",3780,984,29,94,752,122,740,336,6837
"41051010408",4023,1127,18,0,554,140,668,474,7004
"41051010409",6685,600,282,0,768,33,793,372,9533
"41051010410",2551,1193,29,21,933,73,505,214,5519
"41051010411",2444,261,60,41,238,163,416,57,3680
"41051010500",3435,293,48,35,341,17,320,27,4516
"41051010600",956,968,95,112,200,93,36,129,2589
"41051980000",0,0,0,0,0,0,0,0,0
"41053005100",1226,655,64,0,381,111,459,157,3053
"41053005201",7133,644,45,0,1113,46,1188,183,10352
"41053005202",7887,474,146,0,1047,170,1151,0,10875
"41053005300",7547,632,34,0,339,363,561,445,9921
"41053020202",4348,1298,0,0,257,17,142,213,6275
"41053020203",1825,846,12,0,116,69,38,19,2925
"41053020204",4097,510,0,11,523,7,428,7,5583
"41053020302",6370,1494,42,0,1038,481,2000,661,12086
"41053020303",1681,1065,0,17,249,277,101,282,3672
"41053020304",4606,1469,62,39,443,278,862,155,7914
"41053020400",4071,737,15,0,712,190,115,28,5868
"41053020500",5307,364,0,0,478,6,424,25,6604
"41055950100",1333,312,7,3,65,71,64,64,1919
"41057960100",2614,562,13,0,94,19,111,356,3769
"41057960200",1814,354,7,0,56,50,86,8,2375
"41057960300",2155,232,0,0,228,0,106,3,2724
"41057960400",5107,1187,0,0,697,136,577,134,7838
"41057960500",1439,410,0,0,129,287,143,353,2761
"41057960600",2080,356,0,0,127,7,150,66,2786
"41057960700",1999,313,0,0,31,0,11,52,2406
"41057960800",1802,389,16,0,10,8,103,148,2476
"41057990100",0,0,0,0,0,0,0,0,0
"41059940000",1183,169,0,0,1028,455,154,47,3036
"41059950100",3600,299,9,0,306,37,222,13,4486
"41059950200",4317,1929,0,15,916,497,2120,1487,11281
"41059950300",2223,342,4,0,90,103,72,2,2836
"41059950400",4149,493,23,0,189,21,192,76,5143
"41059950500",3544,521,15,0,218,126,237,0,4661
"41059950600",4409,709,131,0,683,168,563,0,6663
"41059950700",1894,313,44,0,176,85,225,71,2808
"41059950800",4871,649,0,0,314,102,2400,264,8600
"41059950900",2385,570,0,19,780,46,1456,236,5492
"41059951000",3577,1407,13,13,950,172,1638,570,8340
"41059951100",4989,602,0,0,249,32,1509,112,7493
"41059951200",5957,1396,0,0,1096,609,2677,1340,13075
"41059951300",2938,478,6,0,465,38,743,157,4825
"41059951400",1801,289,0,0,122,29,112,48,2401
"41061970100",2503,391,0,0,108,40,69,9,3120
"41061970200",2468,599,17,0,132,100,48,90,3454
"41061970300",2175,182,0,4,66,29,61,0,2517
"41061970400",2285,431,0,5,127,38,158,136,3180
"41061970500",2725,564,6,0,139,28,36,56,3554
"41061970600",2851,544,43,39,278,34,101,37,3927
"41061970700",1430,636,32,0,232,155,71,42,2598
"41061970800",2631,775,3,0,101,47,104,17,3678
"41063960100",1375,331,10,0,137,0,58,9,1920
"41063960200",1456,305,0,0,44,1,24,19,1849
"41063960300",2630,371,0,11,72,14,67,6,3171
"41065970100",3149,502,0,0,400,72,648,115,4886
"41065970200",2219,282,0,23,227,24,309,5,3089
"41065970300",2306,270,52,0,425,41,633,0,3727
"41065970400",2195,748,62,0,118,0,400,416,3939
"41065970500",2057,518,0,0,336,63,479,36,3489
"41065970600",1786,546,0,0,177,55,280,8,2852
"41065970700",1519,60,0,0,121,89,384,89,2262
"41065970800",2894,579,20,0,913,143,278,102,4929
"41067030101",6529,481,107,0,759,17,394,4,8291
"41067030102",4492,230,55,0,855,68,224,63,5987
"41067030200",5494,227,365,25,658,135,238,135,7277
"41067030300",4074,107,49,10,287,44,159,20,4750
"41067030401",3544,486,57,4,375,121,226,301,5114
"41067030402",3367,405,103,0,594,29,230,1,4729
"41067030501",3614,457,41,0,353,220,436,306,5427
"41067030502",3104,289,11,78,463,80,272,54,4351
"41067030600",4445,331,79,0,437,14,446,0,5752
"41067030700",972,332,13,0,186,6,185,0,1694
"41067030801",4883,485,68,62,974,377,856,482,8187
"41067030803",3991,422,50,0,304,259,377,104,5507
"41067030805",3103,109,43,24,190,36,122,31,3658
"41067030806",2015,406,16,8,196,48,290,133,3112
"41067030900",3035,781,314,79,361,402,317,448,5737
"41067031003",5310,505,77,0,974,694,463,420,8443
"41067031004",5447,291,222,0,956,147,276,10,7349
"41067031005",3285,882,0,0,856,572,1215,1039,7849
"41067031006",4070,842,204,0,421,630,430,479,7076
"41067031100",1464,220,129,41,285,232,601,169,3141
"41067031200",4188,835,48,0,1552,1334,1358,1369,10684
"41067031300",4922,1160,72,56,1260,339,1973,718,10500
"41067031402",1304,516,56,44,896,173,456,104,3549
"41067031403",2773,407,82,0,1247,257,693,181,5640
"41067031404",3475,403,97,0,618,236,538,227,5594
"41067031504",4777,199,167,0,945,211,497,80,6876
"41067031506",2927,345,7,26,491,184,115,119,4214
"41067031507",3907,292,134,52,1264,2,130,2,5783
"41067031508",5312,300,0,0,1859,186,126,0,7783
"41067031509",2444,225,0,0,914,120,239,80,4022
"41067031511",2042,86,64,0,738,16,362,13,3321
"41067031512",5058,239,211,1,2325,102,469,35,8440
"41067031513",6105,50,115,0,6218,76,494,16,13074
"41067031514",4173,129,256,0,1973,0,284,12,6827
"41067031606",3923,772,178,233,1606,183,1746,266,8907
"41067031609",5593,833,222,125,2033,932,1172,727,11637
"41067031610",4846,901,202,86,1748,398,1486,574,10241
"41067031611",3364,607,163,52,3389,65,438,37,8115
"41067031612",1549,621,256,7,1206,32,529,292,4492
"41067031613",3771,652,15,210,1627,541,1190,432,8438
"41067031614",3283,169,270,0,1416,148,735,46,6067
"41067031615",3539,537,50,6,1020,301,1191,455,7099
"41067031616",2325,115,48,0,1041,31,752,88,4400
"41067031617",2462,198,64,0,2057,42,308,55,5186
"41067031703",3216,487,10,24,982,298,1061,223,6301
"41067031704",6531,578,280,0,1458,342,1356,465,11010
"41067031705",2645,1041,252,111,1352,120,1341,511,7373
"41067031706",2934,804,120,0,1120,692,1292,678,7640
"41067031804",4115,409,0,0,1461,80,1016,38,7119
"41067031805",5181,257,158,0,1562,121,853,62,8194
"41067031806",4112,176,160,73,1049,231,623,227,6651
"41067031807",2725,339,52,0,401,43,227,31,3818
"41067031812",4102,381,145,0,735,457,469,59,6348
"41067031813",4042,296,429,0,882,56,189,118,6012
"41067031814",2690,167,105,2,889,8,263,8,4132
"41067031815",5016,460,91,0,1388,49,441,75,7520
"41067031904",2375,166,23,0,433,12,197,0,3206
"41067031907",4997,472,17,0,304,16,63,126,5995
"41067031908",5676,228,0,0,1018,515,731,0,8168
"41067031909",3777,60,20,0,853,59,128,0,4897
"41067031910",6390,554,54,0,1639,102,808,104,9651
"41067031911",3608,313,134,8,863,161,284,143,5514
"41067031912",3837,458,0,0,379,14,329,227,5244
"41067032001",4735,528,97,0,239,98,722,231,6650
"41067032003",2555,516,86,0,275,142,722,10,4306
"41067032004",1838,157,32,0,71,8,322,88,2516
"41067032005",2132,1235,10,16,464,182,856,822,5717
"41067032103",8565,694,51,12,964,188,567,106,11147
"41067032104",4440,121,0,0,323,38,273,36,5231
"41067032107",1928,27,0,0,215,19,225,0,2414
"41067032108",3476,206,177,8,319,66,395,147,4794
"41067032109",2677,158,13,0,168,0,252,53,3321
"41067032110",1724,165,0,0,240,6,45,0,2180
"41067032200",6289,320,26,0,749,0,583,93,8060
"41067032300",3610,311,172,102,750,267,627,196,6035
"41067032404",5367,451,0,22,649,73,615,145,7322
"41067032406",6077,395,55,16,1183,483,339,244,8792
"41067032407",4527,241,0,0,948,80,757,155,6708
"41067032408",4263,346,0,0,2493,141,564,2,7809
"41067032409",2546,1811,0,11,579,632,1774,2057,9410
"41067032410",2578,357,28,0,970,384,1384,554,6255
"41067032501",1626,452,0,46,465,277,825,244,3935
"41067032502",2046,385,77,0,445,84,217,167,3421
"41067032503",2506,380,17,17,588,218,504,438,4668
"41067032603",5441,551,76,2,1130,311,793,582,8886
"41067032604",3986,574,18,56,725,376,1204,505,7444
"41067032606",5375,862,0,0,627,96,2098,508,9566
"41067032607",2592,97,20,2,862,94,303,1,3971
"41067032608",1712,56,11,0,466,89,301,0,2635
"41067032609",1554,37,43,0,859,0,254,4,2751
"41067032610",1880,150,50,3,953,194,930,78,4238
"41067032700",4022,423,0,0,377,11,421,54,5308
"41067032800",1073,174,14,0,26,12,17,81,1397
"41067032901",3694,602,2,12,1345,207,1828,425,8115
"41067032902",6205,347,0,32,522,410,3671,384,11571
"41067033000",4082,322,14,0,906,90,704,67,6185
"41067033101",2284,556,1,0,209,21,391,41,3503
"41067033102",2257,335,0,0,532,17,1029,77,4247
"41067033200",3386,879,74,0,1000,709,1346,795,8189
"41067033301",4629,704,0,0,486,291,735,518,7363
"41067033302",4483,296,71,0,192,20,326,29,5417
"41067033400",1952,132,0,7,218,37,50,0,2396
"41067033500",3371,132,12,0,261,34,150,7,3967
"41067033600",1883,168,17,0,69,51,7,38,2233
"41069960100",1038,242,0,0,31,8,16,0,1335
"41071030101",4912,515,0,0,277,48,500,35,6287
"41071030102",6331,352,0,0,368,1,432,50,7534
"41071030201",3439,1053,20,44,508,145,589,312,6110
"41071030202",3175,1699,1,4,789,837,435,1132,8072
"41071030301",7985,917,43,0,786,176,1148,277,11332
"41071030302",1746,201,0,0,69,0,40,0,2056
"41071030400",7004,290,0,0,321,8,288,0,7911
"41071030501",3625,571,7,0,162,92,119,80,4656
"41071030502",3229,582,30,0,599,62,320,11,4833
"41071030601",2448,527,0,0,334,2,748,127,4186
"41071030602",4795,970,100,0,375,0,648,261,7149
"41071030701",5976,1221,0,21,171,289,409,816,8903
"41071030702",5140,1462,158,0,788,237,1481,344,9610
"41071030801",3505,711,10,0,450,86,805,307,5874
"41071030802",1873,1205,21,162,679,120,1061,367,5488
"41071030900",3715,520,96,0,530,91,942,280,6174
"41071031000",2948,580,0,0,381,76,464,53,4502
"42001030101",2379,72,18,0,99,18,99,18,2703
"42001030102",5527,188,0,0,84,0,241,31,6071
"42001030200",4107,477,32,0,281,290,465,301,5953
"42001030300",3510,278,47,22,222,100,206,112,4497
"42001030400",4713,551,8,0,270,65,303,65,5975
"42001030500",3076,303,14,0,225,104,428,139,4289
"42001030600",3668,364,0,2,302,109,249,108,4802
"42001030700",5659,390,56,15,107,311,183,402,7123
"42001030800",6246,473,70,10,261,57,236,100,7453
"42001030900",5939,787,134,7,402,255,383,484,8391
"42001031000",1663,234,7,0,8,0,0,0,1912
"42001031101",4286,161,0,34,282,66,215,0,5044
"42001031102",3129,38,0,0,160,7,81,7,3422
"42001031201",3353,53,32,0,157,0,75,0,3670
"42001031202",2573,139,0,0,0,0,0,0,2712
"42001031203",3074,60,0,0,23,0,57,0,3214
"42001031300",3837,384,25,18,150,10,31,34,4489
"42001031401",3136,219,222,0,162,189,61,161,4150
"42001031402",1796,129,31,0,39,0,44,4,2043
"42001031501",679,343,72,9,68,1,33,16,1221
"42001031502",2415,343,200,157,279,383,330,320,4427
"42001031600",6656,213,23,0,208,0,262,3,7365
"42001031700",2334,244,7,17,135,16,45,11,2809
"42003010300",257,115,110,21,83,2,5,11,604
"42003020100",1914,460,175,115,235,35,48,8,2990
"42003020300",591,30,59,0,65,2,9,0,756
"42003030500",113,103,1145,619,61,184,37,81,2343
"42003040200",139,148,531,306,75,103,6,4,1312
"42003040400",810,360,20,188,229,429,49,40,2125
"42003040500",601,2022,9,95,105,152,51,40,3075
"42003040600",532,1205,135,21,172,128,53,28,2274
"42003040900",910,1171,285,61,198,247,16,24,2912
"42003050100",185,29,890,561,80,10,0,0,1755
"42003050600",243,13,989,414,39,166,7,0,1871
"42003050900",0,56,361,878,0,46,0,35,1376
"42003051000",101,121,361,445,11,74,0,25,1138
"42003051100",0,0,86,241,0,0,0,0,327
"42003060300",1526,470,271,96,82,127,142,10,2724
"42003060500",1059,150,67,18,33,4,45,7,1383
"42003070300",1440,191,93,0,117,23,32,8,1904
"42003070500",1992,327,59,24,357,347,98,15,3219
"42003070600",1546,163,20,1,244,135,55,7,2171
"42003070800",1073,220,29,25,292,211,43,58,1951
"42003070900",1711,456,66,108,1055,639,22,23,4080
"42003080200",1310,271,89,21,15,4,92,0,1802
"42003080400",885,340,22,46,84,174,17,43,1611
"42003080600",1616,188,66,35,118,9,0,0,2032
"42003080700",1003,155,199,28,258,186,106,0,1935
"42003080900",1124,204,132,82,72,25,13,0,1652
"42003090100",1254,297,136,15,76,9,54,17,1858
"42003090200",2177,271,139,40,138,43,111,10,2929
"42003090300",1157,304,157,0,19,15,11,5,1668
"42003100500",435,146,1179,309,43,96,0,11,2219
"42003101100",1871,364,204,133,74,107,30,23,2806
"42003101400",2461,232,313,79,106,60,67,52,3370
"42003101600",12,14,495,453,16,0,0,11,1001
"42003101700",269,133,616,451,49,21,27,0,1566
"42003101800",1925,43,445,0,49,43,26,0,2531
"42003110200",2390,136,1224,173,98,213,134,60,4428
"42003110600",1842,234,293,19,116,12,49,0,2565
"42003111300",696,207,1044,179,154,47,37,104,2468
"42003111400",134,31,627,392,118,85,17,22,1426
"42003111500",658,107,1117,796,268,63,1,23,3033
"42003120300",45,0,1100,446,72,122,13,65,1863
"42003120400",20,10,367,298,25,0,13,0,733
"42003120700",0,5,578,178,80,9,2,8,860
"42003120800",34,27,576,125,0,11,0,0,773
"42003130100",0,15,864,946,91,32,0,15,1963
"42003130200",8,15,821,552,17,0,3,0,1416
"42003130300",49,25,711,459,6,36,32,0,1318
"42003130400",2,17,523,382,29,29,0,0,982
"42003130600",127,34,1385,1146,26,110,0,10,2838
"42003140100",1657,266,21,79,152,90,12,49,2326
"42003140200",1342,196,0,15,144,203,69,55,2024
"42003140300",2868,319,227,4,282,9,126,25,3860
"42003140400",1956,89,49,0,220,11,77,0,2402
"42003140500",860,159,570,93,32,0,0,0,1714
"42003140600",2450,221,189,32,96,80,7,11,3086
"42003140800",3681,296,21,0,482,207,131,35,4853
"42003141000",955,58,0,0,8,12,0,0,1033
"42003141100",1170,51,55,0,69,0,23,0,1368
"42003141300",3144,707,19,0,682,494,212,75,5333
"42003141400",4421,378,127,41,747,58,218,0,5990
"42003151600",2395,54,31,27,57,57,201,0,2822
"42003151700",4027,334,129,248,256,75,374,0,5443
"42003160800",2175,417,46,38,69,51,18,21,2835
"42003160900",2137,800,102,31,142,0,81,39,3332
"42003170200",1936,902,2,19,91,28,25,0,3003
"42003170600",1313,343,44,53,22,5,38,0,1818
"42003180300",1026,281,688,330,110,123,0,0,2558
"42003180700",1388,348,233,145,97,4,14,23,2252
"42003190300",1723,144,11,60,50,0,85,29,2102
"42003191100",2093,333,46,0,50,0,0,0,2522
"42003191400",2057,307,72,93,57,0,14,0,2600
"42003191500",1249,348,216,40,31,25,162,0,2071
"42003191600",2965,567,576,168,141,0,48,229,4694
"42003191700",2914,239,188,30,239,0,113,0,3723
"42003191800",4529,300,26,24,362,20,121,21,5403
"42003191900",1324,221,235,24,96,42,0,0,1942
"42003192000",2393,404,402,62,151,100,45,16,3573
"42003202200",1406,235,545,501,134,89,59,0,2969
"42003202300",2773,100,230,0,537,57,54,10,3761
"42003210700",468,122,1070,212,71,1,41,10,1995
"42003220600",880,142,189,223,42,26,73,2,1577
"42003240600",1528,318,259,63,82,33,34,0,2317
"42003241200",554,105,80,19,71,11,51,4,895
"42003250300",511,77,293,339,33,120,10,114,1497
"42003250700",146,29,377,214,3,15,0,4,788
"42003250900",259,51,663,259,12,26,0,59,1329
"42003260200",1294,156,262,220,44,0,28,0,2004
"42003260700",820,44,674,70,119,0,140,0,1867
"42003260900",31,15,243,1228,3,25,0,41,1586
"42003261200",933,45,197,9,7,0,0,0,1191
"42003261400",295,101,778,591,17,12,6,0,1800
"42003261500",426,248,437,270,60,6,11,0,1458
"42003262000",1132,250,295,502,102,76,8,89,2454
"42003270100",1908,41,345,88,103,19,64,0,2568
"42003270300",984,292,555,192,43,25,0,0,2091
"42003270400",492,118,264,110,50,0,35,5,1074
"42003270800",1789,333,462,47,85,17,11,0,2744
"42003271500",1187,293,1123,191,216,16,45,34,3105
"42003281400",1182,157,481,538,114,47,34,0,2553
"42003281500",1134,42,190,30,44,0,19,0,1459
"42003290100",1360,265,200,173,219,0,21,21,2259
"42003290200",2817,396,144,259,224,176,0,12,4028
"42003290400",2729,390,310,244,136,57,165,10,4041
"42003300100",1045,189,1305,1163,147,376,43,81,4349
"42003310200",3189,310,0,0,0,0,57,0,3556
"42003310300",814,6,72,4,62,15,11,0,984
"42003320400",1600,322,57,38,28,28,11,10,2094
"42003320600",1841,124,49,36,70,150,4,22,2296
"42003320700",1179,215,23,14,83,0,55,0,1569
"42003401100",4115,382,62,0,66,0,0,0,4625
"42003401200",1846,1013,26,54,48,70,7,0,3064
"42003401300",2465,100,28,1,123,0,43,1,2761
"42003402000",2605,331,132,7,25,48,16,0,3164
"42003403500",3262,635,357,108,63,36,0,0,4461
"42003404000",1174,123,21,16,44,9,10,11,1408
"42003405000",977,114,0,0,12,0,0,0,1103
"42003406000",2131,134,15,0,48,0,42,0,2370
"42003407001",4799,103,1,1,105,0,56,0,5065
"42003407002",6115,515,0,1,130,0,10,0,6771
"42003408001",4619,368,0,1,114,0,120,0,5222
"42003408002",5628,190,186,0,216,0,177,0,6397
"42003409000",11376,203,169,0,475,1,183,0,12407
"42003410000",1141,40,0,0,17,4,6,4,1212
"42003411000",6420,118,108,0,816,109,61,0,7632
"42003412001",6974,158,146,0,1402,20,96,0,8796
"42003412002",4871,81,35,0,375,0,52,0,5414
"42003413100",5246,258,260,20,1197,106,80,12,7179
"42003413201",3401,145,27,0,46,63,51,0,3733
"42003413202",2554,123,0,0,9,0,35,0,2721
"42003413300",4036,210,67,0,254,0,105,0,4672
"42003413400",3911,189,20,0,135,3,140,0,4398
"42003413500",4552,447,153,102,438,3,0,21,5716
"42003414101",5065,102,44,0,42,0,10,0,5263
"42003414102",6662,235,67,0,523,1,86,26,7600
"42003414200",5217,257,47,103,101,0,42,0,5767
"42003415001",3976,386,9,11,390,0,177,0,4949
"42003415002",2052,49,60,7,130,11,0,0,2309
"42003416000",1444,180,0,0,5,4,0,0,1633
"42003417100",1826,172,5,14,35,70,21,28,2171
"42003417200",992,232,12,0,17,0,17,0,1270
"42003418000",1604,141,0,1,12,0,10,0,1768
"42003419000",2423,286,0,0,45,7,19,7,2787
"42003420000",1101,193,14,19,238,2,19,5,1591
"42003421100",3266,142,44,2,628,11,30,0,4123
"42003421200",3980,71,12,0,302,11,70,11,4457
"42003422000",4751,135,0,0,421,106,67,50,5530
"42003423000",2408,140,16,0,201,30,51,0,2846
"42003424000",2214,545,129,193,144,190,17,161,3593
"42003425000",2888,362,99,1,51,31,87,0,3519
"42003426300",5917,242,0,0,11,0,102,0,6272
"42003426400",4030,247,0,16,19,0,0,0,4312
"42003426700",1980,152,9,1,77,8,53,0,2280
"42003426800",5263,97,1,0,117,0,0,0,5478
"42003427000",2565,938,121,3,62,32,5,15,3741
"42003427100",5121,396,14,0,115,0,0,0,5646
"42003427200",4190,377,191,14,24,0,59,0,4855
"42003428100",1105,86,0,0,7,0,0,0,1198
"42003428200",1944,68,115,0,0,0,0,0,2127
"42003429100",2033,324,79,18,145,0,41,0,2640
"42003429201",3463,125,60,19,392,0,99,11,4169
"42003429202",4017,195,133,0,266,0,136,0,4747
"42003429300",4808,149,54,0,161,0,77,0,5249
"42003429400",3829,283,221,0,69,6,56,0,4464
"42003429500",3296,225,204,1,413,0,83,0,4222
"42003429600",2616,244,36,19,162,11,7,0,3095
"42003429700",2246,177,0,1,62,0,8,0,2494
"42003430100",1905,122,8,7,72,13,5,0,2132
"42003430200",4144,367,39,3,47,0,34,13,4647
"42003431100",2331,363,262,126,78,37,36,8,3241
"42003431400",1439,155,122,67,117,12,0,0,1912
"42003431500",2368,462,159,97,127,0,59,0,3272
"42003432300",1362,221,197,0,64,0,11,0,1855
"42003432400",2260,142,172,22,138,33,26,0,2793
"42003434000",1582,34,14,14,43,2,13,0,1702
"42003435000",2162,95,23,20,22,0,15,0,2337
"42003437000",4952,155,258,45,324,0,73,0,5807
"42003439000",1260,88,73,0,23,0,10,0,1454
"42003445500",3311,186,100,64,171,5,72,5,3914
"42003446000",1547,29,5,0,68,8,52,0,1709
"42003447000",1478,29,9,0,100,0,18,0,1634
"42003448000",962,164,62,0,67,26,33,103,1417
"42003449000",2296,191,80,0,58,8,16,1,2650
"42003450700",2299,307,191,19,165,75,29,43,3128
"42003450800",1561,323,303,171,150,62,78,29,2677
"42003451101",3468,196,35,16,76,0,13,15,3819
"42003451102",3594,313,136,77,320,31,170,18,4659
"42003451104",3138,77,103,5,40,54,74,39,3530
"42003451105",3605,626,193,139,282,104,194,138,5281
"42003451300",6577,179,187,0,382,0,90,0,7415
"42003452000",4682,193,243,18,82,89,19,85,5411
"42003453003",1726,126,0,0,79,0,9,8,1948
"42003453004",5734,818,87,2,247,0,164,0,7052
"42003455000",1275,118,16,0,23,0,16,0,1448
"42003456001",3053,468,8,0,203,0,41,0,3773
"42003456003",6083,152,61,2,558,0,76,0,6932
"42003456004",3842,150,27,1,205,35,0,0,4260
"42003457100",1119,219,32,0,43,11,19,11,1454
"42003457200",3296,260,26,7,97,0,29,0,3715
"42003458000",6854,420,60,4,268,14,39,0,7659
"42003459101",1335,116,80,2,89,5,16,0,1643
"42003459102",5142,268,40,25,276,3,11,0,5765
"42003459201",5143,230,73,20,610,59,308,0,6443
"42003459202",633,47,15,17,7,24,0,0,743
"42003460001",3994,331,12,0,166,0,21,0,4524
"42003460002",3046,130,58,1,182,9,1,0,3427
"42003461000",854,158,18,3,41,23,29,9,1135
"42003462100",1692,356,45,534,106,88,0,0,2821
"42003462600",2030,338,451,392,58,163,30,27,3489
"42003463900",1647,354,357,92,43,30,84,0,2607
"42003464300",2648,318,104,76,135,11,22,17,3331
"42003464400",1774,391,819,398,106,64,2,17,3571
"42003465600",1959,115,259,16,28,6,47,0,2430
"42003465800",3099,101,187,0,125,14,11,0,3537
"42003468700",1324,250,110,6,18,3,0,0,1711
"42003468800",1614,414,124,11,163,0,33,17,2376
"42003468900",2558,656,149,450,46,57,7,28,3951
"42003469000",4148,215,66,0,214,0,25,0,4668
"42003470300",3145,174,91,1,103,115,64,0,3693
"42003470400",2855,69,50,0,23,15,107,15,3134
"42003470501",1872,110,50,0,1403,94,7,41,3577
"42003470502",2599,19,87,0,130,13,25,0,2873
"42003470600",2729,389,312,13,42,0,14,0,3499
"42003471000",1204,100,17,0,3,0,28,12,1364
"42003472100",2145,145,0,2,94,23,103,18,2530
"42003472200",2133,134,0,8,62,0,80,0,2417
"42003472300",1580,185,42,2,43,9,43,5,1909
"42003472400",1773,44,15,0,67,6,0,4,1909
"42003473100",4255,195,12,2,135,7,212,7,4825
"42003473200",2522,136,30,12,242,133,58,7,3140
"42003473300",4939,361,1,0,146,9,14,0,5470
"42003473401",3001,355,0,27,228,20,21,0,3652
"42003473402",3299,112,26,0,268,0,16,0,3721
"42003473500",3368,225,7,0,195,4,109,0,3908
"42003473601",3153,135,107,0,214,46,71,0,3726
"42003473602",3770,287,97,2,492,8,224,10,4890
"42003474101",2895,130,8,0,422,39,13,0,3507
"42003474102",3303,111,0,0,231,0,178,18,3841
"42003474201",2362,16,5,0,175,0,0,0,2558
"42003474202",4519,81,0,0,451,10,70,10,5141
"42003474203",4038,100,8,1,368,46,197,0,4758
"42003475101",3686,344,140,0,219,1,60,15,4465
"42003475102",1432,83,0,0,60,0,15,0,1590
"42003475200",4378,284,12,1,78,0,47,0,4800
"42003475301",3936,146,189,11,319,22,34,0,4657
"42003475303",3786,154,9,0,38,0,10,0,3997
"42003475304",5241,63,87,0,266,32,28,0,5717
"42003475401",3611,186,27,0,67,31,19,31,3972
"42003475402",3033,69,0,0,31,0,35,13,3181
"42003476100",3692,491,98,9,329,348,22,49,5038
"42003476200",2875,355,11,1,45,39,30,84,3440
"42003477100",3226,296,0,0,12,13,0,7,3554
"42003477200",3974,185,0,0,54,9,8,0,4230
"42003477300",4085,175,615,38,259,680,40,13,5905
"42003478100",3563,318,43,8,312,100,102,95,4541
"42003478200",4610,280,136,0,138,90,39,0,5293
"42003479000",1817,140,0,0,22,12,0,0,1991
"42003480101",3336,167,621,330,420,241,0,42,5157
"42003480102",2747,142,101,44,58,0,63,0,3155
"42003480200",3478,93,42,77,37,0,24,0,3751
"42003480300",3017,116,38,0,14,7,37,0,3229
"42003480400",4216,237,71,142,0,11,0,0,4677
"42003481000",1469,504,509,600,174,139,10,49,3454
"42003482500",1486,63,83,87,50,10,15,0,1794
"42003483800",619,175,1643,561,127,19,0,0,3144
"42003484300",2061,422,905,12,166,0,68,0,3634
"42003484500",5186,381,14,0,32,0,104,11,5728
"42003484600",1766,134,62,24,111,7,0,0,2104
"42003485000",896,204,72,12,23,4,34,0,1245
"42003486700",616,212,368,650,201,179,19,48,2293
"42003486800",392,178,858,302,75,45,13,27,1890
"42003486900",305,85,329,418,90,103,11,7,1348
"42003487000",1595,186,4,35,35,9,25,0,1889
"42003488100",1484,333,389,11,27,0,32,0,2276
"42003488200",2296,214,357,393,52,37,32,14,3395
"42003488300",2036,156,1,0,40,0,7,0,2240
"42003488400",3407,276,444,19,52,0,34,30,4262
"42003488500",2651,194,48,25,66,46,20,0,3050
"42003488600",3928,488,131,138,89,299,52,8,5133
"42003489001",3926,238,50,35,60,0,37,0,4346
"42003489002",3502,128,113,49,83,11,47,0,3933
"42003490002",3806,352,92,0,485,47,90,0,4872
"42003490003",3130,446,56,1,111,9,88,57,3898
"42003490004",4501,222,10,7,106,0,39,81,4966
"42003491101",6097,119,226,42,97,0,0,0,6581
"42003491200",1810,92,12,0,33,12,11,0,1970
"42003492700",1151,291,386,120,29,7,35,0,2019
"42003492800",717,159,817,662,74,176,17,0,2622
"42003492900",1133,293,359,220,155,0,121,0,2281
"42003494000",1077,249,14,0,43,8,33,0,1424
"42003495000",3031,243,81,1,0,0,0,66,3422
"42003496101",2859,150,0,0,18,0,0,0,3027
"42003496102",3977,251,42,0,124,0,6,22,4422
"42003496200",5152,613,0,42,54,0,63,0,5924
"42003497000",884,92,8,1,35,1,43,0,1064
"42003498000",2152,210,60,0,51,16,21,0,2510
"42003499300",1423,159,0,13,0,0,0,0,1595
"42003499400",2211,392,18,74,89,66,18,10,2878
"42003500300",3201,375,22,22,161,4,0,26,3811
"42003501000",1274,257,60,40,29,9,5,13,1687
"42003503002",5465,137,190,27,0,0,0,0,5819
"42003504100",3139,373,770,1071,77,79,21,0,5530
"42003507000",1656,177,79,53,156,19,22,0,2162
"42003508000",894,298,292,155,10,117,0,12,1778
"42003509400",3001,900,1003,223,40,18,133,32,5350
"42003510000",642,119,589,313,82,70,0,45,1860
"42003512000",1542,117,269,177,193,156,0,12,2466
"42003512800",323,116,292,512,24,108,0,8,1383
"42003512900",223,84,420,189,24,10,24,27,1001
"42003513800",328,162,789,465,32,53,15,11,1855
"42003514000",360,137,885,718,6,84,5,68,2263
"42003515100",943,150,855,486,30,0,0,0,2464
"42003515200",1393,106,585,83,217,0,104,9,2497
"42003515300",884,197,371,239,73,99,66,0,1929
"42003515401",1554,203,146,192,88,10,35,0,2228
"42003516100",1179,52,49,46,29,18,30,0,1403
"42003516200",1258,149,230,0,56,27,140,0,1860
"42003517000",1160,196,255,81,10,31,55,0,1788
"42003518001",2978,170,311,0,20,0,8,53,3540
"42003519000",2273,81,368,0,196,0,50,0,2968
"42003520001",2362,326,400,20,107,9,0,29,3253
"42003520002",2349,224,394,28,117,0,62,0,3174
"42003521100",3142,136,895,180,200,52,28,4,4637
"42003521200",3251,119,308,285,283,71,8,0,4325
"42003521301",2301,329,843,149,353,73,16,0,4064
"42003521302",2890,198,421,12,550,17,35,12,4135
"42003521401",2276,123,95,0,196,0,162,18,2870
"42003521402",3014,233,222,0,535,0,52,0,4056
"42003521500",3474,288,136,11,160,127,34,10,4240
"42003522000",1984,406,473,151,211,45,23,32,3325
"42003523100",409,52,2677,596,229,15,24,15,4017
"42003523200",1162,133,1864,531,114,97,0,0,3901
"42003523300",2394,124,1191,229,123,0,106,15,4182
"42003523400",2705,143,1420,561,173,0,57,0,5059
"42003523501",2061,64,2147,352,99,34,26,0,4783
"42003523502",945,89,215,149,54,0,23,0,1475
"42003523600",2716,382,1498,102,178,0,48,0,4924
"42003523701",3255,208,446,135,221,22,11,23,4321
"42003523702",3239,242,867,119,474,88,83,13,5125
"42003523800",3943,148,352,28,160,1,37,0,4669
"42003524000",1827,389,178,93,52,21,74,0,2634
"42003525100",1892,40,6,0,102,0,13,0,2053
"42003525200",1827,195,10,3,0,0,22,0,2057
"42003525300",1961,127,0,0,49,18,36,4,2195
"42003526101",6355,192,193,18,156,1,111,0,7026
"42003526102",1969,128,0,0,0,0,0,0,2097
"42003526201",3431,129,83,0,96,5,37,0,3781
"42003526202",4308,132,45,79,183,23,90,26,4886
"42003526301",4151,258,72,23,26,0,19,0,4549
"42003526302",4830,182,84,18,103,21,64,0,5302
"42003550900",473,266,508,284,77,78,20,7,1713
"42003551200",1690,451,360,697,54,263,54,31,3600
"42003551300",2083,316,20,50,67,0,77,0,2613
"42003551900",391,445,195,400,59,104,19,5,1618
"42003552000",1078,264,651,242,365,97,148,125,2970
"42003552100",71,102,202,648,0,0,0,0,1023
"42003552200",564,214,60,38,12,6,27,11,932
"42003552300",427,281,786,527,31,132,73,124,2381
"42003552400",2008,363,200,146,38,0,11,0,2766
"42003560400",322,150,657,258,37,75,30,0,1529
"42003560500",1826,219,158,53,191,0,21,0,2468
"42003560600",163,40,392,165,179,0,6,0,945
"42003561000",220,27,742,357,22,48,27,0,1443
"42003561100",16,8,491,301,12,70,0,5,903
"42003561200",93,17,627,441,112,12,41,14,1357
"42003561400",832,42,2422,667,99,11,56,32,4161
"42003561500",666,62,1544,643,93,116,0,0,3124
"42003561600",1120,361,484,86,63,0,65,0,2179
"42003561700",397,51,293,96,6,21,10,6,880
"42003561900",23,94,1477,582,140,70,0,0,2386
"42003562000",910,793,118,242,441,357,62,126,3049
"42003562300",864,414,1006,1008,80,67,24,79,3542
"42003562400",750,177,1056,374,130,98,0,0,2585
"42003562500",1031,209,1038,571,135,99,0,0,3083
"42003562600",1343,399,529,159,181,115,17,39,2782
"42003562700",909,208,167,170,153,131,58,0,1796
"42003562800",1181,191,160,37,41,33,2,1,1646
"42003562900",1094,176,167,99,107,55,4,0,1702
"42003563000",1579,273,995,198,157,73,43,17,3335
"42003563100",2623,269,222,0,410,311,39,28,3902
"42003563200",1371,213,244,365,86,21,33,8,2341
"42003563300",1222,39,22,0,46,0,11,0,1340
"42003563800",3192,137,25,3,94,11,26,6,3494
"42003563900",3027,239,314,113,201,9,67,13,3983
"42003564000",5193,406,35,0,220,0,34,0,5888
"42003564100",901,16,5,0,23,0,8,0,953
"42003564200",2032,131,27,0,121,0,19,0,2330
"42003564400",4434,472,373,45,92,10,40,2,5468
"42003564500",2732,198,12,26,49,9,19,28,3073
"42003980000",157,4,17,0,27,15,6,0,226
"42003980100",13,14,0,0,0,0,0,0,27
"42003980300",0,0,0,0,0,0,0,0,0
"42003980400",0,0,0,0,0,0,0,0,0
"42003980500",4,0,0,0,0,0,0,0,4
"42003980600",3,0,0,0,0,0,0,0,3
"42003980700",12,0,0,0,0,0,0,0,12
"42003980800",0,0,0,0,0,0,0,0,0
"42003980900",0,0,0,0,0,0,0,0,0
"42003981000",0,0,0,0,0,0,0,0,0
"42003981100",5,0,0,0,0,0,0,0,5
"42003981200",0,0,0,0,0,0,0,0,0
"42003981800",21,10,7,29,0,18,5,15,105
"42003982200",29,41,0,4,0,7,0,0,81
"42005950100",3732,842,7,0,70,30,29,8,4718
"42005950200",1976,220,4,0,20,4,19,2,2245
"42005950300",2797,381,37,44,53,17,11,20,3360
"42005950400",2119,306,0,0,19,0,5,0,2449
"42005950500",5085,391,7,0,4,0,0,0,5487
"42005950600",2638,319,11,0,24,20,7,0,3019
"42005950700",3292,476,0,0,29,28,10,0,3835
"42005950800",3611,381,15,0,15,14,0,0,4036
"42005950900",4451,541,35,0,5,4,1,0,5037
"42005951000",2130,553,111,8,0,126,0,126,3054
"42005951100",2898,823,0,23,82,23,24,0,3873
"42005951200",5472,417,5,0,0,1,13,0,5908
"42005951300",2291,192,31,0,37,10,3,3,2567
"42005951400",2240,260,135,30,14,9,18,1,2707
"42005951500",2370,507,13,5,66,6,11,3,2981
"42005951600",4084,601,0,0,12,0,25,0,4722
"42005951700",3213,463,8,3,34,2,57,0,3780
"42005951800",1518,456,46,0,33,0,10,0,2063
"42005951900",1551,202,0,0,27,0,22,0,1802
"42007600601",1872,299,3,6,16,6,20,0,2222
"42007600602",2378,111,16,0,57,0,40,0,2602
"42007600700",7020,526,21,50,146,0,84,0,7847
"42007601000",3291,213,22,1,105,0,39,0,3671
"42007601100",1485,579,69,61,72,123,0,19,2408
"42007601200",1336,476,677,192,25,229,8,0,2943
"42007601300",1344,378,253,135,40,258,52,3,2463
"42007601400",2569,312,152,50,198,83,52,7,3423
"42007601600",1064,195,30,5,21,10,13,1,1339
"42007601700",3050,277,17,0,57,0,1,0,3402
"42007601800",6845,501,5,0,45,0,0,0,7396
"42007602100",2164,590,436,218,47,42,34,14,3545
"42007602300",2069,216,17,0,38,94,0,37,2471
"42007602400",1876,91,31,0,27,0,59,0,2084
"42007602500",1224,107,22,5,6,0,9,0,1373
"42007602601",4336,365,36,14,108,0,113,46,5018
"42007602602",3069,79,29,7,32,0,8,0,3224
"42007602701",1699,157,8,0,29,0,45,0,1938
"42007602702",3157,288,50,0,29,0,0,0,3524
"42007602800",1341,477,145,414,141,60,185,0,2763
"42007602900",2331,233,0,0,116,7,44,7,2738
"42007603000",2875,137,0,0,27,0,7,7,3053
"42007603202",6496,235,201,17,136,0,169,0,7254
"42007603300",3232,378,0,0,175,24,20,7,3836
"42007603400",1635,232,9,5,3,0,0,0,1884
"42007603500",1160,214,16,100,89,11,26,8,1624
"42007603600",2011,149,23,0,15,0,23,0,2221
"42007603700",3295,337,98,18,173,10,7,0,3938
"42007603801",2707,101,19,0,64,0,23,0,2914
"42007603802",2911,91,0,0,40,0,23,0,3065
"42007603803",2978,213,41,0,24,0,57,0,3313
"42007603900",2835,288,31,0,0,0,24,0,3178
"42007604000",1401,457,332,101,337,14,50,25,2717
"42007604100",1734,231,371,243,119,81,37,21,2837
"42007604200",926,260,207,50,45,8,34,24,1554
"42007604500",268,68,1114,812,43,0,51,0,2356
"42007604600",2149,326,240,351,14,24,10,6,3120
"42007604700",958,173,154,156,48,0,37,0,1526
"42007604800",3818,365,61,0,6,0,27,0,4277
"42007604901",3395,240,92,0,105,22,147,0,4001
"42007604902",4335,115,33,0,41,0,56,0,4580
"42007605001",2291,199,14,17,31,3,15,0,2570
"42007605002",3443,173,9,1,79,55,74,0,3834
"42007605100",4411,353,9,0,43,33,1,0,4850
"42007605200",1970,444,102,14,74,35,63,15,2717
"42007605300",2695,258,37,49,102,0,27,0,3168
"42007605400",2252,537,310,173,152,19,48,0,3491
"42007605500",4326,396,172,73,83,0,26,0,5076
"42007605600",2828,307,79,21,73,5,15,79,3407
"42007605700",950,524,486,301,73,10,47,25,2416
"42007605800",5445,623,37,0,111,68,2,1,6287
"42009960100",3187,398,0,2,50,8,29,13,3687
"42009960200",3015,399,0,0,68,0,11,0,3493
"42009960300",4321,688,22,17,57,14,0,0,5119
"42009960400",4462,770,17,0,43,13,21,22,5348
"42009960500",2996,453,18,0,86,47,30,4,3634
"42009960600",3736,1057,11,25,14,11,20,14,4888
"42009960700",2311,370,0,0,97,0,36,3,2817
"42009960800",4163,637,0,0,20,75,35,40,4970
"42009960900",4023,525,13,22,37,70,60,8,4758
"42009961000",5062,532,4,4,36,0,57,11,5706
"42009961100",3733,494,0,0,64,12,41,0,4344
"42011000100",1284,1130,325,592,836,1017,1516,1667,8367
"42011000200",1218,976,303,65,379,1040,1037,1822,6840
"42011000300",897,242,267,7,445,328,713,477,3376
"42011000400",1338,403,351,238,1043,717,1590,1074,6754
"42011000500",1791,441,326,60,360,451,1166,729,5324
"42011000600",1423,141,196,74,271,122,518,190,2935
"42011000700",1648,488,127,82,1163,673,1747,982,6910
"42011000800",1351,497,394,195,826,1093,1761,1497,7614
"42011000900",1190,547,247,40,445,110,881,433,3893
"42011001000",616,729,274,140,1058,438,1350,1083,5688
"42011001100",681,1324,368,172,665,750,1016,1950,6926
"42011001200",307,334,248,176,474,488,729,736,3492
"42011001300",855,619,344,123,863,540,1450,1077,5871
"42011001400",1235,917,149,235,1044,687,1528,1419,7214
"42011001500",1028,752,218,221,705,463,1314,1146,5847
"42011001600",1156,405,110,31,673,353,1486,585,4799
"42011001700",672,867,138,251,597,701,1131,1430,5787
"42011001800",1302,532,329,10,363,218,521,530,3805
"42011001900",674,644,277,264,589,258,868,595,4169
"42011002000",1587,1084,160,173,655,338,1080,851,5928
"42011002100",1205,600,168,95,265,408,866,708,4315
"42011002200",571,492,187,24,473,345,928,743,3763
"42011002300",505,650,60,119,711,66,949,591,3651
"42011002500",785,561,353,231,574,465,1018,947,4934
"42011002600",715,922,91,265,369,924,699,1649,5634
"42011002700",1428,131,65,14,329,2,346,75,2390
"42011002900",1535,354,271,138,81,33,216,39,2667
"42011010100",5518,322,97,0,107,27,65,38,6174
"42011010201",4113,207,0,0,5,0,77,1,4403
"42011010202",4042,543,0,305,78,4,80,47,5099
"42011010302",2644,171,14,23,70,3,127,27,3079
"42011010303",1881,91,37,0,59,3,102,43,2216
"42011010304",4326,205,41,0,142,16,311,0,5041
"42011010400",6822,851,49,54,101,36,251,112,8276
"42011010500",5576,436,130,4,534,0,323,19,7022
"42011010600",6883,397,125,33,636,42,341,30,8487
"42011010700",5808,325,172,97,461,196,277,201,7537
"42011010801",1619,114,0,0,36,34,73,86,1962
"42011010802",7643,479,319,157,384,104,823,414,10323
"42011010902",2992,368,267,2,353,32,367,128,4509
"42011010903",4663,115,175,0,242,0,150,0,5345
"42011010904",3315,191,58,12,405,86,347,0,4414
"42011010905",3913,62,64,0,252,0,334,0,4625
"42011011000",4115,95,117,14,100,125,456,59,5081
"42011011101",1509,261,90,0,161,0,135,8,2164
"42011011102",4981,119,46,1,279,66,175,66,5733
"42011011200",2705,252,357,30,378,32,715,41,4510
"42011011300",2046,255,157,102,232,37,251,39,3119
"42011011400",4536,376,193,19,105,34,340,81,5684
"42011011500",2667,183,14,15,97,47,85,67,3175
"42011011601",3971,380,166,0,529,15,647,19,5727
"42011011602",3693,194,23,2,215,100,95,99,4421
"42011011603",5074,297,162,48,329,0,367,13,6290
"42011011701",6881,219,0,1,213,0,193,22,7529
"42011011702",4054,143,40,0,354,10,54,11,4666
"42011011703",3680,146,18,0,203,0,16,0,4063
"42011011800",4427,442,72,0,155,59,120,0,5275
"42011011902",3245,55,125,52,34,0,106,1,3618
"42011011903",4497,26,131,0,397,0,241,0,5292
"42011011904",6555,502,401,0,121,81,206,0,7866
"42011012001",2069,198,160,0,28,0,129,0,2584
"42011012002",7407,339,247,147,673,0,260,0,9073
"42011012101",1632,126,17,0,129,11,171,39,2125
"42011012103",2040,110,15,0,204,0,13,5,2387
"42011012104",2832,335,173,0,67,49,62,0,3518
"42011012105",7916,64,248,1,110,0,205,17,8561
"42011012200",2623,266,23,0,176,84,663,86,3921
"42011012300",3103,625,89,113,479,24,345,248,5026
"42011012400",4403,294,571,34,968,32,1740,32,8074
"42011012500",1557,179,17,0,204,68,405,166,2596
"42011012600",1635,315,254,0,430,19,802,131,3586
"42011012700",6951,261,260,1,977,79,793,0,9322
"42011012800",2937,495,98,0,245,70,566,96,4507
"42011012900",6994,301,21,0,92,0,68,24,7500
"42011013000",6080,431,126,0,42,10,11,7,6707
"42011013100",4777,209,0,0,81,0,22,12,5101
"42011013200",3425,261,12,281,72,2,64,19,4136
"42011013301",2660,108,0,0,152,4,164,11,3099
"42011013302",5403,553,7,0,106,0,38,8,6115
"42011013401",7374,407,57,0,88,0,166,0,8092
"42011013402",2790,168,25,0,53,0,13,8,3057
"42011013500",9693,563,465,35,369,91,759,91,12066
"42011013600",3690,114,39,12,94,125,318,146,4538
"42011013701",2812,488,34,1,122,0,132,1,3590
"42011013702",3570,324,0,0,63,27,119,61,4164
"42011013800",3779,395,18,0,68,23,149,70,4502
"42011013900",7257,451,12,6,76,9,90,62,7963
"42011014000",3523,878,76,51,182,165,204,170,5249
"42011014100",3243,516,0,88,59,3,44,30,3983
"42011014200",6847,589,50,0,110,0,136,0,7732
"42013010101",3913,242,6,1,21,3,0,0,4186
"42013010102",2089,683,0,0,4,13,34,0,2823
"42013010103",2069,353,13,0,0,0,29,0,2464
"42013010401",1556,218,0,3,28,0,41,0,1846
"42013010402",5783,417,54,0,63,0,0,0,6317
"42013010500",3166,298,0,0,176,0,0,1,3641
"42013010600",2413,75,0,0,189,0,0,0,2677
"42013010700",5060,1076,44,94,24,0,66,45,6409
"42013010800",3145,562,16,21,15,27,19,14,3819
"42013010900",6744,333,0,0,143,29,61,29,7339
"42013011001",3423,299,0,0,127,5,0,0,3854
"42013011002",3326,449,0,11,63,8,0,0,3857
"42013011100",5094,596,101,0,158,105,0,5,6059
"42013011200",5020,443,2,0,86,0,204,62,5817
"42013011300",4870,469,45,0,23,4,0,0,5411
"42013011400",2212,263,1,20,43,7,10,7,2563
"42013011500",5128,639,48,0,68,0,80,9,5972
"42013011600",3136,842,46,11,34,0,0,10,4079
"42013100200",1997,222,9,0,0,0,9,0,2237
"42013100300",2038,672,14,0,33,53,33,0,2843
"42013100400",1424,266,74,0,0,43,0,0,1807
"42013100500",2581,676,204,171,82,102,0,8,3824
"42013100600",2300,288,6,16,61,0,5,0,2676
"42013100700",1213,1022,32,221,13,105,9,25,2640
"42013100800",1116,110,8,46,0,4,0,4,1288
"42013100900",3548,515,0,20,80,6,80,6,4255
"42013101100",1283,136,63,0,10,44,5,0,1541
"42013101200",3480,344,0,4,71,109,147,119,4274
"42013101400",2750,727,43,30,115,13,49,0,3727
"42013101500",2780,167,3,0,113,46,0,0,3109
"42013101600",1831,1566,6,7,13,41,2,0,3466
"42013101700",2542,650,142,175,193,88,36,0,3826
"42013101800",2267,491,0,0,0,0,0,0,2758
"42013101900",522,721,0,0,70,12,12,12,1349
"42015950100",3454,576,3,1,86,0,28,0,4148
"42015950200",4362,394,20,0,95,0,48,8,4927
"42015950300",4730,541,26,19,63,16,37,0,5432
"42015950400",2316,796,0,0,35,24,92,5,3268
"42015950500",5354,835,96,1,84,7,0,0,6377
"42015950600",3175,674,0,0,76,3,52,3,3983
"42015950700",4017,690,8,23,70,61,30,0,4899
"42015950800",3385,351,3,0,78,14,26,25,3882
"42015950900",4775,526,16,8,114,0,145,3,5587
"42015951000",2137,523,0,0,122,20,113,0,2915
"42015951100",2506,189,7,1,86,0,9,4,2802
"42015951200",4561,793,0,4,104,42,94,52,5650
"42015951300",3563,414,24,28,65,8,90,1,4193
"42015951400",3231,754,0,0,46,0,6,2,4039
"42017100102",2086,102,119,0,586,11,187,11,3102
"42017100103",2207,86,52,61,50,0,118,0,2574
"42017100104",2335,363,306,176,1056,106,206,267,4815
"42017100105",2733,426,23,4,140,0,33,191,3550
"42017100201",3025,341,767,2,294,28,106,29,4592
"42017100206",3832,86,242,0,986,56,347,41,5590
"42017100207",2765,483,268,188,583,16,198,6,4507
"42017100208",3429,312,480,119,570,792,738,648,7088
"42017100209",5092,218,995,10,2491,193,431,193,9623
"42017100210",5576,525,227,72,1230,0,273,54,7957
"42017100211",5983,84,369,11,503,0,95,0,7045
"42017100212",3177,156,80,2,512,16,186,15,4144
"42017100302",4313,312,48,0,149,91,169,48,5130
"42017100303",3030,176,958,521,331,31,768,12,5827
"42017100304",1262,429,341,115,186,26,128,99,2586
"42017100306",1933,103,785,94,391,11,141,0,3458
"42017100307",3436,631,383,61,481,0,547,10,5549
"42017100401",5122,616,235,0,386,11,842,0,7212
"42017100402",6064,574,368,49,295,0,426,61,7837
"42017100403",1077,193,708,383,35,0,80,94,2570
"42017100404",5148,168,263,8,154,71,294,71,6177
"42017100406",3148,128,55,120,225,18,68,18,3780
"42017100407",961,118,4,0,79,1,41,1,1205
"42017100408",5830,191,222,0,387,13,314,0,6957
"42017100500",2204,491,49,0,29,0,148,15,2936
"42017100600",2737,243,231,145,292,30,522,79,4279
"42017100700",2013,200,475,175,232,84,560,76,3815
"42017100803",3944,512,306,0,232,8,532,250,5784
"42017100804",3555,82,115,0,49,0,207,0,4008
"42017100805",5071,259,199,57,69,0,137,0,5792
"42017100807",3303,281,238,60,131,0,155,0,4168
"42017100808",4417,135,111,0,171,7,265,0,5106
"42017100809",4989,25,271,0,284,0,257,0,5826
"42017100811",2814,344,567,102,763,52,117,33,4792
"42017100900",6936,243,181,18,570,56,113,0,8117
"42017101100",1550,241,376,152,130,44,276,48,2817
"42017101401",3973,130,13,0,193,0,54,26,4389
"42017101403",5263,65,69,0,160,0,57,0,5614
"42017101404",2036,64,93,0,90,5,31,0,2319
"42017101405",6110,367,73,4,242,69,210,29,7104
"42017101503",3314,197,21,0,267,0,213,0,4012
"42017101504",2460,94,2,2,138,0,39,0,2735
"42017101505",2950,79,0,0,176,10,26,0,3241
"42017101506",5043,196,0,1,24,1,0,0,5265
"42017101603",2596,535,4,0,72,56,99,193,3555
"42017101605",2579,543,338,102,551,110,1233,44,5500
"42017101607",2716,119,0,0,12,0,169,0,3016
"42017101609",3888,369,29,0,106,20,0,20,4432
"42017101610",4342,240,50,0,88,13,50,92,4875
"42017101611",6405,47,1,3,276,40,238,17,7027
"42017101802",4947,461,70,12,1073,31,16,60,6670
"42017101803",6994,438,37,0,736,0,361,0,8566
"42017101805",2075,69,12,0,32,0,17,0,2205
"42017101807",3030,434,206,0,178,112,465,256,4681
"42017101808",2054,154,76,0,339,0,113,0,2736
"42017101900",3685,133,73,8,145,0,114,0,4158
"42017102002",2398,130,41,0,69,0,54,3,2695
"42017102003",3446,145,83,0,219,0,93,0,3986
"42017102004",4137,73,30,0,343,0,28,0,4611
"42017102102",3137,167,0,0,27,20,0,0,3351
"42017102104",5019,103,47,39,272,33,223,29,5765
"42017102300",5186,379,24,4,94,32,228,28,5975
"42017102401",3344,295,69,41,16,0,51,0,3816
"42017102402",4301,314,15,0,48,34,55,6,4773
"42017102500",3694,241,26,0,250,0,68,0,4279
"42017102600",1645,154,11,92,190,0,126,0,2218
"42017102700",4437,362,171,41,147,0,34,34,5226
"42017102801",3114,242,29,0,62,0,0,0,3447
"42017103101",1928,429,37,15,7,0,96,0,2512
"42017103102",1648,128,81,0,127,0,202,5,2191
"42017103103",3568,498,145,10,94,0,102,103,4520
"42017103300",1990,38,0,0,15,0,31,0,2074
"42017103400",4340,339,0,0,319,0,30,57,5085
"42017103700",3223,136,27,0,36,0,0,0,3422
"42017103800",1063,112,7,2,22,0,33,0,1239
"42017103900",3577,328,0,0,35,0,57,0,3997
"42017104000",6331,254,0,0,246,67,73,93,7064
"42017104100",1825,134,9,0,116,19,224,83,2410
"42017104201",2641,49,91,0,177,0,163,0,3121
"42017104203",5014,253,0,0,86,0,175,0,5528
"42017104204",4128,180,30,0,260,0,13,0,4611
"42017104301",2420,118,9,0,51,0,194,0,2792
"42017104303",4305,121,24,0,264,16,94,0,4824
"42017104304",1251,30,0,0,34,0,0,0,1315
"42017104400",2267,101,0,0,151,0,67,0,2586
"42017104502",6828,207,11,0,397,0,17,0,7460
"42017104503",3766,252,11,0,240,68,246,16,4599
"42017104505",5115,341,49,0,577,5,59,110,6256
"42017104506",2064,119,7,0,81,5,38,0,2314
"42017104601",4233,112,0,0,104,0,120,0,4569
"42017104603",4734,195,0,0,222,1,83,1,5236
"42017104604",5135,219,74,2,64,0,47,27,5568
"42017104701",2915,179,48,11,108,19,124,0,3404
"42017104702",2062,131,61,0,116,17,143,16,2546
"42017104703",2032,89,8,0,66,6,103,0,2304
"42017104800",2009,156,5,0,77,0,38,33,2318
"42017104901",6862,179,1,0,510,0,36,2,7590
"42017104902",6354,254,19,0,437,0,157,0,7221
"42017105003",4439,54,0,0,296,15,152,0,4956
"42017105004",4885,119,31,0,392,0,24,0,5451
"42017105006",5224,176,0,0,437,1,130,0,5968
"42017105008",3287,69,19,0,321,9,37,0,3742
"42017105009",2935,216,64,0,78,0,38,0,3331
"42017105010",3689,91,24,0,186,0,41,0,4031
"42017105011",3024,150,0,0,358,0,84,0,3616
"42017105012",2835,86,8,0,33,0,52,0,3014
"42017105013",5399,44,58,0,436,0,91,0,6028
"42017105100",2809,42,10,3,212,0,33,0,3109
"42017105202",4406,324,0,0,353,0,100,0,5183
"42017105203",1731,75,14,10,219,13,62,0,2124
"42017105206",4087,84,29,0,532,0,85,0,4817
"42017105207",4231,148,21,0,603,7,215,0,5225
"42017105208",2007,91,22,0,439,0,162,0,2721
"42017105300",2011,75,9,0,15,0,0,0,2110
"42017105400",7228,268,81,0,374,282,261,34,8528
"42017105505",3686,31,132,1,170,0,79,0,4099
"42017105506",3223,118,45,1,610,0,67,10,4074
"42017105507",6794,177,71,1,437,0,277,0,7757
"42017105508",3111,36,44,0,336,0,221,0,3748
"42017105509",3917,82,199,0,345,0,120,0,4663
"42017105510",3794,68,114,14,743,0,180,13,4926
"42017105511",3638,77,96,0,329,29,34,0,4203
"42017105600",2087,77,72,12,158,0,81,0,2487
"42017105702",1988,167,249,32,172,0,162,14,2784
"42017105704",4524,223,1217,113,692,70,897,81,7817
"42017105801",4608,41,818,119,610,84,146,64,6490
"42017105805",4043,361,206,15,575,64,430,5,5699
"42017105807",2518,383,308,82,482,33,211,0,4017
"42017105808",3008,255,105,0,175,0,122,0,3665
"42017105809",3818,179,16,0,391,0,322,0,4726
"42017105810",2200,74,7,0,32,24,79,8,2424
"42017105811",5221,280,208,13,138,18,102,0,5980
"42017105812",1504,50,30,15,42,5,54,5,1705
"42017105900",1577,171,28,7,55,12,36,3,1889
"42017106000",3585,162,198,2,236,2,121,2,4308
"42017106100",1958,185,29,32,70,18,7,10,2309
"42017106200",5338,250,398,0,905,8,589,15,7503
"42017106300",6252,292,197,3,418,9,707,43,7921
"42017106401",6455,381,50,0,748,54,413,54,8155
"42017106402",6956,207,33,90,112,0,232,0,7630
"42017106500",5732,417,190,0,178,0,353,35,6905
"42017106600",1820,105,0,3,48,10,57,10,2053
"42017980000",0,0,0,0,0,0,0,0,0
"42019902100",1983,241,0,0,43,0,15,0,2282
"42019902200",1347,441,72,14,33,11,0,20,1938
"42019902300",1757,1078,39,73,3,31,21,135,3137
"42019902400",1326,679,48,61,31,17,75,19,2256
"42019902500",2346,1223,21,10,142,63,11,0,3816
"42019902600",2315,308,67,0,31,0,10,15,2746
"42019902700",1810,354,29,0,33,10,25,0,2261
"42019902800",2439,188,36,11,90,16,17,6,2803
"42019902900",1798,43,0,0,59,0,17,0,1917
"42019903000",4283,137,0,0,61,7,132,0,4620
"42019903100",2295,293,34,0,4,47,0,0,2673
"42019910100",3644,654,20,12,15,26,2,0,4373
"42019910200",4455,475,11,0,55,18,51,4,5069
"42019910301",3351,1295,12,98,49,0,52,36,4893
"42019910302",3388,454,67,0,86,30,90,14,4129
"42019910400",1576,799,22,18,151,84,0,3,2653
"42019910500",8,0,0,0,0,0,0,0,8
"42019910600",3660,578,4,0,56,57,56,19,4430
"42019910700",2672,183,10,0,77,8,0,0,2950
"42019910800",2509,231,11,0,58,0,24,0,2833
"42019910900",4569,267,56,0,56,23,33,0,5004
"42019911000",5975,490,5,0,117,5,118,20,6730
"42019911100",3987,363,36,0,89,140,0,109,4724
"42019911200",4681,528,20,0,8,0,5,0,5242
"42019911300",4846,545,8,0,17,13,56,6,5491
"42019911400",3047,346,0,0,54,0,0,0,3447
"42019911501",5051,190,0,0,7,0,0,0,5248
"42019911502",3828,347,0,0,79,4,57,10,4325
"42019911600",4644,293,0,0,73,13,31,13,5067
"42019911700",4011,220,0,0,58,0,0,0,4289
"42019911800",5688,349,21,0,25,4,5,0,6092
"42019911900",4245,293,3,0,46,2,12,0,4601
"42019912001",4690,111,75,0,125,11,35,0,5047
"42019912002",4160,68,104,11,278,0,57,0,4678
"42019912101",4041,57,0,0,54,17,17,0,4186
"42019912102",2211,166,13,0,175,163,0,0,2728
"42019912200",3054,47,126,0,51,0,204,0,3482
"42019912301",5780,27,12,0,263,9,167,0,6258
"42019912303",2657,27,27,0,175,2,55,0,2943
"42019912304",3282,30,0,0,35,0,0,0,3347
"42019912401",7826,115,11,0,514,0,95,0,8561
"42019912402",5711,262,48,0,238,0,80,0,6339
"42019912700",6874,301,49,0,51,0,129,0,7404
"42019912800",5389,85,3,5,0,0,55,0,5537
"42021000100",560,379,45,105,0,7,0,25,1121
"42021000200",347,142,72,76,41,37,4,7,726
"42021000300",889,417,195,144,37,219,0,140,2041
"42021000500",899,264,50,271,43,89,9,6,1631
"42021000600",974,423,93,59,38,165,0,24,1776
"42021000700",1910,260,9,57,157,117,17,31,2558
"42021001200",2326,714,121,110,67,51,1,40,3430
"42021010100",3741,280,9,0,85,12,85,0,4212
"42021010200",1137,243,32,14,9,0,0,11,1446
"42021010300",2081,254,30,0,24,26,8,3,2426
"42021010500",2954,367,36,7,156,9,0,0,3529
"42021010600",2155,158,5,10,28,12,12,0,2380
"42021010700",2593,217,15,8,6,0,7,0,2846
"42021010801",4571,547,90,7,91,165,46,156,5673
"42021011000",1238,311,10,0,16,0,40,8,1623
"42021011100",4574,120,15,2,43,65,36,1,4856
"42021011200",1943,145,23,0,84,0,21,6,2222
"42021011300",4366,418,74,10,54,33,21,32,5008
"42021011400",2885,474,8,3,14,5,6,19,3414
"42021011500",3951,296,0,4,0,5,8,10,4274
"42021011600",2139,475,0,16,15,7,4,16,2672
"42021011700",2085,324,1,0,0,0,27,0,2437
"42021011800",3442,440,0,1,34,4,6,0,3927
"42021011900",3138,504,0,0,0,0,0,0,3642
"42021012000",5225,623,8,0,36,1,33,11,5937
"42021012100",2084,315,1,0,18,10,14,7,2449
"42021012200",3179,467,12,2,18,14,45,21,3758
"42021012300",1527,281,0,0,35,10,1,17,1871
"42021012400",3285,309,6,7,15,2,18,21,3663
"42021012500",4581,536,84,19,46,17,23,0,5306
"42021012600",2924,327,0,0,0,7,44,0,3302
"42021012700",2303,279,8,0,21,0,6,12,2629
"42021012800",3478,512,0,0,100,18,19,0,4127
"42021012900",2912,471,0,13,12,30,32,4,3474
"42021013000",2043,474,15,0,24,0,5,0,2561
"42021013100",2344,296,0,0,3,0,3,0,2646
"42021013200",3352,434,0,0,24,6,11,15,3842
"42021013300",5060,669,0,0,0,94,8,94,5925
"42021013400",1134,626,301,167,64,47,15,9,2363
"42021013500",1377,610,73,96,72,184,6,96,2514
"42021013600",1898,654,105,578,67,295,10,92,3699
"42021013700",2575,385,0,9,43,13,21,2,3048
"42023960100",1494,314,2,26,27,2,12,8,1885
"42023960200",2618,278,0,2,35,4,8,6,2951
"42025020102",3923,640,57,10,43,0,61,73,4807
"42025020103",3625,589,0,0,69,6,118,0,4407
"42025020105",4333,487,330,0,220,0,576,0,5946
"42025020106",1890,90,0,0,11,39,94,0,2124
"42025020200",5160,636,15,7,84,49,65,34,6050
"42025020300",5026,786,70,20,143,26,284,112,6467
"42025020400",2914,692,0,56,102,46,151,125,4086
"42025020500",6009,606,6,32,188,0,38,185,7064
"42025020600",4635,369,0,161,129,0,41,0,5335
"42025020700",4542,403,89,12,105,35,105,35,5326
"42025020800",8110,536,8,0,54,14,76,42,8840
"42025020900",4735,445,0,0,55,117,213,82,5647
"42027010100",4111,213,9,0,9,2,9,5,4358
"42027010200",2724,277,0,0,4,2,11,0,3018
"42027010300",2450,527,11,24,44,13,19,26,3114
"42027010400",3206,278,0,0,37,0,10,0,3531
"42027010500",4874,422,20,5,38,3,23,6,5391
"42027010600",3162,637,0,0,4,0,82,0,3885
"42027010700",5310,266,3,0,76,3,155,0,5813
"42027010800",4497,818,5,0,77,0,46,4,5447
"42027010900",6848,704,1,8,49,22,50,3,7685
"42027011000",7037,278,217,0,61,26,72,0,7691
"42027011100",5029,810,29,89,67,15,34,15,6088
"42027011201",4928,374,0,0,46,57,84,0,5489
"42027011300",4633,1591,725,487,704,508,258,217,9123
"42027011400",5634,493,161,0,515,168,72,24,7067
"42027011501",2442,148,173,13,303,63,127,0,3269
"42027011502",3927,1670,253,27,979,659,179,0,7694
"42027011600",2717,180,181,0,352,0,39,0,3469
"42027011702",4882,162,45,0,182,6,6,0,5283
"42027011800",4248,489,168,0,257,0,149,43,5354
"42027011901",2553,92,10,0,52,0,29,0,2736
"42027011902",6102,338,129,0,777,156,112,30,7644
"42027012000",1784,2510,50,54,265,357,54,64,5138
"42027012100",11,210,63,39,12,31,0,23,389
"42027012200",201,30,9,0,54,36,36,47,413
"42027012300",1550,405,0,0,184,5,11,63,2218
"42027012400",2045,2109,62,83,416,295,85,51,5146
"42027012500",623,3322,29,132,182,274,37,163,4762
"42027012600",1063,2106,69,126,121,216,42,129,3872
"42027012700",2586,216,137,43,98,37,87,20,3224
"42027012800",3030,771,91,174,946,513,346,0,5871
"42027981202",10,0,0,0,6,0,0,0,16
"42029300101",2622,34,60,0,388,15,73,0,3192
"42029300103",1785,245,197,10,301,71,78,0,2687
"42029300104",4597,90,22,33,404,0,136,0,5282
"42029300106",3157,132,342,0,847,0,85,0,4563
"42029300107",3650,14,6,0,584,29,72,0,4355
"42029300108",4265,511,101,4,1202,87,75,3,6248
"42029300109",3177,127,25,9,309,0,157,7,3811
"42029300201",4285,119,163,8,383,26,254,0,5238
"42029300202",4761,160,38,0,563,14,120,0,5656
"42029300301",3481,58,113,18,298,22,104,0,4094
"42029300302",3528,95,16,0,43,0,70,0,3752
"42029300303",2383,262,12,5,161,0,82,122,3027
"42029300400",2657,133,60,165,213,29,109,0,3366
"42029300501",4092,88,30,18,188,0,75,0,4491
"42029300502",3508,186,45,7,73,0,87,0,3906
"42029300600",4179,141,277,323,437,10,165,61,5593
"42029300700",3774,375,215,53,515,94,896,156,6078
"42029300800",3196,269,138,0,266,0,293,124,4286
"42029300900",1691,235,78,16,166,0,14,38,2238
"42029301000",6523,185,112,0,320,129,202,129,7600
"42029301100",2984,94,127,11,98,17,60,25,3416
"42029301300",5664,328,234,0,369,0,157,14,6766
"42029301401",2277,112,114,0,101,54,84,0,2742
"42029301402",4849,73,82,0,295,0,55,0,5354
"42029301500",2316,169,60,0,18,0,37,0,2600
"42029301600",2395,96,0,0,38,8,4,14,2555
"42029301700",1547,132,28,0,46,0,41,0,1794
"42029301800",4227,217,72,7,329,9,254,13,5128
"42029301900",3836,53,15,0,166,0,166,0,4236
"42029302000",4124,132,147,0,685,0,77,0,5165
"42029302101",5070,182,78,0,1075,82,625,0,7112
"42029302102",2515,153,352,71,425,0,16,24,3556
"42029302202",5176,238,288,0,1133,119,320,54,7328
"42029302203",4047,14,230,25,838,0,112,0,5266
"42029302204",4831,226,236,22,843,0,163,134,6455
"42029302300",2379,172,67,8,19,129,31,6,2811
"42029302400",2547,639,456,76,124,23,523,319,4707
"42029302500",3162,700,252,65,54,2,102,25,4362
"42029302600",1857,2022,286,267,365,0,615,367,5779
"42029302702",3533,236,207,51,651,233,253,69,5233
"42029302703",3555,124,64,0,155,0,0,0,3898
"42029302704",4691,157,87,0,441,9,178,0,5563
"42029302705",3144,279,64,18,543,0,155,32,4235
"42029302706",3553,734,49,10,85,4,77,7,4519
"42029302802",4958,21,0,0,7,0,30,0,5016
"42029302803",1850,69,0,0,0,0,20,0,1939
"42029302804",3609,158,84,0,46,0,0,0,3897
"42029302805",6674,209,175,16,284,0,256,0,7614
"42029302901",4291,49,97,21,241,28,176,3,4906
"42029302902",5274,276,213,33,358,11,77,0,6242
"42029303000",2568,108,110,10,221,6,32,0,3055
"42029303100",3842,53,78,0,273,0,82,0,4328
"42029303301",2671,78,54,0,101,0,469,24,3397
"42029303302",4634,218,64,0,0,0,195,0,5111
"42029303401",2906,456,175,0,551,52,1868,424,6432
"42029303402",1460,145,104,34,164,43,635,134,2719
"42029303501",3587,112,59,14,293,0,203,3,4271
"42029303502",2666,0,37,0,252,0,130,0,3085
"42029303801",3441,264,38,0,199,0,120,23,4085
"42029303802",7039,183,375,0,983,1,90,1,8672
"42029303901",3084,520,15,15,26,27,27,23,3737
"42029303902",4864,204,113,1,227,12,33,117,5571
"42029304000",3774,166,228,0,687,0,157,0,5012
"42029304101",2838,166,610,78,656,7,342,7,4704
"42029304102",2274,145,393,104,273,149,209,103,3650
"42029304201",5087,201,535,105,840,0,264,0,7032
"42029304300",7215,113,51,0,251,0,162,0,7792
"42029304403",3302,166,93,0,333,38,103,0,4035
"42029304404",4007,397,170,41,491,0,103,0,5209
"42029304405",5441,197,209,0,379,41,35,22,6324
"42029304406",2883,79,154,7,90,0,51,0,3264
"42029304501",5991,89,0,0,2434,6,231,6,8757
"42029304502",2795,28,32,2,81,12,34,12,2996
"42029304600",3166,140,115,2,81,0,26,0,3530
"42029304900",6806,701,47,0,129,0,123,0,7806
"42029305000",1541,102,0,0,20,15,3,12,1693
"42029305101",3688,249,146,0,197,0,76,9,4365
"42029305102",4001,178,478,32,78,30,138,69,5004
"42029305300",4402,444,1414,80,898,72,445,74,7829
"42029305400",1563,751,781,608,191,133,362,703,5092
"42029305500",851,422,1220,655,180,103,567,383,4381
"42029305600",670,258,909,1163,199,121,396,224,3940
"42029305700",1075,253,740,133,105,37,192,237,2772
"42029306000",6191,220,638,8,481,0,392,15,7945
"42029306300",2464,28,169,33,132,28,961,28,3843
"42029306501",3812,158,86,0,222,96,107,96,4577
"42029306503",2121,318,42,32,86,0,967,301,3867
"42029306504",4470,357,0,0,254,21,1209,299,6610
"42029306600",3077,39,51,0,57,0,64,0,3288
"42029306700",4083,243,5,7,98,6,118,107,4667
"42029306800",1479,118,25,2,90,0,60,23,1797
"42029306900",5320,253,12,0,247,0,350,48,6230
"42029307000",4592,455,97,0,242,46,377,126,5935
"42029307100",2093,125,0,0,63,0,173,3,2457
"42029307200",1197,48,21,0,38,11,54,0,1369
"42029307300",2727,368,377,17,200,38,100,103,3930
"42029307400",3073,122,217,1,246,0,257,19,3935
"42029307700",2468,114,0,0,9,0,154,0,2745
"42029307800",2244,140,69,0,45,0,120,0,2618
"42029307900",2616,395,112,0,157,23,530,160,3993
"42029308000",3194,1005,240,109,144,236,681,603,6212
"42029308101",4006,182,50,0,138,0,148,0,4524
"42029308102",3478,434,199,17,308,12,644,323,5415
"42029308200",2272,226,133,0,89,0,178,0,2898
"42029310400",3,4,0,0,0,0,0,0,7
"42029311000",5778,196,160,212,214,0,24,79,6663
"42029311100",3072,69,76,0,351,0,26,0,3594
"42029311200",1942,116,4,1,24,0,134,0,2221
"42029311300",2664,109,0,0,287,71,90,0,3221
"42029311401",4433,389,1345,240,540,65,355,37,7404
"42029311403",2806,104,249,21,98,17,18,17,3330
"42029311404",3362,522,68,0,90,0,80,79,4201
"42029311500",3067,187,1,0,73,4,53,5,3390
"42029311600",885,232,579,173,132,24,167,118,2310
"42029311700",8267,245,330,0,658,54,2883,172,12609
"42029311800",3384,136,265,13,113,36,228,37,4212
"42031160101",1672,210,3,0,0,0,0,0,1885
"42031160102",3151,1700,40,163,27,55,57,69,5262
"42031160200",2967,464,1,0,55,13,7,0,3507
"42031160300",4040,446,27,0,86,20,11,0,4630
"42031160400",3283,384,2,10,25,0,21,0,3725
"42031160500",3119,386,0,4,43,4,8,0,3564
"42031160600",2611,1271,44,3,125,94,0,0,4148
"42031160700",3458,679,3,0,66,9,19,0,4234
"42031160800",2878,465,12,6,23,3,33,0,3420
"42031160900",3151,482,2,0,39,10,6,6,3696
"42033330100",3942,501,0,0,8,0,0,0,4451
"42033330200",2705,558,0,0,7,22,63,107,3462
"42033330300",3154,871,88,26,77,94,64,32,4406
"42033330400",5384,326,0,0,43,36,136,0,5925
"42033330500",3749,721,12,0,34,36,36,16,4604
"42033330600",2651,297,0,0,48,0,0,0,2996
"42033330700",1684,294,0,5,6,12,16,10,2027
"42033330800",5717,1128,0,0,46,27,60,15,6993
"42033330900",4103,885,0,0,121,3,0,6,5118
"42033331000",4342,741,0,0,26,2,0,0,5111
"42033331100",2753,553,17,1,68,0,0,92,3484
"42033331200",2217,471,0,0,9,0,0,35,2732
"42033331300",3614,320,15,0,102,44,0,0,4095
"42033331401",2998,485,14,0,41,0,19,16,3573
"42033331402",2808,521,8,0,24,31,24,11,3427
"42033331500",1582,320,0,0,10,3,0,0,1915
"42033331600",1830,440,0,15,10,5,0,0,2300
"42033331700",3758,632,9,0,15,17,4,0,4435
"42033331800",2537,477,7,0,24,6,15,8,3074
"42033331900",1851,378,0,0,38,2,19,0,2288
"42035030100",2238,615,14,4,39,7,15,42,2974
"42035030200",4560,682,16,12,66,15,47,12,5410
"42035030300",3738,212,0,0,78,0,10,0,4038
"42035030400",4604,210,17,0,82,0,59,0,4972
"42035030500",3447,399,11,3,91,47,36,15,4049
"42035030600",1218,897,28,0,110,61,5,27,2346
"42035030700",3449,1849,17,88,15,105,14,26,5563
"42035030800",3683,319,4,0,27,0,22,4,4059
"42035030900",3487,561,17,0,36,0,30,4,4135
"42037050100",4542,563,43,4,29,13,89,0,5283
"42037050200",4907,483,8,0,34,0,82,0,5514
"42037050300",4518,520,20,6,127,3,101,8,5303
"42037050400",3655,192,13,0,79,2,19,0,3960
"42037050500",3099,379,2,26,212,94,167,2,3981
"42037050600",4042,1096,30,0,122,23,109,195,5617
"42037050700",3554,944,76,50,170,48,0,0,4842
"42037050800",3006,460,1,0,52,1,56,0,3576
"42037050900",2773,261,3,67,31,4,0,4,3143
"42037051000",2081,382,68,76,23,8,115,0,2753
"42037051100",1723,1213,8,22,129,239,153,96,3583
"42037051200",3188,1646,14,106,0,45,75,0,5074
"42037051300",2520,363,16,22,33,37,41,26,3058
"42037051400",2476,211,0,0,40,0,30,57,2814
"42037051500",5024,453,0,0,71,5,76,3,5632
"42039110100",4980,1236,21,2,92,14,25,5,6375
"42039110201",3246,231,32,2,40,6,8,0,3565
"42039110202",2916,496,14,3,10,21,24,0,3484
"42039110300",3808,725,28,2,57,8,44,3,4675
"42039110400",2525,302,0,0,18,3,3,0,2851
"42039110501",1662,143,0,0,9,0,46,7,1867
"42039110502",3209,287,22,5,86,7,10,0,3626
"42039110600",2552,311,0,0,30,0,11,0,2904
"42039110700",3190,349,0,0,42,0,33,2,3616
"42039110800",4404,667,25,7,71,48,6,1,5229
"42039110900",2641,395,0,0,14,8,5,0,3063
"42039111000",2190,186,0,0,25,2,3,0,2406
"42039111100",1672,1043,7,35,29,46,0,24,2856
"42039111200",1806,467,0,7,34,11,7,42,2374
"42039111300",5119,354,19,3,103,26,63,9,5696
"42039111400",4130,450,51,78,51,44,28,0,4832
"42039111500",3715,961,120,0,184,160,92,26,5258
"42039111600",2207,1090,132,260,53,81,35,23,3881
"42039111700",2475,260,18,6,103,16,14,0,2892
"42039111800",4719,585,92,24,125,0,109,16,5670
"42039111900",3094,357,7,6,28,5,5,0,3502
"42039112001",2072,298,0,0,14,0,14,1,2399
"42039112002",1100,182,5,0,4,0,0,0,1291
"42041010100",3968,513,305,0,331,186,310,0,5613
"42041010201",5126,121,0,0,245,99,67,99,5757
"42041010203",1833,276,112,2,740,113,35,87,3198
"42041010204",4135,305,26,13,364,226,146,0,5215
"42041010300",3177,545,72,24,604,90,338,51,4901
"42041010400",3427,108,81,17,155,74,56,23,3941
"42041010500",3244,111,27,0,417,12,88,0,3899
"42041010600",3340,514,180,10,477,60,241,0,4822
"42041010700",3370,130,122,0,47,0,47,10,3726
"42041010800",2936,389,31,0,207,30,135,19,3747
"42041010900",4221,88,73,0,205,13,219,13,4832
"42041011002",1857,164,115,0,113,54,23,104,2430
"42041011101",3035,100,7,0,216,71,9,14,3452
"42041011102",3593,356,51,121,263,20,127,0,4531
"42041011200",1330,92,22,0,89,0,81,0,1614
"42041011301",3759,95,176,0,510,6,140,0,4686
"42041011302",6347,96,40,0,1115,18,265,0,7881
"42041011303",5930,127,0,0,370,0,82,16,6525
"42041011304",4125,143,144,11,535,17,123,13,5111
"42041011305",3846,184,181,0,692,9,160,3,5075
"42041011400",3754,382,271,0,253,0,142,0,4802
"42041011500",4024,105,0,0,106,49,114,0,4398
"42041011601",6631,477,259,179,338,23,59,0,7966
"42041011602",3551,9,68,0,67,0,23,0,3718
"42041011605",3996,172,57,0,322,15,11,6,4579
"42041011700",5852,50,2,1,47,0,135,0,6087
"42041011801",6702,558,87,0,641,287,157,342,8774
"42041011802",6042,229,125,31,311,32,139,23,6932
"42041011803",5939,501,66,0,65,0,62,73,6706
"42041011901",4617,487,93,0,190,11,54,0,5452
"42041011902",5103,429,91,1,97,36,226,24,6007
"42041012000",3552,373,196,181,291,69,182,0,4844
"42041012100",1614,300,108,57,126,109,125,60,2499
"42041012200",1110,274,112,96,106,122,32,79,1931
"42041012300",764,306,50,206,128,125,6,37,1622
"42041012400",4822,449,83,398,258,16,76,0,6102
"42041012501",3013,242,45,0,254,27,280,27,3888
"42041012502",6216,142,41,0,424,24,45,25,6917
"42041012600",5701,267,142,0,29,0,151,0,6290
"42041012701",4766,329,1,0,188,0,0,0,5284
"42041012702",4075,269,21,1,120,22,93,0,4601
"42041012800",6941,455,99,2,385,55,185,11,8133
"42041012900",1091,181,28,0,36,11,5,12,1364
"42041013000",6116,586,6,24,106,0,36,24,6898
"42041013101",8261,970,188,49,169,112,99,32,9880
"42041013102",1331,1648,11,137,19,38,19,0,3203
"42041013200",2590,1405,153,19,171,71,142,144,4695
"42041981001",0,0,0,0,0,0,0,0,0
"42041981606",22,0,0,0,0,0,0,0,22
"42043020100",1405,327,661,458,183,75,66,97,3272
"42043020300",610,262,549,278,65,87,70,83,2004
"42043020400",933,161,353,279,72,15,101,143,2057
"42043020500",1713,206,777,506,195,18,372,37,3824
"42043020600",248,47,571,209,27,27,94,43,1266
"42043020700",178,115,1301,756,165,113,148,108,2884
"42043020800",886,358,888,345,292,13,49,21,2852
"42043020900",1176,136,960,641,441,373,512,204,4443
"42043021100",300,406,1393,312,144,150,277,385,3367
"42043021200",203,188,953,443,177,115,251,201,2531
"42043021300",857,698,899,1453,1217,831,1336,1040,8331
"42043021400",487,739,1160,1612,638,455,617,1163,6871
"42043021500",658,179,1825,321,314,396,333,298,4324
"42043021600",506,121,1454,273,362,177,449,117,3459
"42043021700",2163,109,2040,445,835,249,616,153,6610
"42043021800",1393,111,439,0,131,0,57,4,2135
"42043021901",3175,143,636,0,262,0,60,0,4276
"42043021903",2031,92,1078,36,246,26,275,33,3817
"42043021904",2745,149,1685,63,449,11,46,11,5159
"42043022000",2176,114,2083,504,458,0,460,0,5795
"42043022100",2843,215,619,59,345,13,318,33,4445
"42043022200",1282,254,622,318,245,248,255,31,3255
"42043022300",4120,242,616,116,546,0,781,0,6421
"42043022401",3349,168,66,12,198,13,131,0,3937
"42043022403",3997,311,531,368,782,25,304,12,6330
"42043022501",5062,112,221,0,132,188,8,0,5723
"42043022502",4906,456,89,1,151,0,201,0,5804
"42043022601",5736,158,351,114,366,0,236,0,6961
"42043022604",4989,225,471,0,903,0,286,0,6874
"42043022605",2660,86,814,25,644,82,218,71,4600
"42043022606",1523,79,901,206,222,93,158,57,3239
"42043022701",2389,99,759,149,272,158,32,102,3960
"42043022702",2871,86,636,285,724,215,143,31,4991
"42043022800",3773,194,477,1,881,71,884,127,6408
"42043022900",3489,190,1425,342,1234,66,773,74,7593
"42043023000",1206,79,215,73,108,51,81,40,1853
"42043023100",1106,65,159,4,177,8,163,4,1686
"42043023300",1435,380,1544,196,257,388,297,437,4934
"42043023400",736,122,475,171,19,218,125,79,1945
"42043023500",1579,228,122,118,191,11,237,101,2587
"42043023601",2708,123,0,0,32,14,19,0,2896
"42043023602",3832,620,354,166,270,65,106,302,5715
"42043023700",974,284,213,38,33,136,33,137,1848
"42043023800",2720,382,343,38,263,132,184,0,4062
"42043023900",2608,316,24,7,161,48,143,48,3355
"42043024001",5724,433,13,10,31,29,2,106,6348
"42043024002",2730,202,10,19,31,0,61,0,3053
"42043024101",1024,325,79,40,321,76,47,112,2024
"42043024102",3112,772,0,470,330,367,83,462,5596
"42043024104",4544,344,0,39,1009,48,138,12,6134
"42043024105",4197,286,169,0,450,19,255,0,5376
"42043024200",2198,228,113,49,134,54,214,4,2994
"42043024300",3090,404,19,0,246,21,211,21,4012
"42043024400",3949,332,9,0,176,101,199,29,4795
"42043024502",5325,311,78,4,133,0,126,0,5977
"42043024503",5341,299,216,124,548,11,296,83,6918
"42043024600",8750,212,344,37,168,0,100,0,9611
"42043024700",5451,399,16,2,318,20,166,11,6383
"42043024800",7599,526,20,0,66,61,36,10,8318
"42043024900",1926,288,9,15,11,25,9,10,2293
"42043025000",2185,522,0,0,35,57,83,34,2916
"42043025100",3404,504,12,2,23,3,22,30,4000
"42043025200",3255,400,40,8,84,0,15,20,3822
"42043025300",3681,268,0,1,24,2,48,0,4024
"42043025400",2238,240,1,2,49,8,53,0,2591
"42045400301",515,310,3442,1175,266,218,291,150,6367
"42045400302",751,222,2071,369,216,37,182,9,3857
"42045400401",823,185,1659,587,1244,428,336,132,5394
"42045400402",742,98,2217,574,587,213,192,0,4623
"42045400500",965,169,1361,157,906,506,154,160,4378
"42045400600",2432,336,1307,63,655,148,150,35,5126
"42045400700",1642,495,1571,688,1245,563,484,315,7003
"42045400801",177,42,1627,223,125,124,38,8,2364
"42045400802",2278,85,775,279,224,129,175,11,3956
"42045400900",1191,49,130,5,211,40,66,0,1692
"42045401000",1589,85,137,0,27,0,9,0,1847
"42045401101",2219,194,467,51,154,0,226,8,3319
"42045401103",2859,37,192,0,246,39,38,0,3411
"42045401104",3509,186,196,0,268,0,173,75,4407
"42045401200",2952,301,200,1,190,35,25,35,3739
"42045401301",1194,55,200,163,685,25,183,0,2505
"42045401302",2098,145,182,176,288,8,128,0,3025
"42045401401",1500,188,206,7,165,4,50,31,2151
"42045401402",2629,236,592,137,141,8,192,66,4001
"42045401501",3320,178,120,0,74,40,72,0,3804
"42045401502",2571,162,674,317,527,38,5,11,4305
"42045401600",1037,37,498,34,91,0,6,0,1703
"42045401700",704,158,1288,65,388,69,139,0,2811
"42045401800",1299,162,2367,218,113,25,176,63,4423
"42045401900",2011,74,1554,165,374,41,21,17,4257
"42045402000",755,125,803,343,166,19,6,9,2226
"42045402100",277,49,4695,472,252,0,115,0,5860
"42045402200",71,17,1631,133,70,41,25,4,1992
"42045402300",84,10,2557,662,95,0,112,0,3520
"42045402400",197,71,2120,962,20,98,20,166,3654
"42045402500",151,95,1859,1058,66,6,154,58,3447
"42045402600",476,232,1942,669,32,64,11,219,3645
"42045402700",445,52,1526,427,109,0,56,10,2625
"42045402800",1460,90,3232,581,244,72,0,0,5679
"42045402900",59,101,2617,509,37,179,55,201,3758
"42045403001",2951,105,0,13,32,18,10,0,3129
"42045403002",1915,562,129,5,56,8,0,8,2683
"42045403101",2006,288,1147,116,58,0,146,0,3761
"42045403103",1604,140,643,51,226,0,53,0,2717
"42045403104",623,268,1024,538,25,13,26,77,2594
"42045403200",2793,246,1008,72,22,9,29,0,4179
"42045403300",3748,853,1393,30,632,0,169,56,6881
"42045403401",1422,81,763,306,80,109,25,150,2936
"42045403402",1863,435,846,274,265,135,120,135,4073
"42045403501",3243,244,201,121,340,0,129,0,4278
"42045403502",2325,307,232,8,138,0,0,0,3010
"42045403601",3307,345,62,0,262,29,15,23,4043
"42045403602",1540,55,79,0,164,5,27,0,1870
"42045403701",1406,180,23,0,18,0,31,37,1695
"42045403702",2109,278,0,1,28,10,11,0,2437
"42045403800",4951,544,249,61,412,0,77,80,6374
"42045403901",2640,354,0,0,256,0,55,6,3311
"42045403902",3450,158,0,0,91,0,14,15,3728
"42045404003",1505,179,124,12,357,84,25,0,2286
"42045404004",5400,234,30,0,298,11,75,2,6050
"42045404101",5071,685,286,167,124,17,69,134,6553
"42045404102",3446,357,799,157,585,101,293,55,5793
"42045404103",2932,245,84,9,41,52,19,25,3407
"42045404300",1685,268,261,43,116,142,32,6,2553
"42045404400",404,217,823,180,28,5,74,50,1781
"42045404500",789,268,2588,885,360,251,538,268,5947
"42045404600",333,40,1184,570,113,58,105,64,2467
"42045404700",311,369,667,644,86,58,23,78,2236
"42045404800",148,91,1178,386,90,120,199,140,2352
"42045404900",27,79,796,308,27,71,42,112,1462
"42045405000",16,35,1193,560,25,66,10,53,1958
"42045405100",43,41,1388,694,76,27,196,89,2554
"42045405200",120,46,1747,1351,121,66,124,186,3761
"42045405300",262,234,1218,482,180,218,367,243,3204
"42045405400",231,271,1004,469,55,72,58,209,2369
"42045406100",1588,170,173,159,190,0,51,0,2331
"42045406201",2855,213,88,10,99,0,22,0,3287
"42045406202",4506,122,70,22,51,18,100,0,4889
"42045406300",1778,145,747,527,11,17,342,12,3579
"42045406401",411,26,1559,536,97,92,33,71,2825
"42045406402",134,33,561,510,87,36,30,6,1397
"42045406500",1022,317,328,62,45,0,57,0,1831
"42045406600",1404,408,471,80,22,18,0,57,2460
"42045406700",2604,229,257,225,113,35,31,5,3499
"42045406801",3309,300,671,1,198,39,21,13,4552
"42045406802",3293,251,582,77,75,18,17,0,4313
"42045406803",6124,420,826,194,505,0,161,182,8412
"42045406902",5486,49,202,5,56,0,40,0,5838
"42045406903",5020,82,0,0,115,9,0,0,5226
"42045406904",4267,291,266,0,225,28,15,0,5092
"42045407000",2125,100,130,12,184,1,61,1,2614
"42045407101",3567,64,37,6,239,15,90,22,4040
"42045407102",3198,63,20,0,96,0,111,7,3495
"42045407201",4117,271,228,0,307,0,222,49,5194
"42045407202",2694,179,16,1,89,0,21,0,3000
"42045407401",2968,73,268,46,523,31,65,15,3989
"42045407404",2568,102,111,5,215,0,37,17,3055
"42045407501",1982,122,129,124,50,0,10,0,2417
"42045407502",2182,198,282,12,54,30,52,18,2828
"42045407600",4300,97,242,37,284,3,283,3,5249
"42045407700",1642,143,610,73,200,4,21,0,2693
"42045407801",3894,152,89,8,102,0,7,7,4259
"42045407802",6205,148,0,1,429,0,38,0,6821
"42045407803",4819,98,68,0,233,27,85,0,5330
"42045407804",4222,124,8,0,209,0,26,0,4589
"42045407805",1537,37,27,0,74,0,14,0,1689
"42045407806",1318,27,143,0,100,0,0,0,1588
"42045407901",3440,68,120,18,392,26,69,10,4143
"42045407902",2348,31,40,4,243,13,68,0,2747
"42045407903",2684,129,300,29,388,0,37,1,3568
"42045408001",5579,438,0,0,568,0,59,231,6875
"42045408002",3280,167,95,19,196,0,0,0,3757
"42045408101",4301,156,40,0,395,0,46,0,4938
"42045408102",3062,54,84,5,326,10,33,10,3584
"42045408103",3309,127,221,24,397,9,72,21,4180
"42045408300",2890,34,88,16,118,8,58,0,3212
"42045408400",1506,58,24,20,46,0,5,0,1659
"42045408500",3471,156,63,0,298,43,48,11,4090
"42045408600",3135,91,34,3,270,50,76,49,3708
"42045408700",4348,94,49,17,259,73,86,0,4926
"42045408800",4082,229,199,0,421,14,188,0,5133
"42045408900",2562,78,167,0,203,0,27,0,3037
"42045409000",2852,95,19,0,559,0,18,0,3543
"42045409100",3938,324,20,0,99,16,103,1,4501
"42045409200",3694,144,137,0,127,0,35,0,4137
"42045409300",2216,54,32,0,97,23,7,0,2429
"42045409400",2559,24,61,0,150,0,0,6,2800
"42045409500",4359,132,95,1,85,26,27,29,4754
"42045409601",3618,149,123,0,756,0,52,19,4717
"42045409602",1880,484,202,41,155,0,80,0,2842
"42045409701",4528,216,158,3,744,8,114,11,5782
"42045409702",438,22,21,5,4,0,14,0,504
"42045409802",3133,440,70,21,279,42,93,61,4139
"42045409803",5546,322,545,18,536,0,310,0,7277
"42045409902",4296,199,4,0,314,0,28,0,4841
"42045409903",3585,56,50,1,176,0,72,0,3940
"42045409904",3165,255,45,35,108,19,14,6,3647
"42045410000",3486,49,22,0,407,0,14,0,3978
"42045410100",5767,260,28,3,553,0,119,0,6730
"42045410200",3009,107,19,1,546,20,100,0,3802
"42045410301",5347,90,60,1,565,53,172,0,6288
"42045410302",8073,355,344,0,629,5,51,0,9457
"42045410400",7788,145,241,12,844,44,63,0,9137
"42045410500",475,191,665,193,2303,1138,54,382,5401
"42045410601",2950,110,23,0,328,0,79,15,3505
"42045410602",4187,195,78,20,385,16,176,7,5064
"42045410700",219,201,2335,1223,53,67,71,196,4365
"42045410800",6600,112,121,0,708,9,33,0,7583
"42045980000",0,0,0,0,0,0,0,0,0
"42047950100",1458,66,19,0,0,0,23,0,1566
"42047950200",2726,288,3,0,27,0,8,8,3060
"42047950400",3500,366,0,0,31,28,13,2,3940
"42047950500",2075,304,0,0,26,50,36,4,2495
"42047950900",1976,374,7,0,16,5,32,0,2410
"42047951000",4697,283,43,0,32,9,0,0,5064
"42047951100",4706,424,0,0,24,13,82,0,5249
"42047951200",1992,224,0,0,31,0,0,0,2247
"42047951300",4628,271,36,16,135,0,15,0,5101
"42049000100",473,638,92,188,14,211,0,68,1684
"42049000200",3482,355,57,15,105,17,38,0,4069
"42049000300",1967,749,540,226,9,102,15,274,3882
"42049000400",763,384,447,333,87,235,53,25,2327
"42049000500",1371,736,244,208,94,208,96,391,3348
"42049000600",1580,835,542,569,92,235,194,285,4332
"42049000700",948,596,503,617,220,57,173,128,3242
"42049000800",556,751,383,270,187,348,42,259,2796
"42049000900",2309,827,333,356,357,106,111,70,4469
"42049001000",2347,792,157,188,171,97,108,135,3995
"42049001100",1769,541,37,61,340,211,131,220,3310
"42049001200",921,429,132,203,100,216,131,129,2261
"42049001300",287,223,364,485,71,337,94,87,1948
"42049001400",406,322,265,120,70,84,61,45,1373
"42049001500",442,543,581,889,40,295,98,484,3372
"42049001600",2316,520,1059,45,378,65,230,86,4699
"42049001700",871,387,688,333,362,213,325,272,3451
"42049001800",440,305,656,192,206,309,166,105,2379
"42049001900",802,483,152,83,53,67,15,74,1729
"42049002000",1988,515,153,66,215,44,45,109,3135
"42049002100",3339,184,35,99,206,12,65,0,3940
"42049002200",3276,633,13,32,232,18,118,0,4322
"42049002300",1905,553,34,135,113,62,183,28,3013
"42049002400",2535,375,233,41,6,71,53,7,3321
"42049002500",1415,239,227,272,154,53,54,8,2422
"42049002600",2491,396,580,50,287,97,189,31,4121
"42049002700",5094,725,642,66,346,6,191,15,7085
"42049002800",4065,681,221,0,110,11,40,18,5146
"42049002900",2551,133,101,24,142,0,0,0,2951
"42049003000",3206,539,236,18,244,241,70,357,4911
"42049010101",2796,558,0,0,46,0,10,0,3410
"42049010103",1770,238,0,0,12,8,13,8,2049
"42049010104",2047,181,30,0,42,7,19,5,2331
"42049010107",1255,213,7,15,15,9,14,0,1528
"42049010201",5210,623,42,12,128,24,50,67,6156
"42049010202",4489,825,6,0,21,120,29,41,5531
"42049010301",4356,374,4,2,47,27,15,0,4825
"42049010303",4815,274,43,0,128,0,103,0,5363
"42049010304",4146,241,38,14,43,0,45,41,4568
"42049010400",4146,160,18,9,41,0,40,7,4421
"42049010500",3131,754,127,135,157,40,63,0,4407
"42049010700",3004,476,18,18,245,65,157,31,4014
"42049010800",3396,220,25,0,50,5,67,0,3763
"42049010902",3799,329,47,8,202,0,121,0,4506
"42049010903",6046,312,138,0,182,11,66,44,6799
"42049010904",4697,125,134,10,134,0,62,0,5162
"42049011001",5154,954,39,102,424,121,182,50,7026
"42049011002",3442,600,86,2,210,133,83,14,4570
"42049011101",4122,626,18,10,174,0,52,21,5023
"42049011102",2859,166,72,0,148,0,118,8,3371
"42049011201",4362,205,40,0,81,0,56,0,4744
"42049011202",6325,168,53,0,133,13,28,0,6720
"42049011300",2531,389,107,0,209,17,33,17,3303
"42049011400",3395,259,0,0,54,0,172,30,3910
"42049011503",3337,186,81,0,111,6,117,0,3838
"42049011505",2530,149,0,0,22,0,82,0,2783
"42049011507",2690,305,18,0,55,18,95,0,3181
"42049011600",3342,748,0,0,60,0,159,43,4352
"42049011701",2597,253,19,0,27,41,18,9,2964
"42049011702",4437,493,2,13,157,3,31,5,5141
"42049011801",2525,173,6,0,48,0,39,0,2791
"42049011802",2789,262,4,0,76,18,3,11,3163
"42049011900",4616,1423,0,4,253,108,61,0,6465
"42049012001",2430,230,12,0,21,18,17,8,2736
"42049012002",2640,558,7,0,29,7,0,0,3241
"42049012100",6272,972,32,2,98,69,2,16,7463
"42049012201",5198,701,2,0,108,15,129,40,6193
"42049012202",3239,1165,39,129,322,34,213,0,5141
"42049012300",5338,522,123,2,87,0,54,0,6126
"42049012400",1147,145,25,0,44,15,26,0,1402
"42049980109",0,0,0,0,0,0,0,0,0
"42049990000",0,0,0,0,0,0,0,0,0
"42051260100",4433,700,135,12,54,80,0,58,5472
"42051260200",3686,436,55,17,65,63,3,63,4388
"42051260300",3222,560,7,17,120,12,0,0,3938
"42051260401",1915,479,0,0,0,13,0,0,2407
"42051260402",3836,590,0,0,51,0,12,11,4500
"42051260500",4677,1633,0,0,89,6,0,0,6405
"42051260600",3433,686,76,0,54,9,18,10,4286
"42051260700",2733,818,39,6,70,88,93,6,3853
"42051260800",2609,885,47,110,13,140,19,41,3864
"42051260900",4050,704,0,12,9,0,34,0,4809
"42051261000",2110,217,13,0,106,0,14,0,2460
"42051261100",2337,276,34,0,13,13,23,33,2729
"42051261200",1427,543,138,145,93,39,58,50,2493
"42051261300",4216,274,34,72,13,29,11,0,4649
"42051261401",1707,749,131,19,7,136,36,0,2785
"42051261402",1670,497,263,135,19,170,19,39,2812
"42051261500",3198,579,94,17,208,0,18,0,4114
"42051261600",2207,242,0,0,37,44,0,0,2530
"42051261700",2134,384,54,249,105,9,18,0,2953
"42051261800",2855,465,29,0,103,134,0,0,3586
"42051261900",1942,891,120,23,172,154,0,16,3318
"42051262000",3842,284,104,0,191,0,94,0,4515
"42051262100",1808,620,62,0,8,0,0,0,2498
"42051262200",2705,576,63,97,62,0,9,0,3512
"42051262300",1029,574,547,441,236,112,8,69,3016
"42051262400",2816,405,55,0,94,0,53,0,3423
"42051262500",2535,660,27,7,0,0,0,0,3229
"42051262600",2133,470,50,0,44,6,0,0,2703
"42051262701",2944,420,0,0,21,0,0,0,3385
"42051262702",2052,364,9,0,24,3,49,0,2501
"42051262800",5493,1113,77,68,104,0,27,0,6882
"42051262900",3583,1149,84,159,38,0,28,0,5041
"42051263000",2115,907,123,23,25,157,31,0,3381
"42051263100",3962,1293,11,8,37,20,27,20,5378
"42051263200",2057,415,0,0,0,0,0,0,2472
"42051263300",1317,292,35,56,22,2,0,4,1728
"42053530100",1224,188,0,0,8,2,6,0,1428
"42053530201",878,145,0,0,33,5,24,0,1085
"42053530300",967,183,0,0,18,0,5,0,1173
"42055010100",3510,895,16,1,22,0,16,0,4460
"42055010200",4109,334,17,0,52,13,80,0,4605
"42055010300",7782,1479,55,157,122,39,33,165,9832
"42055010400",7113,845,415,275,273,96,513,96,9626
"42055010500",6785,1138,132,7,67,15,189,86,8419
"42055010600",5126,219,467,21,419,3,107,0,6362
"42055010700",7131,705,56,0,223,0,96,232,8443
"42055010800",3189,208,82,39,197,32,348,24,4119
"42055010900",3061,575,241,90,340,44,739,104,5194
"42055011000",2657,1144,331,703,466,216,667,684,6868
"42055011100",2479,472,267,18,100,0,80,114,3530
"42055011200",1640,827,80,25,286,41,499,167,3565
"42055011301",5030,130,0,0,18,0,110,0,5288
"42055011302",5146,260,103,0,302,13,363,51,6238
"42055011400",4910,790,67,35,101,54,55,2,6014
"42055011500",5368,342,98,29,18,4,81,0,5940
"42055011600",5944,367,53,51,57,0,12,12,6496
"42055011700",7129,722,133,12,79,35,232,103,8445
"42055011800",3396,239,276,3,82,35,33,0,4064
"42055011900",6336,250,67,0,189,0,100,0,6942
"42055012000",5878,505,77,13,59,0,0,0,6532
"42055012100",3721,312,22,0,14,0,0,0,4069
"42055012200",2787,442,12,167,120,31,36,101,3696
"42055012300",3102,566,114,208,132,8,30,59,4219
"42055012400",2178,626,80,26,67,0,106,190,3273
"42055012501",5681,327,0,0,222,0,255,0,6485
"42055012502",3522,257,194,0,73,19,15,37,4117
"42057960100",3987,570,134,44,41,17,25,29,4847
"42057960200",4379,766,0,0,38,10,39,0,5232
"42057960300",4133,355,5,3,80,14,31,0,4621
"42059970100",5653,925,85,0,86,65,120,0,6934
"42059970200",2732,287,85,0,10,0,50,0,3164
"42059970300",3863,523,0,0,24,16,3,0,4429
"42059970400",3416,506,7,0,27,6,37,2,4001
"42059970501",1672,89,41,0,38,0,74,0,1914
"42059970502",2879,447,6,0,9,20,16,0,3377
"42059970600",2339,785,7,2,69,0,24,31,3257
"42059970700",2452,256,8,0,31,0,21,3,2771
"42059970800",3201,726,15,0,81,19,22,10,4074
"42061950100",1491,88,9,0,23,0,20,1,1632
"42061950200",3265,226,11,4,73,1,30,1,3611
"42061950300",3920,470,14,0,32,10,23,16,4485
"42061950400",4335,1153,25,54,36,23,7,14,5647
"42061950500",2889,452,2,0,63,9,5,0,3420
"42061950600",3806,283,0,15,33,13,13,4,4167
"42061950800",3116,368,2,2,15,25,32,0,3560
"42061950900",1452,561,124,132,118,42,10,15,2454
"42061951000",2182,439,17,3,100,31,14,14,2800
"42061951100",1652,250,0,2,13,2,11,2,1932
"42061951200",4314,566,8,4,7,10,12,43,4964
"42061951300",1942,339,17,0,11,1,3,0,2313
"42063960100",3340,851,16,51,9,3,2,31,4303
"42063960200",3728,1154,0,0,28,26,0,0,4936
"42063960300",1999,394,0,5,41,11,18,0,2468
"42063960400",3074,505,1,54,14,55,0,80,3783
"42063960500",3009,236,0,17,10,0,0,0,3272
"42063960600",4724,344,0,0,322,27,2,0,5419
"42063960700",5580,945,0,0,215,165,22,0,6927
"42063960800",3368,438,45,30,134,26,72,0,4113
"42063960900",2910,362,283,0,93,25,6,0,3679
"42063961000",1386,551,6,29,32,65,38,12,2119
"42063961101",2088,1828,30,110,26,73,0,9,4164
"42063961102",106,846,2,62,0,30,0,40,1086
"42063961200",2052,440,9,26,153,0,54,14,2748
"42063961300",3293,551,13,8,45,20,59,0,3989
"42063961400",2529,459,1,4,17,0,6,1,3017
"42063961500",3483,626,3,0,100,0,28,4,4244
"42063961600",4167,423,0,1,7,0,16,0,4614
"42063961700",1505,198,5,0,19,8,23,0,1758
"42063961800",1447,171,0,9,29,0,0,0,1656
"42063961900",3780,466,0,0,7,16,88,72,4429
"42063962000",3328,682,15,86,140,14,21,55,4341
"42063962100",2822,317,33,41,86,41,7,41,3388
"42063962200",2057,251,0,0,19,0,0,0,2327
"42065950100",1649,238,0,27,13,0,13,0,1940
"42065950200",2552,477,2,9,20,8,5,2,3075
"42065950300",4825,676,25,8,68,0,41,0,5643
"42065950400",1612,253,0,0,11,29,38,0,1943
"42065950500",1540,316,0,0,27,0,10,11,1904
"42065950600",4556,665,21,0,90,16,20,3,5371
"42065950700",2170,488,17,19,4,25,14,0,2737
"42065950800",3096,607,0,0,20,0,0,0,3723
"42065950900",3669,374,0,0,46,4,19,0,4112
"42065951000",3647,704,0,2,33,15,24,0,4425
"42065951100",3128,444,0,6,37,7,6,0,3628
"42065951200",2540,553,0,0,62,23,86,10,3274
"42065951300",1981,364,0,0,11,57,0,12,2425
"42067070100",5922,1126,30,0,216,13,277,52,7636
"42067070201",1478,358,0,1,18,0,9,0,1864
"42067070202",5169,637,33,42,192,52,241,15,6381
"42067070300",4598,575,12,0,50,15,76,15,5341
"42067070400",3446,415,43,0,61,11,36,4,4016
"42069100200",735,558,90,41,645,118,103,64,2354
"42069100300",743,1191,98,132,117,70,144,101,2596
"42069100400",985,259,111,170,229,106,39,23,1922
"42069100500",1663,319,11,13,31,33,99,20,2189
"42069100600",2334,652,226,88,912,212,532,42,4998
"42069100800",1620,315,0,45,37,50,228,5,2300
"42069100900",995,269,8,100,0,67,58,99,1596
"42069101000",2582,418,32,26,22,52,115,16,3263
"42069101100",1754,431,151,10,78,64,125,12,2625
"42069101200",1995,372,114,0,206,0,54,152,2893
"42069101300",1982,542,42,6,173,0,143,78,2966
"42069101400",1685,905,128,203,92,23,360,613,4009
"42069101600",1615,265,78,65,32,0,52,57,2164
"42069101700",2407,344,32,27,109,4,185,157,3265
"42069101800",3514,527,365,0,139,0,201,78,4824
"42069101900",1132,208,0,19,77,3,120,14,1573
"42069102000",1601,527,157,12,52,120,328,135,2932
"42069102100",2111,301,15,51,14,58,61,40,2651
"42069102200",1995,268,33,2,54,38,38,100,2528
"42069102300",2472,492,87,15,61,0,294,136,3557
"42069102500",1728,464,355,211,51,86,331,155,3381
"42069102600",1794,336,75,86,146,54,346,173,3010
"42069102700",2030,149,124,0,50,12,253,48,2666
"42069102800",2421,96,12,0,97,0,52,0,2678
"42069102900",1702,1220,380,682,126,468,139,936,5653
"42069103000",1573,250,17,36,108,86,383,130,2583
"42069103100",1295,184,12,0,73,0,32,70,1666
"42069110100",2469,323,14,0,26,22,60,18,2932
"42069110201",3563,549,15,0,15,0,8,0,4150
"42069110202",4386,325,0,39,81,45,21,45,4942
"42069110300",3481,247,22,2,55,2,122,7,3938
"42069110401",6276,141,20,0,123,3,68,0,6631
"42069110402",2257,50,2,0,265,0,49,0,2623
"42069110403",2132,57,19,0,70,6,34,3,2321
"42069110500",4877,90,0,0,90,10,19,0,5086
"42069110600",2637,210,5,3,23,8,24,20,2930
"42069110700",1616,677,0,7,16,0,16,77,2409
"42069110800",2367,498,0,133,144,11,0,0,3153
"42069110900",2391,578,13,0,65,0,37,109,3193
"42069111000",1790,331,22,4,82,0,59,7,2295
"42069111100",5902,749,190,2,129,77,107,87,7243
"42069111200",4917,930,0,0,192,173,47,13,6272
"42069111300",4080,507,1,1,20,0,175,42,4826
"42069111400",4222,910,0,0,34,0,111,344,5621
"42069111500",3061,334,46,1,24,18,38,21,3543
"42069111600",2141,286,0,11,51,20,80,0,2589
"42069111700",3355,391,27,161,76,42,59,0,4111
"42069111800",8122,437,19,0,80,25,56,4,8743
"42069112000",2775,458,0,0,129,24,42,8,3436
"42069112100",3823,563,27,0,62,17,486,17,4995
"42069112200",2113,346,0,0,18,0,10,18,2505
"42069112300",2176,180,21,28,111,80,121,30,2747
"42069112400",3872,281,0,2,55,9,63,5,4287
"42069112500",4850,862,64,0,172,20,458,92,6518
"42069112600",4615,582,19,1,56,0,61,0,5334
"42069112700",2353,526,0,13,60,0,114,168,3234
"42069112800",5134,473,0,0,0,111,10,9,5737
"42069112901",3735,224,14,0,66,3,44,0,4086
"42069112902",5293,572,58,0,73,0,113,62,6171
"42071000100",908,637,258,90,144,254,361,280,2932
"42071000200",1388,204,455,48,586,187,592,338,3798
"42071000300",2315,932,572,318,653,496,872,980,7138
"42071000400",2458,380,185,69,532,199,294,194,4311
"42071000500",2159,418,162,233,243,242,333,239,4029
"42071000600",2080,277,411,26,253,52,632,69,3800
"42071000700",1079,402,176,227,421,518,361,698,3882
"42071000800",648,630,334,234,1154,700,1418,1139,6257
"42071000900",894,597,522,261,689,529,1265,917,5674
"42071001000",1218,433,514,479,440,499,1035,461,5079
"42071001100",1682,329,270,363,476,168,686,372,4346
"42071001200",2829,187,825,224,1107,279,1987,489,7927
"42071001400",1680,775,737,205,703,627,1664,945,7336
"42071010101",6771,381,54,0,142,0,153,0,7501
"42071010102",3344,301,18,0,98,10,251,0,4022
"42071010201",4455,258,10,0,68,12,0,0,4803
"42071010202",4952,586,70,35,92,27,81,76,5919
"42071010300",8006,281,38,114,429,18,650,24,9560
"42071010400",4177,346,41,16,77,193,119,157,5126
"42071010501",4329,189,105,0,51,8,291,8,4981
"42071010502",5941,326,14,32,48,0,226,21,6608
"42071010600",8706,1206,62,41,452,7,388,0,10862
"42071010701",4951,538,16,119,222,0,206,65,6117
"42071010702",3346,365,32,42,260,10,44,0,4099
"42071010801",7490,116,0,2,73,0,82,0,7763
"42071010802",2953,346,0,0,13,0,0,0,3312
"42071010900",6228,508,281,46,421,308,553,193,8538
"42071011000",2178,247,83,43,25,0,15,59,2650
"42071011100",7359,250,88,0,224,28,152,0,8101
"42071011200",1024,416,151,73,93,82,82,304,2225
"42071011300",3401,597,142,1,159,0,284,51,4635
"42071011400",3206,268,140,68,281,60,281,41,4345
"42071011502",5350,456,76,46,305,0,715,121,7069
"42071011503",4312,241,289,5,163,0,222,93,5325
"42071011504",6752,361,182,5,418,58,677,29,8482
"42071011600",5097,820,41,0,241,1,518,19,6737
"42071011701",3949,238,66,0,463,59,595,129,5499
"42071011703",7105,194,108,3,324,0,210,18,7962
"42071011704",3814,295,29,0,330,7,139,31,4645
"42071011705",3755,363,543,0,386,19,454,0,5520
"42071011801",2680,111,44,0,106,30,63,30,3064
"42071011802",4812,311,309,0,284,0,518,97,6331
"42071011803",5141,103,83,21,599,120,556,103,6726
"42071011804",6622,330,255,85,900,113,751,44,9100
"42071011805",1564,215,99,2,315,67,491,101,2854
"42071011901",4854,35,221,53,486,41,218,53,5961
"42071011902",5801,341,187,12,492,57,187,0,7077
"42071012001",4703,166,0,14,319,0,62,19,5283
"42071012002",3142,430,17,12,70,0,76,59,3806
"42071012102",7527,128,96,1,98,220,115,220,8405
"42071012103",3587,130,11,0,340,1,292,0,4361
"42071012104",5006,493,154,0,274,0,173,0,6100
"42071012200",5878,1006,132,8,317,0,253,38,7632
"42071012301",2605,277,55,0,194,2,29,13,3175
"42071012302",2765,160,44,16,147,0,0,2,3134
"42071012402",3593,251,1,3,114,0,215,0,4177
"42071012403",3779,516,25,0,319,6,187,10,4842
"42071012404",4523,435,21,0,73,0,145,0,5197
"42071012501",6924,266,147,36,215,20,182,20,7810
"42071012502",3979,715,0,16,53,0,113,206,5082
"42071012601",6607,554,0,0,147,23,143,0,7474
"42071012602",4257,385,10,0,18,0,54,0,4724
"42071012700",6556,769,14,126,637,32,423,122,8679
"42071012800",4494,303,232,0,379,0,436,0,5844
"42071012900",5952,626,0,26,365,0,74,0,7043
"42071013000",6517,677,0,0,689,9,403,0,8295
"42071013101",3861,878,118,0,288,0,198,36,5379
"42071013102",2960,509,0,0,160,8,332,8,3977
"42071013202",3937,644,367,240,764,39,824,295,7110
"42071013203",4240,247,193,188,474,28,298,17,5685
"42071013204",4994,298,310,76,380,264,221,273,6816
"42071013301",3864,152,234,0,308,15,597,14,5184
"42071013303",4306,127,10,0,213,1,168,0,4825
"42071013304",6279,456,0,0,263,0,241,0,7239
"42071013400",1516,133,259,0,342,122,676,137,3185
"42071013501",5233,823,820,529,1689,665,2161,1035,12955
"42071013502",3233,284,100,14,239,0,424,33,4327
"42071013503",2391,33,0,0,79,0,54,0,2557
"42071013601",1403,210,24,10,86,0,50,5,1788
"42071013602",3534,1064,170,0,72,0,40,105,4985
"42071013701",3743,499,201,0,341,62,144,50,5040
"42071013702",7585,1067,317,52,314,119,730,329,10513
"42071013800",3616,67,0,0,57,7,10,7,3764
"42071013901",4358,85,100,0,124,0,179,3,4849
"42071013902",3509,147,0,0,145,16,116,16,3949
"42071014000",6714,233,29,0,95,0,121,4,7196
"42071014101",4783,411,19,0,148,0,46,59,5466
"42071014102",4774,426,13,6,67,32,19,101,5438
"42071014201",5297,524,11,0,7,8,6,0,5853
"42071014202",4751,418,14,11,150,14,132,76,5566
"42071014300",6397,913,76,11,61,25,211,78,7772
"42071014401",5953,773,0,0,185,0,73,0,6984
"42071014402",4047,500,39,5,122,15,162,93,4983
"42071014501",4780,398,0,0,31,0,139,12,5360
"42071014502",4784,889,0,0,17,0,120,18,5828
"42071014601",3459,208,46,0,0,0,155,0,3868
"42071014602",7431,362,25,0,21,4,78,4,7925
"42071014700",1121,790,610,430,582,1064,1347,1730,7674
"42073000100",3414,398,42,24,45,27,76,0,4026
"42073000200",1053,554,27,128,152,45,0,16,1975
"42073000300",2344,617,262,303,130,146,12,102,3916
"42073000400",367,576,353,453,68,115,6,32,1970
"42073000600",609,277,0,20,15,14,3,66,1004
"42073000700",781,502,144,120,57,86,26,19,1735
"42073000800",3077,458,261,72,121,99,40,15,4143
"42073000900",856,550,127,233,12,38,18,27,1861
"42073001000",1375,256,10,6,9,0,14,0,1670
"42073010100",3336,489,8,2,40,16,27,1,3919
"42073010201",3199,161,23,0,112,0,0,0,3495
"42073010202",4436,586,40,0,86,33,66,7,5254
"42073010300",1061,134,0,0,7,4,23,0,1229
"42073010400",2897,369,0,29,20,46,3,0,3364
"42073010500",2429,454,0,0,75,0,59,0,3017
"42073010600",2002,210,20,94,26,0,3,24,2379
"42073010700",2180,367,33,38,11,107,17,0,2753
"42073010800",5288,317,105,53,146,8,86,32,6035
"42073010900",2983,206,0,2,9,0,3,0,3203
"42073011000",4668,384,39,0,77,105,0,0,5273
"42073011100",3268,679,8,7,9,55,15,3,4044
"42073011200",2241,215,0,0,18,0,19,0,2493
"42073011300",3979,246,18,2,30,11,16,0,4302
"42073011400",1829,230,18,3,30,0,32,0,2142
"42073011500",3552,308,2,0,84,0,7,0,3953
"42073011600",3348,418,0,0,92,28,23,0,3909
"42073011700",1799,183,4,0,66,6,11,6,2075
"42073011800",1963,470,92,0,59,0,0,0,2584
"42075000100",2411,846,89,111,339,325,767,454,5342
"42075000200",2689,870,47,93,434,148,482,322,5085
"42075000300",1406,366,146,20,1862,867,2130,889,7686
"42075000401",1665,733,156,211,898,1064,1067,1288,7082
"42075000402",1929,596,31,0,1059,318,1231,413,5577
"42075000500",2497,388,55,88,221,452,402,796,4899
"42075002000",2978,101,0,0,109,0,39,0,3227
"42075002100",4236,684,50,0,91,0,38,0,5099
"42075002200",5305,376,65,0,468,65,338,69,6686
"42075002300",2695,79,0,16,27,15,43,15,2890
"42075002400",2165,86,7,0,33,0,0,0,2291
"42075002500",2725,379,91,0,65,105,69,32,3466
"42075002600",1934,98,13,0,74,6,100,22,2247
"42075002701",5529,270,19,1,350,30,248,31,6478
"42075002702",4843,368,0,1,165,65,183,65,5690
"42075002800",7779,344,104,0,107,0,98,0,8432
"42075002900",2510,217,9,0,249,0,280,65,3330
"42075003000",4893,702,0,0,103,36,83,36,5853
"42075003100",3695,227,166,8,0,0,22,0,4118
"42075003200",3947,305,108,0,228,32,262,103,4985
"42075003300",1724,101,12,0,113,0,119,20,2089
"42075003400",2304,189,25,7,36,30,85,37,2713
"42075003500",3786,301,192,31,582,0,383,0,5275
"42075003600",2293,315,217,76,248,264,471,297,4181
"42075003700",2626,160,29,0,34,19,37,13,2918
"42075003800",7685,210,0,0,228,0,73,0,8196
"42075003901",2775,431,76,0,128,0,24,0,3434
"42075003902",3331,135,29,21,402,40,332,40,4330
"42075004000",6567,234,146,0,210,26,78,0,7261
"42075004100",1850,119,6,0,102,42,63,0,2182
"42075004200",3714,59,0,0,280,0,166,0,4219
"42077000101",1942,312,181,76,666,168,869,142,4356
"42077000102",2595,381,735,24,651,23,1405,184,5998
"42077000400",1950,630,311,135,599,168,1167,765,5725
"42077000500",843,395,245,200,550,335,1143,636,4347
"42077000600",3007,858,931,42,1441,304,2172,983,9738
"42077000700",1257,279,248,262,1198,1081,1783,1359,7467
"42077000800",711,625,240,645,858,842,1265,1459,6645
"42077000900",339,234,186,38,362,273,478,425,2335
"42077001000",638,510,272,150,704,625,1173,1026,5098
"42077001200",486,177,176,106,160,154,449,317,2025
"42077001401",4182,1055,722,234,1603,837,3188,1666,13487
"42077001402",1413,47,179,0,278,4,398,23,2342
"42077001501",3210,704,583,443,1289,596,2260,1309,10394
"42077001502",4284,578,749,145,1195,66,2080,294,9391
"42077001600",1020,159,509,362,530,896,1147,1194,5817
"42077001700",1532,707,289,260,1595,791,2517,1230,8921
"42077001800",1031,915,660,632,1259,413,1583,1414,7907
"42077001900",2536,573,183,14,921,135,1516,494,6372
"42077002000",2125,1141,764,162,550,286,1527,1005,7560
"42077002100",2460,799,538,453,1145,909,1500,1188,8992
"42077002201",3183,355,169,131,312,28,514,186,4878
"42077002202",896,389,133,75,114,36,272,275,2190
"42077002301",4912,377,421,0,580,0,442,0,6732
"42077002302",2127,87,186,16,276,28,625,64,3409
"42077005100",3569,496,36,34,78,25,199,39,4476
"42077005200",6057,418,38,0,109,48,266,24,6960
"42077005301",3378,36,0,0,54,0,134,0,3602
"42077005302",3951,314,0,19,0,2,62,2,4350
"42077005401",2018,92,20,0,49,0,20,15,2214
"42077005402",4556,298,0,0,163,19,157,26,5219
"42077005503",4477,192,0,0,30,0,231,41,4971
"42077005504",4180,324,12,0,68,0,108,0,4692
"42077005505",2947,11,0,0,84,0,52,0,3094
"42077005506",3138,220,0,0,233,26,216,0,3833
"42077005601",4207,126,264,41,143,0,576,41,5398
"42077005602",4341,129,95,0,330,14,188,0,5097
"42077005702",3187,382,158,17,251,0,394,0,4389
"42077005703",2541,221,343,157,428,10,1041,80,4821
"42077005704",2107,84,103,38,848,410,648,271,4509
"42077005705",3666,450,381,0,1184,74,931,27,6713
"42077005800",2488,328,205,27,116,43,109,100,3416
"42077005901",5140,833,92,223,130,87,330,194,7029
"42077005902",1260,140,107,6,141,40,89,48,1831
"42077006001",4149,82,34,0,277,67,235,0,4844
"42077006002",5044,111,130,5,567,148,131,53,6189
"42077006101",2824,171,11,4,116,16,66,19,3227
"42077006102",4369,99,190,155,300,94,296,176,5679
"42077006202",7768,212,395,0,1520,164,512,157,10728
"42077006203",6773,68,0,0,769,130,404,18,8162
"42077006204",3517,21,23,4,551,4,69,4,4193
"42077006302",5763,217,388,104,688,50,287,96,7593
"42077006303",2650,191,44,0,175,19,179,109,3367
"42077006304",3429,182,70,0,287,83,187,11,4249
"42077006305",5918,195,174,0,521,54,836,0,7698
"42077006307",7149,255,45,0,691,25,431,0,8596
"42077006308",6297,106,267,0,668,0,570,1,7909
"42077006401",2535,284,0,0,114,21,201,21,3176
"42077006402",4564,173,8,0,150,0,103,0,4998
"42077006500",4742,602,72,0,441,20,178,102,6157
"42077006600",4571,229,26,3,239,0,121,0,5189
"42077006701",3542,344,50,0,646,2,565,27,5176
"42077006702",2630,174,9,34,27,0,178,11,3063
"42077006703",4916,243,424,3,243,0,108,0,5937
"42077006800",3155,380,188,109,402,149,631,316,5330
"42077006902",1965,105,0,0,55,0,54,22,2201
"42077006903",5198,258,0,0,566,107,167,99,6395
"42077006905",4577,40,0,8,57,0,427,0,5109
"42077006906",3335,102,25,0,410,9,194,0,4075
"42077007000",3734,98,0,0,0,0,34,0,3866
"42077009100",2305,318,64,9,201,29,334,51,3311
"42077009200",3386,148,30,16,229,45,435,12,4301
"42077009300",2559,153,94,32,257,0,428,0,3523
"42077009400",2482,757,253,27,590,231,996,532,5868
"42077009500",3372,341,243,28,316,198,572,230,5300
"42077009600",3060,1185,921,231,712,1305,2430,1516,11360
"42077009700",955,834,509,433,534,291,1104,896,5556
"42079200100",696,288,18,42,11,4,24,23,1106
"42079200200",1973,728,224,144,165,94,146,300,3774
"42079200300",1392,84,84,190,63,127,110,162,2212
"42079200400",1776,323,179,87,40,35,205,0,2645
"42079200500",1094,774,48,389,268,160,269,433,3435
"42079200600",1402,260,115,68,69,152,57,29,2152
"42079200700",2002,625,330,213,78,61,10,290,3609
"42079200800",1519,366,452,368,401,215,480,349,4150
"42079200900",1326,571,459,505,92,185,121,208,3467
"42079201000",1070,249,168,690,86,151,18,368,2800
"42079201100",712,349,98,22,113,23,440,244,2001
"42079201200",781,295,146,25,233,23,69,123,1695
"42079201300",1207,530,144,51,340,14,382,265,2933
"42079201400",1367,300,60,178,226,89,225,95,2540
"42079201500",1666,403,76,15,53,44,48,22,2327
"42079201600",2014,369,49,61,43,0,0,0,2536
"42079210100",3013,242,19,0,36,0,0,0,3310
"42079210200",2248,325,0,0,0,138,0,54,2765
"42079210300",2375,215,0,0,16,44,15,0,2665
"42079210400",1323,225,0,0,3,15,5,0,1571
"42079210500",4097,803,20,0,15,0,122,19,5076
"42079210600",793,173,30,0,0,1,7,0,1004
"42079210700",1346,330,6,0,0,6,0,49,1737
"42079210800",2427,594,16,43,141,0,184,0,3405
"42079210900",1362,338,1,0,68,12,18,7,1806
"42079211000",4106,605,21,1,7,0,20,0,4760
"42079211101",4548,600,153,19,168,1,151,0,5640
"42079211102",2024,60,0,0,15,10,0,0,2109
"42079211201",2420,168,0,0,143,0,42,0,2773
"42079211203",1592,213,15,0,37,0,23,0,1880
"42079211204",4795,562,0,0,44,16,137,0,5554
"42079211205",2504,171,0,0,0,0,0,0,2675
"42079211301",2248,104,0,0,46,0,25,0,2423
"42079211302",3313,139,23,1,21,0,0,0,3497
"42079211303",2380,189,0,0,57,120,23,0,2769
"42079211304",1832,253,8,0,4,0,20,0,2117
"42079211400",6066,541,15,48,202,39,99,0,7010
"42079211500",2461,238,0,0,7,0,13,47,2766
"42079211600",2665,280,6,115,0,0,0,115,3181
"42079211701",4567,351,0,0,13,0,69,57,5057
"42079211702",1435,34,0,2,62,6,15,4,1558
"42079211800",1305,186,44,4,91,22,27,0,1679
"42079211900",4888,946,14,0,63,18,0,0,5929
"42079212000",1592,204,0,0,85,0,42,0,1923
"42079212100",3798,356,11,0,0,5,34,0,4204
"42079212200",4498,502,0,0,14,1,98,1,5114
"42079212300",2160,574,43,0,76,0,1,65,2919
"42079212700",3229,573,104,350,275,60,33,85,4709
"42079212800",2980,282,56,13,290,0,280,8,3909
"42079212900",1261,96,15,0,16,0,94,0,1482
"42079213000",1125,155,0,59,67,5,61,0,1472
"42079213100",1182,166,109,0,123,24,20,0,1624
"42079213200",3022,1251,224,123,121,23,243,9,5016
"42079213300",1399,222,0,9,12,9,7,6,1664
"42079213400",3863,521,0,0,69,0,95,14,4562
"42079213600",1370,419,9,33,55,64,24,7,1981
"42079213700",1769,334,0,0,13,26,0,0,2142
"42079213800",1207,352,39,16,46,113,10,73,1856
"42079213900",1631,197,0,0,9,0,11,0,1848
"42079214000",889,76,7,0,20,28,54,0,1074
"42079214100",1632,666,31,0,103,21,0,15,2468
"42079214200",2265,743,39,0,65,0,34,0,3146
"42079214300",1291,413,13,0,18,0,6,65,1806
"42079214400",1323,459,22,7,33,8,65,21,1938
"42079214500",1473,68,0,21,58,0,0,0,1620
"42079214600",3195,417,37,50,69,50,77,49,3944
"42079214900",1135,174,0,0,42,10,0,0,1361
"42079215000",1236,214,2,0,14,0,2,2,1470
"42079215100",2287,364,34,19,35,0,28,0,2767
"42079215200",1875,546,36,97,194,173,89,232,3242
"42079215300",3686,220,4,9,81,7,19,7,4033
"42079215400",2239,262,2,0,47,8,25,10,2593
"42079215501",3937,264,35,0,233,0,52,27,4548
"42079215502",5037,112,14,13,320,26,18,0,5540
"42079215503",2997,218,29,0,245,0,0,7,3496
"42079215504",3702,261,0,0,17,0,0,0,3980
"42079215600",3161,962,14,0,0,10,0,29,4176
"42079215701",2170,75,0,0,11,6,0,0,2262
"42079215702",1815,184,14,0,0,5,10,0,2028
"42079215800",2741,167,0,0,25,0,26,0,2959
"42079215900",2990,555,16,7,31,26,15,20,3660
"42079216000",638,143,0,2,4,4,37,2,830
"42079216100",3864,218,31,0,0,0,91,0,4204
"42079216200",4708,494,29,6,120,38,99,84,5578
"42079216400",1765,177,34,0,31,0,83,0,2090
"42079216501",1851,111,0,0,34,0,0,0,1996
"42079216502",3491,78,4,0,126,0,140,0,3839
"42079216600",7647,884,112,150,315,141,118,139,9506
"42079216700",2674,652,9,6,151,0,116,0,3608
"42079216800",2967,364,20,0,91,0,27,0,3469
"42079216900",3664,640,24,11,54,30,78,256,4757
"42079217001",1839,182,0,26,33,0,150,50,2280
"42079217002",1785,575,5,73,102,214,320,527,3601
"42079217100",1774,217,37,24,756,198,1187,299,4492
"42079217200",1248,583,94,203,429,429,1054,859,4899
"42079217300",2652,263,38,0,41,155,413,219,3781
"42079217400",640,373,44,9,166,320,417,527,2496
"42079217500",1169,491,94,38,495,285,890,617,4079
"42079217600",1083,369,253,149,983,166,1401,343,4747
"42079217700",2435,376,180,92,1284,479,1686,599,7131
"42079217800",1956,610,49,0,542,335,1412,646,5550
"42079217900",2478,573,151,11,1286,30,2122,127,6778
"42079218000",2842,966,67,12,17,184,5,231,4324
"42079980100",0,0,0,0,0,0,0,0,0
"42081000100",2705,452,37,144,38,28,206,24,3634
"42081000200",1867,164,68,0,178,34,42,34,2387
"42081000300",3086,1390,541,89,120,69,23,36,5354
"42081000400",1551,716,1101,646,233,322,57,248,4874
"42081000500",1199,265,136,51,70,119,42,18,1900
"42081000600",1597,294,75,38,85,0,0,26,2115
"42081000800",172,598,39,177,0,61,0,62,1109
"42081000900",1679,449,157,347,118,29,49,12,2840
"42081001000",2189,413,222,185,10,166,21,86,3292
"42081010100",2171,239,0,0,28,14,7,0,2459
"42081010200",954,49,2,0,7,0,2,0,1014
"42081010300",2992,217,14,3,30,5,14,3,3278
"42081010400",4433,429,64,2,155,12,62,3,5160
"42081010500",5268,347,15,2,54,4,54,6,5750
"42081010600",4135,382,0,0,20,8,23,0,4568
"42081010700",5262,659,61,8,72,0,15,0,6077
"42081010800",6110,654,0,0,175,0,86,24,7049
"42081010900",2475,263,0,18,49,12,19,0,2836
"42081011000",4117,328,0,1,145,0,45,35,4671
"42081011100",4177,885,63,260,183,122,99,83,5872
"42081011200",4198,197,25,0,263,0,0,0,4683
"42081011301",1699,372,10,9,82,5,10,0,2187
"42081011302",4533,351,109,0,23,15,0,0,5031
"42081011400",1468,169,12,7,3,11,0,3,1673
"42081011601",1096,94,0,1,0,0,1,0,1192
"42081011602",5229,858,101,0,134,32,60,0,6414
"42081011700",5118,662,7,0,192,40,44,25,6088
"42081011800",3041,181,0,0,21,2,15,2,3262
"42081011900",4842,967,88,8,51,0,27,8,5991
"42083420100",3072,244,0,1,71,0,47,18,3453
"42083420200",1694,1367,0,0,5,53,5,15,3139
"42083420300",1605,905,0,13,14,48,0,4,2589
"42083420400",2129,458,0,15,0,0,50,0,2652
"42083420500",2831,170,33,2,109,21,74,2,3242
"42083420600",4661,678,27,0,120,25,49,0,5560
"42083420700",3627,676,18,0,72,0,20,2,4415
"42083420800",2912,548,0,0,9,27,5,0,3501
"42083420900",1774,361,0,4,27,1,3,0,2170
"42083421000",3172,276,0,0,14,54,31,22,3569
"42083421100",2650,592,0,0,53,102,3,73,3473
"42083421200",2045,189,0,0,85,0,51,0,2370
"42085030100",998,634,131,16,70,90,17,0,1956
"42085030300",2312,631,100,85,344,35,0,0,3507
"42085030400",2174,80,93,0,229,8,20,0,2604
"42085030500",1405,287,406,87,72,79,26,77,2439
"42085030900",1693,134,1117,117,117,44,121,0,3343
"42085031100",820,285,143,180,10,95,2,8,1543
"42085031200",5291,24,11,0,143,0,26,0,5495
"42085031300",2524,39,12,0,39,18,46,10,2688
"42085031400",4769,185,201,52,52,0,145,0,5404
"42085031700",2382,151,11,22,4,0,27,7,2604
"42085031800",4415,478,0,2,51,8,30,1,4985
"42085031900",4080,448,0,0,51,5,60,5,4649
"42085032000",4342,496,18,0,90,0,27,0,4973
"42085032100",1379,1051,0,8,9,0,0,0,2447
"42085032200",2294,127,66,0,52,6,25,0,2570
"42085032300",2895,215,0,0,57,15,3,0,3185
"42085032400",4904,924,0,0,23,88,74,94,6107
"42085032501",4993,937,6,3,44,7,23,12,6025
"42085032502",1980,289,6,0,3,7,0,0,2285
"42085032601",5007,461,8,3,63,8,17,3,5570
"42085032602",2573,297,19,0,47,24,6,0,2966
"42085032701",4293,341,9,0,106,2,52,4,4807
"42085032702",2056,564,6,0,13,0,4,0,2643
"42085032800",4766,343,55,0,52,3,17,23,5259
"42085032900",2531,236,18,0,63,50,19,0,2917
"42085033000",2339,339,31,0,83,7,20,0,2819
"42085033100",4344,435,0,0,38,4,42,0,4863
"42085033200",1262,677,538,506,113,116,7,47,3266
"42085033300",2032,616,30,47,10,0,0,0,2735
"42085033400",765,236,537,609,95,133,0,3,2378
"42087960100",3345,441,0,0,46,8,0,0,3840
"42087960200",3100,890,0,0,65,0,0,0,4055
"42087960300",4116,838,16,4,41,2,5,1,5023
"42087960400",2558,420,5,24,69,6,21,13,3116
"42087960500",3408,335,3,3,47,2,22,7,3827
"42087960600",4730,838,17,25,101,26,4,170,5911
"42087960700",1657,478,58,33,80,0,75,10,2391
"42087960800",2228,988,17,7,188,13,64,30,3535
"42087960900",1668,575,49,0,89,0,43,19,2443
"42087961000",1778,205,0,1,17,0,0,0,2001
"42087961100",6335,653,0,3,47,5,84,0,7127
"42087961200",2653,390,29,0,31,3,16,0,3122
"42089300101",2739,93,244,130,238,103,192,103,3842
"42089300102",5141,393,831,0,502,23,1176,256,8322
"42089300201",3070,533,317,13,148,46,129,46,4302
"42089300202",4339,155,720,287,622,52,1212,169,7556
"42089300301",2407,150,490,157,10,0,220,157,3591
"42089300304",3859,782,1359,15,691,41,1116,261,8124
"42089300305",3295,954,2055,256,627,163,1246,290,8886
"42089300307",2600,451,2526,412,885,13,1252,100,8239
"42089300308",1356,316,520,61,631,18,873,112,3887
"42089300309",3300,443,844,79,384,33,813,466,6362
"42089300311",1337,95,110,56,167,36,58,0,1859
"42089300312",1114,118,60,138,0,170,153,21,1774
"42089300401",3161,560,495,92,411,0,361,206,5286
"42089300402",4341,527,931,0,297,89,685,64,6934
"42089300403",4874,610,862,0,419,115,836,66,7782
"42089300501",1728,377,285,113,168,27,80,41,2819
"42089300502",3817,318,391,0,518,184,839,205,6272
"42089300600",2946,694,331,98,499,93,331,238,5230
"42089300700",1824,964,454,263,275,27,490,46,4343
"42089300800",2881,1264,286,272,437,376,294,547,6357
"42089300900",3429,498,469,153,702,23,375,150,5799
"42089301001",7210,1280,2024,10,990,123,1891,515,14043
"42089301002",1772,147,0,49,29,0,107,0,2104
"42089301101",5077,273,117,0,176,0,208,0,5851
"42089301102",2342,181,35,14,151,0,77,0,2800
"42089301202",3807,586,208,6,124,0,551,18,5300
"42089301203",4918,421,86,0,248,116,59,113,5961
"42089301204",3314,123,142,22,196,45,550,0,4392
"42089301205",6487,390,800,0,396,25,1154,152,9404
"42089301301",6226,1125,271,0,83,17,359,116,8197
"42089301302",2511,225,73,0,66,5,48,71,2999
"42089301401",2657,299,810,83,398,0,789,90,5126
"42089301402",3273,551,424,38,346,26,464,90,5212
"42091200103",3337,124,70,0,467,30,45,0,4073
"42091200104",3808,64,0,3,296,0,7,0,4178
"42091200105",2306,51,12,0,447,20,63,0,2899
"42091200106",1528,224,44,1,195,0,34,0,2026
"42091200200",1072,70,3,19,47,0,25,11,1247
"42091200301",3945,238,495,0,1040,0,404,61,6183
"42091200305",2016,144,18,0,43,10,94,36,2361
"42091200306",3118,201,60,2,49,0,49,0,3479
"42091200307",2379,76,242,171,96,11,155,12,3142
"42091200308",3071,105,164,0,457,217,29,0,4043
"42091200309",2441,228,72,1,110,0,46,165,3063
"42091200310",2499,95,0,3,55,4,0,0,2656
"42091200401",2838,119,41,1,74,40,350,0,3463
"42091200402",3645,227,229,0,127,54,195,18,4495
"42091200501",3443,74,15,0,230,0,113,0,3875
"42091200502",3897,137,498,20,282,15,81,0,4930
"42091200505",5628,322,124,5,955,13,122,13,7182
"42091200506",3852,43,86,0,387,22,100,0,4490
"42091200507",5076,68,172,2,462,0,119,0,5899
"42091200602",5159,89,596,18,2226,465,125,187,8865
"42091200603",2582,91,107,0,388,0,106,12,3286
"42091200605",4163,105,264,47,1308,44,163,0,6094
"42091200606",2675,24,163,2,353,33,104,0,3354
"42091200607",3345,56,202,0,869,18,70,0,4560
"42091200703",2796,91,470,0,751,154,134,0,4396
"42091200704",2748,103,298,13,509,0,163,0,3834
"42091200707",2439,285,185,9,1015,39,375,21,4368
"42091200708",4383,131,197,0,826,1,156,0,5694
"42091200800",1952,114,271,29,870,66,181,77,3560
"42091200901",2664,92,278,145,573,215,186,0,4153
"42091200902",798,96,108,10,178,33,123,59,1405
"42091200903",2753,261,361,296,857,81,332,14,4955
"42091200906",1125,61,167,0,208,53,50,0,1664
"42091200907",2320,34,105,11,24,0,55,0,2549
"42091200908",1509,105,172,8,327,37,194,13,2365
"42091201003",3658,256,158,0,871,85,88,0,5116
"42091201004",3907,149,174,4,798,1,346,0,5379
"42091201005",2877,3,81,0,267,10,85,10,3333
"42091201006",1933,54,61,0,215,0,32,0,2295
"42091201100",2609,209,36,10,278,54,46,0,3242
"42091201201",4422,623,101,1,728,116,18,15,6024
"42091201203",2554,61,21,52,233,0,33,0,2954
"42091201204",1467,46,486,31,91,24,22,3,2170
"42091201301",2474,85,414,8,395,0,265,43,3684
"42091201302",2044,140,491,135,76,49,151,56,3142
"42091201404",3564,171,146,0,612,22,50,124,4689
"42091201406",3768,49,222,34,531,0,0,0,4604
"42091201407",1763,78,610,52,143,1,36,78,2761
"42091201408",3791,7,23,0,490,22,64,0,4397
"42091201409",3935,58,57,0,364,36,53,0,4503
"42091201410",2187,42,20,94,128,12,35,0,2518
"42091201411",2492,33,118,0,229,0,0,0,2872
"42091201501",2422,150,52,0,579,0,87,40,3330
"42091201502",1676,45,42,0,76,0,86,0,1925
"42091201603",2272,140,1499,214,200,45,161,52,4583
"42091201604",1708,154,963,88,120,0,31,0,3064
"42091201605",2055,32,447,0,281,0,40,0,2855
"42091201606",1085,135,837,117,260,17,100,0,2551
"42091201607",2646,160,254,22,376,0,66,0,3524
"42091201608",3608,213,240,15,523,18,292,14,4923
"42091201703",2667,106,155,36,164,0,94,0,3222
"42091201704",2509,175,413,37,103,0,24,0,3261
"42091201705",4077,197,137,38,143,41,203,0,4836
"42091201706",3403,451,331,124,329,10,92,218,4958
"42091201800",2392,175,190,0,93,14,227,0,3091
"42091201901",4050,201,104,0,464,27,88,51,4985
"42091201902",3971,210,738,32,503,36,156,0,5646
"42091202000",2244,143,5,0,125,20,103,10,2650
"42091202100",3449,591,260,38,106,0,138,19,4601
"42091202201",3233,132,879,177,513,0,286,0,5220
"42091202202",1083,99,1032,41,895,57,382,34,3623
"42091202301",3487,165,601,51,371,23,37,0,4735
"42091202302",1275,55,385,52,197,0,185,0,2149
"42091202401",188,203,2693,206,277,93,69,59,3788
"42091202402",2095,70,1742,156,562,100,344,28,5097
"42091202500",898,217,2690,254,653,140,78,37,4967
"42091202602",1982,220,14,25,110,37,73,0,2461
"42091202603",2201,127,270,0,115,1,46,0,2760
"42091202604",1546,140,376,21,258,37,108,0,2486
"42091203000",2707,65,44,8,237,11,39,0,3111
"42091203103",2704,55,32,0,192,0,29,0,3012
"42091203104",3508,99,43,0,180,0,83,0,3913
"42091203105",4472,199,355,0,339,70,133,20,5588
"42091203106",1577,70,47,39,162,55,30,0,1980
"42091203203",3066,68,184,0,755,82,208,7,4370
"42091203204",4421,126,496,0,1435,137,237,37,6889
"42091203205",1652,102,139,39,155,27,117,0,2231
"42091203207",2825,59,55,1,331,9,1,0,3281
"42091203208",2359,41,47,0,335,7,47,0,2836
"42091203302",4982,250,659,0,284,9,153,9,6346
"42091203303",2614,271,243,21,631,59,230,9,4078
"42091203304",2926,49,476,10,203,0,9,0,3673
"42091203401",4720,151,778,66,229,41,196,16,6197
"42091203402",4918,376,531,25,575,127,70,111,6733
"42091203403",2309,126,421,18,151,17,38,0,3080
"42091203500",2990,118,2024,386,586,0,724,20,6848
"42091203601",767,382,917,583,239,32,356,265,3541
"42091203602",1742,278,1409,185,312,28,484,126,4564
"42091203700",537,337,398,180,257,33,282,123,2147
"42091203801",1558,334,904,485,435,138,583,342,4779
"42091203803",2390,731,997,536,531,206,1071,400,6862
"42091203804",1309,128,848,503,465,81,1023,0,4357
"42091203901",1283,383,873,394,450,138,1346,331,5198
"42091203902",942,656,433,465,603,221,377,451,4148
"42091204002",2452,289,227,82,395,93,208,166,3912
"42091204007",1686,148,102,21,275,30,39,0,2301
"42091204008",2086,28,132,0,305,17,8,0,2576
"42091204009",1160,64,51,1,170,0,96,0,1542
"42091204010",2212,53,195,0,217,0,93,0,2770
"42091204101",3559,238,57,12,40,52,87,9,4054
"42091204102",2870,531,152,13,296,57,75,184,4178
"42091204200",1118,100,23,0,59,6,44,23,1373
"42091204300",2312,63,136,46,207,24,61,24,2873
"42091204400",2778,144,101,1,168,96,147,0,3435
"42091204500",3840,121,68,0,175,0,42,0,4246
"42091204600",3820,112,75,0,335,10,8,0,4360
"42091204701",1692,138,32,0,262,0,0,1,2125
"42091204702",2661,94,41,0,550,0,69,0,3415
"42091204800",4109,123,8,44,642,5,125,0,5056
"42091204900",4332,55,108,17,116,0,141,19,4788
"42091205000",1079,149,170,8,138,36,34,5,1619
"42091205100",927,137,54,6,108,19,5,16,1272
"42091205200",2511,163,0,10,187,26,81,24,3002
"42091205300",958,255,470,154,251,21,182,47,2338
"42091205400",4952,186,195,0,820,127,635,34,6949
"42091205501",2536,259,498,55,98,96,124,0,3666
"42091205502",2832,52,255,0,439,0,76,0,3654
"42091205503",3212,114,353,59,668,32,72,0,4510
"42091205600",3665,138,160,0,277,39,117,0,4396
"42091205700",3153,409,613,0,352,19,229,74,4849
"42091205801",1274,113,100,8,1116,116,124,0,2851
"42091205805",1910,282,107,0,938,88,86,10,3421
"42091205806",1705,155,85,11,307,0,83,4,2350
"42091205807",1140,46,63,25,391,23,39,0,1727
"42091205808",3629,160,97,25,1162,167,61,6,5307
"42091205809",2186,50,110,0,412,0,62,5,2825
"42091205903",2043,74,154,0,341,14,31,6,2663
"42091205904",1904,76,83,0,123,1,56,0,2243
"42091205905",2305,140,158,8,872,95,82,8,3668
"42091205906",1496,120,72,5,352,0,203,28,2276
"42091206004",3353,161,190,1,689,41,95,0,4530
"42091206005",3759,107,117,0,422,0,422,0,4827
"42091206006",2433,50,65,0,157,0,9,0,2714
"42091206007",3852,237,148,236,1986,0,87,0,6546
"42091206102",6898,172,422,0,1139,19,408,28,9086
"42091206104",2540,68,48,0,339,45,118,0,3158
"42091206105",4870,63,66,0,416,0,24,0,5439
"42091206106",4168,137,50,59,283,0,121,0,4818
"42091206201",1790,454,46,21,65,9,87,0,2472
"42091206202",2027,126,85,21,10,5,22,0,2296
"42091206300",2935,157,155,0,196,25,20,0,3488
"42091206400",2766,162,113,85,337,87,215,87,3852
"42091206501",3470,69,259,0,501,22,168,8,4497
"42091206502",4112,355,278,0,117,0,108,0,4970
"42091206600",1122,140,10,0,15,6,90,29,1412
"42091206702",26,0,0,0,0,0,0,0,26
"42091206703",3455,119,83,0,284,21,137,0,4099
"42091206704",6735,295,8,0,405,31,124,39,7637
"42091206801",5519,145,346,4,912,39,340,0,7305
"42091206802",2851,44,6,7,189,2,0,1,3100
"42091206901",3466,173,132,49,436,196,291,29,4772
"42091206904",4135,263,375,0,444,22,167,22,5428
"42091206905",4294,61,161,43,737,77,74,0,5447
"42091206906",2398,32,205,0,186,16,124,16,2977
"42091207001",7121,86,127,0,555,104,158,59,8210
"42091207003",2561,30,170,7,129,1,0,0,2898
"42091207004",3435,97,210,2,445,144,66,120,4519
"42091207101",5303,317,164,3,154,82,76,0,6099
"42091207103",3624,174,79,0,187,82,261,8,4415
"42091207104",2566,99,0,0,139,9,0,0,2813
"42091207201",2302,80,21,12,67,0,154,0,2636
"42091207202",3383,228,49,0,514,9,356,9,4548
"42091207300",1948,113,96,141,328,25,311,0,2962
"42091207400",2599,68,35,0,56,0,14,0,2772
"42091207500",3193,71,8,0,0,19,20,0,3311
"42091207600",3578,155,0,6,10,11,50,0,3810
"42091207800",6421,295,45,21,60,0,53,0,6895
"42091207900",2253,122,37,0,96,0,40,0,2548
"42091208000",3120,306,46,5,147,0,115,11,3750
"42091208100",2666,163,48,0,76,5,105,7,3070
"42091208201",2041,131,0,0,34,0,13,0,2219
"42091208203",4165,158,140,3,19,0,43,0,4528
"42091208204",3354,107,154,23,30,0,105,0,3773
"42091208301",2570,62,0,1,55,0,0,0,2688
"42091208302",8445,289,63,2,459,0,272,9,9539
"42091208400",3234,81,71,0,82,6,32,0,3506
"42091208500",4510,233,41,4,92,0,232,0,5112
"42091208601",5283,246,96,0,438,0,260,0,6323
"42091208603",6374,46,258,0,49,0,273,0,7000
"42091208604",4468,274,232,0,776,27,44,28,5849
"42091208702",2950,216,63,0,114,1,80,0,3424
"42091208703",3271,305,137,13,108,0,30,52,3916
"42091208704",3852,149,241,79,460,59,297,58,5195
"42091208801",554,229,110,241,48,80,77,98,1437
"42091208802",2414,591,53,342,191,126,54,134,3905
"42091208901",2659,376,321,114,114,25,116,139,3864
"42091208903",1619,220,441,211,103,116,126,60,2896
"42091208904",1366,416,585,245,358,168,338,110,3586
"42091208905",2304,135,56,2,158,0,151,14,2820
"42091208906",2139,347,741,234,153,115,258,22,4009
"42091209000",715,285,215,172,94,62,27,66,1636
"42091209100",4823,79,268,26,203,0,153,0,5552
"42091209201",1483,109,98,6,9,0,0,7,1712
"42091209202",1427,354,240,5,53,106,123,0,2308
"42091210100",2918,206,130,29,620,78,420,31,4432
"42091210200",2418,25,256,10,9,0,33,0,2751
"42091210300",3295,157,64,0,125,1,160,1,3803
"42091210400",2900,347,742,34,243,0,66,9,4341
"42091210500",2979,108,593,10,196,92,109,56,4143
"42091210600",3453,87,216,2,397,0,299,6,4460
"42091210700",4598,55,81,0,893,19,137,0,5783
"42093050100",3520,356,34,2,11,0,0,0,3923
"42093050200",3033,295,0,0,362,7,0,116,3813
"42093050300",3431,828,38,0,186,20,172,50,4725
"42093050400",5158,240,93,1,97,0,20,14,5623
"42095010100",3050,80,192,63,457,61,750,42,4695
"42095010200",2932,202,131,0,337,0,149,0,3751
"42095010300",2403,110,129,0,209,32,314,42,3239
"42095010400",4549,153,206,0,369,0,613,44,5934
"42095010500",1863,1126,151,383,432,172,1436,1252,6815
"42095010600",5170,622,323,47,1322,42,1358,233,9117
"42095010700",3265,316,189,71,633,97,1221,76,5868
"42095010800",1460,464,9,58,99,45,72,167,2374
"42095010900",1836,359,449,44,381,228,1087,456,4840
"42095011000",1088,920,46,115,334,402,625,626,4156
"42095011100",106,48,0,0,0,5,27,17,203
"42095011200",2110,1339,456,326,941,671,1661,1746,9250
"42095011300",2388,729,213,127,631,331,1142,661,6222
"42095014100",2763,176,147,27,310,0,282,6,3711
"42095014200",2867,791,551,136,656,518,618,855,6992
"42095014300",1054,597,385,414,778,317,912,791,5248
"42095014400",1199,327,86,250,134,118,212,259,2585
"42095014500",1269,302,530,128,687,145,515,224,3800
"42095014600",1658,476,531,234,333,58,531,386,4207
"42095014700",1594,128,477,51,373,76,484,62,3245
"42095015201",6135,661,0,2,58,48,61,0,6965
"42095015300",4551,179,40,0,238,0,158,0,5166
"42095015400",2873,200,15,0,0,0,81,13,3182
"42095015500",5592,346,50,0,145,17,229,55,6434
"42095015600",2956,340,98,0,86,0,84,0,3564
"42095015700",2360,260,8,0,81,0,48,23,2780
"42095015801",4964,188,0,0,75,0,43,0,5270
"42095015802",2770,197,8,0,121,0,33,0,3129
"42095015901",5357,419,1,0,2,0,88,0,5867
"42095015902",3317,205,0,4,51,7,94,9,3687
"42095016001",5605,301,0,0,104,0,176,0,6186
"42095016002",4006,239,111,0,48,0,99,0,4503
"42095016100",1919,157,7,0,17,0,102,7,2209
"42095016201",4507,517,130,42,288,160,190,139,5973
"42095016202",3728,195,0,0,319,7,375,21,4645
"42095016300",2526,145,24,10,128,0,72,15,2920
"42095016400",4025,83,128,0,244,28,89,0,4597
"42095016500",4394,75,95,35,213,30,83,5,4930
"42095016600",2056,289,123,44,8,83,183,22,2808
"42095016700",5499,195,45,0,49,0,233,33,6054
"42095016800",4862,459,27,0,227,0,181,0,5756
"42095016901",2967,190,1,0,56,0,33,0,3247
"42095016902",2433,53,0,0,87,21,98,0,2692
"42095017000",1880,49,11,34,148,2,77,0,2201
"42095017101",5173,210,307,44,648,17,871,0,7270
"42095017102",7183,361,650,0,454,26,511,71,9256
"42095017200",4792,641,257,2,594,7,434,295,7022
"42095017300",2091,349,83,22,124,35,168,28,2900
"42095017401",5980,137,786,57,711,58,489,0,8218
"42095017402",3246,50,252,76,168,9,371,14,4186
"42095017501",2973,138,174,62,451,0,81,78,3957
"42095017502",4549,197,263,0,316,48,154,0,5527
"42095017603",3292,174,74,0,229,48,324,55,4196
"42095017604",3584,191,168,24,188,49,550,96,4850
"42095017605",3034,20,197,0,335,29,246,0,3861
"42095017606",4484,28,189,0,220,12,332,8,5273
"42095017607",5235,145,464,20,748,0,474,9,7095
"42095017702",1969,61,92,0,120,0,113,3,2358
"42095017703",2069,174,260,1,227,21,495,14,3261
"42095017704",5052,241,176,0,655,115,434,0,6673
"42095017800",1891,119,215,33,321,36,627,49,3291
"42095017901",3282,254,10,0,42,0,311,0,3899
"42095017902",1990,181,15,0,27,10,70,4,2297
"42095018001",3811,182,0,0,74,0,244,0,4311
"42095018002",6097,293,17,1,234,0,328,0,6970
"42095018100",5679,167,226,23,284,6,48,3,6436
"42095018200",2985,184,20,0,251,0,164,0,3604
"42095018300",4284,292,189,19,90,22,373,55,5324
"42097080100",3790,514,5,1,24,1,16,0,4351
"42097080200",6039,717,99,11,34,32,49,24,7005
"42097080300",5466,1026,66,113,155,21,239,110,7196
"42097080400",3009,401,3,2,44,0,77,0,3536
"42097080500",3042,473,0,15,29,0,93,99,3751
"42097080600",3333,301,16,0,62,12,69,0,3793
"42097080700",2876,196,23,2,122,0,55,17,3291
"42097080800",6746,448,0,2,79,0,40,0,7315
"42097080900",3102,563,0,2,3,0,0,0,3670
"42097081000",2451,654,29,0,41,53,0,53,3281
"42097081100",2238,342,0,0,0,0,21,43,2644
"42097081200",2635,353,1,4,69,0,64,5,3131
"42097081300",1605,371,3,2,90,112,0,35,2218
"42097081400",1485,183,4,1,2,0,5,0,1680
"42097081500",1802,454,0,2,0,37,0,5,2300
"42097081600",1913,705,47,2,24,0,0,0,2691
"42097081700",1630,513,3,1,10,0,69,23,2249
"42097081800",2797,271,12,9,32,2,46,1,3170
"42097081900",5479,307,15,2,60,0,112,2,5977
"42097082000",2566,644,14,33,23,0,81,104,3465
"42097082100",1695,716,17,52,36,72,278,81,2947
"42097082200",2670,614,64,16,30,0,97,14,3505
"42097082300",4489,516,0,1,40,15,55,6,5122
"42097082400",2480,362,2,5,45,0,79,4,2977
"42099030100",4256,377,5,6,65,0,33,6,4748
"42099030201",2328,168,0,0,13,0,20,5,2534
"42099030202",3852,771,21,7,91,30,98,20,4890
"42099030301",4202,304,20,0,106,0,5,4,4641
"42099030302",4192,390,23,4,102,5,45,2,4763
"42099030400",4278,232,30,0,197,13,101,0,4851
"42099030501",4582,403,116,0,82,12,107,0,5302
"42099030502",5401,432,19,7,28,7,132,15,6041
"42099030601",4029,496,22,0,31,0,41,17,4636
"42099030602",2629,506,6,8,35,39,37,3,3263
"42101000100",2454,353,310,51,410,30,157,27,3792
"42101000200",669,190,53,58,910,329,32,0,2241
"42101000300",2341,228,134,29,440,56,282,9,3519
"42101000401",1393,271,174,191,474,333,50,126,3012
"42101000402",2380,201,135,0,232,101,37,0,3086
"42101000500",434,270,57,229,290,76,36,52,1444
"42101000600",556,154,19,31,171,23,45,8,1007
"42101000700",1774,292,301,52,412,394,208,66,3499
"42101000801",1125,230,144,36,138,19,42,41,1775
"42101000803",2683,519,0,17,313,0,38,0,3570
"42101000804",2840,195,155,14,542,0,509,0,4255
"42101000901",1126,298,95,53,389,120,76,56,2213
"42101000902",1317,206,62,21,201,236,33,8,2084
"42101001001",2055,169,53,17,332,0,26,0,2652
"42101001002",3017,218,29,18,197,62,245,8,3794
"42101001101",2342,322,43,51,209,0,156,15,3138
"42101001102",1678,343,99,117,239,66,70,0,2612
"42101001201",3555,134,27,12,340,99,171,3,4341
"42101001202",3894,462,241,14,339,86,376,119,5531
"42101001300",3327,281,1147,265,846,24,214,0,6104
"42101001400",2744,281,643,218,554,42,168,9,4659
"42101001500",1653,212,184,212,503,45,158,23,2990
"42101001600",1730,136,19,0,132,0,97,0,2114
"42101001700",2280,76,157,22,278,0,109,8,2930
"42101001800",2225,90,343,136,395,17,202,0,3408
"42101001900",1828,46,532,172,230,19,206,9,3042
"42101002000",413,26,1368,194,36,74,26,0,2137
"42101002100",522,62,1246,397,62,0,59,0,2348
"42101002200",596,79,700,513,238,93,58,39,2316
"42101002300",1924,127,99,1,573,89,305,20,3138
"42101002400",3550,159,285,209,902,58,805,53,6021
"42101002500",2092,200,890,342,411,78,228,0,4241
"42101002701",2023,108,436,585,820,400,820,69,5261
"42101002702",3342,248,155,17,221,8,229,9,4229
"42101002801",1794,306,102,125,1449,610,892,386,5664
"42101002802",3681,269,17,19,1740,77,346,63,6212
"42101002900",2967,385,35,0,1038,108,386,234,5153
"42101003001",1258,345,632,207,1447,518,410,182,4999
"42101003002",549,111,1627,537,269,29,100,0,3222
"42101003100",380,72,2360,936,262,183,147,10,4350
"42101003200",273,290,2634,1670,140,72,43,442,5564
"42101003300",895,529,2513,1726,272,186,125,107,6353
"42101003600",915,328,2026,2437,776,404,116,76,7078
"42101003701",444,204,3152,1378,778,205,333,212,6706
"42101003702",1026,249,1308,327,864,171,143,72,4160
"42101003800",3604,200,35,2,156,10,153,5,4165
"42101003901",3360,867,566,23,1022,227,86,74,6225
"42101003902",4965,409,49,0,203,0,35,47,5708
"42101004001",2833,399,190,22,399,228,244,46,4361
"42101004002",4046,375,15,0,378,0,334,0,5148
"42101004101",1870,572,1083,204,1187,1873,473,619,7881
"42101004102",2653,1879,601,572,2586,997,709,711,10708
"42101004201",4101,510,311,61,345,297,268,24,5917
"42101004202",3218,577,105,83,1061,345,189,177,5755
"42101005000",0,0,0,0,0,0,0,0,0
"42101005400",208,39,868,71,110,7,62,10,1375
"42101005500",736,71,4094,1151,214,53,295,70,6684
"42101005600",66,8,480,376,61,0,23,7,1021
"42101006000",1107,58,3020,1344,327,199,116,11,6182
"42101006100",418,59,1911,489,230,259,27,17,3410
"42101006200",412,24,2976,1271,199,0,133,37,5052
"42101006300",243,180,1488,1334,541,222,222,158,4388
"42101006400",155,161,1923,547,285,372,84,7,3534
"42101006500",42,15,2691,1237,36,63,51,0,4135
"42101006600",191,16,1699,995,143,406,67,0,3517
"42101006700",577,273,3598,1510,264,540,231,0,6993
"42101006900",5,23,1077,1083,0,133,0,148,2469
"42101007000",10,104,2243,1027,0,144,0,10,3538
"42101007101",10,72,1607,788,31,0,0,5,2513
"42101007102",55,10,2587,2067,46,39,17,0,4821
"42101007200",83,22,2643,1335,73,97,72,0,4325
"42101007300",54,0,1491,753,126,0,51,0,2475
"42101007400",269,150,2270,1593,174,11,0,24,4491
"42101007700",317,372,312,112,137,254,16,24,1544
"42101007800",1979,453,844,207,456,149,177,46,4311
"42101007900",2221,236,1226,213,768,98,239,11,5012
"42101008000",450,128,1770,812,257,252,151,75,3895
"42101008101",0,7,1460,1000,14,151,7,7,2646
"42101008102",26,0,3420,1854,77,55,63,0,5495
"42101008200",0,3,5012,1744,53,84,4,1,6901
"42101008301",1,41,3305,752,91,91,87,1,4369
"42101008302",0,2,2865,1354,119,130,73,44,4587
"42101008400",146,62,2515,1826,203,91,23,136,5002
"42101008500",235,101,4269,2537,94,60,67,119,7482
"42101008601",1337,182,555,377,387,25,64,7,2934
"42101008602",314,161,1372,929,49,15,0,47,2887
"42101008701",1864,1024,669,88,774,814,204,443,5880
"42101008702",939,514,160,522,748,318,64,96,3361
"42101008801",106,98,0,15,35,125,7,45,431
"42101008802",401,1841,197,239,460,988,79,224,4429
"42101009000",605,1205,45,140,331,442,53,108,2929
"42101009100",520,356,476,815,343,356,50,8,2924
"42101009200",271,257,1232,1135,224,270,54,21,3464
"42101009300",100,14,2984,1070,42,5,104,0,4319
"42101009400",8,50,2262,1817,90,43,0,35,4305
"42101009500",0,129,1760,1254,75,11,0,119,3348
"42101009600",71,25,2812,1149,70,75,35,52,4289
"42101009801",368,11,1394,460,127,63,35,28,2486
"42101009802",539,48,4904,871,142,0,66,0,6570
"42101010000",527,60,2547,1153,138,56,19,62,4562
"42101010100",148,415,4195,1521,166,116,113,461,7135
"42101010200",0,0,1604,1237,25,0,26,35,2927
"42101010300",7,0,1572,753,39,167,7,115,2660
"42101010400",51,122,2325,1129,36,17,7,55,3742
"42101010500",86,25,1858,1531,60,36,62,0,3658
"42101010600",18,77,630,671,11,59,7,30,1503
"42101010700",66,0,1419,1571,166,7,9,0,3238
"42101010800",177,142,1323,2185,85,24,17,0,3953
"42101010900",165,265,932,950,32,148,67,51,2610
"42101011000",186,42,1583,1556,119,59,131,11,3687
"42101011100",43,137,1592,1452,10,0,0,32,3266
"42101011200",11,17,3147,1437,101,0,83,2,4798
"42101011300",0,0,1708,1191,0,13,0,0,2912
"42101011400",64,35,5597,1566,26,37,86,40,7451
"42101011500",280,66,3521,695,63,61,98,0,4784
"42101011700",129,169,558,57,69,16,23,30,1051
"42101011800",31,19,4596,823,353,72,313,0,6207
"42101011900",2,40,2778,1229,153,45,0,28,4275
"42101012000",341,105,803,89,79,18,85,0,1520
"42101012100",199,235,1434,456,153,84,87,28,2676
"42101012201",384,653,792,356,423,549,88,0,3245
"42101012203",205,144,177,55,155,41,22,0,799
"42101012204",504,165,1784,414,92,93,10,35,3097
"42101012500",3570,644,257,37,487,85,163,21,5264
"42101013100",278,76,685,266,162,25,41,22,1555
"42101013200",170,86,1631,736,38,95,95,94,2945
"42101013300",1204,363,823,566,234,327,211,209,3937
"42101013401",1958,114,61,35,104,0,43,22,2337
"42101013402",2130,188,173,41,200,21,280,124,3157
"42101013500",1812,137,785,314,448,162,361,194,4213
"42101013601",2157,39,222,0,354,55,37,10,2874
"42101013602",2585,205,357,296,363,20,67,13,3906
"42101013700",1022,209,2197,1198,172,65,148,0,5011
"42101013800",283,37,1220,544,116,49,119,19,2387
"42101013900",214,64,1068,1373,34,21,55,57,2886
"42101014000",306,417,1227,735,163,92,35,31,3006
"42101014100",341,147,774,459,310,118,85,98,2332
"42101014200",2793,181,367,36,374,49,409,56,4265
"42101014300",1099,124,29,0,174,28,67,19,1540
"42101014400",1472,416,235,261,755,401,854,519,4913
"42101014500",119,64,815,344,269,65,361,109,2146
"42101014600",88,230,1507,284,25,121,43,41,2339
"42101014700",110,715,742,656,128,194,8,126,2679
"42101014800",0,73,693,255,12,10,7,2,1052
"42101014900",63,14,1902,1057,257,130,127,125,3675
"42101015101",40,27,979,885,5,125,1,139,2201
"42101015102",1,35,1513,1539,208,28,160,35,3519
"42101015200",13,164,2272,3040,218,117,222,128,6174
"42101015300",298,1359,820,563,37,289,0,85,3451
"42101015600",242,366,156,211,583,428,687,648,3321
"42101015700",829,483,219,15,813,205,911,288,3763
"42101015800",4415,1199,108,2,213,0,38,62,6037
"42101016000",5146,788,81,24,485,171,292,71,7058
"42101016100",2227,748,178,151,1128,631,765,716,6544
"42101016200",316,408,139,353,543,519,745,993,4016
"42101016300",465,585,242,112,616,1538,908,1865,6331
"42101016400",401,373,1041,1377,768,607,1236,1105,6908
"42101016500",85,12,601,1172,170,211,172,226,2649
"42101016600",140,151,516,604,136,15,140,21,1723
"42101016701",0,43,1592,1239,51,75,0,0,3000
"42101016702",0,308,1750,995,44,32,18,24,3171
"42101016800",132,19,2195,1527,54,0,11,10,3948
"42101016901",7,52,2109,1159,77,29,0,3,3436
"42101016902",65,0,3570,2262,12,0,66,156,6131
"42101017000",517,91,1611,643,89,37,81,35,3104
"42101017100",7,60,3172,859,58,85,61,127,4429
"42101017201",33,50,1792,1337,89,215,9,5,3530
"42101017202",9,182,1848,1183,0,152,0,154,3528
"42101017300",68,10,1696,1194,12,1,14,47,3042
"42101017400",15,21,929,930,0,112,14,172,2193
"42101017500",629,1158,1365,1268,660,1994,1284,3105,11463
"42101017601",1118,617,184,280,1094,2741,2118,3400,11552
"42101017602",597,1204,286,309,641,1283,1230,2414,7964
"42101017701",651,538,564,511,1098,557,1726,986,6631
"42101017702",695,1251,592,779,701,1731,1228,2948,9925
"42101017800",1217,1049,813,751,458,1354,750,1742,8134
"42101017900",3245,646,1000,777,132,1058,1273,1315,9446
"42101018001",1993,322,0,33,158,61,106,63,2736
"42101018002",4235,1104,0,4,34,53,0,270,5700
"42101018300",3249,513,35,0,0,21,40,1,3859
"42101018400",2093,276,0,1,60,41,106,31,2608
"42101018800",1703,2258,1066,1772,1134,1171,1646,2729,13479
"42101019000",1812,797,1047,695,2055,1494,3205,2069,13174
"42101019100",2525,1166,608,617,2551,957,3466,1441,13331
"42101019200",2101,2218,1130,1385,1538,1092,2922,3658,16044
"42101019501",799,1069,8,475,1118,1217,1776,2205,8667
"42101019502",660,862,201,88,593,862,1183,1350,5799
"42101019700",770,517,1967,1685,989,1168,1923,2065,11084
"42101019800",487,741,1750,963,1222,1829,2050,2619,11661
"42101019900",563,655,1085,772,442,894,1003,1504,6918
"42101020000",132,7,579,437,38,74,163,39,1469
"42101020101",24,8,2391,1366,30,78,100,36,4033
"42101020102",2,7,2123,969,0,158,23,121,3403
"42101020200",126,163,3048,1296,0,10,0,167,4810
"42101020300",14,13,1462,1131,38,89,26,30,2803
"42101020400",3,10,1668,701,27,88,0,51,2548
"42101020500",175,24,1648,655,173,88,53,0,2816
"42101020600",577,146,450,137,145,107,85,15,1662
"42101020700",3492,438,682,139,386,109,146,104,5496
"42101020800",655,215,598,114,133,160,41,18,1934
"42101020900",2293,334,57,13,219,10,144,6,3076
"42101021000",3818,865,160,91,104,51,112,26,5227
"42101021100",1950,244,101,17,151,32,82,0,2577
"42101021200",1837,155,232,15,283,31,202,11,2766
"42101021300",3096,318,117,20,145,45,175,43,3959
"42101021400",2888,803,412,47,122,7,198,126,4603
"42101021500",3048,354,125,5,256,124,115,31,4058
"42101021600",1466,348,86,39,180,26,54,0,2199
"42101021700",5311,339,267,19,225,1,18,18,6198
"42101021800",1985,782,704,177,430,86,77,91,4332
"42101021900",1306,91,36,25,96,9,19,0,1582
"42101022000",1237,50,206,2,155,0,147,1,1798
"42101023100",1329,6,0,0,42,0,66,0,1443
"42101023500",758,13,261,47,200,39,0,0,1318
"42101023600",1695,90,463,220,74,0,49,0,2591
"42101023700",1244,63,2221,344,620,36,172,36,4736
"42101023800",1033,93,2176,538,234,40,122,33,4269
"42101023900",312,75,485,331,103,57,70,33,1466
"42101024000",1001,314,1441,724,130,194,30,67,3901
"42101024100",263,84,506,417,34,36,0,20,1360
"42101024200",295,78,1870,910,149,20,111,14,3447
"42101024300",416,90,2034,1312,30,33,50,1,3966
"42101024400",77,57,1699,735,30,0,177,19,2794
"42101024500",122,146,1768,1565,88,0,52,64,3805
"42101024600",364,45,1434,1122,79,35,46,5,3130
"42101024700",130,90,2206,2318,170,22,34,24,4994
"42101024800",26,17,1736,313,28,0,17,15,2152
"42101024900",0,26,1762,1241,0,78,0,84,3191
"42101025200",313,33,3933,1937,64,15,61,0,6356
"42101025300",245,23,2347,803,245,104,48,49,3864
"42101025400",458,21,2880,470,249,53,75,55,4261
"42101025500",687,78,1721,123,341,0,310,0,3260
"42101025600",1267,128,1094,118,117,9,26,16,2775
"42101025700",1972,88,927,114,272,91,318,0,3782
"42101025800",32,0,1571,72,18,0,20,0,1713
"42101025900",53,13,3945,666,153,0,14,0,4844
"42101026000",89,66,2392,358,136,55,28,66,3190
"42101026100",33,45,2764,352,12,1,14,44,3265
"42101026200",70,0,3837,444,73,0,52,0,4476
"42101026301",29,0,3403,759,59,20,0,0,4270
"42101026302",64,66,4293,964,150,0,13,62,5612
"42101026400",83,1,4634,855,178,2,193,1,5947
"42101026500",61,3,3879,1198,83,5,54,69,5352
"42101026600",19,3,5545,1073,169,14,18,1,6842
"42101026700",192,0,5063,1424,19,24,11,0,6733
"42101026800",92,83,3349,717,302,112,111,12,4778
"42101026900",281,44,1089,233,230,0,164,26,2067
"42101027000",276,50,1627,410,444,11,9,3,2830
"42101027100",118,28,1256,607,726,203,169,77,3184
"42101027200",280,121,3543,508,418,50,149,90,5159
"42101027300",664,191,3367,596,2057,322,878,88,8163
"42101027401",286,87,1379,133,1045,332,199,10,3471
"42101027402",323,186,2912,782,2540,490,1847,156,9236
"42101027500",471,114,2899,663,291,690,306,337,5771
"42101027600",54,11,2391,970,80,41,4,11,3562
"42101027700",153,8,3309,1268,246,142,51,0,5177
"42101027800",184,145,3121,1353,27,6,185,132,5153
"42101027901",89,6,2219,1243,52,905,149,1,4664
"42101027902",76,320,1510,577,107,201,57,140,2988
"42101028000",22,4,2619,1390,13,66,122,1,4237
"42101028100",105,315,2597,1047,21,39,29,222,4375
"42101028200",202,119,3249,1132,285,138,166,227,5518
"42101028300",432,163,2922,1830,287,235,88,322,6279
"42101028400",193,359,2090,1343,421,225,533,412,5576
"42101028500",407,207,775,481,648,403,779,344,4044
"42101028600",776,161,4016,1154,1209,668,1744,744,10472
"42101028700",416,191,443,305,649,497,1022,655,4178
"42101028800",485,596,628,140,1766,758,1286,999,6658
"42101028901",673,252,507,561,1482,931,1675,1036,7117
"42101028902",690,1109,1086,324,2182,1503,2373,2343,11610
"42101029000",781,664,2403,793,1411,1156,1382,1412,10002
"42101029100",729,134,941,1030,1195,782,708,476,5995
"42101029200",824,394,1325,227,1068,212,1109,440,5599
"42101029300",661,227,485,567,264,718,494,767,4183
"42101029400",575,402,674,718,132,359,403,576,3839
"42101029800",1568,641,924,648,1043,48,1259,277,6408
"42101029900",721,705,1200,845,321,131,500,640,5063
"42101030000",1183,518,2801,1591,700,314,1042,482,8631
"42101030100",1178,815,1854,539,289,224,595,422,5916
"42101030200",1104,986,2464,878,1172,190,1329,855,8978
"42101030501",617,769,2373,1180,1174,192,1012,730,8047
"42101030502",777,412,2369,769,1044,1091,510,705,7677
"42101030600",3172,390,1875,393,1895,488,1838,472,10523
"42101030700",1723,516,1269,335,260,41,258,10,4412
"42101030800",2304,233,828,9,930,258,706,131,5399
"42101030900",756,465,1328,268,1144,546,812,580,5899
"42101031000",2833,781,1848,247,2136,528,1385,29,9787
"42101031101",1338,557,1636,492,940,398,1024,503,6888
"42101031102",673,141,2062,225,666,230,591,274,4862
"42101031200",868,215,1856,631,1005,506,1097,121,6299
"42101031300",1985,631,907,695,1447,557,677,691,7590
"42101031401",1604,711,1319,29,2406,872,911,493,8345
"42101031402",2254,589,647,207,1265,696,681,492,6831
"42101031501",4416,820,130,107,480,550,466,243,7212
"42101031502",2141,419,295,9,384,245,163,28,3684
"42101031600",3431,281,820,261,593,455,530,215,6586
"42101031700",2858,228,1373,350,1163,249,1125,262,7608
"42101031800",1125,351,1574,266,710,105,841,190,5162
"42101031900",1665,767,1142,96,492,197,697,502,5558
"42101032000",4569,441,782,92,556,192,937,182,7751
"42101032100",1809,463,835,271,451,343,561,491,5224
"42101032300",1761,370,653,146,199,0,398,40,3567
"42101032500",3406,614,809,735,203,280,611,244,6902
"42101032600",3566,793,653,403,689,259,973,204,7540
"42101032900",1697,413,604,169,127,254,153,116,3533
"42101033000",3854,2382,478,27,290,193,581,520,8325
"42101033101",4233,160,85,46,60,115,143,21,4863
"42101033102",2615,486,236,79,124,11,173,41,3765
"42101033200",2189,184,73,8,180,60,173,14,2881
"42101033300",2723,339,495,148,234,66,285,46,4336
"42101033400",2959,301,650,242,522,565,430,188,5857
"42101033500",1688,323,557,102,896,479,671,179,4895
"42101033600",4710,662,489,115,1212,163,980,93,8424
"42101033701",3479,714,443,80,328,178,217,58,5497
"42101033702",3194,183,456,0,1083,191,165,77,5349
"42101033800",3896,480,688,54,1097,48,489,42,6794
"42101033900",2106,405,321,133,278,240,142,151,3776
"42101034000",1783,144,314,9,547,76,412,3,3288
"42101034100",4771,619,380,52,216,0,233,87,6358
"42101034200",2484,222,282,47,350,51,144,51,3631
"42101034400",5864,185,207,47,1155,0,356,0,7814
"42101034501",1600,1013,295,78,789,29,237,438,4479
"42101034502",2864,328,748,191,639,1,682,34,5487
"42101034600",1174,229,621,121,433,101,215,64,2958
"42101034701",3956,667,507,73,1190,122,665,209,7389
"42101034702",3113,26,313,22,471,0,101,0,4046
"42101034801",3291,319,226,167,150,9,155,29,4346
"42101034802",3278,340,766,484,430,38,497,0,5833
"42101034803",3359,214,275,36,538,0,429,11,4862
"42101034900",3215,593,690,114,672,224,579,288,6375
"42101035100",3109,247,174,0,48,0,70,14,3662
"42101035200",3441,219,0,22,374,31,238,6,4331
"42101035301",4239,430,113,8,386,195,376,188,5935
"42101035302",3513,351,257,97,233,2,172,2,4627
"42101035500",4619,964,268,0,1111,101,470,42,7575
"42101035601",4620,361,0,3,656,0,262,0,5902
"42101035602",1742,120,143,46,1066,48,124,10,3299
"42101035701",1775,661,398,115,1243,298,105,25,4620
"42101035702",2975,579,19,71,562,0,202,0,4408
"42101035800",5019,647,519,0,684,127,216,108,7320
"42101035900",3610,679,195,0,666,0,86,0,5236
"42101036000",1262,200,205,98,980,28,45,0,2818
"42101036100",2681,320,563,76,126,159,104,174,4203
"42101036201",4247,149,460,26,108,0,186,0,5176
"42101036202",5038,209,155,175,315,228,469,110,6699
"42101036203",4877,244,0,25,278,68,214,93,5799
"42101036301",2442,247,95,0,586,0,96,0,3466
"42101036302",2218,373,593,107,284,22,286,280,4163
"42101036303",5466,246,162,0,248,90,78,0,6290
"42101036400",206,165,57,106,40,26,16,31,647
"42101036501",3708,403,512,191,282,34,129,96,5355
"42101036502",3742,377,0,4,165,0,29,0,4317
"42101036600",1232,33,145,20,374,39,50,0,1893
"42101036700",1944,119,517,0,150,17,207,35,2989
"42101036900",480,138,84,15,239,293,22,0,1271
"42101037200",2829,309,273,21,731,401,109,89,4762
"42101037300",4406,176,289,20,497,42,214,35,5679
"42101037500",1311,618,1347,367,139,111,108,118,4119
"42101037600",1015,290,216,410,487,336,244,119,3117
"42101037700",274,437,1557,692,80,464,265,489,4258
"42101037800",1363,546,232,14,71,16,66,43,2351
"42101037900",4551,551,0,148,58,0,147,103,5558
"42101038000",1352,485,81,21,189,77,290,233,2728
"42101038100",341,227,242,56,31,23,66,57,1043
"42101038200",1172,410,175,221,449,104,510,153,3194
"42101038300",361,639,456,641,735,804,1184,1420,6240
"42101038400",1978,136,206,54,153,0,60,2,2589
"42101038500",1569,91,87,28,71,15,59,0,1920
"42101038600",1084,56,147,6,59,14,60,0,1426
"42101038700",1359,97,73,22,166,0,65,0,1782
"42101038800",2209,91,912,157,304,78,82,11,3844
"42101038900",164,138,2176,693,13,37,18,31,3270
"42101039000",1051,424,3118,2192,858,511,915,919,9988
"42101980000",113,0,30,7,31,0,0,0,181
"42101980100",70,10,0,0,0,0,4,0,84
"42101980200",155,8,0,9,6,0,0,0,178
"42101980300",0,0,0,0,0,0,0,0,0
"42101980400",0,0,0,0,0,0,0,0,0
"42101980500",0,0,0,0,0,0,0,0,0
"42101980600",0,0,0,0,0,0,0,0,0
"42101980700",0,0,0,0,0,0,0,0,0
"42101980800",0,0,0,0,0,0,0,0,0
"42101980900",4,0,0,0,0,0,0,0,4
"42101989100",29,23,22,40,0,15,0,0,129
"42103950102",1949,370,22,0,61,18,234,36,2690
"42103950103",1900,240,0,25,126,9,92,58,2450
"42103950104",1979,163,16,0,56,14,137,28,2393
"42103950201",2674,207,440,1,63,0,239,57,3681
"42103950202",1349,96,102,0,83,0,69,0,1699
"42103950301",2246,234,19,0,29,0,27,4,2559
"42103950302",701,37,0,0,21,0,0,0,759
"42103950501",1025,167,11,0,79,0,76,0,1358
"42103950502",2385,164,208,0,358,13,374,0,3502
"42103950601",1301,104,37,0,100,8,71,4,1625
"42103950603",920,81,0,8,8,0,28,6,1051
"42103950605",5470,203,380,19,36,69,304,31,6512
"42103950606",4879,134,61,0,366,68,235,68,5811
"42103950701",3436,353,10,0,98,29,414,0,4340
"42103950702",2536,495,109,0,50,79,143,0,3412
"42103950801",3142,764,666,43,273,50,797,196,5931
"42103950802",3547,672,924,66,273,70,1374,251,7177
"42103950900",3642,456,62,3,121,0,144,0,4428
"42105950100",3960,825,14,10,33,19,46,0,4907
"42105950200",2580,474,19,0,17,4,9,0,3103
"42105950300",3466,413,19,0,113,1,44,5,4061
"42105950400",2551,473,0,0,63,0,67,0,3154
"42105950500",1666,333,12,0,10,18,0,0,2039
"42107000100",4280,498,9,15,74,57,112,51,5096
"42107000200",2081,313,21,5,51,41,123,52,2687
"42107000300",4780,148,0,0,128,0,99,10,5165
"42107000400",1975,228,1,2,6,5,16,4,2237
"42107000500",2651,803,0,228,364,43,338,127,4554
"42107000601",2163,1167,94,0,110,0,457,127,4118
"42107000602",717,278,102,0,63,131,157,127,1575
"42107000700",2808,592,0,0,94,13,10,6,3523
"42107000800",2771,704,16,0,64,54,130,0,3739
"42107000900",5431,404,0,12,0,10,55,26,5938
"42107001000",2212,501,0,0,0,48,0,35,2796
"42107001100",2071,129,9,0,18,0,5,0,2232
"42107001200",3837,237,0,0,56,0,12,0,4142
"42107001300",2443,654,0,4,62,0,21,0,3184
"42107001400",1867,289,0,3,11,26,26,0,2222
"42107001500",3376,722,0,0,212,0,122,0,4432
"42107001600",3505,237,13,25,47,0,4,25,3856
"42107001700",2724,230,31,1,128,0,16,0,3130
"42107001800",1737,299,8,12,20,35,0,0,2111
"42107001900",3133,1180,217,13,277,0,52,224,5096
"42107002000",2372,469,103,48,117,134,94,88,3425
"42107002100",1317,141,0,1,72,0,33,0,1564
"42107002200",2451,274,1,2,0,6,7,6,2747
"42107002300",2408,448,0,19,25,0,0,0,2900
"42107002400",2173,192,0,0,37,5,22,5,2434
"42107002500",2032,325,3,0,31,0,32,4,2427
"42107002600",2912,918,15,0,0,0,6,17,3868
"42107002700",2495,550,0,0,34,0,173,178,3430
"42107002800",1465,629,7,32,40,0,34,73,2280
"42107002900",4956,298,0,0,13,29,6,13,5315
"42107003000",4851,461,20,12,138,3,152,7,5644
"42107003100",2445,138,27,0,169,0,0,12,2791
"42107003200",5077,290,12,16,129,3,97,3,5627
"42107003300",4446,718,0,0,35,38,49,14,5300
"42107003400",3184,181,15,0,32,0,132,8,3552
"42107003500",4759,308,0,0,21,0,55,0,5143
"42107003600",2736,159,3,55,5,34,24,0,3016
"42107003700",3117,330,12,0,109,7,82,0,3657
"42107003800",1787,213,16,20,25,0,60,75,2196
"42107003900",3695,376,0,0,37,0,0,0,4108
"42109070100",5260,259,0,0,143,16,79,3,5760
"42109070200",7070,817,25,9,100,86,262,71,8440
"42109070300",4676,743,60,3,52,32,24,0,5590
"42109070400",4965,580,12,0,89,13,15,9,5683
"42109070500",3255,395,6,32,11,2,16,0,3717
"42109070600",4771,512,0,2,53,0,61,0,5399
"42109070701",2825,545,80,0,92,0,88,5,3635
"42109980705",53,12,32,0,0,19,0,19,135
"42111020101",1712,191,0,0,0,7,16,4,1930
"42111020102",4719,431,38,0,107,1,11,0,5307
"42111020200",4023,271,0,0,42,0,46,0,4382
"42111020300",3171,660,0,11,89,97,26,11,4065
"42111020400",3244,362,5,0,89,0,21,18,3739
"42111020500",2542,316,0,0,20,0,0,0,2878
"42111020600",5139,716,3,18,37,20,31,8,5972
"42111020700",2621,225,4,0,1,2,14,0,2867
"42111020800",3550,344,5,21,19,28,0,0,3967
"42111020900",3839,413,11,6,18,1,50,12,4350
"42111021000",3230,666,0,0,85,25,4,35,4045
"42111021100",1189,728,0,0,4,0,59,0,1980
"42111021200",2554,377,2,0,29,0,0,0,2962
"42111021300",2969,430,2,0,1,0,25,0,3427
"42111021400",3545,586,11,0,72,0,58,0,4272
"42111021500",2328,340,0,4,24,5,11,0,2712
"42111021600",1620,301,0,5,7,0,8,0,1941
"42111021700",2617,484,0,0,15,0,7,44,3167
"42111021800",3160,306,0,6,49,5,20,0,3546
"42111021901",2075,280,0,17,26,0,5,3,2406
"42111021902",1977,367,0,0,12,1,5,4,2366
"42113960100",3140,342,6,149,10,44,77,26,3794
"42113960200",2129,237,0,2,101,28,6,3,2506
"42115032000",2661,262,0,0,65,0,40,0,3028
"42115032100",3466,520,0,12,63,7,21,11,4100
"42115032200",3345,523,24,0,19,5,23,0,3939
"42115032300",2714,783,10,0,55,35,80,26,3703
"42115032400",3558,408,28,10,59,44,25,3,4135
"42115032500",3727,416,82,5,46,31,108,58,4473
"42115032600",3885,442,19,0,24,4,29,45,4448
"42115032700",2927,410,10,0,56,0,76,5,3484
"42115032800",4525,587,15,3,40,22,40,29,5261
"42115032901",3390,506,5,0,21,0,19,26,3967
"42115032902",1611,399,0,0,40,21,17,20,2108
"42117950100",3623,512,20,3,64,0,21,2,4245
"42117950200",3037,597,16,7,51,28,14,13,3763
"42117950300",3017,628,24,7,22,35,17,2,3752
"42117950400",3679,469,6,3,31,1,40,14,4243
"42117950500",4172,572,9,0,64,11,37,4,4869
"42117950600",3825,939,11,0,70,40,141,0,5026
"42117950700",4311,716,0,12,162,22,0,0,5223
"42117950800",2580,372,11,0,113,36,75,83,3270
"42117950900",3478,448,0,0,74,9,4,6,4019
"42117951000",2622,406,21,0,24,18,14,23,3128
"42119090102",5210,796,6,51,9,11,25,9,6117
"42119090200",5241,780,37,15,52,26,188,28,6367
"42119090300",3057,435,145,0,19,20,0,82,3758
"42119090400",3999,288,50,14,60,0,320,0,4731
"42119090502",5799,657,24,92,199,71,0,47,6889
"42119090600",4147,271,0,0,117,2,99,112,4748
"42119090700",2634,933,16,72,70,7,0,249,3981
"42119980101",7,0,0,0,0,0,0,0,7
"42119980501",63,0,0,0,0,0,0,0,63
"42119980800",50,13,0,0,0,0,0,0,63
"42121200000",2958,413,4,0,48,18,16,18,3475
"42121200100",3559,312,8,0,50,4,15,2,3950
"42121200200",4846,701,13,19,94,13,33,0,5719
"42121200300",1152,401,7,3,52,0,2,61,1678
"42121200400",1690,392,30,3,19,32,0,56,2222
"42121200500",1857,440,9,3,39,0,39,0,2387
"42121200600",4336,560,14,0,25,97,0,0,5032
"42121200700",1232,556,5,12,34,48,12,15,1914
"42121200800",1796,298,56,0,61,0,10,0,2221
"42121200900",1487,1033,23,13,18,6,43,3,2626
"42121201000",2612,639,5,3,31,11,0,0,3301
"42121201100",3977,523,1,5,71,26,10,16,4629
"42121201200",2632,268,0,0,91,16,33,0,3040
"42121201300",3150,319,0,0,57,0,0,0,3526
"42121201400",3333,436,2,13,48,21,44,6,3903
"42121201500",2973,386,2,0,99,80,9,45,3594
"42123970100",1968,263,15,10,15,19,0,0,2290
"42123970200",3552,270,20,0,57,0,31,13,3943
"42123970300",4567,974,7,0,61,28,59,10,5706
"42123970400",2481,283,15,0,60,15,12,0,2866
"42123970500",3031,375,1,2,52,30,5,9,3505
"42123970600",3072,185,21,1,43,39,0,5,3366
"42123970700",2443,175,25,0,77,0,30,0,2750
"42123970800",2673,461,0,15,9,49,45,0,3252
"42123970900",2607,612,13,0,21,0,104,0,3357
"42123971000",1904,233,0,0,31,9,6,0,2183
"42123971100",2631,161,0,3,14,0,12,0,2821
"42123971200",1999,402,0,7,3,0,3,0,2414
"42123971400",1576,261,0,6,22,3,4,0,1872
"42125704100",341,255,91,81,65,115,30,20,998
"42125711000",3607,211,0,7,25,35,58,0,3943
"42125712700",1233,131,14,0,6,0,30,0,1414
"42125713700",3991,379,0,0,23,0,18,0,4411
"42125714000",2387,286,26,0,65,5,7,5,2781
"42125715700",1337,211,52,2,17,2,100,4,1725
"42125721000",3824,381,10,0,47,17,24,15,4318
"42125722700",3369,132,7,0,2,0,58,0,3568
"42125731000",5483,512,23,15,58,17,36,0,6144
"42125732000",3159,111,0,0,45,0,17,0,3332
"42125741100",4094,111,21,10,301,2,69,2,4610
"42125741300",3063,154,6,0,103,0,12,0,3338
"42125742100",4980,257,232,85,296,28,0,0,5878
"42125742200",1687,81,0,0,0,0,63,13,1844
"42125743700",1083,189,10,11,26,6,16,3,1344
"42125744100",4528,596,301,19,321,8,50,38,5861
"42125744200",2514,325,160,51,116,4,140,49,3359
"42125745100",8029,108,341,0,296,28,77,0,8879
"42125745200",4535,184,55,11,130,0,83,0,4998
"42125746100",5548,68,48,0,259,0,67,0,5990
"42125746200",3912,177,9,0,250,0,71,13,4432
"42125746301",4988,72,1,0,87,0,113,0,5261
"42125746302",5642,127,0,0,322,11,122,0,6224
"42125751100",4239,514,109,21,33,74,0,0,4990
"42125751200",2343,562,82,179,6,0,52,41,3265
"42125752700",3827,355,60,9,128,51,179,57,4666
"42125753700",1541,100,33,99,109,23,51,26,1982
"42125754200",1473,415,158,24,20,0,28,0,2118
"42125754300",1739,346,495,171,71,84,42,0,2948
"42125754400",1025,441,173,53,117,64,7,10,1890
"42125754500",1931,314,79,67,111,142,3,0,2647
"42125754600",1273,267,176,40,27,11,6,15,1815
"42125755100",3428,364,74,75,20,0,0,0,3961
"42125755200",5120,198,48,0,13,0,0,0,5379
"42125755700",3336,189,0,27,98,29,50,0,3729
"42125761000",4909,351,22,0,75,15,32,2,5406
"42125762000",2160,366,23,37,44,17,8,20,2675
"42125763700",1493,157,72,0,15,6,18,0,1761
"42125764000",2338,740,21,18,86,50,20,0,3273
"42125771100",5294,384,0,0,104,0,14,0,5796
"42125771200",2834,445,9,2,35,32,0,34,3391
"42125772700",1726,227,8,12,29,30,45,1,2078
"42125773100",2173,474,113,13,70,84,10,22,2959
"42125773200",1034,160,56,22,0,0,0,0,1272
"42125774700",5131,183,110,0,51,0,164,0,5639
"42125775200",1432,612,219,18,34,14,0,9,2338
"42125775300",1408,410,169,52,180,40,65,0,2324
"42125781700",3690,343,167,0,54,32,73,4,4363
"42125782700",1002,169,49,27,41,12,17,9,1326
"42125783200",1718,669,22,130,0,6,0,6,2551
"42125783300",1142,314,27,0,4,0,0,0,1487
"42125784000",2205,321,9,4,26,23,16,9,2613
"42125791000",1311,202,6,0,25,5,10,0,1559
"42125792100",2441,750,74,43,100,13,38,0,3459
"42125792200",1194,535,57,0,30,81,30,16,1943
"42125795700",1867,448,10,9,16,82,0,26,2458
"42125795800",3580,72,66,0,104,0,89,0,3911
"42125795900",3496,497,18,3,11,55,20,4,4104
"42125796000",2961,321,3,0,51,1,0,10,3347
"42127960100",1063,138,0,0,12,6,18,0,1237
"42127960200",2447,433,26,0,104,26,51,31,3118
"42127960300",2273,147,0,0,31,0,39,0,2490
"42127960400",2575,350,4,0,32,12,63,38,3074
"42127960500",3382,187,0,0,23,0,11,10,3613
"42127960600",4304,565,46,4,182,7,251,36,5395
"42127960700",2904,1333,0,41,20,0,107,39,4444
"42127960800",3549,563,60,1,31,22,76,29,4331
"42127960900",2997,479,0,4,49,61,63,60,3713
"42127961000",4549,231,166,46,29,19,73,0,5113
"42127961100",3238,444,0,0,51,9,26,16,3784
"42127961200",3576,509,31,2,27,10,294,19,4468
"42127961300",2486,334,90,0,34,4,69,0,3017
"42127961400",1316,157,12,13,21,7,47,0,1573
"42129800100",344,356,130,176,0,60,7,34,1107
"42129800200",783,203,337,90,24,86,6,0,1529
"42129800300",1453,459,139,211,16,46,11,88,2423
"42129800400",1140,188,10,15,106,0,104,0,1563
"42129800500",1946,92,119,0,111,1,9,0,2278
"42129800600",1317,535,167,394,74,100,16,0,2603
"42129800700",882,643,133,394,88,69,19,0,2228
"42129800800",1433,208,47,32,38,13,0,0,1771
"42129800900",2057,257,23,37,114,0,21,0,2509
"42129801001",3439,191,0,0,70,0,10,0,3710
"42129801002",2326,250,31,22,25,33,57,21,2765
"42129801100",4493,512,0,5,62,18,62,0,5152
"42129801200",5124,352,146,0,50,0,70,0,5742
"42129801300",3765,466,29,13,33,0,4,0,4310
"42129801400",1543,239,40,0,49,16,0,0,1887
"42129801500",1928,530,123,27,47,16,24,0,2695
"42129801600",837,210,100,92,7,22,1,0,1269
"42129801701",2151,88,62,18,0,0,4,0,2323
"42129801702",4445,180,0,0,9,17,75,0,4726
"42129801703",2335,176,0,0,10,0,38,0,2559
"42129801800",5656,618,68,5,101,13,111,18,6590
"42129801900",5838,493,74,1,116,61,15,0,6598
"42129802001",2310,80,5,1,94,13,15,2,2520
"42129802002",6671,533,42,6,415,21,32,21,7741
"42129802101",4487,233,50,0,170,0,0,0,4940
"42129802102",5421,258,0,0,129,62,136,73,6079
"42129802103",2278,40,0,0,274,0,16,0,2608
"42129802200",2662,307,59,0,21,0,0,0,3049
"42129802301",5488,226,0,0,12,0,0,0,5726
"42129802303",2983,149,0,0,33,0,0,0,3165
"42129802304",5989,379,6,0,294,0,0,0,6668
"42129802400",3985,221,0,0,89,0,81,0,4376
"42129802500",1923,214,0,17,56,111,31,0,2352
"42129802600",2902,258,58,18,122,0,0,0,3358
"42129802700",1667,223,69,0,44,0,10,0,2013
"42129802800",1403,416,128,61,91,183,0,0,2282
"42129802900",5187,295,0,0,0,0,21,0,5503
"42129803000",4131,545,0,30,1,0,25,0,4732
"42129803100",3668,130,0,0,196,20,38,0,4052
"42129803200",2179,96,0,0,0,0,0,0,2275
"42129803301",5557,63,0,29,144,0,84,0,5877
"42129803302",4228,141,39,12,10,5,59,0,4494
"42129803400",3157,78,32,0,97,0,65,0,3429
"42129803501",4154,184,49,0,55,0,0,0,4442
"42129803502",3845,189,22,0,35,0,36,0,4127
"42129803600",1639,181,0,2,7,0,12,0,1841
"42129803700",3748,381,0,0,55,0,39,0,4223
"42129803800",4938,292,14,0,59,0,35,0,5338
"42129803901",2683,200,125,24,172,0,76,35,3315
"42129803902",2194,511,74,2,68,161,52,82,3144
"42129804000",586,403,57,68,53,57,0,18,1242
"42129804100",1324,673,167,48,46,146,10,10,2424
"42129804200",2789,608,239,35,87,48,15,20,3841
"42129804300",1708,280,31,2,0,0,10,0,2031
"42129804400",1820,167,1,4,74,0,4,0,2070
"42129804501",4305,188,11,0,98,0,44,8,4654
"42129804502",4365,471,14,0,118,47,59,0,5074
"42129804600",2463,414,0,0,44,0,61,0,2982
"42129804701",2686,151,70,5,17,0,2,0,2931
"42129804702",4001,312,0,0,0,0,0,0,4313
"42129804801",1908,298,7,24,61,9,10,0,2317
"42129804802",5631,472,26,0,74,0,90,0,6293
"42129804900",5096,450,6,34,115,41,90,5,5837
"42129805000",3507,385,1,1,9,21,21,0,3945
"42129805100",2150,412,21,0,13,1,0,0,2597
"42129805200",1371,281,184,220,42,42,0,4,2144
"42129805400",672,404,252,159,59,82,26,36,1690
"42129805500",3409,124,125,25,42,0,29,0,3754
"42129805600",1614,304,32,0,31,8,54,6,2049
"42129805800",2523,257,68,84,53,1,0,0,2986
"42129805901",1489,32,0,0,15,8,0,0,1544
"42129805902",6045,271,47,56,207,47,74,0,6747
"42129806000",2152,396,0,0,7,0,0,0,2555
"42129806100",3108,246,2,19,5,21,12,10,3423
"42129806200",2236,363,0,0,3,59,0,52,2713
"42129806300",1681,126,173,0,10,0,0,0,1990
"42129806400",1783,398,81,0,41,12,0,0,2315
"42129806500",4330,323,6,0,0,150,29,65,4903
"42129806600",2472,381,28,3,89,0,7,0,2980
"42129806700",2205,431,10,0,83,1,77,0,2807
"42129806800",1246,223,12,0,93,0,8,0,1582
"42129806900",3312,439,0,0,32,0,0,0,3783
"42129807000",3011,301,1,2,18,0,10,0,3343
"42129807100",3420,196,0,0,0,0,54,0,3670
"42129807200",6536,311,59,0,293,0,15,0,7214
"42129807300",4589,503,0,4,18,67,36,41,5258
"42129807401",2198,148,2,3,30,4,5,0,2390
"42129807402",5674,543,50,51,201,14,77,14,6624
"42129807500",2096,141,0,0,20,0,11,12,2280
"42129807600",1963,466,0,0,59,0,0,7,2495
"42129807700",2942,343,50,40,52,0,0,0,3427
"42129807800",3125,617,1,3,99,60,29,0,3934
"42129807900",5561,518,10,0,97,28,14,1,6229
"42129808100",3564,737,119,90,12,147,81,17,4767
"42129808200",2119,421,0,0,44,22,6,12,2624
"42129808300",4398,689,13,18,54,18,17,1,5208
"42129808401",1785,109,0,0,51,12,10,0,1967
"42129808402",4449,224,0,0,39,0,67,6,4785
"42129808500",1313,154,0,0,6,10,0,10,1493
"42129808600",3842,508,0,8,102,7,72,0,4539
"42131400100",2448,426,6,7,75,20,81,78,3141
"42131400200",3663,458,2,0,15,17,85,20,4260
"42131400300",3968,338,17,25,41,35,22,17,4463
"42131400400",3870,230,0,0,64,33,41,0,4238
"42131400500",3609,507,8,0,77,4,55,10,4270
"42131400600",2864,423,14,12,63,0,25,0,3401
"42131400700",3548,474,11,0,73,21,5,0,4132
"42133000100",493,158,160,327,5,57,22,253,1475
"42133000200",752,427,398,544,350,98,448,274,3291
"42133000300",814,483,180,260,199,173,469,426,3004
"42133000400",1299,299,356,49,189,159,351,113,2815
"42133000500",963,487,443,302,196,160,292,370,3213
"42133000600",1761,374,226,340,29,210,621,384,3945
"42133000700",823,644,660,523,46,273,555,570,4094
"42133000800",1081,212,413,117,186,45,294,194,2542
"42133000900",639,808,388,497,171,138,317,281,3239
"42133001000",453,300,459,427,33,119,259,251,2301
"42133001100",1455,503,554,440,662,159,943,364,5080
"42133001200",879,1125,305,466,464,591,596,1251,5677
"42133001300",1494,216,915,98,278,126,242,0,3369
"42133001400",2341,432,402,298,420,161,509,259,4822
"42133001500",1055,892,511,419,215,400,526,1044,5062
"42133001600",627,327,136,203,84,153,78,297,1905
"42133010110",4926,426,823,96,500,30,467,73,7341
"42133010120",4123,177,126,8,298,0,152,1,4885
"42133010130",3183,130,53,0,163,8,61,0,3598
"42133010210",2601,64,13,6,133,77,66,0,2960
"42133010220",4203,186,399,0,265,200,375,23,5651
"42133010300",1156,96,230,18,59,0,3,23,1585
"42133010400",3063,102,151,9,280,69,340,10,4024
"42133010510",2681,69,157,0,321,7,269,0,3504
"42133010520",2079,75,80,16,19,0,37,0,2306
"42133020100",2672,295,168,0,35,26,157,127,3480
"42133020220",3950,262,29,0,80,0,92,3,4416
"42133020221",4153,328,122,0,84,33,213,0,4933
"42133020222",4308,192,40,1,109,0,43,0,4693
"42133020310",2497,45,41,0,49,3,36,0,2671
"42133020320",7031,326,0,0,144,17,43,2,7563
"42133020410",4817,442,22,23,90,0,275,7,5676
"42133020420",7610,481,42,0,553,0,74,35,8795
"42133020510",3549,277,0,0,6,0,35,0,3867
"42133020521",4897,513,188,6,180,37,93,44,5958
"42133020522",3772,128,112,0,45,7,67,0,4131
"42133020600",6353,713,0,0,87,124,130,0,7407
"42133020710",5519,385,412,40,301,37,63,69,6826
"42133020720",8182,517,251,0,175,20,571,44,9760
"42133020800",6351,567,437,164,227,42,469,331,8588
"42133020910",5456,338,12,8,141,31,117,28,6131
"42133020921",6329,650,78,0,368,14,313,0,7752
"42133020922",3718,222,0,0,64,26,67,0,4097
"42133021010",4190,273,175,23,242,175,99,137,5314
"42133021020",6064,363,39,37,180,67,279,31,7060
"42133021100",3929,204,296,36,173,0,378,1,5017
"42133021210",6294,449,609,211,369,33,354,63,8382
"42133021220",5918,28,740,0,524,0,106,0,7316
"42133021300",2734,490,421,112,544,259,465,155,5180
"42133021410",3855,486,244,107,289,4,265,171,5421
"42133021420",6471,281,183,18,203,0,421,0,7577
"42133021500",3186,276,40,0,45,102,107,16,3772
"42133021600",2060,145,330,28,116,26,180,37,2922
"42133021711",2875,159,5,0,15,0,10,6,3070
"42133021712",5822,423,8,0,136,0,140,0,6529
"42133021720",3889,246,253,7,90,0,59,16,4560
"42133021801",4057,199,164,0,73,119,208,145,4965
"42133021802",3751,48,70,0,87,49,77,0,4082
"42133021900",5861,584,122,0,377,83,27,51,7105
"42133022000",2737,657,48,23,133,328,83,257,4266
"42133022100",1849,745,71,81,74,286,67,399,3572
"42133022200",4125,259,0,0,172,37,268,37,4898
"42133022300",2939,186,22,0,357,0,225,5,3734
"42133022401",3370,38,0,0,7,0,53,0,3468
"42133022402",7394,256,42,16,312,2,48,1,8071
"42133022500",3410,293,58,0,69,0,43,0,3873
"42133022600",7367,320,246,13,295,31,141,0,8413
"42133022700",5095,480,193,93,235,21,202,0,6319
"42133022800",6882,547,110,0,158,0,245,0,7942
"42133022910",7077,836,678,0,616,355,574,43,10179
"42133022920",3999,177,23,0,160,0,38,0,4397
"42133023000",3748,864,35,81,119,107,121,113,5188
"42133023100",5413,686,40,14,91,6,261,0,6511
"42133023200",5576,391,320,10,125,68,167,5,6662
"42133023301",5629,196,449,0,218,0,191,0,6683
"42133023302",5236,638,44,0,177,0,81,0,6176
"42133023400",5154,391,13,0,39,35,88,0,5720
"42133023500",4828,379,9,66,106,47,65,66,5566
"42133023601",3217,308,0,0,106,115,55,68,3869
"42133023602",4300,571,32,5,53,57,53,75,5146
"42133023710",3645,206,0,5,61,0,14,3,3934
"42133023721",4956,819,217,0,124,0,0,0,6116
"42133023722",2725,270,0,0,52,18,12,0,3077
"42133023810",4302,242,16,37,54,0,44,48,4743
"42133023821",4761,162,170,4,96,0,230,0,5423
"42133023822",6611,163,239,0,86,44,225,57,7425
"42133023901",6841,355,50,88,99,4,104,0,7541
"42133023902",2793,116,0,0,13,2,85,0,3009
"42133024001",4441,855,38,0,185,0,38,9,5566
"42133024002",3165,208,16,0,79,33,13,14,3528
"44001030100",4172,115,81,0,361,2,87,10,4828
"44001030200",2689,89,10,0,186,0,46,0,3020
"44001030300",4253,66,0,33,170,0,63,4,4589
"44001030400",3875,31,0,3,93,12,89,0,4103
"44001030500",2654,399,15,0,72,26,103,16,3285
"44001030601",3014,329,0,0,33,0,94,0,3470
"44001030602",3329,382,9,0,12,20,53,0,3805
"44001030700",3091,764,0,0,20,91,46,72,4084
"44001030800",2869,270,47,205,58,8,73,8,3538
"44001030901",5430,179,0,0,127,9,262,0,6007
"44001030902",5477,323,165,30,173,10,32,10,6220
"44003020101",5344,443,179,0,230,41,97,0,6334
"44003020102",3770,718,178,37,191,13,280,213,5400
"44003020200",3000,736,120,0,816,52,250,29,5003
"44003020300",3858,1563,46,19,246,178,241,222,6373
"44003020400",2143,226,55,35,93,26,34,9,2621
"44003020500",3429,495,44,0,354,15,76,0,4413
"44003020601",5538,294,16,1,328,0,186,0,6363
"44003020602",2770,440,7,0,106,0,117,0,3440
"44003020603",5921,253,0,0,105,0,30,0,6309
"44003020604",4724,805,0,0,0,1,34,98,5662
"44003020701",1506,138,38,0,106,4,0,0,1792
"44003020702",4428,170,8,12,16,0,36,0,4670
"44003020703",6044,377,122,0,144,1,0,1,6689
"44003020800",5272,122,49,16,639,0,211,0,6309
"44003020901",2951,355,94,0,143,50,163,0,3756
"44003020903",5340,313,21,4,250,17,165,0,6110
"44003020904",3030,98,44,1,321,10,47,1,3552
"44003021001",2228,241,16,3,198,4,484,13,3187
"44003021002",3726,522,66,2,548,68,475,33,5440
"44003021100",3892,199,114,25,595,22,254,25,5126
"44003021200",3027,255,47,0,194,53,102,17,3695
"44003021300",4037,182,223,14,346,0,370,6,5178
"44003021401",3560,78,9,10,308,0,164,0,4129
"44003021402",3099,231,138,0,100,82,83,17,3750
"44003021501",2507,340,20,0,71,0,85,0,3023
"44003021502",3497,433,43,11,215,4,191,0,4394
"44003021600",1287,34,15,1,66,0,31,1,1435
"44003021700",4300,232,94,0,79,14,88,0,4807
"44003021800",3636,189,25,11,315,0,40,0,4216
"44003021901",3038,99,32,0,206,29,106,0,3510
"44003021902",2101,312,46,1,77,44,131,60,2772
"44003021903",3450,133,9,1,187,27,193,21,4021
"44003022000",3041,166,17,7,81,2,73,0,3387
"44003022100",4484,678,14,0,169,47,59,156,5607
"44003022201",5856,197,86,1,380,15,259,15,6809
"44003022202",3171,228,22,0,385,9,146,0,3961
"44003022300",3335,302,1,0,330,82,112,1,4163
"44003022400",2130,44,8,0,86,0,126,0,2394
"44003980000",0,0,0,0,0,0,0,0,0
"44005040101",4186,450,47,1,176,27,127,13,5027
"44005040102",5026,480,1,0,188,92,99,0,5886
"44005040103",5679,411,77,25,193,20,181,50,6636
"44005040200",770,45,205,10,201,18,71,9,1329
"44005040302",1921,107,114,0,306,0,187,0,2635
"44005040303",1705,313,228,178,694,149,242,17,3526
"44005040304",2065,276,69,41,229,79,139,42,2940
"44005040400",5467,277,73,4,257,13,243,4,6338
"44005040500",2718,515,446,160,275,248,593,367,5322
"44005040600",2815,282,282,11,399,296,359,113,4557
"44005040700",2856,285,14,35,236,0,246,10,3682
"44005040800",1625,265,25,75,322,74,175,68,2629
"44005040900",3402,211,27,0,26,7,87,0,3760
"44005041000",1276,402,52,12,33,25,14,0,1814
"44005041100",1088,147,6,23,56,79,91,27,1517
"44005041200",175,26,122,70,83,22,46,88,632
"44005041300",4842,381,0,0,241,0,61,0,5525
"44005041400",3022,385,38,0,53,6,24,20,3548
"44005041601",2605,294,0,0,45,0,47,1,2992
"44005041602",3987,206,97,2,129,1,131,2,4555
"44005041701",3012,128,0,0,141,0,24,0,3305
"44005041702",4764,316,34,0,0,0,13,0,5127
"44005990000",0,0,0,0,0,0,0,0,0
"44007000101",1017,841,440,117,1416,484,1488,647,6450
"44007000102",1272,636,820,156,1574,454,1730,1041,7683
"44007000200",759,1290,949,591,2189,863,2485,1817,10943
"44007000300",1671,516,1210,97,1705,855,2797,786,9637
"44007000400",526,471,1096,272,835,518,1509,889,6116
"44007000500",373,233,867,292,516,687,909,853,4730
"44007000600",200,274,497,442,318,79,452,322,2584
"44007000700",329,304,568,545,486,357,535,577,3701
"44007000800",1070,353,92,79,278,533,199,346,2950
"44007000900",1063,552,63,40,228,247,295,296,2784
"44007001000",908,393,124,299,453,204,610,298,3289
"44007001100",1367,385,49,49,271,251,351,183,2906
"44007001200",948,185,330,375,694,603,1316,764,5215
"44007001300",1122,509,372,202,1736,1079,1611,1233,7864
"44007001400",1307,682,869,238,2317,1417,2410,1627,10867
"44007001500",1036,358,380,100,1047,13,897,269,4100
"44007001600",2007,447,879,162,3392,1818,4592,1968,15265
"44007001700",1148,253,117,30,1111,417,1330,394,4800
"44007001800",1723,921,594,241,1976,794,2488,1285,10022
"44007001900",1275,923,337,451,1069,1176,1533,1537,8301
"44007002000",2287,916,580,280,1121,1041,1849,1501,9575
"44007002101",1415,139,582,25,472,337,932,397,4299
"44007002102",1766,429,1074,544,1406,344,2468,564,8595
"44007002200",1418,681,837,402,1140,408,1976,921,7783
"44007002300",2950,802,309,0,339,48,471,165,5084
"44007002400",4152,309,258,18,566,13,883,5,6204
"44007002500",1012,458,533,26,732,278,429,224,3692
"44007002600",528,372,638,393,1069,297,996,416,4709
"44007002700",966,983,672,326,974,698,1244,1502,7365
"44007002800",1833,1352,1040,75,1082,969,1355,1652,9358
"44007002900",2709,461,1246,750,1313,292,1204,707,8682
"44007003100",1987,336,383,349,304,752,78,670,4859
"44007003200",2199,124,359,66,384,100,140,46,3418
"44007003300",2981,266,306,39,521,91,156,16,4376
"44007003400",4377,231,73,2,295,1,43,30,5052
"44007003500",3432,711,74,0,631,275,193,91,5407
"44007003601",832,428,10,0,151,258,0,98,1777
"44007003602",890,350,20,21,103,73,19,20,1496
"44007003700",2167,673,58,27,277,258,66,288,3814
"44007010101",3487,187,142,1,170,40,175,32,4234
"44007010102",3169,189,76,8,213,10,248,0,3913
"44007010200",4448,288,470,474,1078,224,626,0,7608
"44007010300",2483,312,353,13,515,199,173,20,4068
"44007010400",4374,712,505,73,658,257,323,192,7094
"44007010501",2526,504,367,61,244,404,163,330,4599
"44007010502",3244,322,267,161,622,131,57,0,4804
"44007010600",5259,644,0,17,94,0,204,37,6255
"44007010701",2090,99,36,0,22,0,36,0,2283
"44007010702",3671,144,39,0,115,180,56,0,4205
"44007010800",1672,853,534,360,912,293,2040,906,7570
"44007010900",1732,1010,562,165,767,314,1688,1108,7346
"44007011000",1579,1234,849,185,947,649,2221,1665,9329
"44007011100",1659,442,1104,146,409,664,1902,1015,7341
"44007011200",4345,682,189,0,354,220,281,307,6378
"44007011301",3967,325,14,19,73,17,350,88,4853
"44007011302",3945,151,0,0,149,0,141,50,4436
"44007011401",7109,168,16,1,375,20,161,0,7850
"44007011402",4065,90,0,1,45,42,42,0,4285
"44007011403",6818,360,0,0,314,0,86,83,7661
"44007011500",5182,763,340,0,253,13,444,366,7361
"44007011600",4702,295,0,0,478,1,0,2,5478
"44007011701",3744,643,0,149,210,3,387,19,5155
"44007011702",3956,199,12,2,250,20,249,23,4711
"44007011800",3960,531,1053,55,538,153,312,93,6695
"44007011901",2366,305,424,56,170,45,467,186,4019
"44007011902",4018,338,82,0,384,0,273,0,5095
"44007012000",4999,190,84,9,445,20,514,23,6284
"44007012102",3678,286,175,72,291,47,576,153,5278
"44007012103",2056,317,52,17,170,42,28,0,2682
"44007012104",3437,504,305,0,176,7,185,22,4636
"44007012200",6511,133,160,0,634,13,430,0,7881
"44007012300",5500,645,84,0,208,3,172,28,6640
"44007012401",5766,338,185,2,642,0,600,0,7533
"44007012402",2067,222,17,0,237,0,206,34,2783
"44007012500",3856,779,0,0,363,184,302,182,5666
"44007012601",1453,44,0,1,107,3,72,2,1682
"44007012602",6666,377,0,0,239,1,165,21,7469
"44007012701",4600,116,0,0,60,9,0,0,4785
"44007012702",4238,217,85,1,104,9,96,53,4803
"44007012801",4472,231,1,0,0,1,115,1,4821
"44007012802",2092,187,13,0,37,0,31,0,2360
"44007012803",4691,35,21,0,79,0,0,0,4826
"44007012900",4106,779,10,10,158,30,29,4,5126
"44007013001",3169,242,0,0,61,0,51,0,3523
"44007013002",6536,423,28,0,45,40,93,6,7171
"44007013101",4358,237,21,0,139,33,75,12,4875
"44007013102",4813,186,9,0,87,0,103,0,5198
"44007013201",4467,158,0,2,64,0,46,1,4738
"44007013202",5120,480,17,0,109,0,0,0,5726
"44007013300",4242,199,21,0,190,0,0,0,4652
"44007013400",3007,417,81,93,301,42,256,15,4212
"44007013500",2779,703,271,30,443,254,655,471,5606
"44007013600",1936,276,260,8,112,177,320,80,3169
"44007013701",2700,392,185,2,557,100,624,114,4674
"44007013702",1783,210,36,21,609,12,120,0,2791
"44007013800",3680,317,325,1,401,16,273,1,5014
"44007013900",2327,190,39,0,239,37,251,22,3105
"44007014000",4417,283,74,146,867,228,983,0,6998
"44007014100",2592,688,268,354,969,479,1034,499,6883
"44007014200",1724,258,33,4,232,38,40,16,2345
"44007014300",4007,112,174,0,455,190,77,0,5015
"44007014400",3345,110,56,2,142,0,185,6,3846
"44007014501",4728,44,201,4,124,0,104,0,5205
"44007014502",3873,423,80,1,152,0,252,97,4878
"44007014600",5892,117,104,1,719,20,265,0,7118
"44007014700",4048,1097,505,0,1126,283,2036,611,9706
"44007014800",4134,516,73,0,343,179,45,132,5422
"44007015000",2243,710,862,75,473,61,602,406,5432
"44007015100",989,538,1159,448,1015,372,695,647,5863
"44007015200",652,695,258,263,296,300,415,639,3518
"44007015300",1012,498,388,58,173,58,303,338,2828
"44007015400",764,166,597,269,525,53,742,63,3179
"44007015500",2325,567,409,9,572,229,413,266,4790
"44007015600",1576,292,154,8,312,83,579,37,3041
"44007015700",2624,175,180,0,279,1,197,0,3456
"44007015800",2938,203,76,0,246,15,241,21,3740
"44007015900",2047,216,679,67,359,36,401,10,3815
"44007016000",1300,485,494,273,621,174,506,536,4389
"44007016100",1404,706,885,526,830,478,864,798,6491
"44007016300",1848,72,344,0,344,181,325,185,3299
"44007016400",1344,536,1104,439,787,455,597,662,5924
"44007016500",2204,369,353,30,575,43,290,48,3912
"44007016600",783,216,335,91,119,115,349,178,2186
"44007016700",1609,410,352,207,394,307,420,111,3810
"44007016800",2220,315,165,36,330,0,484,18,3568
"44007016900",1532,219,34,0,156,0,90,0,2031
"44007017000",2828,340,541,33,422,34,572,55,4825
"44007017100",2574,726,494,72,659,203,946,673,6347
"44007017300",2519,326,79,90,271,0,295,22,3602
"44007017400",1797,1069,130,264,284,211,242,702,4699
"44007017500",2535,312,72,1,326,53,189,40,3528
"44007017600",1160,522,406,78,432,90,293,208,3189
"44007017700",2985,133,142,7,435,16,138,0,3856
"44007017800",1260,768,125,126,102,162,181,231,2955
"44007017900",1570,1100,59,165,59,53,114,310,3430
"44007018000",1142,940,73,56,266,27,22,324,2850
"44007018100",1922,775,39,75,98,55,522,305,3791
"44007018200",1297,510,298,87,475,22,281,100,3070
"44007018300",1004,509,192,92,39,109,86,117,2148
"44007018400",3846,470,121,337,554,67,433,499,6327
"44007018500",1969,429,8,1,273,15,18,49,2762
"44009041500",810,51,4,3,22,13,13,4,920
"44009050102",1949,144,20,0,62,1,51,0,2227
"44009050103",3981,706,103,151,624,278,255,81,6179
"44009050104",3669,108,0,0,142,14,83,14,4030
"44009050301",3628,357,3,0,174,100,24,6,4292
"44009050302",2453,116,35,35,75,34,38,19,2805
"44009050401",4222,168,46,0,146,0,51,0,4633
"44009050402",2409,68,7,2,55,13,126,1,2681
"44009050500",5754,535,23,62,159,73,204,58,6868
"44009050600",7009,320,158,0,118,0,69,0,7674
"44009050700",7358,422,200,0,108,0,136,31,8255
"44009050801",4712,863,62,41,131,68,134,35,6046
"44009050802",3419,158,14,1,271,80,169,0,4112
"44009050901",5123,516,23,0,378,0,77,12,6129
"44009050902",4586,236,48,0,36,139,14,0,5059
"44009051000",1378,86,9,0,26,1,0,0,1500
"44009051101",4086,606,0,11,258,40,117,0,5118
"44009051102",2333,290,1,0,121,26,7,16,2794
"44009051201",3550,534,166,35,142,247,112,234,5020
"44009051202",3967,246,8,1,206,126,29,0,4583
"44009051302",3820,155,25,0,63,0,79,0,4142
"44009051304",1803,115,0,0,79,0,77,0,2074
"44009051305",3276,283,16,15,275,66,0,13,3944
"44009051306",4477,405,94,23,453,20,275,0,5747
"44009051400",238,240,0,14,14,49,0,20,575
"44009051502",6209,682,68,0,187,40,148,63,7397
"44009051503",3639,690,0,0,56,23,209,11,4628
"44009051504",3078,966,0,11,26,17,27,0,4125
"44009990100",0,0,0,0,0,0,0,0,0
"44009990200",0,0,0,0,0,0,0,0,0
"45001950100",2155,348,372,99,78,14,72,0,3138
"45001950200",2390,321,605,98,67,75,0,48,3604
"45001950300",2499,583,133,55,12,3,59,0,3344
"45001950400",3832,601,650,1088,28,0,84,0,6283
"45001950500",2294,394,1540,799,68,0,0,0,5095
"45001950600",1203,347,774,605,130,41,7,0,3107
"45003020100",2883,535,745,474,51,110,267,100,5165
"45003020200",3542,332,1152,211,88,109,88,7,5529
"45003020301",1563,460,145,41,32,14,99,0,2354
"45003020302",2457,309,2090,754,122,22,220,0,5974
"45003020400",4930,550,1030,826,54,33,447,103,7973
"45003020500",6109,203,1295,273,114,263,64,263,8584
"45003020601",2632,71,888,0,170,0,60,0,3821
"45003020602",2865,550,1208,644,514,576,267,480,7104
"45003020701",3966,437,1006,49,110,31,139,0,5738
"45003020702",2130,207,857,568,307,492,678,423,5662
"45003020801",2491,71,159,0,65,0,35,0,2821
"45003020802",3493,438,841,118,304,117,188,152,5651
"45003020901",1557,253,578,160,51,27,69,11,2706
"45003020902",3221,820,1363,731,176,0,48,0,6359
"45003021001",2684,746,634,211,239,231,189,184,5118
"45003021002",2771,1132,836,129,23,419,49,723,6082
"45003021101",1646,932,108,254,28,0,0,0,2968
"45003021102",2446,647,168,14,56,0,0,0,3331
"45003021201",4947,233,448,83,151,0,61,0,5923
"45003021202",3066,162,205,20,117,7,70,0,3647
"45003021203",6520,425,493,15,390,134,342,12,8331
"45003021300",2813,181,543,124,82,13,38,0,3794
"45003021400",546,361,2529,1989,45,72,31,59,5632
"45003021500",3274,86,805,158,271,0,157,0,4751
"45003021601",2268,273,1861,1377,28,432,162,295,6696
"45003021602",6267,175,1008,458,539,12,299,0,8758
"45003021700",2388,610,1038,403,133,54,7,128,4761
"45003021800",1152,154,595,580,41,13,19,0,2554
"45003021900",2878,848,785,188,363,678,308,636,6684
"45003022001",2805,656,697,102,149,7,266,43,4725
"45003022002",4551,436,1172,498,225,0,164,0,7046
"45003022100",1829,448,836,66,87,1,83,0,3350
"45003980100",0,0,0,0,0,0,0,0,0
"45005970200",690,66,2655,1363,138,0,190,0,5102
"45005970300",528,146,274,45,2,0,3,50,1048
"45005970400",577,55,1356,862,0,0,0,0,2850
"45007000200",2437,257,467,152,132,6,267,14,3732
"45007000300",2607,262,1003,26,323,0,112,1,4334
"45007000500",617,61,2114,442,33,0,7,8,3282
"45007000600",260,231,1025,1260,0,92,6,50,2924
"45007000700",831,709,1228,1339,101,158,120,113,4599
"45007000800",1356,455,433,238,7,6,202,0,2697
"45007000900",1343,420,697,545,59,68,19,237,3388
"45007001000",1911,229,295,113,93,8,397,0,3046
"45007001100",3954,278,405,287,203,0,57,0,5184
"45007010102",6654,134,241,68,140,11,88,27,7363
"45007010103",6430,552,366,243,63,0,687,0,8341
"45007010104",6146,685,570,0,119,75,107,0,7702
"45007010200",4613,342,166,0,13,0,23,0,5157
"45007010300",2913,947,110,12,42,117,66,99,4306
"45007010401",4626,489,467,42,108,61,137,92,6022
"45007010402",4846,1263,337,0,64,67,21,47,6645
"45007010500",4983,545,392,0,437,0,484,0,6841
"45007010600",5740,956,530,14,392,10,35,0,7677
"45007010700",2981,902,879,583,151,124,282,0,5902
"45007010800",3921,402,429,31,99,0,0,0,4882
"45007010900",4021,400,46,58,65,0,5,0,4595
"45007011001",3777,744,157,47,238,34,48,61,5106
"45007011002",3283,276,432,0,110,176,22,27,4326
"45007011100",1823,396,318,45,48,40,14,6,2690
"45007011201",3390,88,289,0,312,24,0,0,4103
"45007011202",6281,455,952,0,221,72,180,41,8202
"45007011300",4998,819,859,277,48,143,83,143,7370
"45007011401",2971,302,618,45,128,0,214,0,4278
"45007011402",2183,564,389,222,57,82,130,8,3635
"45007011500",4834,906,404,278,69,121,53,0,6665
"45007011600",1626,306,36,5,13,32,0,0,2018
"45007011700",3612,1051,439,118,42,59,0,44,5365
"45007011800",2578,681,163,153,120,31,175,27,3928
"45007011901",3070,767,928,611,112,24,258,101,5871
"45007011902",1353,306,894,216,0,12,25,0,2806
"45007012001",3411,260,754,46,157,47,246,107,5028
"45007012002",2491,780,1008,232,157,7,245,142,5062
"45007012200",4483,606,686,225,42,244,0,0,6286
"45007012300",1222,338,867,783,132,44,51,32,3469
"45009960100",580,61,2098,1874,85,5,61,0,4764
"45009960200",2524,215,2935,1179,35,43,42,57,7030
"45009960300",736,190,287,55,18,34,0,31,1351
"45009960400",797,208,267,213,20,0,0,0,1505
"45011970100",3130,547,1106,926,61,18,0,0,5788
"45011970200",688,215,1705,838,23,176,16,76,3737
"45011970300",1307,261,1315,1060,64,0,62,0,4069
"45011970400",2642,634,410,187,242,78,222,83,4498
"45011970500",1678,176,1417,703,59,0,40,1,4074
"45011980100",0,0,0,0,0,0,0,0,0
"45013000100",1177,210,2232,1005,36,23,166,0,4849
"45013000200",1522,413,1693,1054,19,19,19,45,4784
"45013000300",3215,500,780,58,490,21,455,85,5604
"45013000400",29,0,19,0,0,0,0,0,48
"45013000501",3332,48,1149,985,620,23,806,0,6963
"45013000502",3161,95,997,723,341,208,475,131,6131
"45013000503",2571,652,1620,325,99,22,140,341,5770
"45013000600",1331,402,511,161,58,36,33,10,2542
"45013000700",3249,326,576,316,726,178,752,55,6178
"45013000800",2376,501,1418,485,459,0,166,10,5415
"45013000901",2031,120,341,99,292,0,331,8,3222
"45013000902",5993,624,901,287,162,33,207,58,8265
"45013000903",1139,51,309,153,55,123,39,123,1992
"45013001000",668,24,51,0,104,0,98,13,958
"45013001101",1954,87,1286,230,45,12,1,4,3619
"45013001102",1090,147,2914,980,364,324,181,223,6223
"45013001200",876,28,0,0,40,0,32,0,976
"45013002101",368,223,0,0,8,0,0,0,599
"45013002102",1502,131,99,15,71,4,215,62,2099
"45013002103",2905,90,390,0,301,1,414,2,4103
"45013002104",11180,779,139,0,208,0,94,24,12424
"45013002105",2473,212,341,0,103,0,142,20,3291
"45013002106",6440,168,933,439,717,273,959,139,10068
"45013002107",7432,966,865,99,1253,573,3341,1135,15664
"45013002108",3366,478,455,0,389,175,979,299,6141
"45013002201",6773,302,304,35,148,21,251,0,7834
"45013002202",3049,85,127,0,85,0,57,0,3403
"45013010100",1602,85,0,0,9,8,0,5,1709
"45013010200",3271,214,142,0,242,0,459,112,4440
"45013010300",3961,177,0,0,313,0,331,0,4782
"45013010400",4071,95,319,191,168,0,111,0,4955
"45013010500",2411,243,390,353,489,150,783,264,5083
"45013010600",3788,133,14,0,147,0,65,0,4147
"45013010700",4213,253,135,0,8,0,16,12,4637
"45013010800",1135,649,620,225,911,484,1537,854,6415
"45013010900",1491,202,21,20,11,0,63,102,1910
"45013011000",1243,121,454,73,105,56,315,37,2404
"45013011100",2123,58,35,0,23,111,149,140,2639
"45013011200",705,67,0,0,17,0,10,0,799
"45013011300",1061,73,0,0,96,0,114,0,1344
"45013990100",0,0,0,0,0,0,0,0,0
"45015020101",980,238,1561,228,42,30,73,11,3163
"45015020102",1841,425,877,403,23,67,13,42,3691
"45015020201",1578,155,1243,1004,42,5,0,2,4029
"45015020202",324,142,1648,936,0,7,0,0,3057
"45015020301",2247,383,289,50,23,0,23,0,3015
"45015020302",3535,875,1408,688,215,2,3,2,6728
"45015020401",1932,438,1757,328,103,7,31,7,4603
"45015020403",6381,223,205,0,205,23,45,23,7105
"45015020404",3423,103,847,6,32,45,449,7,4912
"45015020405",1196,187,1559,370,101,0,0,0,3413
"45015020503",2722,775,1126,316,167,45,57,83,5291
"45015020504",2053,129,1504,558,88,0,11,0,4343
"45015020505",1798,294,1117,314,152,0,131,135,3941
"45015020506",2750,461,1367,320,199,240,0,240,5577
"45015020600",4602,160,1118,371,514,0,223,0,6988
"45015020707",3638,438,1455,37,340,73,79,10,6070
"45015020710",4098,169,1206,20,247,6,312,15,6073
"45015020711",3000,133,465,33,32,172,144,0,3979
"45015020712",2835,448,28,48,190,66,28,9,3652
"45015020713",2009,198,164,22,86,34,120,0,2633
"45015020714",3904,281,594,514,99,0,319,79,5790
"45015020715",2922,348,321,302,428,235,273,0,4829
"45015020716",5402,477,1054,188,925,0,361,168,8575
"45015020717",3159,314,907,214,388,45,292,3,5322
"45015020718",2967,311,1041,149,324,150,376,147,5465
"45015020719",4597,307,1249,77,893,178,556,76,7933
"45015020720",2610,43,220,13,130,0,56,0,3072
"45015020721",2439,48,465,0,505,23,375,16,3871
"45015020722",2310,250,239,0,159,0,34,0,2992
"45015020723",1820,348,491,94,320,53,160,0,3286
"45015020724",914,110,7,4,55,4,58,4,1156
"45015020725",949,77,317,3,110,30,247,29,1762
"45015020804",1161,126,626,149,624,185,348,156,3375
"45015020806",1883,257,750,47,221,102,265,97,3622
"45015020807",3749,282,1764,591,869,55,458,0,7768
"45015020808",1899,411,933,251,244,228,83,54,4103
"45015020809",1659,341,773,67,726,233,317,102,4218
"45015020810",1960,792,941,57,400,198,403,524,5275
"45015020811",1977,424,1390,362,466,311,357,323,5610
"45015020812",4138,101,551,94,595,0,240,0,5719
"45015020901",1010,284,278,12,72,130,160,218,2164
"45015020903",2423,492,204,74,181,24,188,237,3823
"45015020904",2551,117,696,0,276,28,136,0,3804
"45015021000",2726,800,510,135,353,129,570,201,5424
"45015980100",0,0,0,0,0,0,0,0,0
"45017950100",3238,334,1128,525,254,89,280,4,5852
"45017950200",2422,238,2185,922,32,53,37,84,5973
"45017950400",1699,118,858,585,28,32,47,32,3399
"45019000100",2086,146,103,177,35,50,73,9,2679
"45019000200",1344,33,0,0,5,0,0,0,1382
"45019000400",634,926,61,306,12,44,0,0,1983
"45019000500",1043,803,37,25,43,0,41,0,1992
"45019000600",565,436,26,15,60,45,24,30,1201
"45019000700",539,1061,403,86,18,63,32,0,2202
"45019000900",306,129,601,345,17,5,27,30,1460
"45019001000",602,857,439,150,55,76,21,0,2200
"45019001100",509,297,484,844,62,70,39,40,2345
"45019001500",461,54,751,145,46,0,48,13,1518
"45019001600",1076,65,453,37,79,0,54,0,1764
"45019001901",3459,390,282,37,80,2,56,39,4345
"45019001902",2871,326,470,313,187,14,58,68,4307
"45019002002",4582,410,660,603,107,0,45,0,6407
"45019002003",4914,519,2471,459,139,0,322,0,8824
"45019002004",1902,231,0,0,111,0,40,0,2284
"45019002005",5461,218,294,0,137,0,86,0,6196
"45019002006",3419,357,586,135,140,58,87,0,4782
"45019002007",3542,118,23,8,107,2,123,0,3923
"45019002101",8840,1506,2311,512,25,0,401,1094,14689
"45019002103",2007,298,980,358,8,0,307,89,4047
"45019002104",1324,75,6,0,14,13,7,0,1439
"45019002105",1620,97,4,0,28,0,31,0,1780
"45019002200",1305,44,907,677,25,31,31,0,3020
"45019002300",698,72,601,77,67,18,26,18,1577
"45019002400",1793,345,1864,649,48,10,32,101,4842
"45019002502",3974,302,2099,853,69,2,9,42,7350
"45019002604",2818,222,382,208,107,13,28,0,3778
"45019002605",1863,163,1041,565,169,54,17,0,3872
"45019002606",1864,31,132,18,64,0,47,0,2156
"45019002611",2166,351,377,169,77,31,102,22,3295
"45019002612",3036,538,1764,776,68,86,130,136,6534
"45019002613",3923,209,979,213,162,0,0,15,5501
"45019002614",2231,485,932,237,112,20,104,288,4409
"45019002701",723,137,967,295,40,104,72,8,2346
"45019002702",1112,250,2053,769,180,29,175,0,4568
"45019002801",3548,360,495,107,68,88,96,0,4762
"45019002802",2333,189,15,0,156,0,55,0,2748
"45019002900",1791,129,591,156,40,0,6,0,2713
"45019003000",2974,327,46,2,39,0,18,0,3406
"45019003104",1629,752,1130,605,678,100,1207,551,6652
"45019003105",1227,744,1009,750,140,133,635,694,5332
"45019003106",3084,539,2180,270,256,144,214,176,6863
"45019003107",1255,187,2587,287,140,153,114,170,4893
"45019003108",660,128,1670,396,235,0,128,42,3259
"45019003109",1684,258,1349,79,416,14,141,198,4139
"45019003110",1983,1308,2129,1633,352,107,460,564,8536
"45019003111",1291,71,2635,624,629,166,927,140,6483
"45019003113",1092,276,870,319,295,12,357,159,3380
"45019003114",4123,463,2117,694,520,59,261,138,8375
"45019003115",2247,624,2195,1322,299,73,177,263,7200
"45019003200",354,21,108,0,34,9,33,0,559
"45019003300",807,384,1412,994,153,12,438,167,4367
"45019003400",1118,498,1604,1150,271,78,599,236,5554
"45019003500",1846,227,281,228,100,24,43,0,2749
"45019003600",1286,149,393,503,89,41,72,0,2533
"45019003700",402,146,1158,1441,91,41,60,13,3352
"45019003800",329,144,1782,1095,57,0,52,0,3459
"45019003900",1367,218,517,342,81,0,64,42,2631
"45019004000",174,50,1477,786,8,43,8,0,2546
"45019004300",210,57,1302,912,30,50,30,0,2591
"45019004400",188,76,1393,698,30,6,57,6,2454
"45019004606",7263,452,631,356,330,84,73,0,9189
"45019004607",4782,584,15,7,152,19,140,29,5728
"45019004608",19442,1175,620,15,1033,32,685,0,23002
"45019004609",4959,554,1295,63,243,6,53,0,7173
"45019004610",2174,124,794,33,55,0,23,65,3268
"45019004611",7481,477,420,0,114,0,109,0,8601
"45019004612",5974,431,218,6,338,58,593,37,7655
"45019004613",1631,77,4,0,99,0,12,0,1823
"45019004614",5395,492,920,116,226,0,50,10,7209
"45019004701",4698,317,366,138,24,0,217,0,5760
"45019004702",2071,190,104,0,55,1,121,13,2555
"45019004800",1899,119,8,3,38,0,40,0,2107
"45019004901",1679,296,0,0,37,0,39,0,2051
"45019004902",2081,162,0,0,19,0,113,14,2389
"45019005000",1764,288,1710,724,36,0,52,29,4603
"45019005100",1058,241,178,211,38,36,73,14,1849
"45019005200",1072,144,717,64,50,0,51,4,2102
"45019005300",626,255,1122,1706,25,22,28,14,3798
"45019005400",211,75,756,1024,6,4,5,0,2081
"45019005500",230,104,444,431,4,15,4,0,1232
"45019005600",7775,461,1954,564,370,0,230,319,11673
"45019005700",7061,246,632,140,257,15,268,0,8619
"45019005800",4032,350,933,139,564,0,104,0,6122
"45019990100",0,0,0,0,0,0,0,0,0
"45021970100",6449,1207,273,80,250,140,675,246,9320
"45021970201",1688,334,472,344,64,15,5,15,2937
"45021970202",4597,481,862,88,535,55,397,0,7015
"45021970301",1240,220,1537,616,85,58,30,0,3786
"45021970302",1658,965,898,570,145,85,105,144,4570
"45021970401",2010,1006,140,224,82,89,8,21,3580
"45021970402",3473,1299,201,276,115,65,42,49,5520
"45021970501",1319,491,292,63,18,71,9,127,2390
"45021970502",1562,563,1533,1377,56,33,34,0,5158
"45021970503",932,233,25,0,27,0,0,0,1217
"45021970601",3520,488,375,246,0,112,0,102,4843
"45021970602",1992,603,163,0,12,8,0,0,2778
"45021970700",2880,546,313,0,168,42,169,33,4151
"45023020100",726,106,725,596,5,5,13,17,2193
"45023020200",554,301,619,1353,24,10,0,0,2861
"45023020300",707,142,1997,857,12,15,54,32,3816
"45023020400",1376,460,279,92,15,50,123,52,2447
"45023020500",1377,427,498,225,29,0,0,0,2556
"45023020601",1540,382,589,61,37,0,0,0,2609
"45023020602",1959,405,1015,336,62,0,93,0,3870
"45023020700",1400,135,411,253,75,0,0,0,2274
"45023020800",3164,1066,877,235,50,31,86,8,5517
"45023020900",1431,436,385,170,24,12,49,0,2507
"45023021000",992,364,613,197,17,12,12,0,2207
"45025950101",3097,1006,763,213,99,323,201,557,6259
"45025950102",1769,757,1148,216,104,48,215,157,4414
"45025950200",2407,594,918,322,114,41,48,0,4444
"45025950300",1202,170,556,353,57,16,21,17,2392
"45025950400",4540,415,830,1127,31,11,27,8,6989
"45025950501",740,232,920,209,5,13,0,0,2119
"45025950502",2426,750,1668,814,208,79,58,0,6003
"45025950600",2192,429,1731,1462,85,12,67,0,5978
"45025950700",3335,1311,603,179,1,50,76,125,5680
"45025950800",1399,267,597,501,34,10,141,36,2985
"45027960100",1985,429,565,255,64,209,64,201,3772
"45027960201",875,163,480,170,21,0,57,41,1807
"45027960202",0,0,0,0,0,0,0,0,0
"45027960300",849,150,621,236,93,76,61,104,2190
"45027960400",798,117,644,467,68,11,42,0,2147
"45027960500",996,91,2264,1995,65,12,93,0,5516
"45027960600",1156,176,845,362,8,23,16,38,2624
"45027960701",1879,104,1290,421,78,57,64,0,3893
"45027960702",666,185,180,82,33,20,10,20,1196
"45027960703",2288,320,592,235,10,0,29,7,3481
"45027960801",870,135,1310,1070,3,0,3,16,3407
"45027960802",1650,181,982,411,13,0,40,0,3277
"45029970100",604,59,577,423,40,67,0,46,1816
"45029970200",1023,100,329,140,18,7,13,0,1630
"45029970300",3000,331,1316,1168,204,211,96,76,6402
"45029970401",1980,726,1017,194,20,0,8,0,3945
"45029970402",2487,211,388,510,58,0,215,0,3869
"45029970500",1754,523,1886,952,156,53,12,0,5336
"45029970600",2873,726,2573,342,242,129,474,51,7410
"45029970700",3025,811,1304,305,219,18,101,33,5816
"45029970800",1170,49,725,285,24,0,0,0,2253
"45029990100",0,0,0,0,0,0,0,0,0
"45031010100",900,231,1801,694,9,11,102,43,3791
"45031010200",4219,903,398,140,97,165,149,0,6071
"45031010300",3077,633,953,230,110,0,247,0,5250
"45031010400",4663,687,372,79,87,0,132,0,6020
"45031010500",1576,228,412,159,47,33,44,0,2499
"45031010600",1377,274,1302,1150,83,199,0,15,4400
"45031010700",15,25,1452,870,0,15,0,0,2377
"45031010800",1151,279,942,102,53,23,13,0,2563
"45031010900",3622,468,1974,801,91,0,106,0,7062
"45031011000",1452,419,606,468,114,0,0,0,3059
"45031011100",1015,77,164,180,47,4,38,0,1525
"45031011200",1828,675,1203,608,79,103,56,203,4755
"45031011300",1975,462,2543,438,38,154,19,0,5629
"45031011400",818,101,1796,1581,34,0,34,0,4364
"45031011500",2193,212,1248,976,56,0,34,0,4719
"45031011600",1496,512,1002,470,145,39,0,31,3695
"45033970100",803,175,1675,465,208,125,75,32,3558
"45033970200",1636,1055,1669,984,323,92,123,288,6170
"45033970300",2014,642,929,727,289,405,136,0,5142
"45033970400",786,280,1517,2390,35,103,30,68,5209
"45033970500",2329,237,606,646,71,23,18,0,3930
"45033970600",3634,1114,1799,965,125,74,7,0,7718
"45035010100",1330,37,585,178,23,0,0,0,2153
"45035010200",1720,222,1449,796,82,4,105,0,4378
"45035010300",2954,510,1331,570,0,53,100,0,5518
"45035010400",2417,339,1804,196,342,290,75,232,5695
"45035010501",3530,187,789,136,373,77,136,73,5301
"45035010503",2383,117,465,0,26,0,57,0,3048
"45035010504",4022,359,1080,512,758,8,470,97,7306
"45035010505",4073,494,652,453,668,110,403,109,6962
"45035010603",4447,936,1178,0,268,120,396,133,7478
"45035010604",2793,375,741,102,162,0,120,0,4293
"45035010605",5460,589,867,1141,286,157,116,0,8616
"45035010606",1373,34,343,64,27,0,41,0,1882
"45035010700",2670,330,1252,912,41,125,52,22,5404
"45035010801",4558,253,410,309,13,41,227,6,5817
"45035010807",4096,176,385,92,23,15,151,29,4967
"45035010808",5333,381,666,436,323,57,211,32,7439
"45035010809",2866,300,529,214,0,40,11,64,4024
"45035010813",5774,1199,1435,242,177,116,106,237,9286
"45035010814",4355,664,1435,113,235,0,134,0,6936
"45035010815",1864,374,729,299,536,23,201,23,4049
"45035010816",7571,51,2866,269,1524,78,802,24,13185
"45035010817",2805,157,720,200,306,42,431,15,4676
"45035010818",3454,566,3280,1065,428,15,486,464,9758
"45035010819",2916,56,881,16,498,7,69,7,4450
"45035010820",4479,148,1721,103,675,87,446,0,7659
"45037970201",1240,87,482,57,14,0,4,0,1884
"45037970202",2270,203,2070,619,55,11,13,0,5241
"45037970300",1942,227,1275,790,44,82,83,97,4540
"45037970400",1127,254,1086,171,122,54,122,54,2990
"45037970501",2234,510,1229,141,216,5,217,5,4557
"45037970502",4056,396,257,203,173,86,80,216,5467
"45039960100",189,4,1102,440,46,1,1,2,1785
"45039960200",1382,278,1303,421,147,0,0,0,3531
"45039960300",2540,360,1961,485,92,121,17,5,5581
"45039960400",1857,567,1807,1311,134,0,370,39,6085
"45039960500",1436,239,3164,1125,42,214,0,0,6220
"45041000101",2215,126,272,49,106,42,170,0,2980
"45041000102",4393,159,943,0,217,15,6,0,5733
"45041000201",1550,58,478,227,226,1,0,1,2541
"45041000202",4931,435,1485,373,141,141,226,0,7732
"45041000300",687,77,2849,410,19,1,1,1,4045
"45041000400",2138,621,1637,434,122,0,111,0,5063
"45041000500",1478,653,1283,993,139,132,80,31,4789
"45041000600",2861,155,1940,43,170,0,142,0,5311
"45041000700",12,128,1169,1323,0,5,0,29,2666
"45041000800",25,62,2521,1036,0,0,49,0,3693
"45041000900",16,5,1797,1326,45,0,0,0,3189
"45041001000",630,302,314,378,69,69,84,0,1846
"45041001100",2644,577,987,572,46,83,45,0,4954
"45041001200",3096,107,147,28,143,0,112,0,3633
"45041001300",2422,126,590,394,46,5,206,25,3814
"45041001400",5225,221,1774,129,404,18,106,0,7877
"45041001503",2184,160,1142,265,42,0,76,109,3978
"45041001504",2552,604,1576,510,143,20,52,170,5627
"45041001505",2626,274,1010,692,30,24,109,0,4765
"45041001506",1255,67,322,332,16,5,0,0,1997
"45041001601",2217,368,2892,1043,374,0,76,0,6970
"45041001602",3005,269,1060,411,82,0,71,60,4958
"45041001700",1280,149,720,473,40,0,0,0,2662
"45041001800",2058,220,803,364,169,22,318,0,3954
"45041001900",3509,665,1017,729,206,16,17,51,6210
"45041002000",1785,468,1019,498,42,38,10,0,3860
"45041002201",786,293,2113,1807,242,0,32,149,5422
"45041002202",1094,276,1794,515,20,193,0,193,4085
"45041002300",2324,475,372,71,14,22,33,7,3318
"45041002400",2128,334,739,352,148,99,68,7,3875
"45041002500",1599,243,692,394,33,0,123,0,3084
"45041002600",1134,58,1388,845,28,100,23,36,3612
"45041980100",4,0,0,0,0,0,0,0,4
"45043920100",1528,196,859,873,78,2,21,2,3559
"45043920201",2121,706,1143,1112,66,0,3,74,5225
"45043920202",709,456,488,629,136,33,113,36,2600
"45043920301",2286,252,1123,663,135,380,102,322,5263
"45043920302",1792,118,415,70,39,25,20,13,2492
"45043920400",729,251,1251,468,143,15,21,0,2878
"45043920501",4571,338,170,0,128,0,0,0,5207
"45043920502",3166,165,90,456,24,0,15,0,3916
"45043920503",4157,489,482,315,149,0,211,0,5803
"45043920504",4151,139,783,57,86,0,122,0,5338
"45043920505",3471,221,92,24,77,0,114,0,3999
"45043920600",1371,459,2605,1584,42,109,71,0,6241
"45043920700",2899,260,950,826,294,0,356,179,5764
"45043920800",1295,173,1278,693,0,0,33,0,3472
"45043990100",0,0,0,0,0,0,0,0,0
"45045000100",841,59,11,75,52,0,65,0,1103
"45045000200",738,118,29,14,37,5,44,0,985
"45045000400",778,54,149,97,6,19,1,4,1108
"45045000500",245,74,704,344,17,21,0,0,1405
"45045000700",290,251,778,528,22,112,15,99,2095
"45045000800",114,114,466,586,8,0,25,32,1345
"45045000900",177,162,471,435,24,18,3,33,1323
"45045001000",1331,232,242,195,190,8,38,8,2244
"45045001101",3197,136,242,16,177,25,212,18,4023
"45045001102",1713,75,65,10,47,0,193,0,2103
"45045001203",611,105,0,0,86,3,19,0,824
"45045001204",1669,256,462,132,110,16,157,0,2802
"45045001205",822,102,173,44,51,54,164,58,1468
"45045001302",1104,162,124,30,35,6,11,0,1472
"45045001400",2735,178,185,108,24,5,0,0,3235
"45045001501",3445,237,62,91,82,11,106,11,4045
"45045001502",319,78,1304,843,9,67,0,0,2620
"45045001600",4105,550,150,33,194,5,204,235,5476
"45045001700",2800,663,417,19,268,10,523,346,5046
"45045001803",2836,592,185,206,305,108,394,186,4812
"45045001804",3212,195,413,15,229,0,237,0,4301
"45045001805",3345,289,99,71,190,46,89,0,4129
"45045001807",4207,216,398,33,446,49,284,45,5678
"45045001808",2004,419,654,542,242,154,165,82,4262
"45045001809",2295,189,396,88,117,117,198,32,3432
"45045001810",1760,374,1007,173,321,70,524,133,4362
"45045001900",3961,239,609,270,154,0,64,12,5309
"45045002001",331,115,1525,1188,31,83,151,139,3563
"45045002003",1038,368,1658,715,152,560,401,731,5623
"45045002005",778,178,1802,1073,68,162,94,28,4183
"45045002103",1728,213,1024,295,23,43,193,96,3615
"45045002104",584,157,397,182,88,6,128,110,1652
"45045002105",531,498,820,555,7,23,69,269,2772
"45045002106",1393,382,562,327,279,17,372,113,3445
"45045002107",1365,458,790,225,27,139,186,398,3588
"45045002108",676,110,340,349,10,0,17,13,1515
"45045002201",2688,2260,728,484,99,333,823,1368,8783
"45045002202",985,729,299,151,65,104,171,462,2966
"45045002301",2389,704,291,142,91,188,538,566,4909
"45045002302",1596,713,624,563,75,31,279,284,4165
"45045002303",546,696,438,272,22,34,154,370,2532
"45045002304",707,455,622,708,74,56,175,261,3058
"45045002402",5541,971,162,21,194,29,58,62,7038
"45045002403",3632,913,25,11,83,5,114,8,4791
"45045002404",3045,359,8,0,64,0,23,16,3515
"45045002503",6772,927,864,181,999,42,721,390,10896
"45045002504",1156,234,341,180,4,0,250,51,2216
"45045002505",2297,864,222,255,87,44,371,150,4290
"45045002506",3017,321,35,73,78,38,9,91,3662
"45045002507",3496,578,605,111,61,0,247,172,5270
"45045002602",2843,446,251,14,441,0,502,117,4614
"45045002604",3500,853,755,352,134,4,289,172,6059
"45045002606",4930,167,437,2,64,13,172,0,5785
"45045002608",7463,348,450,40,671,153,528,73,9726
"45045002609",5798,356,493,24,257,29,278,158,7393
"45045002610",2039,220,470,105,67,28,209,56,3194
"45045002611",3758,396,883,73,279,63,396,60,5908
"45045002701",3721,176,74,44,82,0,46,0,4143
"45045002702",5847,1634,443,0,146,0,138,0,8208
"45045002803",6909,330,262,0,547,0,787,195,9030
"45045002804",2212,24,0,0,36,19,269,0,2560
"45045002805",3942,129,533,52,337,35,510,0,5538
"45045002808",4806,326,557,668,573,269,119,182,7500
"45045002811",5997,149,1047,0,478,490,380,84,8625
"45045002812",5542,180,609,52,507,72,407,13,7382
"45045002813",3757,35,121,95,436,0,198,0,4642
"45045002814",4927,297,118,43,683,28,220,0,6316
"45045002815",4860,76,552,0,380,0,96,0,5964
"45045002816",8253,50,666,51,712,107,512,95,10446
"45045002901",2728,374,1647,300,376,33,57,170,5685
"45045002903",4211,341,1482,656,480,35,763,149,8117
"45045002904",2760,62,1579,69,197,184,303,184,5338
"45045002905",3099,67,1132,11,267,0,455,0,5031
"45045003005",1181,271,701,51,60,74,21,87,2446
"45045003008",5934,123,399,20,404,0,92,107,7079
"45045003009",5098,159,752,33,59,0,482,0,6583
"45045003010",4149,237,1127,92,373,13,473,13,6477
"45045003011",4733,329,151,225,196,56,805,152,6647
"45045003012",4250,365,796,79,110,29,496,266,6391
"45045003013",4522,371,1400,43,224,26,639,102,7327
"45045003014",3175,460,725,144,121,9,243,9,4886
"45045003015",6885,236,1001,120,117,0,310,96,8765
"45045003101",4346,554,1564,358,133,110,46,40,7151
"45045003103",2497,206,83,12,67,78,77,79,3099
"45045003104",1727,200,25,16,21,11,84,11,2095
"45045003201",3193,168,325,243,187,0,146,0,4262
"45045003202",2835,308,95,19,47,28,30,19,3381
"45045003301",3388,897,852,705,53,0,40,0,5935
"45045003303",3284,460,1005,79,200,88,345,0,5461
"45045003304",3454,871,1662,468,342,29,1068,29,7923
"45045003401",315,167,410,210,44,0,88,22,1256
"45045003500",1059,524,666,244,119,9,82,167,2870
"45045003601",3028,583,1297,436,287,12,721,255,6619
"45045003602",646,382,796,618,170,46,252,221,3131
"45045003701",3469,857,614,133,259,65,482,137,6016
"45045003704",1403,894,290,543,91,92,493,554,4360
"45045003705",979,290,168,64,86,107,211,214,2119
"45045003706",1440,1204,247,111,306,144,268,559,4279
"45045003707",2170,527,422,444,29,23,427,362,4404
"45045003801",3895,431,275,10,84,0,290,205,5190
"45045003802",3527,329,482,494,165,22,189,0,5208
"45045003902",3038,288,163,6,77,6,75,0,3653
"45045003903",3425,512,76,18,74,0,144,12,4261
"45045003904",4167,1058,687,214,246,0,83,218,6673
"45045004001",2636,157,78,11,39,23,19,0,2963
"45045004002",3135,490,40,37,121,16,133,42,4014
"45045004101",2408,831,116,22,139,70,396,96,4078
"45045004102",944,70,0,0,8,0,21,0,1043
"45045004200",1870,320,208,46,38,0,17,0,2499
"45045004300",685,40,1759,1412,41,34,0,8,3979
"45045004400",899,251,483,247,77,6,171,86,2220
"45047970101",2081,387,1080,142,74,0,55,0,3819
"45047970102",2254,755,615,768,87,31,15,193,4718
"45047970201",2381,494,193,160,15,126,15,0,3384
"45047970202",5086,471,1579,519,369,31,147,0,8202
"45047970301",2699,319,393,194,91,113,113,137,4059
"45047970302",4267,365,447,160,259,0,137,173,5808
"45047970400",3609,621,1176,344,72,27,72,26,5947
"45047970500",425,676,1565,1784,253,218,379,741,6041
"45047970600",3515,688,1358,545,297,131,439,278,7251
"45047970701",1839,133,302,8,35,0,134,0,2451
"45047970702",3015,387,962,787,69,87,150,0,5457
"45047970800",2876,867,2547,2274,406,148,324,329,9771
"45047970900",915,301,380,110,171,12,1,19,1909
"45047971000",1222,639,126,53,11,0,0,0,2051
"45049920100",1795,400,502,113,35,0,19,0,2864
"45049920200",2617,381,2756,1063,53,0,55,0,6925
"45049920300",550,164,1106,398,50,8,29,10,2315
"45049920400",1827,99,2069,751,375,39,318,31,5509
"45049920500",398,22,912,523,0,2,0,0,1857
"45051010100",1570,786,343,377,0,35,47,140,3298
"45051020100",2441,177,226,402,16,9,16,18,3305
"45051020200",2634,549,1175,721,52,82,160,21,5394
"45051020300",4278,1041,583,694,283,38,56,18,6991
"45051030101",220,187,304,162,0,0,27,0,900
"45051030102",1692,249,440,335,134,51,208,51,3160
"45051030103",1916,167,449,326,59,0,40,0,2957
"45051040101",2990,551,1050,260,48,0,157,0,5056
"45051040102",3495,446,733,439,73,53,715,1,5955
"45051040103",4257,349,505,93,354,0,87,94,5739
"45051040104",2172,678,102,0,50,0,63,0,3065
"45051040105",1904,202,7,0,96,0,83,0,2292
"45051040200",2878,333,400,78,24,16,42,20,3791
"45051040300",3173,557,60,77,102,43,41,237,4290
"45051040400",3505,375,155,9,69,12,274,29,4428
"45051040500",2644,709,136,44,89,22,55,154,3853
"45051050102",3385,359,200,0,82,24,79,0,4129
"45051050200",1465,98,12,0,43,0,21,0,1639
"45051050303",2231,116,71,0,31,0,43,0,2492
"45051050401",1509,395,116,172,138,0,135,129,2594
"45051050402",1658,112,0,4,79,0,50,0,1903
"45051050500",3292,817,186,163,114,231,409,328,5540
"45051050600",1450,498,1085,1004,198,288,425,170,5118
"45051050700",778,324,125,111,0,190,162,117,1807
"45051050900",3485,1647,617,293,616,119,580,601,7958
"45051051000",2800,200,104,0,305,8,233,18,3668
"45051051201",1260,124,10,0,60,50,89,84,1677
"45051051202",2078,282,21,0,79,95,115,108,2778
"45051051301",897,73,15,0,7,0,4,0,996
"45051051302",2715,210,0,0,160,0,10,0,3095
"45051051403",3931,333,32,0,137,0,96,0,4529
"45051051404",2999,508,0,80,359,35,163,51,4195
"45051051405",2602,314,0,0,185,123,51,70,3345
"45051051406",2363,350,74,19,0,0,18,0,2824
"45051051501",2749,269,395,32,694,25,431,104,4699
"45051051502",5766,832,487,207,354,338,596,317,8897
"45051051503",2150,497,345,180,351,550,570,717,5360
"45051051601",6526,830,806,55,763,634,739,377,10730
"45051051603",3171,383,440,120,115,57,66,0,4352
"45051051604",7169,544,217,0,221,13,88,0,8252
"45051051605",4823,454,302,38,142,179,18,0,5956
"45051051700",1640,270,92,133,46,0,25,0,2206
"45051060101",1827,734,83,66,215,111,30,0,3066
"45051060102",1609,686,79,53,104,231,86,234,3082
"45051060203",4739,719,546,109,883,0,1037,68,8101
"45051060204",5924,1016,444,266,210,205,134,520,8719
"45051060206",4659,434,665,135,511,68,330,19,6821
"45051060207",4849,349,85,24,131,77,64,30,5609
"45051060208",2304,366,129,22,87,48,2,9,2967
"45051060209",4459,568,240,373,306,157,248,185,6536
"45051060301",2756,490,507,266,29,0,7,2,4057
"45051060303",1704,217,13,6,13,16,24,0,1993
"45051060308",3790,512,1204,53,163,0,52,0,5774
"45051060403",1602,384,128,59,131,207,333,207,3051
"45051060404",1298,411,74,114,20,25,40,7,1989
"45051060405",2864,1341,499,368,130,71,457,77,5807
"45051060406",4674,652,209,2,222,90,51,0,5900
"45051070101",3296,425,433,74,230,157,391,198,5204
"45051070102",2410,371,134,10,0,0,0,7,2932
"45051070200",2338,239,105,456,139,33,100,0,3410
"45051070300",1515,347,859,1054,121,0,34,7,3937
"45051070400",1460,251,1855,2020,66,24,19,53,5748
"45051070500",1602,352,1069,546,0,0,88,0,3657
"45051070601",3345,671,121,206,42,177,212,83,4857
"45051070602",2414,404,1031,168,196,65,64,0,4342
"45051070701",3320,390,856,70,87,63,55,0,4841
"45051070702",3114,874,1191,98,191,41,404,0,5913
"45051080101",2537,601,207,88,2,73,20,0,3528
"45051080102",1726,452,285,94,78,0,1,0,2636
"45051080200",3593,666,39,166,87,3,135,0,4689
"45051980100",77,15,0,0,0,0,0,0,92
"45051990100",0,0,0,0,0,0,0,0,0
"45053950100",2305,303,1143,478,129,85,254,85,4782
"45053950201",2896,323,878,476,219,21,105,0,4918
"45053950202",2678,404,3056,1601,582,145,1059,165,9690
"45053950300",2953,951,2394,1267,615,52,1290,737,10259
"45053990100",0,0,0,0,0,0,0,0,0
"45055970100",1347,177,482,323,29,50,63,10,2481
"45055970200",2131,449,245,152,11,0,0,11,2999
"45055970300",915,299,452,72,7,45,0,24,1814
"45055970401",3189,404,465,187,210,11,40,0,4506
"45055970402",1973,248,324,213,8,0,143,0,2909
"45055970403",1887,144,328,133,282,5,211,5,2995
"45055970500",3365,227,920,517,359,57,269,57,5771
"45055970601",3412,378,1342,453,79,40,218,2,5924
"45055970602",2640,789,533,576,148,53,89,0,4828
"45055970700",1545,252,759,99,32,0,8,88,2783
"45055970800",2816,404,1943,1331,202,40,281,58,7075
"45055970902",1694,527,461,76,77,44,24,35,2938
"45055970903",4490,460,837,2,93,57,134,41,6114
"45055970904",5013,311,1490,658,540,127,713,15,8867
"45055970905",2685,71,84,6,10,0,0,0,2856
"45057010100",2834,696,110,147,65,0,65,0,3917
"45057010200",4601,1216,665,493,84,74,24,2,7159
"45057010300",3507,707,1297,327,107,17,112,0,6074
"45057010400",1135,148,480,346,117,16,39,0,2281
"45057010500",2254,978,990,758,89,0,393,144,5606
"45057010600",3046,724,873,509,120,71,415,71,5829
"45057010700",483,87,1646,1621,1,0,40,0,3878
"45057010800",1178,392,657,571,0,3,157,18,2976
"45057010900",2563,146,541,137,195,87,5,87,3761
"45057011001",3526,370,828,148,7,22,10,0,4911
"45057011002",2877,592,539,214,36,0,0,173,4431
"45057011100",3060,633,1382,306,247,46,29,18,5721
"45057011201",8592,982,780,123,782,369,805,301,12734
"45057011202",11270,608,717,118,123,0,979,32,13847
"45059920101",3927,598,1563,368,289,461,30,449,7685
"45059920102",1017,390,219,4,76,4,63,3,1776
"45059920103",2292,648,835,58,187,11,104,185,4320
"45059920104",2521,352,546,0,181,0,75,0,3675
"45059920201",2410,310,375,38,74,0,0,0,3207
"45059920202",2520,787,0,0,2,9,0,0,3318
"45059920301",2546,477,669,152,0,62,10,109,4025
"45059920302",1779,539,1068,581,76,10,181,8,4242
"45059920400",2746,125,1084,328,145,33,357,0,4818
"45059920501",1140,160,339,35,10,0,16,0,1700
"45059920502",2553,978,1269,299,216,533,327,531,6706
"45059920600",2473,460,486,525,42,49,14,76,4125
"45059920700",1455,507,1882,868,37,20,12,0,4781
"45059920800",3108,404,322,653,25,38,67,147,4764
"45059920900",1583,335,137,35,66,15,0,9,2180
"45059921001",1313,488,799,217,21,0,4,3,2845
"45059921002",1728,386,518,43,54,2,31,9,2771
"45061920100",726,247,443,245,0,0,0,0,1661
"45061920200",1706,225,1131,1276,31,131,0,98,4598
"45061920301",0,0,0,0,0,0,0,0,0
"45061920302",585,33,1902,1000,73,55,243,0,3891
"45061920400",1231,195,1964,471,10,28,28,6,3933
"45061920500",428,24,883,364,15,12,0,0,1726
"45061920600",257,17,795,340,17,0,0,0,1426
"45063020100",1505,361,341,357,84,0,43,0,2691
"45063020201",1672,773,181,148,135,62,79,159,3209
"45063020202",1419,126,338,177,176,10,81,0,2327
"45063020300",2319,562,461,317,446,7,779,99,4990
"45063020505",1927,646,556,361,35,198,706,282,4711
"45063020506",3055,370,353,159,150,182,560,264,5093
"45063020507",4576,460,928,300,135,15,597,0,7011
"45063020508",1927,60,51,0,30,0,15,0,2083
"45063020509",2005,177,461,344,142,175,206,59,3569
"45063020510",2786,69,1700,349,276,16,330,0,5526
"45063020511",1331,194,1054,155,293,84,40,0,3151
"45063020601",2481,277,526,397,254,229,219,9,4392
"45063020602",3181,225,431,40,95,7,206,79,4264
"45063020604",2247,189,518,91,58,0,33,0,3136
"45063020605",1561,78,222,31,53,19,83,12,2059
"45063020703",2662,713,187,93,212,12,55,40,3974
"45063020705",1820,802,1080,77,136,44,222,104,4285
"45063020706",861,304,1605,573,73,0,485,0,3901
"45063020707",2271,214,420,192,334,0,246,0,3677
"45063020708",1756,505,45,20,18,35,0,0,2379
"45063020801",975,169,235,275,0,0,0,0,1654
"45063020802",1459,299,582,219,51,4,53,0,2667
"45063020803",1549,413,664,453,51,221,0,148,3499
"45063020804",1270,671,257,230,72,91,236,64,2891
"45063020805",3057,994,595,133,62,257,127,292,5517
"45063020903",3885,875,288,15,109,0,397,437,6006
"45063020904",2270,338,182,73,110,16,107,41,3137
"45063020905",2289,727,332,136,55,0,11,37,3587
"45063020906",3501,497,31,9,0,14,0,14,4066
"45063020907",4330,271,843,245,366,0,188,0,6243
"45063020908",2229,610,273,54,75,14,181,14,3450
"45063021009",6397,1390,895,37,505,133,267,160,9784
"45063021014",4928,222,399,0,730,135,236,128,6778
"45063021017",6407,844,507,304,214,0,228,375,8879
"45063021018",3492,927,178,50,39,0,19,0,4705
"45063021019",1302,49,78,0,0,154,79,0,1662
"45063021020",3030,203,663,1,227,6,108,38,4276
"45063021021",1465,88,0,0,0,0,47,0,1600
"45063021022",4268,82,172,12,38,78,183,131,4964
"45063021023",2514,63,107,0,27,0,125,0,2836
"45063021024",3816,226,188,60,161,194,93,197,4935
"45063021025",3154,257,8,0,19,0,0,0,3438
"45063021026",4467,0,111,0,171,0,137,0,4886
"45063021027",3288,62,65,12,323,0,90,0,3840
"45063021028",2511,176,368,150,78,0,139,10,3432
"45063021029",1628,94,362,256,236,39,71,0,2686
"45063021030",3520,520,427,1,356,36,171,0,5031
"45063021031",2871,338,286,310,81,9,306,0,4201
"45063021032",3178,382,34,0,174,8,4,0,3780
"45063021033",3201,303,579,16,212,59,66,89,4525
"45063021034",3370,234,739,22,150,34,199,37,4785
"45063021106",2310,159,461,0,104,0,60,8,3102
"45063021109",2074,119,306,478,179,139,6,0,3301
"45063021110",2151,37,426,20,341,0,171,14,3160
"45063021111",1114,210,814,38,451,0,85,19,2731
"45063021112",2382,287,435,34,66,0,49,0,3253
"45063021113",1909,188,795,212,235,25,48,0,3412
"45063021114",2825,180,238,39,216,58,116,97,3769
"45063021115",1868,217,128,0,60,0,39,0,2312
"45063021116",2196,80,440,63,406,55,220,0,3460
"45063021203",4845,185,83,0,28,111,100,102,5454
"45063021204",3204,178,148,50,155,42,142,62,3981
"45063021205",2835,101,0,5,18,0,113,0,3072
"45063021206",2302,86,370,303,53,13,15,0,3142
"45063021303",2794,200,0,0,81,0,0,0,3075
"45063021304",3591,292,85,10,508,83,283,69,4921
"45063021305",2251,493,45,5,148,63,179,70,3254
"45063021306",3242,437,53,21,119,202,151,233,4458
"45063021307",1370,140,197,169,101,116,61,70,2224
"45063021308",3144,543,449,0,49,0,54,14,4253
"45063021402",1592,220,880,868,95,61,286,0,4002
"45063021403",1166,559,136,313,96,114,114,208,2706
"45063021404",1718,339,308,230,50,0,62,19,2726
"45063980100",0,0,0,0,0,0,0,0,0
"45065920100",1527,53,406,198,58,0,37,0,2279
"45065920200",1588,215,1669,817,34,0,47,2,4372
"45065920300",1018,137,602,238,32,23,24,0,2074
"45067950100",1562,281,1573,1232,4,9,0,0,4661
"45067950200",1924,126,2369,968,344,92,0,15,5838
"45067950300",504,116,1247,770,22,34,0,34,2727
"45067950400",1620,276,1343,635,55,24,9,12,3974
"45067950500",2347,265,1448,273,54,192,54,136,4769
"45067950600",1748,241,2038,2090,39,42,59,0,6257
"45067950700",564,220,452,210,0,0,25,68,1539
"45067950800",866,232,801,510,120,27,286,128,2970
"45069960100",1459,472,782,270,121,35,17,0,3156
"45069960200",1060,359,2167,1296,128,117,45,0,5172
"45069960301",1628,221,1764,1458,203,0,0,0,5274
"45069960302",830,138,772,422,99,40,2,0,2303
"45069960400",1621,914,1048,387,407,188,96,39,4700
"45069960500",587,143,705,446,149,56,3,13,2102
"45069960600",1191,183,746,56,198,23,0,17,2414
"45071950100",2593,150,561,65,217,22,64,22,3694
"45071950201",1010,441,734,33,584,198,548,437,3985
"45071950202",3150,376,1196,536,340,282,126,307,6313
"45071950300",2103,301,543,208,109,4,4,4,3276
"45071950502",1176,212,2420,883,298,274,236,200,5699
"45071950601",2841,586,745,346,12,11,18,28,4587
"45071950602",4669,301,623,433,144,0,147,48,6365
"45071950700",2322,298,1249,304,390,172,310,172,5217
"45073030100",3587,657,0,4,67,7,33,7,4362
"45073030200",4705,415,59,0,76,0,22,0,5277
"45073030300",6113,644,92,0,199,18,174,18,7258
"45073030401",3716,1791,234,39,397,333,487,959,7956
"45073030402",1396,135,20,0,52,165,117,192,2077
"45073030500",3492,764,108,8,170,13,110,85,4750
"45073030601",3526,915,307,6,75,0,206,31,5066
"45073030602",2972,1157,238,153,130,50,86,108,4894
"45073030701",1829,412,983,399,109,49,89,0,3870
"45073030702",3788,1352,676,154,297,0,100,10,6377
"45073030800",3731,866,1061,379,365,89,326,59,6876
"45073030901",2089,450,36,0,82,0,57,0,2714
"45073030902",6055,1261,0,0,25,170,122,0,7633
"45073031000",3297,966,343,96,88,31,53,0,4874
"45073031100",2681,849,57,11,51,89,31,123,3892
"45075010100",1427,298,1975,871,193,1,80,14,4859
"45075010200",1178,489,2378,1071,171,319,80,353,6039
"45075010300",1470,139,2719,1363,404,48,41,1,6185
"45075010400",1025,114,1594,626,141,12,63,2,3577
"45075010500",1238,44,1543,521,141,0,99,0,3586
"45075010600",820,106,2252,1390,65,51,38,28,4750
"45075010700",678,21,2137,351,11,2,0,27,3227
"45075010800",413,84,2442,1159,61,0,10,0,4169
"45075010900",3279,291,4088,636,325,296,96,279,9290
"45075011000",1448,17,2872,732,252,114,117,17,5569
"45075011100",231,11,1764,1182,23,0,22,0,3233
"45075011200",21,0,473,202,0,0,0,0,696
"45075011300",73,183,1321,1208,33,5,55,35,2913
"45075011400",654,66,1748,1006,79,39,19,0,3611
"45075011500",936,295,1487,1055,12,0,0,0,3785
"45075011600",3164,545,1834,363,4,171,181,0,6262
"45075011700",2953,596,1223,356,51,4,76,0,5259
"45075011800",1814,180,2127,688,34,19,3,0,4865
"45075011900",2142,471,988,146,79,21,36,0,3883
"45075012000",1451,164,1393,441,186,17,12,7,3671
"45077010100",2552,239,0,50,101,57,19,0,3018
"45077010200",3451,825,56,0,12,9,22,0,4375
"45077010300",5143,309,75,41,128,6,93,0,5795
"45077010401",1442,424,0,0,16,17,49,18,1966
"45077010402",3817,908,199,60,1,0,1,2,4988
"45077010403",1706,186,25,0,77,0,87,3,2084
"45077010501",2305,507,0,0,24,16,0,5,2857
"45077010502",2507,247,138,169,0,0,0,0,3061
"45077010601",2636,787,0,0,40,0,141,0,3604
"45077010602",5665,660,0,24,149,33,106,0,6637
"45077010700",3120,713,0,58,256,64,101,0,4312
"45077010801",3144,499,897,167,93,24,40,20,4884
"45077010802",2297,423,206,170,133,11,120,0,3360
"45077010803",2955,689,612,101,315,233,197,224,5326
"45077010804",2508,488,188,14,229,11,133,58,3629
"45077010901",3997,538,172,110,132,0,162,61,5172
"45077010902",5115,281,535,27,241,0,168,0,6367
"45077010903",3995,540,352,47,194,44,129,22,5323
"45077011001",2207,839,111,0,34,43,277,0,3511
"45077011002",5594,934,362,92,178,0,310,0,7470
"45077011003",1792,670,26,36,3,52,35,0,2614
"45077011101",2132,199,101,10,56,15,156,15,2684
"45077011102",2870,2921,717,243,285,336,150,498,8020
"45077011103",885,226,63,0,9,0,9,0,1192
"45077011202",74,172,16,62,0,4,0,0,328
"45077011203",4665,648,318,194,232,84,10,55,6206
"45077011204",1728,1151,93,120,358,334,167,75,4026
"45077011205",1039,1851,93,126,100,357,60,51,3677
"45079000100",191,82,1055,561,13,47,38,66,2053
"45079000200",179,75,795,402,53,8,0,0,1512
"45079000300",197,97,1759,898,26,280,0,279,3536
"45079000400",577,75,939,256,124,18,45,0,2034
"45079000500",39,30,923,962,72,137,59,106,2328
"45079000600",1784,63,245,409,125,0,21,0,2647
"45079000700",1119,106,239,72,82,0,0,0,1618
"45079000900",19,72,1034,1406,10,21,0,6,2568
"45079001000",31,0,789,838,25,7,4,7,1701
"45079001100",1842,278,1514,522,46,19,18,1,4240
"45079001200",1518,51,86,0,21,0,32,0,1708
"45079001300",162,63,782,1031,41,14,0,6,2099
"45079001600",869,180,135,214,94,11,56,4,1563
"45079002100",1613,776,315,55,70,40,86,8,2963
"45079002200",985,259,105,120,0,9,44,46,1568
"45079002300",1909,185,16,0,16,3,8,0,2137
"45079002400",3516,178,103,71,490,14,525,138,5035
"45079002500",2902,410,181,24,112,25,218,112,3984
"45079002602",1862,299,491,64,45,36,73,0,2870
"45079002603",1953,327,362,1446,311,381,311,268,5359
"45079002604",404,116,385,415,134,17,110,41,1622
"45079002700",2321,499,72,14,190,4,42,8,3150
"45079002800",1229,1688,446,185,358,126,221,144,4397
"45079002900",447,245,39,0,85,47,3,0,866
"45079003000",873,477,73,58,79,205,86,57,1908
"45079003100",238,181,141,183,24,46,3,0,816
"45079010102",3155,83,2680,669,258,15,151,0,7011
"45079010103",6900,98,8686,524,1459,2,810,0,18479
"45079010104",2341,131,1204,226,126,8,60,0,4096
"45079010200",2741,151,2073,350,122,0,243,67,5747
"45079010304",2224,364,2603,627,476,217,338,17,6866
"45079010305",3593,676,1713,583,342,102,308,352,7669
"45079010306",7529,497,597,31,607,0,165,21,9447
"45079010307",7979,256,713,0,582,0,379,0,9909
"45079010308",3777,133,1050,181,484,0,97,0,5722
"45079010309",5913,475,3194,137,251,0,306,0,10276
"45079010403",1415,259,1588,536,74,26,47,12,3957
"45079010407",737,79,2686,724,171,53,103,0,4553
"45079010408",7,61,3,55,0,4,0,0,130
"45079010409",277,43,1061,380,21,39,13,26,1860
"45079010410",821,68,1612,354,428,320,66,54,3723
"45079010411",574,157,1555,1208,108,72,84,117,3875
"45079010412",978,198,1635,406,131,77,79,41,3545
"45079010413",616,133,691,296,85,0,38,41,1900
"45079010501",527,184,517,397,121,66,70,0,1882
"45079010502",0,0,284,235,15,13,0,0,547
"45079010600",170,154,2673,1259,148,34,161,141,4740
"45079010701",64,0,1936,823,0,25,0,0,2848
"45079010702",119,0,2488,911,192,10,12,0,3732
"45079010703",20,6,2285,688,0,120,0,120,3239
"45079010803",461,60,1231,502,139,76,141,11,2621
"45079010804",132,41,1659,508,26,0,12,0,2378
"45079010805",308,0,1237,391,113,18,173,21,2261
"45079010806",25,48,12,57,0,0,0,0,142
"45079010900",0,31,894,1815,85,34,0,49,2908
"45079011000",113,4,1044,587,3,0,0,0,1751
"45079011101",1973,92,999,174,130,2,60,0,3430
"45079011102",2872,17,403,347,268,127,165,127,4326
"45079011201",1827,69,119,30,31,12,55,0,2143
"45079011202",2689,261,277,159,59,39,39,10,3533
"45079011301",3443,11,1208,693,224,0,53,0,5632
"45079011303",1016,94,2080,411,601,110,268,100,4680
"45079011304",1325,418,2708,350,553,77,459,270,6160
"45079011305",1496,244,2317,631,384,105,500,271,5948
"45079011404",2282,278,4913,833,696,129,500,192,9823
"45079011407",2261,28,629,213,171,0,104,0,3406
"45079011411",1782,101,1011,60,418,102,106,0,3580
"45079011412",1871,120,1577,153,536,208,220,104,4789
"45079011413",4072,215,2821,250,953,25,191,0,8527
"45079011414",2293,518,2100,338,740,36,404,42,6471
"45079011415",4335,293,4782,415,860,162,179,19,11045
"45079011416",5455,581,4012,296,1025,0,661,0,12030
"45079011417",2473,75,5577,493,686,0,206,0,9510
"45079011418",2187,43,1796,130,292,69,50,69,4636
"45079011419",1334,95,2609,427,262,21,66,0,4814
"45079011501",0,0,0,0,0,0,0,0,0
"45079011502",1262,54,777,0,233,0,329,0,2655
"45079011603",3435,256,757,149,276,0,126,0,4999
"45079011604",4078,231,408,18,264,65,181,0,5245
"45079011606",1925,8,2736,308,155,7,107,20,5266
"45079011607",1116,151,2314,296,182,59,228,94,4440
"45079011608",2504,353,2146,1222,443,257,477,153,7555
"45079011701",1048,2786,758,706,29,202,19,98,5646
"45079011702",307,0,1494,1117,0,0,0,9,2927
"45079011800",533,308,4908,1155,433,2,339,0,7678
"45079011901",1254,145,5889,601,498,295,559,59,9300
"45079011902",2248,121,1994,120,129,21,96,0,4729
"45079012000",2049,160,1772,527,244,17,195,37,5001
"45079980100",14,0,32,0,4,0,4,0,54
"45081960100",1445,307,448,102,124,174,206,174,2980
"45081960201",2305,577,1160,597,878,156,1105,290,7068
"45081960202",1278,65,775,755,384,321,519,330,4427
"45081960300",4116,360,317,120,5,7,36,0,4961
"45081960400",1650,200,696,212,129,109,134,145,3275
"45083020301",155,81,378,432,6,19,55,3,1129
"45083020400",164,121,449,367,5,23,52,31,1212
"45083020500",25,41,712,589,0,49,21,0,1437
"45083020601",781,404,1502,262,171,64,110,0,3294
"45083020602",877,58,649,128,195,44,126,17,2094
"45083020603",1188,37,558,316,88,52,114,19,2372
"45083020701",382,183,1208,1346,0,315,114,82,3630
"45083020702",540,243,447,512,113,3,0,0,1858
"45083020800",23,64,354,854,0,32,0,19,1346
"45083020900",468,130,544,180,16,1,7,47,1393
"45083021001",240,100,1411,769,19,11,10,6,2566
"45083021100",1554,124,1329,429,215,11,124,10,3796
"45083021200",2270,209,138,80,32,9,46,0,2784
"45083021301",1155,187,606,223,122,5,54,54,2406
"45083021302",2246,127,11,8,28,0,7,0,2427
"45083021303",3583,188,846,384,80,29,83,0,5193
"45083021401",1126,70,274,7,37,0,13,0,1527
"45083021402",2317,307,311,17,250,0,59,0,3261
"45083021403",1480,602,655,487,336,11,232,62,3865
"45083021500",1559,614,650,336,53,12,37,0,3261
"45083021600",1073,124,729,397,108,30,57,0,2518
"45083021700",1199,422,1072,881,31,139,168,262,4174
"45083021802",1581,1903,901,310,147,123,540,1093,6598
"45083021803",4477,533,1334,27,484,66,221,0,7142
"45083021804",839,561,274,294,225,220,321,540,3274
"45083021901",3126,1482,843,256,532,168,1385,1039,8831
"45083021902",5056,500,1287,130,669,30,190,92,7954
"45083022003",1947,480,625,264,142,38,61,47,3604
"45083022004",907,74,722,405,239,30,0,11,2388
"45083022005",4014,189,687,59,583,0,799,0,6331
"45083022006",1491,60,2208,920,14,7,95,0,4795
"45083022007",1702,241,902,105,196,0,406,0,3552
"45083022101",2281,110,735,161,186,15,21,0,3509
"45083022102",1634,408,63,28,21,66,42,82,2344
"45083022201",3674,490,414,156,47,0,187,0,4968
"45083022202",2473,607,254,176,45,45,120,0,3720
"45083022302",3789,922,316,0,107,0,145,0,5279
"45083022303",994,302,156,122,184,63,188,58,2067
"45083022304",2788,980,305,34,51,46,74,210,4488
"45083022401",4282,532,469,374,289,9,108,83,6146
"45083022403",5783,903,821,74,226,41,159,0,8007
"45083022404",4516,589,418,0,67,0,33,0,5623
"45083022405",3308,220,263,9,44,4,60,14,3922
"45083022406",5276,268,292,245,339,0,125,0,6545
"45083022500",3009,669,81,5,39,27,22,15,3867
"45083022600",2385,521,290,141,86,4,317,4,3748
"45083022700",5062,861,238,20,158,9,161,41,6550
"45083022801",4808,151,801,0,606,187,489,19,7061
"45083022802",5306,1012,421,147,647,97,234,147,8011
"45083022900",4096,1047,393,281,495,21,101,41,6475
"45083023001",6272,671,424,82,437,32,414,96,8428
"45083023002",1755,159,554,61,281,282,45,122,3259
"45083023101",2750,715,691,164,779,320,362,286,6067
"45083023102",3962,710,834,296,432,122,702,176,7234
"45083023201",3350,110,192,0,64,11,162,0,3889
"45083023202",2184,544,419,79,148,26,69,48,3517
"45083023301",1315,185,144,8,89,110,29,103,1983
"45083023302",1520,716,1285,383,434,515,900,971,6724
"45083023401",1447,61,520,48,158,0,94,0,2328
"45083023402",3649,180,259,0,106,0,91,0,4285
"45083023403",4681,177,1071,104,467,201,143,0,6844
"45083023404",4704,625,1066,14,99,43,77,63,6691
"45083023405",3935,358,182,10,268,0,75,26,4854
"45083023500",3377,639,269,35,99,167,116,13,4715
"45083023600",3566,819,984,401,150,90,98,0,6108
"45083023700",3468,441,163,211,55,45,18,8,4409
"45083023801",4296,416,922,0,234,0,149,0,6017
"45083023802",3864,328,67,47,80,9,38,32,4465
"45083023900",3069,579,624,190,119,153,51,78,4863
"45085000100",433,24,1334,580,48,20,22,23,2484
"45085000201",2181,122,1469,448,80,18,151,0,4469
"45085000202",2666,166,2464,973,559,28,176,0,7032
"45085000300",1852,145,657,125,109,48,38,14,2988
"45085000400",3991,188,3432,688,431,26,667,33,9456
"45085000500",800,101,961,436,23,46,16,50,2433
"45085000600",1749,412,1330,442,94,128,49,49,4253
"45085000700",1493,194,1508,905,85,48,125,92,4450
"45085000800",61,148,1776,1227,107,76,105,60,3560
"45085000901",1339,371,1173,177,350,211,126,174,3921
"45085000902",3901,235,543,33,64,0,66,16,4858
"45085001100",899,266,1706,627,356,34,385,126,4399
"45085001300",280,15,1178,421,14,25,9,0,1942
"45085001500",0,0,1143,776,45,36,0,0,2000
"45085001600",137,21,2148,1330,110,72,38,0,3856
"45085001701",4485,579,1492,258,144,0,132,0,7090
"45085001703",3208,325,961,47,366,87,270,0,5264
"45085001704",2499,21,2430,411,283,0,177,0,5821
"45085001801",2221,298,1150,408,48,8,40,0,4173
"45085001802",3835,574,2599,759,123,192,418,18,8518
"45085001901",4066,466,1154,268,204,43,29,47,6277
"45085001902",2699,370,2140,274,90,0,0,0,5573
"45085002000",1807,225,1150,875,29,43,128,6,4263
"45087030100",1001,165,540,293,17,30,32,0,2078
"45087030200",927,317,729,610,0,63,0,0,2646
"45087030300",2552,359,677,451,29,0,78,0,4146
"45087030400",3419,461,1017,619,88,93,0,0,5697
"45087030500",1379,260,356,131,56,4,59,59,2304
"45087030600",473,91,832,218,6,1,0,0,1621
"45087030700",2302,251,608,138,48,18,63,0,3428
"45087030800",2223,315,552,292,52,79,32,0,3545
"45087030900",1711,190,400,149,38,7,0,0,2495
"45089970100",906,148,540,216,0,3,17,0,1830
"45089970200",237,17,895,278,30,12,0,0,1469
"45089970300",1459,493,1983,992,8,0,55,0,4990
"45089970400",895,157,1037,492,25,0,0,0,2606
"45089970501",532,70,1964,619,71,0,87,13,3356
"45089970502",211,31,2237,1247,0,0,0,0,3726
"45089970600",1785,678,1765,1334,31,111,27,113,5844
"45089970700",430,180,1292,775,0,23,10,11,2721
"45089970801",301,85,1302,788,18,0,0,0,2494
"45089970802",0,0,0,0,0,0,0,0,0
"45089970900",1407,138,582,462,37,0,37,0,2663
"45091060102",1821,402,132,141,16,6,62,11,2591
"45091060200",1852,642,805,354,300,75,433,40,4501
"45091060300",832,550,1740,611,203,11,41,10,3998
"45091060401",94,95,1364,920,0,0,0,0,2473
"45091060402",347,4,999,413,48,0,65,19,1895
"45091060501",530,425,1363,634,31,98,24,80,3185
"45091060502",252,15,1529,273,0,135,0,0,2204
"45091060600",1,6,0,1,0,0,0,0,8
"45091060700",3403,133,696,311,187,0,86,0,4816
"45091060802",1352,202,138,5,130,0,57,0,1884
"45091060803",2736,217,1301,122,449,124,348,124,5421
"45091060804",2569,464,1011,61,332,86,228,98,4849
"45091060901",1860,503,1229,602,492,48,320,56,5110
"45091060904",5025,144,1064,0,267,0,168,0,6668
"45091060905",5315,816,1395,633,383,206,144,151,9043
"45091060906",6837,846,541,95,549,0,631,103,9602
"45091060907",6156,661,1292,426,888,59,816,74,10372
"45091061003",9174,310,461,24,405,0,378,0,10752
"45091061004",6282,230,426,139,348,0,519,47,7991
"45091061005",7922,460,689,353,377,38,622,0,10461
"45091061006",2881,15,55,0,419,0,145,0,3515
"45091061007",4830,752,1026,32,520,16,794,326,8296
"45091061008",3760,43,501,0,359,0,190,12,4865
"45091061101",2572,403,389,299,64,19,0,44,3790
"45091061103",4333,387,151,205,211,24,106,0,5417
"45091061104",3734,58,361,21,231,0,288,0,4693
"45091061201",4577,1010,1337,310,344,105,230,157,8070
"45091061202",2908,558,61,3,925,226,76,14,4771
"45091061203",4257,641,615,290,181,49,125,72,6230
"45091061301",1553,98,2582,494,150,28,100,68,5073
"45091061302",3371,200,804,429,155,15,133,11,5118
"45091061401",3312,297,505,35,60,91,21,0,4321
"45091061403",3779,362,556,13,81,32,0,11,4834
"45091061404",2402,166,878,90,18,23,93,43,3713
"45091061501",5192,1013,634,162,696,210,204,200,8311
"45091061502",6080,1498,539,98,0,41,186,321,8763
"45091061601",1117,140,725,601,139,0,0,0,2722
"45091061602",2873,424,1042,750,252,151,301,114,5907
"45091061701",3305,621,96,12,99,99,25,106,4363
"45091061705",3945,595,9,31,460,11,46,22,5119
"45091061706",4013,230,160,16,38,16,61,0,4534
"45091061707",7663,372,573,120,335,29,445,15,9552
"45091061708",4266,125,249,35,244,47,253,72,5291
"45091061801",1366,570,720,115,176,0,153,64,3164
"45091061802",3240,884,239,267,15,59,0,0,4704
"45091061900",3310,355,388,107,33,42,65,2,4302
"46003973600",2265,211,11,0,105,12,145,18,2767
"46005956600",1459,248,0,17,15,31,22,0,1792
"46005956700",1683,238,0,0,0,0,56,0,1977
"46005956800",1395,120,2,0,233,16,170,16,1952
"46005956900",1879,934,19,0,314,155,142,385,3828
"46005957000",4082,930,0,7,297,416,76,517,6325
"46005957100",2510,221,0,0,214,375,129,87,3536
"46007941000",451,27,10,0,558,338,53,3,1440
"46007941200",529,51,0,23,451,922,35,47,2058
"46009967600",2663,345,0,0,114,15,133,4,3274
"46009967700",2108,208,7,0,52,8,0,0,2383
"46011958600",3261,244,5,12,102,129,107,58,3918
"46011958700",4724,346,13,41,54,39,32,101,5350
"46011958802",3272,1170,0,0,211,19,119,0,4791
"46011958803",4268,520,9,8,314,0,30,33,5182
"46011958900",3207,1421,35,0,193,329,76,135,5396
"46011959000",4463,480,245,0,384,53,30,0,5655
"46013951300",4986,345,0,0,108,63,145,0,5647
"46013951400",5146,582,340,0,443,0,94,0,6605
"46013951500",1820,244,0,0,400,189,132,35,2820
"46013951600",2953,270,0,0,438,169,46,0,3876
"46013951700",3800,674,19,0,103,211,68,147,5022
"46013951800",4618,457,141,0,36,3,0,0,5255
"46013951900",3353,189,6,0,71,1,119,26,3765
"46013952000",4298,216,26,0,77,0,7,3,4627
"46015973100",1819,506,0,0,105,8,12,0,2450
"46015973200",1993,148,0,0,432,127,10,0,2710
"46017940200",329,44,4,0,985,667,21,0,2050
"46019967600",2769,362,0,0,188,42,93,11,3465
"46019967700",5926,575,2,5,213,98,233,20,7072
"46021964100",1339,133,0,0,66,7,3,0,1548
"46023940200",1099,62,3,0,845,1000,21,32,3062
"46023940300",1666,242,0,0,852,530,118,43,3451
"46023970100",2433,135,1,0,50,1,5,6,2631
"46025955800",2895,478,7,28,90,60,66,26,3650
"46027965700",3173,996,59,21,391,238,60,54,4992
"46027965800",2628,160,2,0,45,0,6,0,2841
"46027965900",2046,1642,0,60,191,138,102,74,4253
"46029954100",3003,262,0,31,92,39,45,36,3508
"46029954301",3630,406,0,36,439,24,28,23,4586
"46029954302",4519,226,0,0,0,0,24,0,4769
"46029954400",3402,848,19,7,254,103,220,33,4886
"46029954501",2047,216,7,14,61,21,41,0,2407
"46029954502",4476,332,0,0,140,119,45,0,5112
"46029954600",2376,115,0,0,37,7,7,0,2542
"46031941000",701,100,0,0,286,539,2,0,1628
"46031941100",452,28,12,0,776,1198,10,9,2485
"46033965100",4624,425,2,0,277,108,33,169,5638
"46033965200",2274,287,0,0,35,30,39,0,2665
"46035962600",2829,272,0,0,36,56,6,31,3230
"46035962700",4963,544,62,0,113,18,30,0,5730
"46035962800",4134,935,0,0,312,33,42,0,5456
"46035962900",3744,511,24,0,348,10,278,2,4917
"46037952700",1312,241,0,0,18,10,0,39,1620
"46037952800",1408,437,0,0,34,18,0,0,1897
"46037952900",1251,169,0,0,206,325,41,29,2021
"46039953600",2605,264,30,0,2,0,109,11,3021
"46039953700",1285,66,0,0,10,0,0,0,1361
"46041941500",161,5,2,0,1517,862,2,21,2570
"46041941700",958,69,0,0,1311,587,0,26,2951
"46043969600",2511,234,0,0,117,12,26,0,2900
"46045962100",1877,271,5,0,7,35,0,0,2195
"46045962200",1480,172,0,0,49,1,50,1,1753
"46047964100",2158,408,0,0,92,23,35,0,2716
"46047964200",2769,471,59,19,442,176,186,8,4130
"46049961100",1879,340,0,0,27,33,12,83,2374
"46051953100",4627,325,0,26,80,39,161,6,5264
"46051953300",1874,189,0,0,10,3,34,0,2110
"46053971100",1628,254,5,0,76,136,11,0,2110
"46053971200",1573,242,0,0,124,137,2,21,2099
"46055960100",1601,213,8,0,92,130,0,0,2044
"46057955100",2335,200,2,2,85,44,92,28,2788
"46057955200",2969,158,1,2,11,18,63,4,3226
"46059975600",1336,126,0,0,12,0,36,0,1510
"46059975700",1670,145,0,0,28,0,7,4,1854
"46061964100",2835,332,97,21,41,53,18,15,3412
"46063968700",1101,154,2,7,20,13,12,0,1309
"46065977700",4722,268,0,0,109,494,46,99,5738
"46065977800",4316,93,0,0,406,153,47,0,5015
"46065977900",1776,180,0,85,391,222,98,90,2842
"46065978000",2597,86,30,0,326,82,23,5,3149
"46067968600",2513,436,14,0,40,45,77,13,3138
"46067968700",1913,201,0,0,64,0,9,0,2187
"46067968800",1454,226,0,0,13,18,3,0,1714
"46069976700",1094,117,0,0,114,51,10,0,1386
"46071941200",298,36,5,0,756,855,73,2,2025
"46071961100",912,168,0,0,150,0,0,0,1230
"46073974100",1760,176,0,0,33,0,26,25,2020
"46075091600",667,71,16,0,9,18,2,0,783
"46077958100",2562,274,0,31,106,21,54,40,3088
"46077958200",1807,179,0,0,37,0,14,0,2037
"46079960100",2095,114,0,0,10,1,20,3,2243
"46079960200",5131,1311,58,0,279,60,74,102,7015
"46079960300",2041,242,0,0,18,4,2,42,2349
"46081966100",5478,494,9,4,92,41,96,6,6220
"46081966200",2720,543,0,0,220,27,82,13,3605
"46081966301",3528,464,0,0,247,118,258,104,4719
"46081966302",3701,663,0,19,292,60,9,0,4744
"46081966600",4172,470,16,47,155,165,116,32,5173
"46083010101",4522,159,56,0,147,0,79,0,4963
"46083010102",7277,323,0,0,343,0,334,0,8277
"46083010103",5110,247,159,0,105,0,63,0,5684
"46083010104",9300,238,71,0,622,3,46,41,10321
"46083010105",589,21,26,0,15,0,0,0,651
"46083010106",1146,50,7,0,50,0,27,0,1280
"46083010107",4765,356,57,28,118,101,2,16,5443
"46083010108",1956,46,0,0,140,0,11,0,2153
"46083010200",3220,209,64,0,127,39,100,30,3789
"46083010300",4585,230,38,10,76,4,22,0,4965
"46083010400",2542,94,0,0,43,0,39,0,2718
"46085940100",89,10,0,0,744,624,7,3,1477
"46085972600",2023,92,0,0,173,49,0,3,2340
"46087964600",2901,268,0,7,58,18,35,13,3300
"46087964700",1941,160,9,2,61,12,90,17,2292
"46089963100",1644,376,5,0,40,102,25,22,2214
"46091950800",3543,437,25,4,359,260,179,39,4846
"46093020200",340,62,173,0,21,23,12,0,631
"46093020301",6513,951,111,0,637,114,206,111,8643
"46093020302",4992,309,0,0,244,38,155,0,5738
"46093020400",5281,759,0,0,234,270,111,68,6723
"46093020500",3721,238,136,0,352,0,323,0,4770
"46095940300",624,185,0,0,490,736,70,24,2129
"46097961600",1928,231,22,0,58,3,45,0,2287
"46099000100",1808,233,43,237,449,223,148,134,3275
"46099000201",2191,524,465,41,283,854,443,138,4939
"46099000202",1784,407,110,0,194,0,23,0,2518
"46099000300",2631,228,144,165,428,153,660,98,4507
"46099000401",2046,89,216,0,157,386,159,364,3417
"46099000405",2993,395,605,137,1022,425,58,54,5689
"46099000406",2162,313,189,337,205,45,71,0,3322
"46099000407",2221,446,69,122,63,19,13,0,2953
"46099000408",2574,215,104,502,453,135,517,156,4656
"46099000500",2099,352,39,55,351,342,353,88,3679
"46099000600",1742,327,183,0,219,103,96,14,2684
"46099000700",2580,528,224,309,603,172,373,24,4813
"46099000900",2069,760,342,25,347,69,315,241,4168
"46099001001",2812,527,11,0,210,56,385,61,4062
"46099001002",3475,701,95,0,433,259,389,6,5358
"46099001101",3342,771,79,17,249,140,60,184,4842
"46099001105",5569,535,89,0,348,58,79,27,6705
"46099001106",9973,285,0,213,228,0,509,0,11208
"46099001107",2958,159,12,0,231,26,36,0,3422
"46099001108",3621,380,35,79,465,366,148,25,5119
"46099001200",3352,179,241,70,331,0,69,0,4242
"46099001500",3950,360,151,260,213,203,69,58,5264
"46099001600",3024,105,14,0,133,0,52,0,3328
"46099001700",1941,103,56,0,79,9,44,5,2237
"46099001801",5502,389,114,174,441,151,319,29,7119
"46099001803",7055,254,83,190,388,37,74,0,8081
"46099001804",3919,171,0,0,266,18,116,0,4490
"46099001901",1737,103,0,0,135,22,38,0,2035
"46099001902",5006,108,0,0,24,0,24,0,5162
"46099010101",3982,245,20,0,243,50,135,26,4701
"46099010102",3429,422,10,0,193,12,146,0,4212
"46099010200",2680,152,0,0,15,10,75,3,2935
"46099010300",5864,182,0,0,20,11,30,11,6118
"46099010401",1820,28,0,0,36,0,59,0,1943
"46099010402",2352,69,3,0,36,0,16,0,2476
"46099010403",1711,0,24,0,75,0,31,0,1841
"46099010404",4270,121,17,109,167,19,36,9,4748
"46099010405",2930,405,290,0,287,11,59,0,3982
"46099010406",2143,86,7,0,216,71,29,0,2552
"46099010501",4867,224,0,0,90,0,15,0,5196
"46099010502",3382,435,22,0,21,0,0,0,3860
"46099010600",3449,332,109,55,158,378,7,0,4488
"46101959600",2938,305,47,0,104,99,27,0,3520
"46101959700",1553,263,2,0,802,243,105,58,3026
"46102940500",151,35,0,51,2480,1999,52,0,4768
"46102940800",213,42,17,0,1175,3009,9,0,4465
"46102940900",167,58,0,0,2346,2288,34,52,4945
"46103010200",2893,600,0,39,513,1087,185,0,5317
"46103010300",1451,584,0,78,597,235,176,0,3121
"46103010400",2101,523,52,93,662,498,173,10,4112
"46103010500",1244,284,0,78,892,347,286,144,3275
"46103010600",2508,347,29,0,359,334,85,9,3671
"46103010700",2871,243,38,67,577,406,134,146,4482
"46103010800",2897,551,0,0,433,62,115,15,4073
"46103010903",6651,583,130,0,819,33,169,42,8427
"46103010904",3948,481,28,0,359,94,172,129,5211
"46103010905",3873,293,164,16,685,244,63,0,5338
"46103010906",4757,238,25,0,263,65,124,0,5472
"46103010907",1490,240,3,0,468,77,190,9,2477
"46103011001",2083,247,0,0,235,7,118,54,2744
"46103011002",5159,323,88,0,394,200,588,0,6752
"46103011004",6204,269,0,0,440,33,134,42,7122
"46103011005",2058,112,7,4,93,37,11,32,2354
"46103011100",2423,158,52,0,545,151,16,0,3345
"46103011200",2356,196,19,9,56,77,50,31,2794
"46103011300",5156,389,68,0,303,138,86,15,6155
"46103011400",6044,347,15,0,899,289,355,56,8005
"46103011500",239,225,50,7,185,91,174,24,995
"46103011600",6105,378,135,1,541,146,103,0,7409
"46103011700",3756,290,0,0,513,135,367,176,5237
"46105968300",2475,361,3,0,46,35,45,3,2968
"46107000100",1843,236,0,0,103,19,8,12,2221
"46109940400",1108,82,0,0,1129,686,46,2,3053
"46109940700",1658,153,24,18,370,190,56,16,2485
"46109940800",1186,155,0,1,1013,589,32,46,3022
"46109950400",1508,152,0,0,19,5,39,0,1723
"46111962100",2032,238,0,0,20,0,44,0,2334
"46115000100",1688,97,14,0,42,28,6,0,1875
"46115000200",2260,367,0,0,27,20,16,0,2690
"46115000300",1439,264,14,0,81,22,100,7,1927
"46117960100",2418,228,0,0,286,12,38,5,2987
"46119979100",1356,71,0,0,21,3,6,3,1460
"46121940100",272,23,22,0,1690,1991,106,39,4143
"46121940200",692,26,4,7,2484,2424,56,146,5839
"46123971600",1870,211,0,0,70,125,0,0,2276
"46123971700",1910,415,0,0,258,461,33,0,3077
"46125965100",3626,328,35,0,81,21,48,11,4150
"46125965200",3571,373,10,0,31,39,40,60,4124
"46127020100",3891,179,6,0,81,0,57,0,4214
"46127020200",2508,183,9,0,8,24,5,0,2737
"46127020300",6773,318,26,0,569,79,259,118,8142
"46129965100",1549,158,0,10,54,69,50,62,1952
"46129965200",2386,292,0,0,672,121,145,0,3616
"46135966100",2322,302,55,7,258,152,127,5,3228
"46135966200",5010,643,15,103,205,15,116,0,6107
"46135966301",2527,257,0,0,31,8,4,8,2835
"46135966302",3993,989,0,92,96,121,95,47,5433
"46135966400",3431,274,9,0,77,30,13,14,3848
"46137941600",657,49,8,4,1021,1050,65,23,2877
"47001020100",1255,642,399,283,305,68,0,0,2952
"47001020201",3154,194,237,0,420,31,89,0,4125
"47001020202",3220,424,84,0,264,59,370,0,4421
"47001020300",2853,319,310,41,310,0,206,178,4217
"47001020400",2762,1163,28,72,132,92,292,16,4557
"47001020500",2230,843,450,123,235,171,75,147,4274
"47001020600",2037,275,163,21,152,24,53,35,2760
"47001020700",1139,408,0,0,8,0,0,0,1555
"47001020800",3258,1110,16,0,64,7,7,3,4465
"47001020901",5209,972,3,0,133,3,20,0,6340
"47001020902",5157,524,0,0,32,85,41,0,5839
"47001021000",3701,2319,76,0,38,0,0,0,6134
"47001021100",3361,230,100,0,84,0,35,8,3818
"47001021201",3937,596,51,32,54,46,0,2,4718
"47001021202",3836,886,72,0,103,105,27,106,5135
"47001021301",2805,375,0,22,17,0,39,18,3276
"47001021302",6291,744,160,0,182,0,103,0,7480
"47001980100",0,0,0,0,0,0,0,0,0
"47003950100",2927,221,223,1,234,0,67,0,3673
"47003950200",5729,760,175,17,238,18,154,0,7091
"47003950300",3157,336,41,25,217,71,112,0,3959
"47003950401",3911,533,228,101,235,537,664,470,6679
"47003950402",4095,784,441,129,810,374,1241,366,8240
"47003950500",3555,884,372,69,301,134,368,252,5935
"47003950600",4347,1579,801,419,627,0,1197,114,9084
"47003950700",1990,536,53,10,195,3,135,139,3061
"47003950800",2475,176,50,10,12,0,0,0,2723
"47005963000",2260,772,0,0,23,19,10,7,3091
"47005963100",2536,256,245,15,42,0,34,0,3128
"47005963200",1779,608,57,22,23,0,63,13,2565
"47005963300",2299,1057,68,76,13,72,81,55,3721
"47005963400",3004,723,35,41,7,6,9,62,3887
"47007953000",2666,686,0,0,278,1,28,0,3659
"47007953100",4176,1160,204,16,91,15,135,38,5835
"47007953200",2313,817,0,0,8,2,5,0,3145
"47009010100",1249,721,579,471,0,84,156,210,3470
"47009010200",4254,1155,221,20,229,1,442,0,6322
"47009010301",3970,949,310,44,94,0,17,17,5401
"47009010302",2054,576,113,0,90,14,10,14,2871
"47009010400",2376,332,66,2,15,24,54,3,2872
"47009010500",1942,293,97,24,71,8,99,45,2579
"47009010600",2272,526,0,0,113,51,0,21,2983
"47009010700",3808,490,122,0,150,144,190,86,4990
"47009010800",1566,516,98,39,0,150,11,0,2380
"47009010900",5126,549,111,3,191,0,324,133,6437
"47009011001",4790,902,12,0,143,34,11,258,6150
"47009011002",3824,194,0,0,113,103,29,22,4285
"47009011101",3640,763,287,0,65,0,49,0,4804
"47009011102",7871,691,31,0,177,44,76,0,8890
"47009011200",6465,1039,147,0,351,0,228,46,8276
"47009011301",5231,475,187,1,35,0,165,0,6094
"47009011302",4916,750,0,14,90,102,23,0,5895
"47009011401",1247,267,0,0,130,4,44,3,1695
"47009011402",3833,715,0,0,42,36,0,0,4626
"47009011501",1293,260,0,0,47,20,8,0,1628
"47009011502",3520,1011,0,0,20,82,0,0,4633
"47009011503",5773,783,16,0,90,0,238,0,6900
"47009011602",8325,837,0,0,102,0,208,75,9547
"47009011603",4153,442,221,0,81,32,103,20,5052
"47009011604",3816,278,27,0,160,0,87,29,4397
"47009011605",2856,231,0,9,51,0,81,0,3228
"47009980100",0,0,0,0,0,0,0,0,0
"47009980200",4,0,0,0,5,0,5,0,14
"47011010100",3138,741,447,10,186,160,282,77,5041
"47011010200",4127,945,9,15,368,0,444,374,6282
"47011010300",1518,1164,81,0,118,0,0,66,2947
"47011010400",672,1002,431,293,112,92,37,212,2851
"47011010500",1453,451,130,58,44,10,71,62,2279
"47011010600",2365,445,68,23,50,36,140,280,3407
"47011010700",1927,1555,412,216,186,194,167,301,4958
"47011010800",1552,1051,219,99,13,163,46,151,3294
"47011010900",2707,459,0,0,0,70,4,76,3316
"47011011000",4514,874,141,0,100,0,206,67,5902
"47011011100",7980,1485,160,39,194,39,71,61,10029
"47011011201",4983,732,168,138,134,5,135,11,6306
"47011011202",6696,932,205,185,132,42,481,228,8901
"47011011300",6625,730,0,0,446,16,68,9,7894
"47011011401",6857,1121,501,0,110,0,20,0,8609
"47011011402",1842,575,57,95,193,0,461,224,3447
"47011011500",6272,1153,0,270,225,0,247,0,8167
"47011011601",4126,565,15,1,48,0,7,210,4972
"47011011602",4187,1064,33,0,36,44,62,20,5446
"47013950100",1874,1008,0,0,99,0,0,16,2997
"47013950200",1364,665,98,0,79,15,41,0,2262
"47013950300",1143,595,0,0,45,0,0,0,1783
"47013950400",4104,788,0,0,35,25,0,14,4966
"47013950500",4359,768,0,0,79,28,187,0,5421
"47013950600",2887,1208,29,0,40,31,0,104,4299
"47013950700",3000,1563,0,0,46,0,0,0,4609
"47013950800",1737,413,0,0,43,0,0,0,2193
"47013950900",2379,507,0,0,0,10,24,9,2929
"47013951000",2229,500,0,0,11,29,0,11,2780
"47013951100",4663,1024,46,0,0,26,20,67,5846
"47015960100",2982,637,17,2,2,38,28,1,3707
"47015960200",4691,1180,51,50,92,112,13,102,6291
"47015960300",3105,412,47,17,120,52,55,52,3860
"47017962000",2822,969,248,108,60,160,12,170,4549
"47017962100",4692,1021,419,344,95,18,56,123,6768
"47017962201",1905,456,107,294,109,128,0,0,2999
"47017962202",3392,558,2,96,31,45,73,0,4197
"47017962300",3419,673,388,89,46,20,67,85,4787
"47017962400",1870,336,215,78,69,0,0,20,2588
"47017962500",1607,211,168,100,29,9,14,19,2157
"47017980100",0,0,0,0,0,0,0,0,0
"47019070100",1344,336,18,7,10,0,0,0,1715
"47019070200",3339,669,22,8,38,0,47,189,4312
"47019070300",3280,1179,184,208,139,106,37,12,5145
"47019070400",1352,713,0,14,4,0,0,2,2085
"47019070500",3446,542,0,0,17,0,8,10,4023
"47019070600",2062,656,8,0,83,0,24,0,2833
"47019070700",2756,406,0,0,47,0,69,0,3278
"47019070800",1971,479,7,31,62,12,0,0,2562
"47019070900",2296,704,86,3,28,25,183,14,3339
"47019071000",2190,773,0,26,70,0,7,7,3073
"47019071100",1331,338,0,0,15,2,2,0,1688
"47019071200",2651,1207,0,0,6,6,50,0,3920
"47019071300",5482,1780,0,0,114,66,78,10,7530
"47019071400",2209,804,0,0,107,0,42,0,3162
"47019071500",1544,523,9,0,22,19,0,5,2122
"47019071600",916,484,0,0,21,25,0,27,1473
"47019071700",2775,870,0,0,61,0,70,0,3776
"47021070102",3657,377,32,0,183,29,217,0,4495
"47021070103",3154,347,35,0,247,36,302,0,4121
"47021070104",3976,936,61,0,336,28,80,91,5508
"47021070201",3712,424,31,0,44,0,53,0,4264
"47021070202",3729,674,74,28,124,24,8,0,4661
"47021070203",3152,331,0,0,37,0,0,0,3520
"47021070300",2326,836,203,22,117,0,43,114,3661
"47021070401",1989,396,48,16,0,0,0,0,2449
"47021070402",6189,873,19,19,155,0,77,8,7340
"47023970100",4312,1096,425,7,224,24,198,45,6331
"47023970200",2352,908,465,731,112,95,86,60,4809
"47023970300",4678,655,109,0,21,0,0,23,5486
"47025970100",2573,382,4,0,11,8,0,25,3003
"47025970200",2252,323,3,0,0,28,14,2,2622
"47025970300",2556,684,0,0,104,101,0,0,3445
"47025970400",413,206,0,0,4,49,0,0,672
"47025970500",2124,714,0,0,43,0,25,0,2906
"47025970600",3659,803,0,0,0,21,10,26,4519
"47025970700",3836,947,16,0,222,0,95,0,5116
"47025970800",2621,1099,8,27,2,17,4,0,3778
"47025970900",3294,1089,15,18,13,142,0,90,4661
"47027955000",3676,1169,74,38,61,16,69,35,5138
"47027955100",2042,544,0,0,24,34,38,0,2682
"47029920100",2862,756,0,0,34,0,45,0,3697
"47029920200",3103,1904,112,58,250,74,104,25,5630
"47029920300",3038,650,48,47,75,49,57,7,3971
"47029920400",1258,479,0,0,0,37,0,0,1774
"47029920501",4334,1854,44,22,154,28,54,201,6691
"47029920502",4392,853,0,0,71,0,44,0,5360
"47029920600",2637,1378,105,69,0,2,51,69,4311
"47029920700",2866,851,0,0,388,0,32,34,4171
"47029980100",0,0,0,0,0,0,0,0,0
"47031970100",3259,756,0,6,53,7,5,4,4090
"47031970200",5188,1079,0,0,65,189,19,138,6678
"47031970300",1438,290,0,0,43,24,8,0,1803
"47031970400",4299,938,44,0,498,172,316,221,6488
"47031970500",3888,1080,184,5,315,50,175,82,5779
"47031970600",3353,478,38,0,230,38,99,24,4260
"47031970700",3287,639,2,7,124,61,21,11,4152
"47031970801",3280,686,56,0,310,130,127,23,4612
"47031970802",5420,590,83,10,138,24,0,24,6289
"47031970900",2023,1029,162,221,346,217,187,97,4282
"47031971000",4222,829,122,20,522,243,295,224,6477
"47031980100",0,0,0,0,0,0,0,0,0
"47033961000",1523,325,217,50,47,25,153,50,2390
"47033961100",2182,648,436,86,141,168,120,181,3962
"47033961200",1526,266,26,16,131,98,93,93,2249
"47033961300",1656,311,162,102,73,57,89,46,2496
"47033961400",2654,441,537,199,123,46,450,112,4562
"47035970101",3298,229,101,0,64,0,12,0,3704
"47035970102",5307,700,49,0,124,32,46,32,6290
"47035970200",5592,521,0,0,145,48,24,68,6398
"47035970301",2656,533,0,0,0,0,0,0,3189
"47035970302",3463,652,24,0,135,0,88,0,4362
"47035970400",3654,1967,0,0,71,64,161,289,6206
"47035970501",2126,438,52,0,44,16,44,95,2815
"47035970502",2269,1200,31,0,113,110,143,190,4056
"47035970601",4394,376,0,7,62,25,201,10,5075
"47035970602",3086,340,0,0,90,28,0,0,3544
"47035970603",2051,105,10,0,53,7,52,7,2285
"47035970701",1778,451,0,0,8,0,20,0,2257
"47035970702",3198,747,0,0,30,0,19,0,3994
"47035970800",3103,672,0,0,46,32,24,17,3894
"47037010103",2199,174,147,0,28,3,37,0,2588
"47037010104",2594,141,153,13,63,36,31,28,3059
"47037010105",732,80,2967,597,77,0,55,0,4508
"47037010106",534,102,1822,305,71,218,64,129,3245
"47037010201",2208,372,1696,219,202,0,387,165,5249
"47037010202",3040,141,76,50,137,0,93,0,3537
"47037010301",2302,226,766,166,156,19,139,17,3791
"47037010302",1091,293,341,280,72,28,45,16,2166
"47037010303",2289,540,1523,221,365,0,197,0,5135
"47037010401",3122,349,1109,231,90,184,1049,233,6367
"47037010402",2297,860,555,857,847,563,1015,578,7572
"47037010501",3874,1167,230,95,382,14,446,216,6424
"47037010502",3781,395,486,283,148,21,63,31,5208
"47037010601",2542,90,1720,250,382,162,537,160,5843
"47037010602",1026,357,1320,339,480,264,371,292,4449
"47037010701",1686,563,853,466,433,252,430,249,4932
"47037010702",1118,411,673,487,691,125,696,129,4330
"47037010801",1699,432,1959,452,296,119,204,178,5339
"47037010802",2151,236,559,78,189,114,186,131,3644
"47037010901",1547,123,899,211,157,0,144,17,3098
"47037010903",373,155,2695,1826,170,330,130,359,6038
"47037010904",363,8,1814,661,0,0,0,0,2846
"47037011001",1209,536,2307,730,320,233,211,354,5900
"47037011002",1039,133,1016,281,183,97,143,75,2967
"47037011100",2704,311,341,64,592,204,432,198,4846
"47037011200",2364,434,616,243,216,58,70,67,4068
"47037011300",1516,621,1366,422,523,338,638,524,5948
"47037011400",1730,314,1811,913,106,11,234,2,5121
"47037011500",2603,363,489,103,125,12,32,0,3727
"47037011600",2859,403,1210,107,45,0,21,0,4645
"47037011700",3447,665,1046,507,153,107,106,89,6120
"47037011800",735,44,806,1054,141,79,97,0,2956
"47037011900",627,89,769,738,159,96,87,41,2606
"47037012100",2072,197,50,33,113,16,214,0,2695
"47037012200",1644,120,84,33,92,21,68,21,2083
"47037012600",481,58,676,619,153,49,71,41,2148
"47037012701",188,56,3295,1869,57,197,0,0,5662
"47037012702",132,138,1709,457,119,20,3,0,2578
"47037012801",267,463,2696,1730,159,17,11,208,5551
"47037012802",303,110,1861,445,51,0,60,0,2830
"47037013000",0,0,0,0,0,0,0,0,0
"47037013100",1249,312,618,105,114,10,0,0,2408
"47037013201",1721,140,171,57,916,148,16,38,3207
"47037013202",2691,143,236,11,481,24,684,0,4270
"47037013300",2099,643,486,239,430,75,596,183,4751
"47037013400",3670,260,108,0,316,0,94,0,4448
"47037013500",1058,208,271,151,61,119,39,86,1993
"47037013601",120,108,1724,1560,51,57,24,57,3701
"47037013602",18,24,206,88,27,3,18,0,384
"47037013700",385,171,2821,2084,90,118,26,0,5695
"47037013800",85,12,975,578,65,21,25,0,1761
"47037013900",37,6,826,686,51,17,9,17,1649
"47037014200",83,20,804,772,17,0,0,10,1706
"47037014300",176,43,1079,462,23,20,94,5,1902
"47037014400",157,49,417,465,118,80,20,20,1326
"47037014800",16,33,526,2104,0,97,0,71,2847
"47037015100",3314,308,73,65,483,144,203,123,4713
"47037015200",1901,172,97,2,54,152,144,143,2665
"47037015300",4674,357,646,19,135,34,310,95,6270
"47037015401",4211,681,398,37,395,0,503,297,6522
"47037015402",3521,134,669,57,82,20,325,13,4821
"47037015404",2108,365,181,48,124,6,317,53,3202
"47037015405",3336,502,634,13,473,93,316,181,5548
"47037015501",2335,212,148,74,140,0,159,21,3089
"47037015502",2446,346,401,56,231,8,62,56,3606
"47037015609",2549,125,550,9,446,9,199,0,3887
"47037015610",5910,309,1111,566,617,78,230,0,8821
"47037015612",2917,537,2361,158,781,41,594,41,7430
"47037015613",1599,525,803,197,428,202,720,533,5007
"47037015614",2128,535,927,59,565,157,733,230,5334
"47037015615",1537,1012,1059,41,824,345,1162,863,6843
"47037015617",1400,127,720,12,120,19,48,32,2478
"47037015618",2201,508,2383,108,268,0,433,132,6033
"47037015619",2447,204,1839,59,489,0,208,109,5355
"47037015620",2686,791,3357,209,688,50,759,0,8540
"47037015622",2547,277,596,138,105,76,220,49,4008
"47037015623",2882,79,1518,1228,383,144,605,0,6839
"47037015624",2911,547,1045,282,270,15,139,233,5442
"47037015625",3551,438,814,181,244,32,77,120,5457
"47037015626",1953,494,2892,395,830,35,632,0,7231
"47037015627",1133,124,1311,128,322,36,329,39,3422
"47037015628",961,250,1423,426,572,231,692,260,4815
"47037015629",2236,213,1876,548,652,0,373,0,5898
"47037015630",1657,233,1501,196,393,58,264,35,4337
"47037015631",4351,366,3062,663,1582,26,1000,232,11282
"47037015700",1062,172,228,47,71,26,433,60,2099
"47037015802",2640,745,812,467,848,182,1278,159,7131
"47037015803",1114,701,366,330,320,64,737,180,3812
"47037015804",1643,465,1175,311,649,109,704,152,5208
"47037015900",858,761,98,349,78,13,41,253,2451
"47037016000",126,26,490,293,24,20,3,0,982
"47037016100",632,206,726,366,23,4,60,5,2022
"47037016200",684,278,937,1124,28,141,100,72,3364
"47037016300",687,362,476,712,53,39,23,5,2357
"47037016400",1036,319,84,7,46,35,28,22,1577
"47037016500",183,114,0,7,39,30,18,12,403
"47037016600",1421,340,87,124,429,68,58,38,2565
"47037016700",4217,288,115,16,227,31,81,13,4988
"47037016800",3019,699,341,35,437,208,0,39,4778
"47037016900",3569,238,382,0,373,91,141,0,4794
"47037017000",1550,262,741,109,29,0,17,13,2721
"47037017100",1616,107,336,15,51,2,58,0,2185
"47037017200",855,273,97,12,85,2,225,106,1655
"47037017300",1423,791,429,27,297,167,272,480,3886
"47037017401",1352,190,394,73,311,162,551,215,3248
"47037017402",3189,1378,442,81,447,355,678,1243,7813
"47037017500",1920,497,222,66,320,15,556,194,3790
"47037017701",1849,4,127,0,158,0,54,0,2192
"47037017702",2928,204,56,0,99,9,61,20,3377
"47037017800",4368,553,112,17,204,76,41,20,5391
"47037017901",4134,248,26,0,162,26,85,8,4689
"47037017902",4098,184,157,28,188,13,52,0,4720
"47037018000",4254,235,22,18,207,54,11,0,4801
"47037018101",2251,461,476,498,621,693,369,443,5812
"47037018102",3260,283,25,0,161,0,82,0,3811
"47037018201",2645,79,9,33,109,0,61,0,2936
"47037018202",4803,735,1106,221,553,181,95,185,7879
"47037018203",1553,33,5,0,12,7,59,7,1676
"47037018301",5750,882,272,409,592,0,286,0,8191
"47037018302",2472,56,83,0,105,0,13,0,2729
"47037018401",4441,329,765,370,574,20,624,15,7138
"47037018404",3519,276,238,48,159,19,221,17,4497
"47037018405",4109,158,135,11,294,12,86,24,4829
"47037018407",3797,85,115,53,328,6,52,0,4436
"47037018408",2885,30,179,0,391,0,25,0,3510
"47037018409",4025,222,209,0,172,0,41,0,4669
"47037018410",2176,292,260,0,131,210,31,212,3312
"47037018500",4757,92,31,13,139,0,46,0,5078
"47037018601",2059,97,79,0,63,14,0,0,2312
"47037018602",4066,72,38,12,149,8,53,0,4398
"47037018700",3219,22,0,0,52,0,33,0,3326
"47037018801",4588,201,94,8,541,0,21,17,5470
"47037018803",3097,146,46,0,69,0,168,0,3526
"47037018804",3922,264,633,0,506,14,351,56,5746
"47037018901",1455,659,192,53,162,247,48,85,2901
"47037018902",2008,492,76,32,206,22,369,253,3458
"47037018904",1712,658,228,322,962,480,591,177,5130
"47037018905",1538,337,413,100,322,147,166,229,3252
"47037019003",1778,935,727,84,512,637,971,1217,6861
"47037019004",1472,408,883,153,922,836,894,471,6039
"47037019005",1121,177,858,652,390,232,532,319,4281
"47037019006",1790,862,1103,271,636,593,909,864,7028
"47037019105",2299,1233,458,281,1116,517,233,333,6470
"47037019106",2792,270,457,32,279,25,132,49,4036
"47037019108",1341,545,404,67,555,450,1001,825,5188
"47037019109",2191,664,1327,67,1101,265,823,483,6921
"47037019110",2365,631,857,63,376,123,1196,237,5848
"47037019111",1724,443,1439,107,389,166,514,267,5049
"47037019112",1694,461,1426,36,563,434,288,612,5514
"47037019114",8013,296,2390,28,865,0,1077,0,12669
"47037019115",3149,0,423,106,329,0,164,0,4171
"47037019116",3949,767,1058,154,548,155,766,67,7464
"47037019117",1749,114,2177,210,336,31,153,0,4770
"47037019118",1826,556,2293,129,456,92,315,417,6084
"47037019200",2015,339,497,364,188,228,191,203,4025
"47037019300",344,336,333,2102,55,176,12,28,3386
"47037019400",1827,183,587,1045,60,17,40,3,3762
"47037019500",3080,714,291,238,250,132,197,85,4987
"47037019600",2515,413,595,130,274,25,628,204,4784
"47037980100",0,0,0,0,0,0,0,0,0
"47037980200",0,0,0,0,0,0,0,0,0
"47039955001",1385,458,21,11,65,6,67,0,2013
"47039955002",3206,1083,129,43,102,68,86,174,4891
"47039955101",1253,389,88,19,3,0,19,2,1773
"47039955102",2624,391,0,0,113,2,0,0,3130
"47041920101",1573,516,0,4,15,49,0,66,2223
"47041920102",4034,821,1,2,13,18,517,47,5453
"47041920200",4371,1592,80,74,236,33,263,70,6719
"47041920300",4312,476,62,12,36,290,105,293,5586
"47043060100",3105,942,54,21,20,28,100,12,4282
"47043060200",5055,980,209,16,67,62,35,0,6424
"47043060300",5387,875,43,0,98,26,107,0,6536
"47043060401",3030,177,12,11,78,9,37,0,3354
"47043060402",4977,722,96,2,207,18,142,86,6250
"47043060501",5049,552,283,54,224,35,195,0,6392
"47043060502",2432,230,45,8,175,24,12,67,2993
"47043060601",2338,676,351,62,96,58,128,125,3834
"47043060602",3734,1370,325,197,381,163,310,177,6657
"47043060700",3658,742,98,13,83,43,59,0,4696
"47045964000",5432,869,225,24,258,18,83,9,6918
"47045964200",4157,801,495,211,215,24,177,154,6234
"47045964300",3086,715,732,250,154,70,26,19,5052
"47045964400",2414,1112,1497,731,171,160,219,1,6305
"47045964500",1970,264,27,6,34,8,22,11,2342
"47045964600",1874,439,233,73,258,51,176,92,3196
"47045964800",2343,148,226,39,94,0,63,0,2913
"47045964900",4341,618,154,15,217,0,83,9,5437
"47047060300",1089,256,983,543,33,4,34,0,2942
"47047060401",1929,165,304,115,173,239,35,370,3330
"47047060402",2787,76,638,73,46,0,74,0,3694
"47047060403",3254,180,627,55,45,19,24,0,4204
"47047060404",4193,429,759,8,118,0,126,26,5659
"47047060501",2139,245,802,777,36,7,25,0,4031
"47047060502",2362,219,735,334,46,1,23,0,3720
"47047060600",2032,305,1409,377,75,8,48,8,4262
"47047060701",1392,202,519,117,6,0,93,0,2329
"47047060702",1821,121,505,285,58,2,73,2,2867
"47047060800",1435,117,533,65,127,7,0,0,2284
"47049965000",2225,718,0,0,52,36,0,0,3031
"47049965100",2694,1438,0,0,54,58,163,9,4416
"47049965200",4464,1231,0,0,36,4,36,0,5771
"47049965300",3372,1092,18,0,106,0,0,17,4605
"47051960100",2343,704,68,45,110,176,98,124,3668
"47051960201",5856,398,40,0,185,34,0,84,6597
"47051960202",4664,541,43,0,181,117,23,0,5569
"47051960300",2109,345,55,8,76,0,0,0,2593
"47051960400",5377,906,215,40,371,211,117,148,7385
"47051960500",2248,765,244,35,189,200,55,76,3812
"47051960600",3102,960,100,53,197,148,73,18,4651
"47051960700",2040,482,35,25,66,57,39,4,2748
"47051960800",2192,377,69,12,247,30,126,79,3132
"47053966100",1742,307,196,64,77,4,0,7,2397
"47053966200",2428,551,271,203,89,92,33,0,3667
"47053966300",1665,506,261,11,15,0,15,0,2473
"47053966400",3522,803,328,18,137,46,203,46,5103
"47053966500",2748,695,755,687,92,52,155,39,5223
"47053966600",1443,86,175,10,26,11,35,11,1797
"47053966700",3331,765,771,752,121,0,179,52,5971
"47053966800",953,144,45,0,24,0,15,0,1181
"47053966900",560,99,1398,614,47,7,23,0,2748
"47053967000",4405,878,1145,461,81,74,0,201,7245
"47053967100",5225,159,522,137,89,1,83,0,6216
"47053967300",1012,158,0,0,27,10,17,10,1234
"47053967400",3496,597,63,38,97,40,48,0,4379
"47053980100",18,0,0,0,0,0,0,0,18
"47055920100",2754,482,86,25,16,40,19,0,3422
"47055920200",2819,670,195,334,97,131,59,7,4312
"47055920300",4719,478,488,233,424,31,127,76,6576
"47055920400",1734,408,248,22,2,21,29,0,2464
"47055920500",3394,398,433,123,116,13,86,42,4605
"47055920600",2195,343,73,78,40,0,8,1,2738
"47055920700",1295,242,158,6,19,12,19,0,1751
"47055920800",1953,464,198,41,57,32,44,13,2802
"47057500100",2651,1102,0,0,58,0,84,63,3958
"47057500200",3945,608,15,5,37,0,10,4,4624
"47057500300",5036,1187,83,28,107,4,231,22,6698
"47057500401",2025,727,1,15,0,1,0,14,2783
"47057500402",3916,754,0,24,26,192,59,109,5080
"47059090100",2848,2325,342,228,120,385,87,669,7004
"47059090200",1932,172,0,2,36,8,11,0,2161
"47059090300",4087,611,70,0,169,0,169,11,5117
"47059090400",3959,417,126,5,70,79,35,0,4691
"47059090500",5920,946,109,45,107,20,92,39,7278
"47059090600",3369,318,0,15,76,20,33,54,3885
"47059090700",2379,423,18,86,15,12,15,0,2948
"47059090800",3660,484,23,22,16,48,45,0,4298
"47059090900",4203,749,27,3,0,0,89,42,5113
"47059091000",5445,1778,88,0,26,0,43,149,7529
"47059091100",3206,737,0,0,34,53,37,15,4082
"47059091200",2296,584,16,26,46,132,55,0,3155
"47059091300",3570,1007,26,33,37,46,60,31,4810
"47059091400",2152,817,5,0,23,13,2,16,3028
"47059091500",2284,958,0,0,11,40,0,29,3322
"47061955000",1593,933,0,0,343,219,0,0,3088
"47061955100",985,96,2,2,91,68,4,0,1248
"47061955200",2343,893,0,0,382,206,0,20,3844
"47061955300",3107,919,0,3,609,458,19,13,5128
"47063100100",3686,1417,327,267,563,307,858,614,8039
"47063100200",2928,849,191,171,439,412,396,633,6019
"47063100300",1256,1257,60,74,56,141,230,628,3702
"47063100400",3648,1014,335,331,55,380,577,644,6984
"47063100500",2110,433,79,39,82,36,0,5,2784
"47063100600",5622,826,191,4,106,63,47,0,6859
"47063100700",4518,1108,74,0,121,213,270,221,6525
"47063100800",1973,987,155,0,113,84,47,174,3533
"47063100900",3776,623,43,67,663,279,1027,284,6762
"47063101000",4713,692,0,22,94,0,23,15,5559
"47063101100",4476,413,0,0,161,0,188,0,5238
"47063101200",5901,671,54,1,216,12,0,0,6855
"47065000400",326,71,2141,930,103,40,0,0,3611
"47065000600",2767,355,2,25,42,1,39,0,3231
"47065000700",2941,534,194,0,193,0,104,11,3977
"47065000800",949,143,231,192,71,4,23,0,1613
"47065001100",362,59,643,634,11,84,36,76,1905
"47065001200",134,106,1480,1529,24,49,0,0,3322
"47065001300",269,253,610,518,0,54,25,219,1948
"47065001400",540,308,451,223,83,21,107,121,1854
"47065001600",63,217,382,1608,19,9,0,14,2312
"47065001800",1485,443,240,145,139,2,145,0,2599
"47065001900",210,22,1475,2225,41,107,34,7,4121
"47065002000",509,92,229,252,55,21,37,11,1206
"47065002300",593,199,171,162,160,121,193,219,1818
"47065002400",1748,1581,591,954,189,175,149,741,6128
"47065002500",1151,584,792,1488,303,12,332,62,4724
"47065002600",652,340,404,560,225,337,384,423,3325
"47065002800",2388,266,562,137,64,0,38,26,3481
"47065002900",984,210,828,563,67,0,220,60,2932
"47065003000",1028,278,702,186,363,36,309,135,3037
"47065003100",638,201,92,141,49,0,10,0,1131
"47065003200",533,143,1989,448,245,147,124,0,3629
"47065003300",1240,106,4350,769,133,205,68,18,6889
"47065003400",2574,518,965,281,52,86,389,115,4980
"47065010101",4350,764,144,43,77,45,119,63,5605
"47065010103",3394,207,26,2,58,10,32,10,3739
"47065010104",3999,298,34,44,99,0,0,0,4474
"47065010201",3321,76,0,0,78,0,0,0,3475
"47065010202",3608,669,48,11,13,0,38,0,4387
"47065010303",2727,221,111,0,94,0,8,0,3161
"47065010304",4689,348,6,0,143,0,49,0,5235
"47065010305",2776,134,36,0,10,0,0,0,2956
"47065010306",3288,476,30,0,42,0,139,156,4131
"47065010307",4550,793,0,0,21,50,0,20,5434
"47065010411",6153,510,102,0,299,12,68,147,7291
"47065010412",4679,313,61,0,325,0,10,0,5388
"47065010413",3667,263,0,9,140,0,41,0,4120
"47065010431",5886,413,386,8,313,178,187,64,7435
"47065010432",5994,258,28,4,166,7,91,0,6548
"47065010433",3123,588,416,191,24,0,122,0,4464
"47065010434",1892,261,78,0,34,0,0,0,2265
"47065010435",4391,886,382,22,97,172,0,2,5952
"47065010501",4769,517,643,73,242,66,7,0,6317
"47065010502",2422,489,115,87,474,117,318,130,4152
"47065010600",2011,386,118,56,207,24,129,9,2940
"47065010700",1623,712,174,69,21,20,0,196,2815
"47065010800",2980,819,174,120,116,82,320,183,4794
"47065010901",1733,151,0,2,14,11,20,0,1931
"47065010902",634,244,0,0,0,0,0,0,878
"47065010903",4134,766,258,196,387,0,77,0,5818
"47065011001",1439,233,0,0,76,0,0,0,1748
"47065011002",7085,288,0,13,172,32,51,35,7676
"47065011100",6589,80,13,21,6,0,0,0,6709
"47065011201",8762,543,281,148,255,16,332,211,10548
"47065011203",3607,377,503,48,327,0,313,8,5183
"47065011204",4374,348,200,0,417,35,525,46,5945
"47065011311",4991,894,595,117,283,0,606,34,7520
"47065011314",3913,463,703,163,161,30,146,56,5635
"47065011321",4238,642,1047,110,799,45,298,264,7443
"47065011323",3729,510,514,120,474,0,177,35,5559
"47065011324",3382,72,343,19,352,0,74,0,4242
"47065011325",4558,198,912,26,268,16,244,35,6257
"47065011326",2896,921,645,279,299,83,212,598,5933
"47065011402",1543,222,3220,632,324,4,324,0,6269
"47065011411",1840,440,1713,89,171,43,28,110,4434
"47065011413",5507,294,1474,37,323,117,329,0,8081
"47065011442",1944,373,263,52,205,7,90,41,2975
"47065011443",3207,459,1333,235,518,40,243,0,6035
"47065011444",326,63,2261,454,106,75,81,0,3366
"47065011445",2389,174,892,123,106,71,221,64,4040
"47065011446",2682,97,516,23,80,0,213,0,3611
"47065011447",7177,197,290,18,432,0,279,0,8393
"47065011600",3548,623,428,10,539,43,119,51,5361
"47065011700",3298,424,436,0,224,11,687,138,5218
"47065011800",4760,604,682,72,190,329,469,333,7439
"47065011900",1128,72,453,45,103,20,66,0,1887
"47065012000",1755,51,5,10,39,5,24,0,1889
"47065012100",4948,810,27,2,28,0,280,252,6347
"47065012200",48,34,1362,1102,0,0,0,0,2546
"47065012300",1051,284,2212,1078,110,147,0,0,4882
"47065012400",832,935,312,176,0,117,77,0,2449
"47065980100",0,0,0,0,0,0,0,0,0
"47065980200",0,0,0,0,0,0,0,0,0
"47067960500",2227,402,0,0,54,16,0,0,2699
"47067960600",2371,1335,0,2,30,38,0,0,3776
"47069950100",2382,425,378,135,103,15,66,28,3532
"47069950200",1115,274,1181,591,38,0,55,50,3304
"47069950300",1442,157,1132,649,25,6,0,0,3411
"47069950400",1897,455,1710,1153,51,73,0,0,5339
"47069950500",3341,794,130,92,24,34,16,79,4510
"47069950600",811,126,1303,655,13,2,0,0,2910
"47071920100",2889,926,0,0,46,38,20,0,3919
"47071920200",3183,1047,150,17,191,47,83,0,4718
"47071920300",3205,470,158,166,45,9,36,0,4089
"47071920400",2860,1439,201,101,0,27,0,316,4944
"47071920500",3912,962,0,0,224,56,0,0,5154
"47071920600",2441,602,0,13,24,0,54,0,3134
"47073050100",3128,682,0,0,30,0,8,5,3853
"47073050200",3332,1473,0,10,23,15,0,0,4853
"47073050301",3031,884,0,0,115,34,83,0,4147
"47073050302",2964,507,148,17,194,0,91,0,3921
"47073050400",4897,1210,0,0,64,3,21,0,6195
"47073050501",3606,499,0,0,54,0,13,0,4172
"47073050502",1991,778,46,7,67,62,21,0,2972
"47073050503",3777,418,89,0,41,51,25,48,4449
"47073050601",4535,700,210,0,142,151,52,113,5903
"47073050602",3590,796,29,0,48,0,98,31,4592
"47073050700",2788,518,5,0,58,16,0,0,3385
"47073050800",3418,1262,114,23,101,56,72,46,5092
"47073050900",2482,489,0,0,10,0,16,0,2997
"47075930100",1354,230,610,39,49,0,134,0,2416
"47075930200",665,145,449,328,33,0,21,0,1641
"47075930301",1685,251,1502,862,275,116,107,52,4850
"47075930302",871,63,1185,715,17,0,42,0,2893
"47075930400",1477,282,1321,535,282,19,292,19,4227
"47075930500",1106,182,1000,340,21,0,40,49,2738
"47077975000",2204,577,78,11,24,6,0,110,3010
"47077975100",2714,456,167,22,27,40,28,0,3454
"47077975200",4136,1326,152,0,23,0,31,0,5668
"47077975300",5563,733,590,292,152,207,41,33,7611
"47077975400",2364,752,421,300,259,159,217,108,4580
"47077975500",2756,1027,1,4,13,13,8,44,3866
"47079969000",3744,738,23,0,21,26,92,15,4659
"47079969100",2317,456,29,4,10,36,67,3,2922
"47079969200",1541,261,30,0,10,0,41,0,1883
"47079969300",1456,714,511,576,93,51,9,81,3491
"47079969400",912,454,335,211,27,52,0,0,1991
"47079969500",3896,442,173,211,200,0,43,0,4965
"47079969600",6439,802,310,9,48,0,132,0,7740
"47079969700",1822,253,44,76,0,0,0,0,2195
"47079969800",1702,468,73,22,27,0,141,0,2433
"47081950100",4526,1046,44,0,48,0,62,0,5726
"47081950200",4701,1426,66,10,143,45,19,45,6455
"47081950301",1946,535,128,60,35,113,0,0,2817
"47081950302",3652,783,0,10,141,33,322,0,4941
"47081950400",1542,472,0,0,74,6,0,0,2094
"47081950500",837,122,0,22,8,55,0,0,1044
"47083120100",2661,553,40,51,61,27,16,68,3477
"47083120200",1231,341,86,27,44,76,25,0,1830
"47083120300",2035,770,0,7,32,8,18,45,2915
"47085130100",4659,1034,0,20,91,0,28,86,5918
"47085130200",1548,409,17,0,40,4,13,15,2046
"47085130300",3835,713,247,118,34,0,185,8,5140
"47085130400",1982,199,121,16,28,0,28,0,2374
"47085130500",2393,319,5,3,72,21,9,0,2822
"47087960100",1223,366,0,0,21,19,0,0,1629
"47087960200",1806,459,38,0,70,0,14,0,2387
"47087960300",3714,1225,0,1,34,150,26,128,5278
"47087960400",1362,814,0,0,0,0,0,36,2212
"47089070100",5355,983,30,20,343,67,344,122,7264
"47089070200",4153,625,0,0,153,0,87,10,5028
"47089070300",4736,910,366,190,158,75,113,22,6570
"47089070400",2874,673,78,0,45,7,45,124,3846
"47089070500",4382,1219,82,107,9,11,83,27,5920
"47089070600",3935,987,20,8,70,0,125,178,5323
"47089070700",5716,660,42,62,212,70,249,7,7018
"47089070800",5990,919,2,0,80,0,17,84,7092
"47089070900",3309,748,91,2,19,0,107,27,4303
"47091956000",729,130,0,0,5,4,5,0,873
"47091956100",2078,624,11,0,13,12,32,9,2779
"47091956200",1627,395,0,0,6,0,0,0,2028
"47091956300",4049,1154,21,39,53,187,20,154,5677
"47091956400",3242,1576,97,0,51,2,30,15,5013
"47093000100",1163,420,72,120,127,77,69,31,2079
"47093000800",1336,1113,272,447,122,65,56,22,3433
"47093000901",0,0,0,0,0,0,0,0,0
"47093000902",113,125,0,0,10,36,0,6,290
"47093001400",689,841,143,949,84,145,84,331,3266
"47093001500",2346,391,294,224,143,0,156,18,3572
"47093001600",1866,521,395,7,39,0,37,9,2874
"47093001700",1504,592,165,41,31,73,130,45,2581
"47093001800",1494,262,349,45,58,0,52,0,2260
"47093001900",309,235,578,629,19,69,23,98,1960
"47093002000",241,414,1619,1049,75,47,27,15,3487
"47093002100",607,684,1036,329,51,58,22,412,3199
"47093002200",2493,555,219,173,35,19,17,27,3538
"47093002300",2045,816,105,203,154,78,77,74,3552
"47093002400",2292,771,419,312,145,171,188,7,4305
"47093002600",872,565,233,553,74,116,42,275,2730
"47093002700",1741,456,94,133,282,202,243,35,3186
"47093002800",1903,709,920,774,19,282,56,20,4683
"47093002900",1573,1184,360,578,98,143,31,13,3980
"47093003000",2893,671,364,185,104,148,73,0,4438
"47093003100",1874,206,447,49,118,53,35,2,2784
"47093003200",879,349,1105,580,51,95,0,29,3088
"47093003300",1274,102,508,109,124,7,34,0,2158
"47093003400",3203,416,107,27,88,8,60,0,3909
"47093003500",3462,705,0,636,15,17,52,35,4922
"47093003700",1475,490,169,81,99,74,163,96,2647
"47093003801",2559,951,415,27,329,127,293,363,5064
"47093003802",2617,255,280,86,178,32,275,18,3741
"47093003901",2950,498,363,99,439,33,136,168,4686
"47093003902",2144,547,216,184,74,28,182,69,3444
"47093004000",2920,431,260,182,106,15,179,15,4108
"47093004100",3548,380,232,0,131,19,35,0,4345
"47093004200",2953,248,34,21,164,6,84,0,3510
"47093004300",1859,414,200,186,42,70,34,0,2805
"47093004401",4820,212,0,0,100,0,57,0,5189
"47093004403",3845,768,132,54,600,41,129,286,5855
"47093004404",2733,110,94,48,157,0,12,0,3154
"47093004500",4261,430,210,55,613,178,293,158,6198
"47093004606",5573,504,532,0,483,0,229,29,7350
"47093004607",5059,205,526,0,153,24,201,0,6168
"47093004608",2595,87,169,37,45,0,58,0,2991
"47093004609",3401,752,755,31,315,312,88,275,5929
"47093004610",2679,766,430,42,545,159,646,0,5267
"47093004611",3567,81,244,0,179,23,128,23,4245
"47093004612",2436,67,47,0,34,0,24,59,2667
"47093004613",4053,1124,291,0,24,8,97,176,5773
"47093004614",2557,123,62,0,314,241,41,296,3634
"47093004615",2286,875,282,223,169,176,7,95,4113
"47093004700",3404,277,232,149,115,16,161,0,4354
"47093004800",4159,546,375,0,429,87,160,194,5950
"47093004900",4596,605,80,0,396,0,70,0,5747
"47093005000",2997,437,26,88,97,29,78,0,3752
"47093005100",4562,342,82,0,167,199,22,0,5374
"47093005201",4097,543,364,0,153,26,27,0,5210
"47093005202",2693,220,394,32,58,27,268,14,3706
"47093005301",3541,247,84,0,69,0,0,0,3941
"47093005302",2922,234,0,2,41,0,0,0,3199
"47093005401",2554,537,143,8,144,40,141,0,3567
"47093005402",2362,711,0,9,30,17,0,17,3146
"47093005501",2262,155,0,0,82,10,21,0,2530
"47093005502",2520,456,60,15,12,0,0,0,3063
"47093005602",3496,567,0,0,219,58,102,0,4442
"47093005603",3150,426,40,0,41,0,98,0,3755
"47093005604",2311,139,0,0,71,0,67,0,2588
"47093005701",4052,390,15,0,216,5,177,175,5030
"47093005704",4557,389,442,0,551,40,162,39,6180
"47093005706",3477,242,106,42,397,22,137,0,4423
"47093005707",3076,91,109,0,46,0,17,0,3339
"47093005708",2403,7,135,0,127,0,73,0,2745
"47093005709",1537,96,62,0,142,3,27,0,1867
"47093005710",1871,57,29,0,136,0,44,0,2137
"47093005711",4538,175,376,0,491,0,106,0,5686
"47093005712",6477,651,112,0,836,0,42,380,8498
"47093005803",2252,136,8,0,91,30,41,15,2573
"47093005807",2171,284,104,0,49,20,227,150,3005
"47093005808",4554,564,289,41,252,0,285,0,5985
"47093005809",4719,259,29,0,346,70,157,0,5580
"47093005810",3195,63,21,0,369,0,44,0,3692
"47093005811",2350,30,57,0,335,0,0,0,2772
"47093005812",4548,98,34,0,327,0,38,0,5045
"47093005813",4920,185,226,0,470,0,208,0,6009
"47093005903",3383,218,100,118,116,0,69,20,4024
"47093005904",4636,285,47,0,129,0,108,0,5205
"47093005905",1838,219,12,0,77,0,46,21,2213
"47093005906",1742,38,0,0,19,0,26,0,1825
"47093005907",3013,54,166,0,59,0,49,14,3355
"47093005908",4331,600,66,7,74,0,258,21,5357
"47093006001",2035,112,264,0,114,34,46,0,2605
"47093006002",4809,680,31,148,156,0,149,0,5973
"47093006003",3629,463,16,0,158,0,120,0,4386
"47093006102",4592,615,173,0,0,0,0,0,5380
"47093006103",4959,639,40,0,59,41,220,63,6021
"47093006104",4545,761,0,0,38,75,17,259,5695
"47093006202",4682,314,0,9,34,0,67,38,5144
"47093006203",4626,379,62,1,100,0,62,0,5230
"47093006205",3932,342,38,0,63,52,20,65,4512
"47093006206",4610,195,21,7,123,0,0,0,4956
"47093006207",2898,267,43,0,46,0,37,0,3291
"47093006208",4770,679,48,0,316,91,542,0,6446
"47093006301",2861,421,0,0,0,0,6,0,3288
"47093006302",2232,325,8,37,38,0,44,0,2684
"47093006401",3293,530,26,0,208,11,40,0,4108
"47093006402",4106,226,0,0,0,0,27,0,4359
"47093006403",2393,244,59,0,49,0,7,0,2752
"47093006501",2683,186,45,0,74,0,28,0,3016
"47093006502",2399,668,125,0,30,0,0,0,3222
"47093006600",1811,1019,157,221,91,11,64,16,3390
"47093006700",837,407,795,1060,307,0,376,31,3813
"47093006800",762,794,1691,2001,193,58,259,100,5858
"47093006900",1333,3757,310,68,99,281,41,136,6025
"47093007000",763,387,547,628,0,137,64,62,2588
"47093007100",3168,304,26,0,93,189,42,229,4051
"47095960100",1582,483,297,171,13,25,4,34,2609
"47095960200",1540,467,87,78,49,95,54,54,2424
"47097050100",881,352,110,7,0,0,12,13,1375
"47097050200",2232,412,547,419,38,47,51,0,3746
"47097050300",1983,444,293,249,0,0,15,100,3084
"47097050400",2632,318,224,20,147,0,125,24,3490
"47097050503",1553,222,318,72,43,0,31,0,2239
"47097050504",965,588,710,575,178,15,58,0,3089
"47097050505",477,465,1168,1269,130,38,0,0,3547
"47097050506",1029,264,632,300,22,4,13,18,2282
"47097050600",722,158,921,267,18,27,9,15,2137
"47099960100",4119,553,0,4,30,12,21,39,4778
"47099960200",1837,406,20,0,26,0,23,20,2332
"47099960300",3508,3113,0,0,39,37,44,102,6843
"47099960401",3862,499,333,0,188,0,47,0,4929
"47099960402",3249,194,19,0,172,0,5,0,3639
"47099960501",2005,1114,137,153,432,85,362,81,4369
"47099960502",3267,632,41,0,26,39,0,20,4025
"47099960600",1870,391,11,0,75,0,0,0,2347
"47099960700",3221,475,0,29,54,27,17,0,3823
"47099960800",3048,419,0,0,23,0,3,0,3493
"47099960900",1516,252,0,0,0,9,0,0,1777
"47101970100",3862,581,60,0,82,0,130,0,4715
"47101970200",5157,1459,100,16,150,236,87,26,7231
"47103975000",1264,240,77,0,60,19,0,0,1660
"47103975100",1865,306,17,8,66,0,6,0,2268
"47103975200",1784,302,18,0,24,12,52,10,2202
"47103975300",3537,844,665,396,181,336,39,182,6180
"47103975400",2651,562,250,42,94,132,0,21,3752
"47103975500",3791,557,0,0,159,30,6,2,4545
"47103975601",4173,587,122,7,167,214,258,163,5691
"47103975602",3347,535,19,42,187,42,205,13,4390
"47103975700",2890,304,14,0,105,0,60,0,3373
"47105060100",4127,644,20,20,213,4,37,78,5143
"47105060201",3360,397,63,0,95,0,231,0,4146
"47105060202",5128,2295,121,12,412,19,996,717,9700
"47105060301",2900,122,0,39,181,63,132,63,3500
"47105060302",5349,293,28,0,181,0,257,22,6130
"47105060400",4049,395,31,0,123,6,11,0,4615
"47105060501",8287,645,0,0,44,7,42,37,9062
"47105060502",1861,473,17,0,13,17,32,0,2413
"47105060600",3259,956,164,44,73,39,587,477,5599
"47105060700",2398,690,45,5,19,0,88,39,3284
"47107970101",4233,1051,144,26,199,19,101,86,5859
"47107970102",4610,523,36,36,225,57,115,0,5602
"47107970200",3264,1733,220,315,194,164,95,164,6149
"47107970300",2142,396,222,48,231,28,157,0,3224
"47107970401",2856,808,0,0,166,0,148,184,4162
"47107970402",4720,728,97,28,0,0,0,188,5761
"47107970500",2653,948,114,0,109,13,17,29,3883
"47107970600",5055,1543,322,0,189,0,32,181,7322
"47107970700",3157,488,176,105,9,63,12,32,4042
"47107970800",5650,1039,109,34,34,27,174,0,7067
"47109930100",3015,974,0,22,43,2,0,0,4056
"47109930200",1731,464,4,24,59,0,81,29,2392
"47109930300",2269,747,135,25,26,3,17,0,3222
"47109930400",1796,321,3,3,10,0,54,22,2209
"47109930500",4862,1254,689,265,33,141,137,0,7381
"47109930600",3086,505,250,57,74,26,42,35,4075
"47109930700",2159,422,70,18,64,46,18,46,2843
"47111970100",3127,1072,0,0,154,36,418,77,4884
"47111970200",5101,403,0,0,205,0,312,0,6021
"47111970300",6509,1738,0,0,51,194,56,139,8687
"47111970400",2807,764,44,0,90,11,65,30,3811
"47113000100",1085,467,1596,172,5,0,53,275,3653
"47113000200",1532,758,2870,1037,76,0,105,397,6775
"47113000300",2555,519,1440,379,106,188,100,90,5377
"47113000400",569,231,1677,1148,7,0,0,23,3655
"47113000500",212,141,1452,1800,0,68,0,16,3689
"47113000600",679,94,693,449,0,0,46,0,1961
"47113000700",559,200,670,509,56,35,2,9,2040
"47113000800",132,172,201,438,0,41,4,16,1004
"47113000900",96,16,1036,837,0,37,0,0,2022
"47113001000",53,135,1177,598,0,0,0,0,1963
"47113001100",0,5,489,312,0,0,0,0,806
"47113001300",3631,564,859,410,34,83,22,67,5670
"47113001401",839,393,415,96,42,41,0,76,1902
"47113001402",1489,113,415,127,68,0,14,0,2226
"47113001501",2585,133,1637,446,221,0,40,0,5062
"47113001502",5007,483,457,81,49,0,95,15,6187
"47113001603",1744,71,497,142,60,0,114,0,2628
"47113001604",1877,230,491,102,89,0,36,170,2995
"47113001605",912,416,274,51,136,0,8,11,1808
"47113001606",5546,685,2844,610,415,436,391,58,10985
"47113001607",4072,413,848,181,358,0,729,220,6821
"47113001608",1764,113,306,0,15,0,5,4,2207
"47113001609",1392,67,90,172,41,0,0,0,1762
"47113001610",5098,83,471,0,130,0,53,0,5835
"47113001700",669,69,656,139,0,0,0,0,1533
"47113001800",2252,81,475,226,16,8,47,39,3144
"47113001900",3366,459,266,11,10,0,0,0,4112
"47115050101",2884,562,2,0,161,14,52,0,3675
"47115050102",4387,1332,36,0,200,91,64,74,6184
"47115050201",3549,856,20,0,237,3,20,18,4703
"47115050202",4501,574,56,0,158,21,0,0,5310
"47115050301",3474,1242,189,75,202,181,82,123,5568
"47115050302",2385,399,0,0,100,0,1,0,2885
"47117955000",5920,927,49,5,28,0,70,1,7000
"47117955100",4588,435,122,19,150,0,120,120,5554
"47117955200",4266,813,324,23,68,0,30,101,5625
"47117955300",1873,1044,975,267,299,73,337,184,5052
"47117955400",2832,468,153,193,311,46,307,113,4423
"47117955500",3758,643,56,4,45,26,65,71,4668
"47119010100",2392,482,34,0,183,0,9,0,3100
"47119010201",4927,402,259,0,130,0,388,0,6106
"47119010202",7357,183,360,98,409,9,231,28,8675
"47119010301",6013,215,635,0,269,25,207,21,7385
"47119010302",2472,204,168,0,8,6,20,104,2982
"47119010400",4135,783,397,243,271,73,186,177,6265
"47119010500",1491,603,1563,983,59,33,116,25,4873
"47119010600",2532,626,900,261,213,316,306,488,5642
"47119010700",2990,1066,208,346,70,72,179,42,4973
"47119010801",2786,192,125,15,20,7,94,0,3239
"47119010802",3812,1280,597,469,211,132,481,454,7436
"47119010900",2390,323,262,84,54,20,101,0,3234
"47119011001",2181,227,259,22,42,0,26,0,2757
"47119011002",4650,1206,660,228,109,208,110,180,7351
"47119011101",3841,127,192,29,215,111,49,0,4564
"47119011102",2218,358,12,46,28,12,30,128,2832
"47119011200",4665,492,199,0,137,50,116,0,5659
"47121960100",2228,714,0,0,0,0,101,0,3043
"47121960200",3366,757,60,0,24,0,27,10,4244
"47121960300",3179,755,94,0,78,151,25,0,4282
"47123925000",6306,799,158,0,209,25,44,208,7749
"47123925100",6311,1577,0,0,130,0,758,11,8787
"47123925200",3023,757,526,113,141,0,9,0,4569
"47123925300",5984,1432,66,0,82,68,289,103,8024
"47123925400",5797,1953,0,0,74,148,10,260,8242
"47123925501",2294,536,0,0,118,6,0,0,2954
"47123925502",4621,1191,0,0,225,22,29,12,6100
"47125100100",374,347,50,7,13,37,86,12,926
"47125100200",1048,484,158,52,120,40,25,38,1965
"47125100300",3030,1050,974,258,71,53,214,0,5650
"47125100400",822,639,703,689,372,96,172,367,3860
"47125100500",3162,807,652,94,405,71,550,124,5865
"47125100601",1761,181,26,32,95,0,78,36,2209
"47125100602",2263,227,145,26,93,0,138,17,2909
"47125100700",601,104,217,86,26,38,9,0,1081
"47125100800",292,257,539,864,46,23,8,10,2039
"47125100900",733,581,213,255,211,14,109,0,2116
"47125101001",2305,616,535,359,289,101,335,145,4685
"47125101002",1266,461,972,0,556,217,164,67,3703
"47125101101",1567,209,387,384,99,22,231,49,2948
"47125101102",4473,799,1138,805,626,54,630,207,8732
"47125101103",1865,377,319,25,135,72,409,15,3217
"47125101201",794,73,1024,276,237,25,275,37,2741
"47125101202",1965,554,446,134,278,58,245,32,3712
"47125101303",4735,522,3240,443,1397,247,1043,63,11690
"47125101304",2514,613,1442,348,859,30,819,87,6712
"47125101305",1942,284,882,136,449,14,438,12,4157
"47125101306",2854,546,1174,630,758,0,729,0,6691
"47125101307",1019,153,450,832,275,40,184,32,2985
"47125101400",3821,552,319,137,742,101,949,140,6761
"47125101500",5541,294,675,0,458,29,381,29,7407
"47125101600",4165,1177,97,126,29,53,161,163,5971
"47125101700",6871,688,178,6,77,88,137,18,8063
"47125101802",8457,559,427,34,331,53,502,0,10363
"47125101803",5096,1099,396,105,323,58,78,20,7175
"47125101804",5018,461,324,0,605,41,234,18,6701
"47125101902",2141,270,225,10,139,51,181,17,3034
"47125101903",5483,448,1063,193,663,297,470,212,8829
"47125101904",2546,83,332,20,119,78,247,78,3503
"47125102001",3601,380,423,239,358,0,246,60,5307
"47125102002",5467,205,1430,37,835,137,1073,113,9297
"47125102003",3592,332,1041,227,653,171,645,123,6784
"47125102004",2766,439,1354,114,372,8,629,109,5791
"47125102005",3073,198,893,398,323,85,348,83,5401
"47125102006",4285,637,1361,131,603,30,887,195,8129
"47125980100",0,0,0,0,0,0,0,0,0
"47127930100",3259,420,28,17,10,43,0,0,3777
"47127930200",2071,120,121,57,47,11,24,0,2451
"47129110100",1951,757,0,3,23,19,13,1,2767
"47129110200",2466,627,0,2,38,0,4,0,3137
"47129110300",2640,614,0,0,43,2,19,72,3390
"47129110400",3649,695,6,0,0,24,0,11,4385
"47129110500",3423,1441,7,1,37,0,28,0,4937
"47131965000",3195,554,331,139,37,76,0,16,4348
"47131965100",2020,272,72,85,25,0,19,33,2526
"47131965200",2047,207,24,3,45,0,31,0,2357
"47131965300",2802,861,24,5,38,10,50,105,3895
"47131965400",3394,725,22,16,90,39,66,29,4381
"47131965500",1421,565,76,102,8,45,8,29,2254
"47131965600",1383,472,839,721,284,121,260,121,4201
"47131965700",3287,611,419,251,0,89,236,0,4893
"47131965800",1407,163,24,0,15,1,74,0,1684
"47131965900",931,158,50,0,29,18,27,0,1213
"47133950100",1318,674,0,0,11,0,0,0,2003
"47133950200",1469,266,0,0,14,21,24,0,1794
"47133950301",3283,652,83,29,11,71,0,0,4129
"47133950302",2301,762,0,2,30,0,0,151,3246
"47133950400",1577,358,0,0,42,10,0,10,1997
"47133950500",4804,1314,0,0,65,0,11,20,6214
"47133950600",2022,509,0,0,59,0,53,0,2643
"47135930100",2195,737,0,0,39,56,4,35,3066
"47135930200",3330,1083,102,101,68,18,66,61,4829
"47137925100",4164,731,3,28,30,49,9,9,5023
"47139950100",1041,439,0,0,11,5,0,0,1496
"47139950201",1712,464,2,21,7,14,30,23,2273
"47139950202",5047,662,0,0,107,26,15,26,5883
"47139950300",2647,635,6,0,84,0,138,0,3510
"47139950400",2522,718,0,0,98,110,4,41,3493
"47141000100",3616,1422,9,28,24,29,429,422,5979
"47141000200",7329,1175,88,133,44,63,152,0,8984
"47141000301",2279,451,0,1,172,0,33,0,2936
"47141000302",3391,3219,53,262,134,104,150,777,8090
"47141000303",1574,754,17,10,138,0,187,191,2871
"47141000400",2825,642,108,1,248,20,105,0,3949
"47141000500",1385,769,31,29,12,88,123,239,2676
"47141000600",2473,553,0,89,205,33,36,0,3389
"47141000700",1752,1411,26,70,44,45,70,27,3445
"47141000800",1939,1555,109,202,73,186,462,69,4595
"47141000900",4948,1047,95,1,194,1,89,29,6404
"47141001000",2667,514,0,0,68,0,53,0,3302
"47141001100",5053,1164,0,0,97,31,201,67,6613
"47141001200",7402,1438,17,28,264,0,240,0,9389
"47141001300",1752,242,52,0,128,20,25,3,2222
"47143975000",3989,998,58,0,37,64,21,18,5185
"47143975100",3583,688,56,0,8,0,70,0,4405
"47143975200",4628,836,77,0,109,207,138,225,6220
"47143975300",3920,1716,81,12,52,130,11,205,6127
"47143975401",3780,2482,270,86,220,26,269,259,7392
"47143975402",2571,419,38,0,84,0,106,59,3277
"47145030100",2764,110,230,0,94,0,53,0,3251
"47145030201",5321,557,117,0,87,0,167,0,6249
"47145030202",5975,662,102,19,207,0,198,0,7163
"47145030300",4592,1297,71,0,25,53,0,90,6128
"47145030400",5587,597,47,38,53,16,110,0,6448
"47145030500",2182,1618,99,75,92,39,7,0,4112
"47145030600",2768,705,54,15,130,99,37,0,3808
"47145030700",3399,821,65,1,33,254,33,130,4736
"47145030800",3242,1600,302,38,111,66,22,0,5381
"47145030900",4783,848,68,0,108,92,0,0,5899
"47145980100",0,0,0,0,0,0,0,0,0
"47147080101",3414,210,175,13,86,52,33,13,3996
"47147080103",5264,457,63,0,313,194,467,133,6891
"47147080104",6532,392,78,0,145,0,131,0,7278
"47147080200",4194,1161,160,17,300,150,261,191,6434
"47147080301",1415,246,488,244,110,195,186,241,3125
"47147080302",1314,490,404,488,71,44,280,198,3289
"47147080401",1900,611,1091,252,302,166,590,275,5187
"47147080402",3575,195,376,141,273,8,518,23,5109
"47147080500",3515,286,411,6,163,23,127,0,4531
"47147080603",3676,563,22,0,109,20,38,177,4605
"47147080604",3564,160,0,0,89,0,62,0,3875
"47147080605",2749,211,35,10,117,0,24,0,3146
"47147080606",4988,314,197,121,126,39,53,36,5874
"47147080700",6613,466,50,30,97,30,23,0,7309
"47149040101",2580,268,445,0,132,54,670,247,4396
"47149040102",2338,402,755,47,149,41,651,350,4733
"47149040103",4965,190,2534,255,312,271,2552,271,11350
"47149040104",2648,374,1188,85,255,0,422,0,4972
"47149040105",3198,596,596,0,287,36,237,251,5201
"47149040200",2512,323,286,105,337,8,322,0,3893
"47149040302",6811,863,428,0,245,278,398,147,9170
"47149040303",1413,421,147,15,30,67,24,76,2193
"47149040304",1570,205,513,0,22,0,248,0,2558
"47149040305",1396,498,285,45,52,0,150,13,2439
"47149040306",3351,190,632,157,358,52,767,0,5507
"47149040307",2392,30,260,0,280,0,18,13,2993
"47149040308",4877,253,867,0,458,0,551,0,7006
"47149040403",4859,1210,306,373,851,187,720,529,9035
"47149040501",6732,337,386,0,144,0,170,0,7769
"47149040502",5850,523,290,49,140,0,23,0,6875
"47149040600",4192,425,178,9,27,19,0,0,4850
"47149040701",7041,355,781,0,572,216,255,0,9220
"47149040702",4428,251,401,89,103,0,93,5,5370
"47149040805",6326,228,1272,372,823,20,251,93,9385
"47149040806",6361,769,222,0,300,21,289,25,7987
"47149040807",4557,303,349,0,483,24,266,130,6112
"47149040808",5594,304,502,37,618,293,481,0,7829
"47149040809",3690,224,64,9,78,0,196,10,4271
"47149040810",2098,170,45,3,7,12,5,2,2342
"47149040901",2108,188,408,14,89,0,23,0,2830
"47149040902",7749,603,1251,40,486,56,520,37,10742
"47149040903",8785,961,1794,9,443,77,488,160,12717
"47149040904",3327,373,472,0,498,65,7,112,4854
"47149040905",6871,201,1341,13,605,153,102,35,9321
"47149041000",6434,423,453,53,33,79,95,165,7735
"47149041101",6094,309,629,71,216,3,84,48,7454
"47149041102",1999,547,234,44,193,34,29,33,3113
"47149041201",4133,477,432,16,181,0,34,0,5273
"47149041202",3347,123,334,78,323,0,199,0,4404
"47149041301",4398,107,176,0,263,0,17,7,4968
"47149041302",4877,187,493,1,277,0,66,56,5957
"47149041401",2952,661,460,294,239,122,71,213,5012
"47149041402",3700,526,669,819,433,85,731,59,7022
"47149041403",3869,1445,1169,951,438,67,161,87,8187
"47149041500",3,4,18,0,0,0,0,0,25
"47149041600",2944,1275,1213,523,125,361,259,0,6700
"47149041700",3351,689,475,95,376,44,260,46,5336
"47149041800",1607,755,327,336,240,222,104,218,3809
"47149041900",1224,736,1055,629,208,173,412,204,4641
"47149042000",3508,185,610,200,149,142,151,0,4945
"47149042100",4304,1937,655,448,1030,360,553,477,9764
"47149042200",3175,1065,407,206,461,173,464,544,6495
"47149042300",5146,650,1007,19,579,12,432,172,8017
"47151975000",2810,935,0,0,98,47,5,11,3906
"47151975100",5002,1634,0,0,43,0,0,0,6679
"47151975200",3938,2181,3,0,50,57,88,0,6317
"47151975300",1616,541,0,0,12,16,0,22,2207
"47151975400",2111,484,0,1,0,7,0,30,2633
"47153060101",6192,1111,15,0,735,150,357,0,8560
"47153060102",1523,514,0,0,131,71,0,65,2304
"47153060200",3118,410,0,0,279,79,52,15,3953
"47155080101",2823,915,22,0,49,0,97,0,3906
"47155080102",4797,1021,24,0,321,123,50,35,6371
"47155080201",7139,420,19,0,238,26,240,0,8082
"47155080202",4745,514,0,54,76,24,94,162,5669
"47155080300",4385,640,31,0,105,0,0,0,5161
"47155080400",6357,953,151,0,0,39,76,102,7678
"47155080500",3380,841,0,2,138,384,101,387,5233
"47155080601",3153,769,0,49,212,132,331,319,4965
"47155080602",8143,1507,1,1,76,9,420,1,10158
"47155080700",6415,865,0,0,362,118,164,78,8002
"47155080801",1327,722,56,15,164,261,363,480,3388
"47155080802",5479,776,8,0,665,45,496,255,7724
"47155080901",3284,316,0,0,9,0,0,0,3609
"47155080902",4015,930,15,0,174,17,339,0,5490
"47155081000",4474,837,61,0,504,31,380,0,6287
"47155081101",1355,299,11,10,23,14,10,0,1722
"47155081102",3407,449,0,0,127,0,28,0,4011
"47155980100",0,0,0,0,0,0,0,0,0
"47157000100",3279,779,1026,233,896,94,300,0,6607
"47157000200",4,0,476,390,0,23,0,0,893
"47157000300",0,0,595,288,10,0,0,0,893
"47157000400",4,46,1043,760,16,13,0,0,1882
"47157000600",0,0,1035,837,21,0,0,0,1893
"47157000700",124,19,2715,2022,68,0,0,0,4948
"47157000800",8,16,1040,1089,0,0,0,0,2153
"47157000900",55,0,1231,1102,19,0,0,0,2407
"47157001100",853,530,483,615,527,61,604,333,4006
"47157001200",1643,636,697,173,172,176,288,228,4013
"47157001300",390,280,1112,1162,101,519,53,353,3970
"47157001400",88,50,960,438,18,10,32,33,1629
"47157001500",134,60,645,491,36,22,50,0,1438
"47157001600",1427,146,284,37,63,86,47,0,2090
"47157001700",1438,97,1968,289,85,11,41,0,3929
"47157001900",0,3,929,419,0,0,0,0,1351
"47157002000",56,51,878,813,60,0,0,12,1870
"47157002100",111,46,594,496,9,29,5,0,1290
"47157002400",64,130,1128,839,217,64,148,172,2762
"47157002500",957,347,828,493,317,54,44,208,3248
"47157002600",1932,236,142,22,263,47,100,6,2748
"47157002700",685,349,367,561,117,5,13,192,2289
"47157002800",437,77,1492,1710,0,8,24,0,3748
"47157002900",4064,468,113,28,92,61,73,0,4899
"47157003000",1511,218,1021,470,115,30,0,30,3395
"47157003100",2303,264,315,149,71,51,64,51,3268
"47157003200",1803,444,362,128,96,62,135,44,3074
"47157003300",2119,262,0,10,101,0,68,36,2596
"47157003400",1296,389,334,148,71,13,86,8,2345
"47157003500",2348,150,570,108,145,37,65,0,3423
"47157003600",677,481,285,184,148,56,197,103,2131
"47157003700",214,105,448,426,9,28,8,19,1257
"47157003800",152,72,316,274,229,18,0,0,1061
"47157003900",56,77,524,631,82,0,42,0,1412
"47157004200",1616,169,554,37,152,83,90,55,2756
"47157004300",919,85,243,20,106,28,27,0,1428
"47157004500",22,8,239,230,13,4,0,0,516
"47157004600",100,89,750,445,12,15,0,0,1411
"47157005000",6,6,422,674,31,0,0,0,1139
"47157005300",18,17,2185,1280,0,0,0,11,3511
"47157005500",7,54,862,861,0,19,0,31,1834
"47157005600",0,0,2778,913,44,0,0,0,3735
"47157005700",30,0,1683,607,9,10,0,0,2339
"47157005800",0,0,463,608,0,10,0,0,1081
"47157005900",0,18,1197,1058,80,10,31,0,2394
"47157006000",9,62,1288,721,22,29,9,18,2158
"47157006200",79,55,1438,540,11,0,0,17,2140
"47157006300",1540,190,536,265,36,0,52,0,2619
"47157006400",49,50,997,543,99,42,0,0,1780
"47157006500",84,8,1309,1275,0,8,0,0,2684
"47157006600",1063,227,337,347,109,0,24,0,2107
"47157006700",35,37,1307,1753,12,0,12,0,3156
"47157006800",14,7,971,1280,63,4,50,0,2389
"47157006900",71,20,1773,1162,7,40,0,0,3073
"47157007000",867,280,1445,834,37,132,142,95,3832
"47157007100",1563,79,456,265,40,14,39,0,2456
"47157007200",2018,240,91,25,96,0,46,9,2525
"47157007300",1067,537,226,284,119,49,0,0,2282
"47157007400",1439,466,334,86,197,284,27,6,2839
"47157007500",5,1,718,438,0,0,0,0,1162
"47157007810",33,110,1208,813,84,0,84,13,2345
"47157007821",12,38,2867,2623,4,17,12,0,5573
"47157007822",56,9,796,527,41,87,67,96,1679
"47157007900",167,0,3691,2080,0,75,0,0,6013
"47157008000",1107,76,2156,1845,116,88,34,26,5448
"47157008110",168,143,1185,912,198,223,129,345,3303
"47157008120",71,125,2811,1426,22,34,11,83,4583
"47157008200",176,353,1391,2095,860,676,763,635,6949
"47157008500",4150,124,34,0,150,19,9,0,4486
"47157008600",4639,315,314,468,405,33,316,54,6544
"47157008700",2680,394,281,60,434,409,472,414,5144
"47157008800",2359,2485,667,798,934,515,1868,2168,11794
"47157008900",881,951,937,545,311,447,588,1042,5702
"47157009100",1635,625,55,0,209,400,690,737,4351
"47157009200",6037,612,76,46,655,51,0,126,7603
"47157009300",3056,483,252,538,264,30,245,54,4922
"47157009400",2623,325,609,0,73,14,97,0,3741
"47157009500",5623,411,297,0,92,10,147,0,6580
"47157009600",4444,321,164,8,219,17,113,12,5298
"47157009700",817,227,1177,297,109,101,91,36,2855
"47157009800",2054,613,557,161,179,170,317,303,4354
"47157009901",606,207,854,926,458,256,298,158,3763
"47157009902",201,166,984,1178,87,89,115,0,2820
"47157010000",416,410,4175,2174,0,163,0,95,7433
"47157010110",318,41,2895,4349,333,0,0,0,7936
"47157010120",295,143,2001,2117,0,51,97,111,4815
"47157010210",211,65,3133,1983,68,125,0,0,5585
"47157010220",617,94,3581,2197,5,50,60,70,6674
"47157010300",4,5,756,691,35,6,0,0,1497
"47157010500",171,42,608,284,68,95,82,82,1432
"47157010610",602,75,4339,1443,541,226,569,299,8094
"47157010620",164,100,1822,989,235,147,253,231,3941
"47157010630",258,145,1777,1145,195,969,454,1114,6057
"47157010710",825,145,2781,631,181,392,355,321,5631
"47157010720",208,58,1980,1270,189,104,172,139,4120
"47157010810",323,28,3605,1332,502,645,261,533,7229
"47157010820",488,10,2952,684,223,312,129,203,5001
"47157011010",771,343,2250,789,58,295,112,441,5059
"47157011020",83,10,665,354,84,71,56,30,1353
"47157011100",31,9,1022,781,0,0,39,0,1882
"47157011200",0,4,730,905,5,9,0,0,1653
"47157011300",196,68,483,593,36,16,7,0,1399
"47157011400",316,242,756,1632,4,93,13,0,3056
"47157011500",43,0,1462,842,6,0,0,0,2353
"47157011600",0,46,1523,895,8,66,0,56,2594
"47157011700",0,0,853,595,0,0,0,0,1448
"47157011800",2172,589,1473,918,532,285,910,761,7640
"47157020101",1209,239,1441,1299,108,0,98,24,4418
"47157020102",2407,118,349,90,33,0,33,0,3030
"47157020210",3297,340,1315,460,205,39,171,3,5830
"47157020221",1657,181,1006,64,31,110,103,155,3307
"47157020222",1354,108,978,509,279,137,177,160,3702
"47157020300",2992,735,592,688,131,117,68,292,5615
"47157020400",629,7,353,5,169,5,80,0,1248
"47157020511",276,65,1466,233,95,27,41,23,2226
"47157020512",813,219,2358,2032,0,3,27,41,5493
"47157020521",193,189,1810,1550,48,81,0,41,3912
"47157020523",148,49,1695,1087,88,213,65,34,3379
"47157020524",440,98,2852,1210,79,0,85,112,4876
"47157020531",1061,518,3268,541,385,257,647,434,7111
"47157020532",1003,194,3189,543,199,111,135,87,5461
"47157020541",1076,120,3283,916,128,0,62,0,5585
"47157020542",537,68,2545,1690,288,0,91,0,5219
"47157020610",1019,158,1886,280,145,29,110,0,3627
"47157020621",2021,198,3979,681,64,38,97,0,7078
"47157020622",2935,271,656,34,140,10,72,0,4118
"47157020632",4124,125,648,22,422,8,205,0,5554
"47157020633",2818,52,198,6,136,14,37,3,3264
"47157020634",2629,46,49,1,203,59,61,0,3048
"47157020635",2312,297,180,0,67,0,72,5,2933
"47157020642",5563,106,2501,288,627,0,114,0,9199
"47157020643",5624,226,1735,109,649,0,410,36,8789
"47157020644",3027,185,3956,422,1011,61,1230,54,9946
"47157020651",3643,673,2400,378,541,19,436,0,8090
"47157020652",4382,241,613,0,60,0,36,0,5332
"47157020700",1823,128,390,11,32,0,8,0,2392
"47157020810",2416,38,588,223,0,6,0,0,3271
"47157020820",6821,425,977,0,321,56,328,0,8928
"47157020831",3254,139,337,112,266,0,74,0,4182
"47157020832",6049,37,1747,56,817,0,353,0,9059
"47157020900",7554,115,934,27,892,50,537,50,10159
"47157021010",7120,175,6978,673,1942,79,1263,110,18340
"47157021020",4309,132,1167,283,574,18,372,35,6890
"47157021111",1865,233,1215,456,227,116,413,182,4707
"47157021112",3236,942,1416,436,877,108,1280,632,8927
"47157021113",1934,142,1033,195,370,60,351,0,4085
"47157021121",2240,160,2402,331,64,11,40,28,5276
"47157021122",2120,382,1907,434,428,13,35,166,5485
"47157021124",3142,324,3589,685,916,0,867,0,9523
"47157021125",2902,108,591,427,200,13,193,0,4434
"47157021126",2141,170,1443,36,536,7,156,0,4489
"47157021135",3415,173,2175,717,320,39,18,0,6857
"47157021136",2709,61,1672,336,411,0,92,0,5281
"47157021137",4296,443,1560,50,891,57,477,0,7774
"47157021138",2042,125,910,62,217,23,104,53,3536
"47157021139",2843,111,695,11,340,171,214,0,4385
"47157021140",3417,85,1078,19,402,186,211,53,5451
"47157021141",3931,125,2755,368,583,26,344,4,8136
"47157021142",1830,161,1731,5,63,41,149,50,4030
"47157021200",0,0,0,0,0,0,0,0,0
"47157021311",3661,47,545,0,214,0,91,22,4580
"47157021312",1769,106,156,0,132,20,37,0,2220
"47157021320",4140,84,1084,118,120,54,41,0,5641
"47157021331",1961,168,478,230,227,14,231,0,3309
"47157021333",1713,10,1342,398,346,12,93,47,3961
"47157021334",1085,50,1984,412,174,0,90,0,3795
"47157021341",4270,265,471,16,340,0,74,0,5436
"47157021342",4867,75,3302,470,778,116,372,89,10069
"47157021351",3069,134,272,17,849,0,154,0,4495
"47157021352",5910,94,127,0,356,0,10,0,6497
"47157021353",7819,742,449,0,832,0,216,402,10460
"47157021410",2443,76,72,0,123,0,10,21,2745
"47157021420",2776,119,52,0,245,15,114,0,3321
"47157021430",3676,31,38,52,166,0,63,0,4026
"47157021510",1815,108,5203,590,505,8,118,0,8347
"47157021520",5690,340,2938,52,2019,237,319,33,11628
"47157021530",4350,171,167,0,457,0,27,0,5172
"47157021540",9993,61,502,18,1666,0,376,0,12616
"47157021611",5794,139,246,316,165,46,39,0,6745
"47157021612",4583,62,105,4,229,0,106,0,5089
"47157021613",4123,30,155,0,467,0,43,0,4818
"47157021620",1096,64,1517,292,100,0,23,0,3092
"47157021710",159,144,1748,742,48,0,55,121,3017
"47157021721",132,159,2362,2005,295,394,163,294,5804
"47157021724",140,73,1436,430,328,9,376,57,2849
"47157021725",245,13,3404,508,259,312,306,312,5359
"47157021726",726,206,2167,1367,57,218,40,96,4877
"47157021731",108,22,1214,657,317,653,240,606,3817
"47157021732",365,90,3957,1918,240,195,323,255,7343
"47157021741",590,11,4653,2594,243,580,484,490,9645
"47157021744",716,42,4591,355,303,32,329,32,6400
"47157021745",1028,0,6019,353,589,0,532,0,8521
"47157021746",406,12,3236,648,265,0,203,0,4770
"47157021747",266,51,2509,433,232,77,122,77,3767
"47157021751",338,0,5617,754,126,10,20,10,6875
"47157021752",346,191,3618,272,258,0,292,14,4991
"47157021753",217,137,2391,167,560,0,473,0,3945
"47157021754",602,21,2889,529,185,166,242,0,4634
"47157021900",54,63,3638,1473,0,0,0,34,5262
"47157022022",32,176,1955,1182,10,25,4,171,3555
"47157022023",0,0,1288,423,9,0,0,0,1720
"47157022024",137,30,2682,561,18,0,0,0,3428
"47157022111",87,11,3086,1771,51,0,67,0,5073
"47157022112",40,104,4037,2249,0,0,0,0,6430
"47157022121",269,10,3671,1038,7,0,38,0,5033
"47157022122",35,22,2958,1030,23,0,0,0,4068
"47157022130",189,13,3659,1482,116,24,0,0,5483
"47157022210",38,8,2745,1579,119,41,0,0,4530
"47157022220",113,7,2523,740,20,31,50,0,3484
"47157022310",52,0,3102,2561,11,0,21,0,5747
"47157022321",0,23,2707,645,0,0,0,23,3398
"47157022322",50,32,2798,1017,0,0,0,0,3897
"47157022330",96,128,3504,831,76,134,170,262,5201
"47157022410",535,31,4918,897,261,0,183,0,6825
"47157022500",315,795,3532,635,220,161,322,937,6917
"47157022600",408,36,2337,702,392,581,505,581,5542
"47157022700",78,8,5086,1794,96,132,0,0,7194
"47157980100",14,24,0,26,0,0,0,0,64
"47157980200",0,0,0,0,0,0,0,0,0
"47157980300",0,0,0,0,0,0,0,0,0
"47157980400",0,0,0,0,0,0,0,0,0
"47159975000",3142,578,23,0,9,1,43,78,3874
"47159975100",1720,417,100,68,44,14,13,0,2376
"47159975200",4887,965,166,0,264,7,299,6,6594
"47159975300",1471,230,0,0,0,5,0,0,1706
"47159975400",3855,737,36,0,32,44,36,0,4740
"47161110200",4371,778,108,1,171,146,39,77,5691
"47161110600",2183,545,10,58,36,22,39,0,2893
"47161110700",3547,870,0,23,164,117,28,133,4882
"47161980100",0,0,0,0,0,0,0,0,0
"47161980200",0,0,0,0,0,0,0,0,0
"47163040200",1206,679,425,192,56,54,23,22,2657
"47163040300",1881,494,43,59,9,4,0,2,2492
"47163040500",2366,1479,163,65,33,288,0,183,4577
"47163040600",1858,1257,83,81,148,0,107,74,3608
"47163040700",1968,396,57,8,16,63,8,27,2543
"47163040800",1909,862,36,6,279,26,161,197,3476
"47163040900",2592,472,23,7,134,33,12,48,3321
"47163041000",3880,205,26,0,43,48,0,53,4255
"47163041100",1900,280,10,36,43,48,0,27,2344
"47163041200",5543,646,100,0,181,21,160,21,6672
"47163041300",3513,532,11,8,56,27,25,0,4172
"47163041400",4018,498,0,4,250,0,27,0,4797
"47163041500",2599,61,17,0,57,0,18,21,2773
"47163041600",2272,283,60,0,42,38,41,0,2736
"47163041700",2500,785,79,0,158,22,0,21,3565
"47163041800",3163,1119,2,70,290,383,57,40,5124
"47163041900",2829,363,0,0,46,0,0,0,3238
"47163042000",2684,519,0,0,26,69,0,0,3298
"47163042100",4281,908,3,1,287,110,44,7,5641
"47163042200",2731,607,30,0,60,7,66,137,3638
"47163042300",5723,371,81,0,114,0,32,0,6321
"47163042400",2247,623,0,0,116,29,0,0,3015
"47163042500",2794,438,13,12,56,0,33,0,3346
"47163042600",3137,474,126,26,291,79,237,72,4442
"47163042701",3327,1044,136,23,35,67,26,65,4723
"47163042702",1914,343,16,3,29,19,17,19,2360
"47163042801",2454,137,62,0,91,0,67,0,2811
"47163042802",2609,991,178,122,19,35,0,47,4001
"47163042900",3711,275,33,3,44,0,49,1,4116
"47163043000",3488,908,46,2,129,11,0,0,4584
"47163043100",2351,547,23,16,29,24,0,22,3012
"47163043201",4172,266,0,11,51,0,0,0,4500
"47163043202",4552,510,0,0,14,0,35,0,5111
"47163043301",4766,369,18,0,64,0,18,0,5235
"47163043302",4671,1382,43,3,77,52,8,0,6236
"47163043401",3796,1340,0,2,52,16,0,0,5206
"47163043402",3103,799,52,0,42,0,0,0,3996
"47163043500",3273,535,9,0,61,4,74,4,3960
"47163043600",3941,706,25,6,69,78,35,1,4861
"47165020101",3039,685,0,0,0,12,0,0,3736
"47165020102",3823,711,0,0,33,0,23,0,4590
"47165020203",2214,212,22,0,0,17,141,0,2606
"47165020204",2890,197,0,0,31,14,0,0,3132
"47165020205",2575,279,266,12,275,11,250,92,3760
"47165020206",909,116,0,0,23,8,96,4,1156
"47165020207",1387,153,13,0,26,4,19,0,1602
"47165020208",1868,380,19,0,34,44,9,23,2377
"47165020209",1656,165,0,0,53,9,0,0,1883
"47165020300",3856,1041,27,68,86,25,119,143,5365
"47165020403",1536,171,3,91,12,0,0,0,1813
"47165020404",1752,213,0,0,0,49,0,57,2071
"47165020405",1642,227,12,16,66,0,42,0,2005
"47165020406",3312,264,0,0,37,12,36,120,3781
"47165020407",3821,144,29,0,209,19,177,9,4408
"47165020501",4527,288,100,0,183,0,106,0,5204
"47165020502",3657,70,192,0,82,0,29,0,4030
"47165020503",1613,208,21,0,5,0,27,111,1985
"47165020601",2733,194,75,0,55,10,16,0,3083
"47165020602",4011,110,81,4,75,25,0,24,4330
"47165020603",3165,372,61,5,74,0,74,0,3751
"47165020700",2663,597,227,156,12,196,131,219,4201
"47165020800",2913,781,2507,703,185,65,857,149,8160
"47165020901",1279,113,164,5,22,13,100,15,1711
"47165020902",4768,750,723,70,589,166,794,106,7966
"47165020903",2799,336,155,130,376,0,258,31,4085
"47165021002",6053,99,513,387,85,206,166,0,7509
"47165021004",3356,177,222,0,175,97,89,97,4213
"47165021005",5286,518,296,43,366,18,90,18,6635
"47165021006",2837,82,42,0,19,0,30,0,3010
"47165021007",2172,151,221,0,206,0,97,0,2847
"47165021008",3558,140,115,0,261,0,110,39,4223
"47165021009",4024,456,232,0,391,6,246,35,5390
"47165021103",4879,215,514,20,86,0,368,0,6082
"47165021104",1764,46,140,0,206,0,169,0,2325
"47165021105",5083,219,567,0,491,166,203,183,6912
"47165021106",2969,149,825,27,179,0,157,1,4307
"47165021107",3861,304,158,2,85,40,36,2,4488
"47165021201",6335,117,544,0,180,0,97,0,7273
"47165021203",5281,170,119,0,229,0,315,0,6114
"47165021204",6271,637,395,113,423,194,109,0,8142
"47165021205",2337,109,35,0,70,0,4,0,2555
"47167040100",3732,794,495,125,36,18,0,118,5318
"47167040200",1670,359,41,0,9,9,138,16,2242
"47167040302",7598,273,667,91,709,138,318,0,9794
"47167040303",5369,148,591,147,359,0,38,0,6652
"47167040304",4626,755,374,79,176,73,135,0,6218
"47167040400",2633,461,0,0,3,0,36,18,3151
"47167040500",5481,592,638,106,213,0,288,0,7318
"47167040601",2076,467,1557,696,88,7,43,0,4934
"47167040602",2384,247,581,10,111,13,178,59,3583
"47167040700",1642,427,1239,1064,61,75,41,0,4549
"47167040800",3353,274,309,43,55,39,22,6,4101
"47167040900",1102,126,463,103,4,0,4,0,1802
"47167041000",918,197,1067,330,27,6,43,9,2597
"47169090100",3756,789,321,0,0,82,22,0,4970
"47169090200",1819,339,461,135,87,0,0,0,2841
"47171080100",1964,626,4,5,18,5,15,13,2650
"47171080200",4489,1607,54,0,116,10,174,164,6614
"47171080300",4127,854,23,0,101,61,7,83,5256
"47171080400",2750,740,23,7,19,59,0,312,3910
"47173040100",5373,1159,2,31,73,8,58,13,6717
"47173040201",2915,703,9,36,38,19,77,27,3824
"47173040202",4169,1566,0,0,0,24,44,0,5803
"47173040300",2055,459,0,0,78,31,32,12,2667
"47175925000",1983,474,0,0,15,2,25,22,2521
"47175925200",2419,464,21,0,69,48,17,0,3038
"47177930100",2823,539,13,12,125,94,131,103,3840
"47177930200",5131,946,21,21,218,77,269,386,7069
"47177930300",2219,214,49,3,40,2,21,3,2551
"47177930400",4235,1524,0,0,441,302,679,136,7317
"47177930500",2736,906,92,58,275,104,158,228,4557
"47177930600",2455,991,86,6,74,127,118,195,4052
"47177930700",3998,766,28,0,222,53,358,161,5586
"47177930800",4416,1225,20,57,190,45,104,125,6182
"47177930900",1019,180,0,2,111,75,102,69,1558
"47179060100",1464,1044,491,110,86,13,37,146,3391
"47179060400",5149,222,177,15,502,0,115,39,6219
"47179060501",3093,1085,209,0,97,20,66,10,4580
"47179060502",4341,1031,142,21,129,49,229,137,6079
"47179060600",4234,2079,213,15,86,168,175,60,7030
"47179060700",0,0,0,0,0,0,0,0,0
"47179060800",1769,1152,19,60,223,98,51,0,3372
"47179060900",3191,1725,353,846,177,97,0,24,6413
"47179061000",1050,821,162,123,103,121,148,109,2637
"47179061100",3537,954,136,0,40,0,107,0,4774
"47179061200",2347,510,94,72,68,83,39,0,3213
"47179061300",6127,603,252,193,610,89,165,0,8039
"47179061401",4418,1035,17,0,139,0,452,0,6061
"47179061402",5628,658,3,4,273,15,23,0,6604
"47179061500",6779,772,1,0,18,19,194,1,7784
"47179061601",3741,222,1,12,15,0,217,0,4208
"47179061602",8518,420,0,0,108,0,74,0,9120
"47179061701",5114,445,125,6,211,66,93,124,6184
"47179061702",5741,854,36,0,202,18,129,0,6980
"47179061800",4821,1333,17,0,202,0,56,0,6429
"47179061901",5310,932,1,0,126,123,41,160,6693
"47179061902",4015,484,0,0,15,0,78,154,4746
"47179062000",2364,831,336,95,70,79,160,157,4092
"47181950100",2016,409,6,74,8,29,3,0,2545
"47181950200",4031,1179,40,29,87,16,10,82,5474
"47181950300",3247,620,2,0,21,27,34,29,3980
"47181950400",2010,806,41,0,21,22,45,0,2945
"47183968000",888,213,0,0,5,5,2,0,1113
"47183968101",1973,523,414,445,29,21,7,8,3420
"47183968102",1713,62,0,74,7,44,86,0,1986
"47183968201",3707,402,396,32,102,0,85,0,4724
"47183968202",58,319,0,86,23,0,18,1,505
"47183968203",1283,889,230,221,112,42,44,28,2849
"47183968300",1806,323,126,21,61,6,2,3,2348
"47183968400",4410,681,227,0,62,116,101,116,5713
"47183968500",3562,750,24,54,105,19,84,31,4629
"47183968600",2946,506,94,76,14,41,35,27,3739
"47183968700",1274,104,0,0,8,0,19,12,1417
"47185935000",3171,651,0,0,0,0,23,0,3845
"47185935100",4717,867,0,0,72,0,51,45,5752
"47185935200",2935,916,0,9,30,0,12,0,3902
"47185935300",4161,508,0,40,331,0,379,0,5419
"47185935400",2455,883,175,139,57,58,2,0,3769
"47185935500",2417,923,0,0,68,17,23,0,3448
"47187050101",6433,169,792,121,969,0,239,0,8723
"47187050102",3449,121,328,0,273,0,0,0,4171
"47187050103",3902,149,108,11,72,0,81,0,4323
"47187050203",4900,69,146,0,258,71,129,0,5573
"47187050204",4778,75,84,0,454,22,138,0,5551
"47187050205",3451,98,36,0,170,0,116,31,3902
"47187050206",2789,20,53,0,156,0,19,0,3037
"47187050207",3026,100,155,103,446,10,173,0,4013
"47187050208",5736,71,67,0,1305,23,328,0,7530
"47187050303",2658,35,27,0,91,0,58,0,2869
"47187050304",1707,50,0,11,114,0,0,0,1882
"47187050305",2284,20,76,0,270,0,134,0,2784
"47187050306",1604,45,118,0,254,0,16,0,2037
"47187050307",2665,198,113,0,326,0,64,0,3366
"47187050403",1712,54,17,0,101,0,0,0,1884
"47187050404",6086,458,95,0,270,0,83,0,6992
"47187050405",2343,124,0,0,107,0,9,0,2583
"47187050406",5334,116,120,10,126,14,63,0,5783
"47187050502",3525,289,20,0,60,11,102,0,4007
"47187050503",4353,333,143,0,274,0,197,19,5319
"47187050504",3387,263,0,0,153,0,85,39,3927
"47187050601",4721,484,491,57,138,0,437,306,6634
"47187050602",7845,452,512,187,478,39,188,124,9825
"47187050701",4047,154,75,0,265,0,103,0,4644
"47187050702",3867,149,46,0,45,37,129,36,4309
"47187050800",3536,1055,600,253,226,98,619,593,6980
"47187050904",3753,305,840,64,468,52,862,279,6623
"47187050905",4403,273,456,0,676,0,65,0,5873
"47187050906",5178,20,244,83,54,0,16,0,5595
"47187050907",4534,280,97,0,411,0,298,37,5657
"47187050908",3585,11,41,0,79,0,80,0,3796
"47187050909",3482,50,88,0,65,0,73,0,3758
"47187051001",5760,372,275,0,523,10,270,0,7210
"47187051002",5387,472,115,0,428,0,427,0,6829
"47187051100",6006,337,201,15,150,0,27,157,6893
"47187051201",5513,750,36,0,0,0,151,0,6450
"47187051202",21856,560,1155,7,829,164,1351,378,26300
"47189030101",6913,577,208,0,243,117,193,117,8368
"47189030102",5361,532,387,15,94,30,21,0,6440
"47189030202",6387,144,1,26,241,2,14,2,6817
"47189030203",4359,167,306,26,146,0,10,0,5014
"47189030204",6089,281,88,2,345,0,255,0,7060
"47189030303",4056,97,82,6,206,1,114,1,4563
"47189030304",5680,239,110,238,217,34,189,18,6725
"47189030305",5074,180,326,34,101,0,252,0,5967
"47189030307",6330,324,288,58,411,13,398,0,7822
"47189030308",4208,104,260,106,312,7,200,0,5197
"47189030309",4429,313,319,37,420,74,96,25,5713
"47189030401",1706,188,130,176,94,21,127,5,2447
"47189030402",2396,582,515,219,933,150,938,258,5991
"47189030500",3959,796,588,345,58,145,62,87,6040
"47189030600",2580,400,265,30,33,205,31,195,3739
"47189030700",1194,316,594,702,8,0,33,72,2919
"47189030800",4409,1142,222,43,110,86,139,0,6151
"47189030901",8559,912,477,231,348,0,285,0,10812
"47189030903",6902,291,355,0,291,25,80,0,7944
"47189030904",2907,267,89,0,116,19,19,0,3417
"47189031000",4328,895,65,83,262,79,50,77,5839
"48001950100",3355,696,368,45,227,33,190,252,5166
"48001950401",208,16,7,87,3,23,26,23,393
"48001950402",110,22,39,0,0,11,0,11,193
"48001950500",2283,866,430,508,318,94,1145,301,5945
"48001950600",3598,598,1425,501,365,71,825,379,7762
"48001950700",1105,241,378,411,140,163,710,255,3403
"48001950800",2812,329,815,376,436,103,216,148,5235
"48001950901",3503,574,173,117,256,44,439,215,5321
"48001950902",3743,717,314,119,60,7,211,169,5340
"48001951000",5908,670,133,100,95,39,339,225,7509
"48001951100",3377,656,484,19,41,18,210,331,5136
"48003950100",1932,84,26,0,118,0,476,77,2713
"48003950200",5620,717,130,77,253,125,3031,715,10668
"48003950300",3460,633,28,0,278,112,2463,468,7442
"48003950400",2625,233,58,0,18,51,1459,121,4565
"48005000101",4610,940,109,61,299,0,549,34,6602
"48005000102",3814,412,109,40,373,53,799,200,5800
"48005000200",4120,1297,617,127,292,135,737,540,7865
"48005000301",3795,536,325,150,29,12,346,241,5434
"48005000302",3349,546,369,152,120,122,755,240,5653
"48005000400",2440,671,507,1262,48,33,820,473,6254
"48005000500",632,409,1710,788,31,21,234,187,4012
"48005000600",3367,821,1336,430,403,154,2443,849,9803
"48005000700",1635,785,459,577,332,250,1502,972,6512
"48005000800",3949,752,972,128,200,174,399,500,7074
"48005000901",4715,566,969,110,247,91,302,427,7427
"48005000902",1999,223,103,119,520,0,362,31,3357
"48005001001",2325,892,404,182,667,78,1697,475,6720
"48005001002",3718,339,114,23,207,51,853,207,5512
"48005001100",5035,659,277,36,113,10,123,144,6397
"48005001200",2322,296,31,14,196,82,160,0,3101
"48005001300",4244,703,57,0,75,185,163,185,5612
"48007950100",4206,802,34,4,462,42,599,97,6246
"48007950200",1032,28,0,0,61,0,100,0,1221
"48007950300",5053,814,173,0,777,79,1414,603,8913
"48007950400",2273,1075,33,127,220,140,972,610,5450
"48007950500",4415,1374,20,0,491,24,1355,417,8096
"48007990000",0,0,0,0,0,0,0,0,0
"48009020100",2557,166,3,3,91,15,44,4,2883
"48009020200",2217,203,18,15,56,31,145,66,2751
"48009020300",2704,332,28,19,145,78,379,64,3749
"48011950100",1559,130,20,0,169,0,220,0,2098
"48013960100",5370,1255,39,35,444,103,2486,1130,10862
"48013960201",5692,779,40,0,511,47,3916,535,11520
"48013960202",7343,1527,151,0,702,155,5819,1275,16972
"48013960300",2555,921,0,0,277,43,2599,862,7257
"48013960401",1271,522,0,0,226,47,1121,490,3677
"48013960402",6213,931,84,0,431,65,3119,806,11649
"48013960500",2125,555,19,0,81,45,1538,564,4927
"48013960600",4937,548,0,0,309,41,2420,499,8754
"48015760100",1708,162,353,1,188,55,628,89,3184
"48015760200",3747,693,598,212,432,233,1594,610,8119
"48015760300",6012,188,297,69,525,19,2161,34,9305
"48015760400",2753,247,43,155,11,59,89,162,3519
"48015760501",4064,237,114,4,133,30,659,94,5335
"48015760502",3712,766,492,159,124,0,627,494,6374
"48017950100",4701,1237,107,7,827,75,3316,875,11145
"48019000101",4017,402,0,0,58,11,757,108,5353
"48019000102",4047,490,0,0,224,0,511,233,5505
"48019000200",2192,323,0,274,7,0,290,35,3121
"48019000300",4880,500,4,0,344,297,1050,282,7357
"48019000400",1923,359,0,0,90,6,245,59,2682
"48021950100",6621,897,132,20,604,301,1797,699,11071
"48021950200",4141,1332,734,439,1213,18,2521,1291,11689
"48021950300",9633,1057,2023,0,1293,185,2635,402,17228
"48021950400",5963,661,590,168,349,14,952,514,9211
"48021950501",4937,1076,108,0,702,7,2359,763,9952
"48021950502",4862,641,193,0,75,50,757,369,6947
"48021950600",4096,597,241,46,224,68,671,198,6141
"48021950700",2845,300,501,205,387,20,421,120,4799
"48021950801",4190,1156,48,0,1636,108,4134,1197,12469
"48021950802",5149,730,92,0,236,568,2656,1070,10501
"48023950300",2946,364,55,9,131,50,304,12,3871
"48025950100",1517,226,10,1,79,13,581,42,2469
"48025950201",826,168,20,3,0,12,298,144,1471
"48025950202",4028,636,64,0,86,316,1838,789,7757
"48025950300",3716,922,37,60,231,20,2192,622,7800
"48025950400",1815,193,29,34,123,67,1360,179,3800
"48025950500",4039,1503,62,26,954,598,3936,2013,13131
"48025950600",1717,354,62,9,169,113,1127,267,3818
"48027020100",5342,607,45,6,250,14,966,136,7366
"48027020201",6570,340,321,0,292,26,539,103,8191
"48027020202",5133,552,42,13,187,32,799,159,6917
"48027020300",6891,246,850,0,875,165,2120,63,11210
"48027020401",1535,222,759,59,145,152,365,158,3395
"48027020402",1608,72,244,162,45,29,642,54,2856
"48027020500",2371,781,484,20,165,147,1018,639,5625
"48027020600",1922,516,395,32,72,31,281,194,3443
"48027020701",721,393,81,174,26,22,318,251,1986
"48027020702",858,498,187,198,141,122,684,412,3100
"48027020800",972,981,1028,848,67,119,588,782,5385
"48027020900",1037,316,435,308,54,74,610,129,2963
"48027021000",2398,748,450,183,358,124,1124,578,5963
"48027021100",3702,856,460,322,295,19,1421,501,7576
"48027021201",1472,171,441,65,499,28,409,12,3097
"48027021202",2699,467,342,213,375,51,659,201,5007
"48027021203",3015,504,190,39,158,64,510,97,4577
"48027021301",3708,134,492,164,231,13,687,22,5451
"48027021302",2792,122,288,0,176,0,157,36,3571
"48027021303",4186,550,555,500,615,356,817,248,7827
"48027021400",3195,455,21,19,158,17,423,206,4494
"48027021500",4406,787,671,83,364,60,1739,393,8503
"48027021601",3591,927,433,92,222,68,1856,799,7988
"48027021602",832,232,120,23,61,14,418,94,1794
"48027021700",6213,1251,132,0,754,84,1024,106,9564
"48027021800",4350,1233,652,147,924,334,1119,499,9258
"48027021901",2077,302,341,219,477,143,579,172,4310
"48027021903",4995,447,1502,0,1975,50,1436,296,10701
"48027021904",6653,1201,497,464,631,295,1177,698,11616
"48027022000",3989,870,1420,819,667,144,1041,836,9786
"48027022101",2067,402,830,197,437,450,734,159,5276
"48027022103",2169,180,1325,403,858,80,1067,134,6216
"48027022104",1167,330,974,520,532,240,574,161,4498
"48027022105",975,259,350,179,324,56,302,51,2496
"48027022200",918,324,1256,432,216,52,315,254,3767
"48027022300",1431,430,1117,204,398,448,542,446,5016
"48027022401",2275,634,2302,342,638,351,1018,636,8196
"48027022402",2550,151,2048,195,1378,290,1349,298,8259
"48027022403",2221,11,1189,154,441,96,602,155,4869
"48027022404",3386,212,3174,27,1429,82,1805,225,10340
"48027022405",834,309,411,47,271,84,352,287,2595
"48027022501",1513,324,432,0,526,71,406,154,3426
"48027022502",3896,468,3458,122,1825,64,1738,141,11712
"48027022600",1519,554,569,337,777,141,1201,294,5392
"48027022801",804,327,469,282,194,259,340,372,3047
"48027022900",1261,567,605,439,623,311,988,420,5214
"48027023000",4356,620,1881,173,1296,250,2108,233,10917
"48027023103",1694,263,1111,557,794,56,743,108,5326
"48027023104",1349,200,1302,381,492,129,482,355,4690
"48027023105",5562,97,4040,208,1329,287,2089,169,13781
"48027023106",4767,413,2977,304,1937,35,1817,278,12528
"48027023107",2400,301,2269,781,1089,149,1780,68,8837
"48027023108",5068,233,3288,1475,3971,308,4134,305,18782
"48027023201",1392,94,351,9,271,38,377,10,2542
"48027023202",2234,305,919,194,601,91,1262,255,5861
"48027023203",1623,132,520,0,420,27,812,51,3585
"48027023204",1088,201,328,0,115,47,322,91,2192
"48027023300",5791,618,872,28,704,387,1071,232,9703
"48027023402",3843,500,56,32,160,6,706,191,5494
"48027023403",4902,183,142,0,180,27,656,27,6117
"48027023404",2719,280,43,0,104,49,513,191,3899
"48027023500",446,388,299,335,337,165,388,376,2734
"48027980001",0,0,0,0,0,0,0,0,0
"48027980002",0,0,0,0,0,0,0,0,0
"48027980003",0,0,0,0,0,0,0,0,0
"48029110100",1603,601,35,68,408,50,1238,509,4512
"48029110300",1320,471,195,213,457,100,1468,496,4720
"48029110500",578,1081,8,22,63,250,637,1253,3892
"48029110600",1170,1139,25,29,135,140,1232,1248,5118
"48029110700",1121,351,24,38,117,22,1085,344,3102
"48029110800",997,356,28,3,160,52,896,314,2806
"48029110900",835,230,20,14,111,4,497,164,1875
"48029111000",1162,318,74,65,234,152,1157,404,3566
"48029120100",2490,174,703,15,677,115,849,100,5123
"48029120300",6315,240,105,4,704,158,1469,139,9134
"48029120400",5577,87,0,0,164,1,846,13,6688
"48029120501",5570,636,1020,297,954,201,4587,653,13918
"48029120502",2934,1100,340,436,215,346,2059,1219,8649
"48029120600",4039,935,169,33,498,106,1029,237,7046
"48029120701",3536,634,91,133,424,217,2347,639,8021
"48029120702",3269,443,178,0,588,91,948,126,5643
"48029120800",6219,151,20,4,172,22,1393,25,8006
"48029120901",1370,399,95,84,107,95,384,204,2738
"48029120902",4469,378,820,186,736,295,2198,428,9510
"48029121000",5314,1032,332,143,436,83,2209,686,10235
"48029121108",5878,491,178,111,542,165,2119,346,9830
"48029121110",4343,188,92,10,751,18,2149,27,7578
"48029121111",5227,575,120,337,342,29,2662,412,9704
"48029121112",2726,596,216,8,348,18,1104,391,5407
"48029121115",4515,250,173,36,268,49,1435,126,6852
"48029121116",3848,774,171,0,576,131,1580,481,7561
"48029121117",3351,221,187,60,508,16,1537,95,5975
"48029121118",4748,227,496,4,676,0,1880,148,8179
"48029121119",4253,516,142,69,290,2,1614,166,7052
"48029121120",4800,144,203,0,338,19,2384,58,7946
"48029121121",2631,71,195,0,259,0,1002,2,4160
"48029121122",4538,138,197,54,487,13,1879,57,7363
"48029121203",2395,716,322,86,402,159,1944,643,6667
"48029121204",4406,796,1328,194,462,48,2029,661,9924
"48029121205",2582,1091,310,298,202,46,1629,874,7032
"48029121206",6731,443,524,222,296,40,3862,375,12493
"48029121300",4448,388,779,18,522,0,1803,346,8304
"48029121402",3163,513,1090,128,1062,186,3216,687,10045
"48029121403",2694,651,728,515,992,143,2298,372,8393
"48029121404",2409,558,699,425,638,104,2307,467,7607
"48029121501",5067,416,1636,16,1512,24,3012,138,11821
"48029121504",4958,567,991,60,834,141,2724,515,10790
"48029121505",2860,303,858,34,929,118,1663,78,6843
"48029121506",3027,434,461,271,335,207,2062,448,7245
"48029121507",2849,223,632,163,560,71,1557,106,6161
"48029121508",1922,573,1018,385,488,305,1343,556,6590
"48029121601",3458,574,455,72,380,86,1832,430,7287
"48029121604",5462,393,917,190,1421,0,2926,229,11538
"48029121605",1471,289,15,87,287,37,538,297,3021
"48029121606",3374,478,415,359,459,0,1068,142,6295
"48029121701",2970,294,132,62,242,219,1141,275,5335
"48029121702",4806,675,564,28,1020,107,2082,136,9418
"48029121802",5855,1055,387,195,962,172,3378,948,12952
"48029121803",3321,190,321,171,605,13,2188,166,6975
"48029121804",4641,1094,382,444,730,114,2430,939,10774
"48029121808",2704,298,177,10,367,0,1575,173,5304
"48029121809",3909,521,271,1,350,96,1800,368,7316
"48029121810",3657,220,432,69,268,126,1997,138,6907
"48029121811",4531,70,245,17,209,18,2095,68,7253
"48029121812",4693,555,321,2,581,2,2277,357,8788
"48029121813",1197,100,40,0,49,16,498,58,1958
"48029121903",4950,102,106,0,354,0,1091,29,6632
"48029121904",2653,60,70,341,525,0,941,0,4590
"48029121905",4343,94,328,0,1135,56,1412,12,7380
"48029121906",4575,203,214,0,560,0,1632,28,7212
"48029121907",8848,167,653,11,1175,0,4163,118,15135
"48029121908",2136,116,87,0,372,54,792,84,3641
"48029121909",3598,301,791,12,979,221,1978,367,8247
"48029121910",3357,69,588,38,788,0,1516,107,6463
"48029130200",543,259,355,220,281,611,749,839,3857
"48029130300",1774,729,290,96,465,241,2139,947,6681
"48029130401",1741,1184,439,40,410,256,2003,1368,7441
"48029130402",1729,861,438,726,517,162,2245,907,7585
"48029130500",955,1134,721,941,722,427,1558,1426,7884
"48029130600",786,1005,983,853,233,516,949,1348,6673
"48029130700",992,549,379,99,161,74,988,514,3756
"48029130800",1129,956,2058,953,383,161,1391,1049,8080
"48029130900",1600,366,1093,868,332,172,1611,494,6536
"48029131000",1006,993,1789,733,505,113,1223,1064,7426
"48029131100",402,408,942,144,292,51,679,448,3366
"48029131200",1396,338,631,457,136,61,1233,206,4458
"48029131300",2447,706,1306,476,465,1,2084,668,8153
"48029131401",4155,1387,909,37,1334,462,3662,1659,13605
"48029131402",1266,304,607,51,381,178,1326,436,4549
"48029131503",2237,128,324,143,832,66,1584,42,5356
"48029131504",1630,356,512,118,937,30,1353,325,5261
"48029131505",2184,119,961,184,649,81,2000,98,6276
"48029131506",1506,225,588,151,675,208,1477,334,5164
"48029131507",2291,673,717,403,1756,1036,3214,1548,11638
"48029131601",1894,528,362,4,494,27,959,217,4485
"48029131606",2600,170,1130,48,1296,83,2050,63,7440
"48029131608",2341,388,1496,336,1134,69,2037,420,8221
"48029131609",3554,483,2352,198,1733,363,3248,621,12552
"48029131610",2185,138,1340,294,1246,79,1934,47,7263
"48029131611",436,76,366,41,275,25,274,82,1575
"48029131612",675,293,580,0,429,9,687,276,2949
"48029131613",1728,215,1180,88,830,466,1181,584,6272
"48029131614",1974,116,1255,125,661,0,1327,124,5582
"48029131615",3534,455,1747,42,1084,298,2731,438,10329
"48029131700",791,22,144,1,95,12,93,6,1164
"48029131801",2114,98,2,0,288,14,436,46,2998
"48029131802",3690,250,250,109,924,13,1880,202,7318
"48029140100",708,283,14,13,678,91,1244,324,3355
"48029140200",1834,466,43,0,259,35,1768,372,4777
"48029140300",1749,760,116,0,433,165,2047,871,6141
"48029140400",2880,521,19,10,400,123,2961,548,7462
"48029140500",2579,465,128,12,658,135,2739,573,7289
"48029140600",1532,487,84,77,425,65,1903,517,5090
"48029140700",2819,897,91,86,956,251,3198,817,9115
"48029140800",3320,1251,48,7,703,281,3604,1491,10705
"48029140900",1246,425,7,0,258,88,1239,491,3754
"48029141000",1677,1198,56,66,372,350,1907,1435,7061
"48029141101",2258,739,254,180,407,222,2222,806,7088
"48029141102",1816,565,158,102,552,122,1665,498,5478
"48029141200",3308,1795,285,196,1007,386,3716,2049,12742
"48029141300",3938,636,533,98,985,113,3495,661,10459
"48029141402",1982,348,184,0,952,190,2580,394,6630
"48029141403",2546,472,141,9,1005,44,2570,475,7262
"48029141404",3351,592,93,269,830,183,3380,701,9399
"48029141600",3476,247,24,0,823,324,3889,425,9208
"48029141700",3589,578,98,8,825,32,3202,271,8603
"48029141800",2564,483,0,1,466,729,1816,968,7027
"48029141900",4185,407,223,14,798,32,1923,186,7768
"48029150100",2704,1250,0,0,765,534,3129,1750,10132
"48029150300",2573,1538,17,14,311,807,2672,2159,10091
"48029150400",2070,1182,0,1,457,153,2494,1092,7449
"48029150501",2549,1429,16,0,643,288,3164,1699,9788
"48029150502",2467,864,12,3,904,205,3294,1065,8814
"48029150600",2596,1191,0,0,612,427,3120,1490,9436
"48029150700",3711,1332,0,36,687,303,3951,1505,11525
"48029150800",894,1570,0,320,287,335,950,1809,6165
"48029150900",3307,939,0,31,1075,647,4050,1463,11512
"48029151000",1861,851,0,0,370,354,2139,1120,6695
"48029151100",4880,774,0,16,788,538,5373,1253,13622
"48029151200",5495,2057,118,0,1655,326,6956,2195,18802
"48029151301",3777,1001,38,0,778,280,4395,1239,11508
"48029151302",2114,441,26,0,495,67,2388,461,5992
"48029151400",2691,1108,0,54,675,274,3187,1235,9224
"48029151500",1892,371,0,7,335,63,1923,417,5008
"48029151600",4546,1326,10,12,1061,412,4573,1665,13605
"48029151700",4581,789,0,29,1169,437,5007,1122,13134
"48029151900",3384,739,46,1,1314,550,4456,1215,11705
"48029152000",1084,451,185,47,296,256,1274,589,4182
"48029152100",2779,737,23,11,660,272,2658,737,7877
"48029152201",4368,1784,167,0,1191,112,4397,1668,13687
"48029152202",3500,402,175,55,380,221,3200,469,8402
"48029160100",2608,2623,10,0,771,405,3373,2976,12766
"48029160200",1898,263,10,0,220,135,1952,386,4864
"48029160300",3471,974,0,0,612,497,3771,1431,10756
"48029160400",2827,778,36,54,400,350,3143,1121,8709
"48029160501",1472,1856,27,184,85,245,1462,2097,7428
"48029160502",2955,581,0,0,467,143,3389,722,8257
"48029160600",2456,2033,0,0,373,188,2782,2206,10038
"48029160701",2100,889,0,0,200,198,2268,1012,6667
"48029160702",2495,1295,11,44,757,412,3032,1651,9697
"48029160901",1703,892,0,5,297,195,1870,1031,5993
"48029160902",2840,1167,0,0,561,284,3321,1450,9623
"48029161000",1782,1380,44,1,340,166,2031,1451,7195
"48029161100",7037,790,10,0,1989,160,8721,947,19654
"48029161200",1987,662,67,0,251,184,1895,746,5792
"48029161302",3662,1521,153,0,448,153,3758,1621,11316
"48029161303",2804,1295,0,20,605,294,3147,1589,9754
"48029161304",2147,1513,16,0,68,395,2160,1775,8074
"48029161400",923,195,251,17,217,4,287,0,1894
"48029161501",5401,1231,151,57,1036,261,5135,1419,14691
"48029161503",1927,969,218,0,703,84,2078,1011,6990
"48029161504",3078,660,174,73,305,300,3093,966,8649
"48029161600",2886,912,102,175,494,69,2835,865,8338
"48029161801",3252,510,131,0,36,30,2621,318,6898
"48029161802",4921,1696,253,84,619,17,4558,1495,13643
"48029161901",897,124,0,0,67,5,675,103,1871
"48029161902",6117,1123,71,0,445,24,4958,735,13473
"48029162001",1551,292,23,2,247,46,1296,308,3765
"48029162003",3777,836,19,44,393,121,3162,880,9232
"48029162004",1944,780,10,12,477,52,1765,712,5752
"48029170101",2290,1264,0,15,202,362,2440,1626,8199
"48029170102",2405,575,28,3,435,356,2851,904,7557
"48029170200",2640,1693,0,19,833,453,3436,2130,11204
"48029170300",2740,1787,0,160,804,596,3520,2466,12073
"48029170401",1491,1850,160,124,452,166,1859,1927,8029
"48029170402",2402,1141,6,29,751,126,3071,1266,8792
"48029170500",3017,493,6,20,892,394,3665,771,9258
"48029170600",3319,987,41,33,140,53,3201,948,8722
"48029170700",2799,1796,21,1,268,186,2841,1947,9859
"48029170800",781,483,0,5,66,47,821,521,2724
"48029170900",1964,835,0,24,139,343,2049,1137,6491
"48029171000",2957,1932,12,0,781,334,3445,2259,11720
"48029171100",2120,970,6,0,391,70,2472,1004,7033
"48029171200",2773,1131,50,0,547,157,3127,1282,9067
"48029171301",1859,595,14,0,298,150,2076,688,5680
"48029171302",2324,847,7,21,214,117,2414,719,6663
"48029171401",2657,1533,53,49,221,208,2726,1730,9177
"48029171402",3447,1366,0,2,733,216,3962,1530,11256
"48029171501",1197,851,160,123,172,138,1269,938,4848
"48029171502",2851,1465,253,42,347,14,2969,1452,9393
"48029171601",3259,900,49,10,241,150,3314,955,8878
"48029171602",1495,1171,129,45,106,102,1508,1203,5759
"48029171700",4276,2005,449,117,560,444,3647,2354,13852
"48029171801",4141,1222,93,0,536,222,3892,1303,11409
"48029171802",3146,2141,269,435,213,119,2907,2086,11316
"48029171902",7289,1297,1175,996,1190,496,7127,1445,21015
"48029171903",5090,1449,170,139,503,218,4771,1191,13531
"48029171912",4666,322,693,0,813,6,3677,280,10457
"48029171913",2949,1187,565,171,393,278,2650,1401,9594
"48029171914",3830,779,267,174,535,50,3171,650,9456
"48029171915",1699,196,191,13,202,1,1216,149,3667
"48029171916",4470,558,650,35,1516,521,4189,793,12732
"48029171917",6148,404,1823,187,1369,51,4850,207,15039
"48029171918",4800,191,237,0,896,48,3264,151,9587
"48029171919",2702,656,479,39,252,0,2371,647,7146
"48029171920",5984,1521,663,0,684,0,5456,1424,15732
"48029171921",3365,542,229,88,855,162,3186,514,8941
"48029171922",2763,130,87,0,429,0,2540,130,6079
"48029171923",7404,659,991,22,1143,41,5466,502,16228
"48029171924",3751,391,695,59,619,18,2173,163,7869
"48029171925",6092,575,645,3,2041,300,4671,568,14895
"48029172002",8645,115,463,395,1027,108,6011,168,16932
"48029172003",3978,224,719,0,1013,67,2572,276,8849
"48029172004",2842,222,326,8,522,31,1148,176,5275
"48029172005",4404,563,269,20,1367,6,2622,516,9767
"48029172006",5986,192,562,133,856,4,3072,116,10921
"48029172007",8086,333,775,0,1317,42,4482,332,15367
"48029180101",3514,825,12,93,556,0,3467,698,9165
"48029180102",1273,308,8,9,276,37,1105,310,3326
"48029180201",2337,812,114,52,790,412,2586,1073,8176
"48029180202",3257,1008,166,114,271,62,2932,548,8358
"48029180300",2348,1432,24,32,343,112,2387,1506,8184
"48029180400",2634,1491,27,131,79,126,2443,1429,8360
"48029180501",2785,1242,234,175,256,59,2736,1157,8644
"48029180503",3261,927,129,10,275,38,3234,876,8750
"48029180504",2855,1499,39,225,164,0,2822,1453,9057
"48029180602",2218,273,30,83,36,380,1713,540,5273
"48029180603",1236,627,55,0,72,35,850,633,3508
"48029180604",3814,1454,192,18,775,108,3376,1120,10857
"48029180701",2278,465,265,95,240,127,1303,258,5031
"48029180702",4776,1185,708,337,225,69,3284,791,11375
"48029180800",1096,444,89,56,487,177,1303,467,4119
"48029180901",3206,1005,55,44,1149,35,3414,803,9711
"48029180902",4456,807,0,0,1776,380,5175,1104,13698
"48029181001",2873,902,52,109,237,29,1991,894,7087
"48029181003",3617,951,626,316,464,272,2469,351,9066
"48029181004",3385,830,254,143,627,46,2150,554,7989
"48029181005",2216,903,266,165,196,273,1527,708,6254
"48029181100",4114,817,190,125,559,326,2484,913,9528
"48029181200",3742,577,112,0,137,11,1393,427,6399
"48029181301",3251,371,240,0,589,90,2108,380,7029
"48029181302",4169,748,381,157,532,282,2652,760,9681
"48029181303",1103,1070,164,74,427,816,705,613,4972
"48029181402",850,609,129,220,107,187,445,248,2795
"48029181403",4434,537,839,87,1195,87,3239,340,10758
"48029181404",2165,506,382,120,1935,72,1134,182,6496
"48029181503",4773,1122,541,74,161,172,2557,764,10164
"48029181504",4012,636,575,24,609,96,2730,290,8972
"48029181505",4300,199,24,25,219,19,2770,78,7634
"48029181506",3359,238,184,26,313,119,2427,210,6876
"48029181601",2280,382,62,40,341,57,2115,351,5628
"48029181602",4422,943,152,173,351,272,4102,1189,11604
"48029181703",5202,806,356,14,726,126,2607,675,10512
"48029181704",4258,948,190,0,576,72,3356,867,10267
"48029181705",3873,269,410,106,772,96,3022,138,8686
"48029181711",5701,714,419,2,1499,61,4396,468,13260
"48029181712",2767,180,209,0,571,79,1945,151,5902
"48029181713",4904,809,534,40,1141,475,3972,907,12782
"48029181715",4591,561,357,0,568,124,3665,403,10269
"48029181716",4397,825,466,14,1925,248,4937,812,13624
"48029181718",4779,247,183,16,396,184,2526,237,8568
"48029181720",4002,52,393,0,598,26,2376,35,7482
"48029181721",2906,360,100,28,492,53,2286,325,6550
"48029181722",3635,141,301,37,733,69,2448,173,7537
"48029181723",3016,362,683,33,1045,42,2663,235,8079
"48029181724",4601,67,214,0,673,39,2509,81,8184
"48029181725",3161,453,697,313,730,50,2871,398,8673
"48029181726",7608,458,480,0,1348,141,5225,480,15740
"48029181727",2695,396,221,84,239,15,2103,310,6063
"48029181728",7991,551,891,64,1473,210,6186,703,18069
"48029181729",3964,257,448,7,867,0,2582,264,8389
"48029181730",3076,161,413,0,416,34,2435,169,6704
"48029181731",5512,150,182,19,1404,124,4104,203,11698
"48029181808",839,443,84,62,76,0,342,304,2150
"48029181809",3591,1048,370,62,923,191,2724,933,9842
"48029181811",2937,249,52,0,789,45,1703,149,5924
"48029181813",3925,1194,647,0,925,181,2738,879,10489
"48029181814",2953,669,173,12,513,42,1691,443,6496
"48029181815",2653,270,183,0,791,22,1515,65,5499
"48029181816",3776,253,196,26,357,0,2083,200,6891
"48029181817",2683,219,262,0,246,0,1896,170,5476
"48029181818",4152,807,588,0,314,0,2241,667,8769
"48029181819",3411,675,221,103,1847,97,3150,398,9902
"48029181820",1411,1264,219,362,220,779,700,1012,5967
"48029181821",2559,141,102,86,629,40,1542,40,5139
"48029181822",4076,288,300,0,453,24,2533,173,7847
"48029181823",1449,492,161,93,377,304,809,410,4095
"48029181824",3771,455,205,183,696,243,1959,542,8054
"48029181825",2432,231,147,0,579,75,1390,145,4999
"48029181826",5131,431,334,2,1046,2,2879,86,9911
"48029181901",1775,1126,144,212,648,252,1031,631,5819
"48029181902",5509,373,125,22,633,78,1593,128,8461
"48029182001",4053,161,70,162,970,124,1796,49,7385
"48029182002",7577,140,352,32,1384,2,2999,2,12488
"48029182003",2916,129,175,19,839,51,1189,41,5359
"48029182101",6688,148,13,36,712,0,1719,51,9367
"48029182102",6387,200,287,46,621,11,2394,94,10040
"48029182103",2295,44,17,41,62,0,855,9,3323
"48029182105",2111,36,43,0,188,7,907,36,3328
"48029182106",5004,130,182,0,1112,17,2472,74,8991
"48029190100",1800,631,65,21,481,202,1912,589,5701
"48029190200",2620,893,2,0,388,38,1194,691,5826
"48029190400",1719,147,11,0,149,84,647,51,2808
"48029190501",2027,132,19,0,735,132,2500,246,5791
"48029190503",2645,665,28,22,244,33,2174,372,6183
"48029190504",1789,459,0,21,557,75,1883,469,5253
"48029190601",2653,454,0,2,722,244,3230,676,7981
"48029190603",1697,704,53,0,481,0,1912,581,5428
"48029190604",2234,820,0,0,531,723,2501,1428,8237
"48029190700",1849,584,59,62,294,75,1370,550,4843
"48029190800",1843,22,24,71,30,0,356,0,2346
"48029190901",3787,1263,313,17,525,126,3004,910,9945
"48029190902",3146,347,81,59,146,111,2179,249,6318
"48029191003",4351,1318,244,149,1607,495,4714,1491,14369
"48029191004",2229,1078,28,108,568,201,2185,1106,7503
"48029191005",1866,372,0,0,264,35,1890,352,4779
"48029191006",3229,935,212,0,1381,521,4427,1370,12075
"48029191101",1496,71,1,0,80,17,512,52,2229
"48029191102",2203,263,25,0,131,0,1065,121,3808
"48029191201",2443,519,0,5,40,31,1166,353,4557
"48029191202",3813,506,119,95,384,0,2359,355,7631
"48029191303",1386,104,41,0,48,6,667,31,2283
"48029191304",1616,408,157,27,150,91,992,406,3847
"48029191405",6333,618,239,1,544,103,2479,393,10710
"48029191406",6105,230,0,0,979,54,1639,67,9074
"48029191408",1710,437,163,8,477,209,1366,426,4796
"48029191409",4285,796,284,103,1180,266,3519,957,11390
"48029191410",3926,588,416,66,557,156,2414,431,8554
"48029191411",3479,255,186,0,388,0,1411,59,5778
"48029191412",2162,6,6,0,188,0,450,6,2818
"48029191413",4772,571,153,0,516,27,1590,510,8139
"48029191503",4044,311,107,32,539,34,1627,90,6784
"48029191504",2007,129,0,0,324,4,673,0,3137
"48029191505",1985,68,0,0,145,0,595,55,2848
"48029191506",4316,617,41,3,559,12,2071,422,8041
"48029191701",1300,23,0,0,211,0,264,5,1803
"48029191702",6648,238,372,47,317,16,1779,105,9522
"48029191804",6076,25,114,31,483,0,1660,0,8389
"48029191806",6890,159,377,0,881,45,2032,135,10519
"48029191807",3585,290,136,26,385,47,1581,189,6239
"48029191808",3573,21,188,0,198,9,915,9,4913
"48029191809",5317,730,152,57,606,28,1955,662,9507
"48029191810",4139,70,284,0,946,0,1422,24,6885
"48029191811",3663,120,282,0,790,31,1231,40,6157
"48029191812",3913,133,223,0,587,0,1309,117,6282
"48029191813",5167,474,342,0,711,0,1780,388,8862
"48029191814",3514,351,49,0,664,0,1564,314,6456
"48029191815",4150,175,236,0,914,0,1682,112,7269
"48029191816",2638,33,14,0,322,0,959,0,3966
"48029191817",9320,499,364,0,1594,0,3554,377,15708
"48029191900",2162,1234,654,175,433,410,2226,1461,8755
"48029192000",2638,982,102,36,276,122,1224,768,6148
"48029192100",2269,356,78,16,90,70,1236,368,4483
"48029192200",796,108,56,0,314,153,786,143,2356
"48029192300",3978,193,86,26,110,14,1542,112,6061
"48029980001",0,0,0,0,0,0,0,0,0
"48029980002",22,0,0,0,0,0,22,0,44
"48029980003",601,11,75,5,60,0,138,16,906
"48029980004",0,0,0,0,0,0,0,0,0
"48029980005",12,0,0,0,14,0,4,0,30
"48029980100",126,0,0,12,37,5,55,5,240
"48031950100",4148,400,59,0,139,5,675,104,5530
"48031950200",4813,453,4,0,452,96,1103,141,7062
"48033950100",667,10,0,0,25,0,62,0,764
"48035950100",3299,741,0,0,123,43,649,199,5054
"48035950200",1089,351,65,11,30,56,256,145,2003
"48035950300",1307,242,0,0,25,0,31,41,1646
"48035950400",2942,153,0,0,107,0,256,30,3488
"48035950500",2112,289,92,2,72,195,574,209,3545
"48035950600",1504,126,0,0,13,0,178,9,1830
"48035950700",2145,257,15,58,89,25,385,26,3000
"48037010100",2470,306,979,1167,378,0,295,0,5595
"48037010400",1038,349,1368,1289,38,153,78,62,4375
"48037010500",310,249,956,632,37,26,128,45,2383
"48037010600",194,69,939,408,30,26,77,0,1743
"48037010700",2104,197,1089,888,327,106,448,88,5247
"48037010800",1422,390,1538,998,482,76,417,314,5637
"48037010901",5725,448,482,38,243,0,41,4,6981
"48037010902",5212,611,885,170,656,87,688,290,8599
"48037011000",4443,802,1353,766,169,10,289,99,7931
"48037011100",3349,432,1122,399,154,0,96,1,5553
"48037011200",5513,264,152,6,200,27,309,17,6488
"48037011300",3898,715,221,321,316,72,301,234,6078
"48037011401",6145,867,520,264,320,23,231,0,8370
"48037011402",1545,389,67,12,89,9,13,6,2130
"48037011501",3703,538,136,92,348,11,83,12,4923
"48037011502",1445,744,478,317,114,0,15,55,3168
"48037011600",3523,345,619,181,158,22,160,80,5088
"48037011700",1815,378,0,0,108,4,45,39,2389
"48039660100",4107,60,163,14,381,38,749,21,5533
"48039660200",4345,349,427,0,656,0,976,13,6766
"48039660300",8546,165,1005,84,715,130,2818,100,13563
"48039660400",6955,585,690,61,1295,282,2070,480,12418
"48039660500",6496,935,731,0,1166,35,2694,455,12512
"48039660601",6472,120,2378,183,2979,123,1739,0,13994
"48039660602",13473,1467,9097,318,8842,288,6553,1119,41157
"48039660701",8612,169,3533,234,2930,0,2098,0,17576
"48039660702",6516,1117,2797,587,3059,188,1477,918,16659
"48039660801",6647,38,1122,18,1242,472,3041,416,12996
"48039660802",5153,64,918,221,1216,79,2012,104,9767
"48039660900",4827,1251,100,0,596,178,2539,1074,10565
"48039661000",5502,829,15,0,138,11,2123,735,9353
"48039661100",2405,509,119,36,150,53,955,367,4594
"48039661200",3080,758,49,16,286,7,1105,193,5494
"48039661300",1904,633,60,18,51,25,869,307,3867
"48039661400",5731,895,118,0,242,0,1986,641,9613
"48039661501",4541,440,133,2,186,42,1667,214,7225
"48039661502",3674,378,145,0,174,62,810,146,5389
"48039661601",4836,833,133,165,321,0,1973,272,8533
"48039661602",2311,461,36,0,11,66,890,404,4179
"48039661700",2162,181,82,0,23,20,614,25,3107
"48039661800",3841,312,322,24,1375,318,1947,186,8325
"48039661900",5004,884,1028,257,670,94,3028,775,11740
"48039662000",4556,726,203,181,187,161,740,533,7287
"48039662100",3538,568,773,223,533,59,1685,274,7653
"48039662200",3959,527,478,32,384,0,1256,451,7087
"48039662300",3276,313,581,261,222,246,485,291,5675
"48039662400",4607,384,171,13,332,8,1038,94,6647
"48039662500",1819,112,347,0,129,15,601,99,3122
"48039662600",2679,267,435,31,79,51,410,101,4053
"48039662700",1720,372,167,26,250,13,420,52,3020
"48039662800",4124,488,242,701,106,58,421,176,6316
"48039662900",3855,429,198,155,299,103,995,227,6261
"48039663000",2192,316,320,31,8,0,413,124,3404
"48039663100",4624,205,131,16,276,33,1175,0,6460
"48039663200",4040,239,187,11,453,14,1139,93,6176
"48039663300",1629,314,75,0,123,15,547,53,2756
"48039663400",5289,279,486,191,661,568,1330,651,9455
"48039663500",4299,352,451,125,816,47,1809,108,8007
"48039663600",4617,102,165,0,351,0,793,38,6066
"48039663700",2545,382,282,176,136,10,878,243,4652
"48039663800",4149,641,770,152,138,156,1990,384,8380
"48039663900",1310,179,93,75,121,174,876,234,3062
"48039664000",2737,720,383,99,134,20,1707,575,6375
"48039664100",3880,854,362,30,375,185,1912,756,8354
"48039664200",1505,369,46,0,94,7,265,143,2429
"48039664300",2963,1726,388,467,132,33,2337,1302,9348
"48039664400",4169,811,451,71,655,69,3204,453,9883
"48039664501",3929,591,317,163,102,39,1124,221,6486
"48039990000",0,0,0,0,0,0,0,0,0
"48041000101",5299,545,697,74,868,127,1634,31,9275
"48041000102",4913,226,145,11,504,21,288,17,6125
"48041000103",1646,14,49,0,75,23,87,23,1917
"48041000201",3489,1010,362,891,595,246,1198,427,8218
"48041000202",4087,847,397,186,522,485,2170,794,9488
"48041000300",4098,404,1378,337,1273,305,3569,640,12004
"48041000400",1698,595,1103,460,273,91,747,424,5391
"48041000500",1111,771,1405,940,487,517,1450,1151,7832
"48041000603",1778,648,430,368,1037,515,2486,898,8160
"48041000604",1713,1011,408,521,1112,1137,2363,1985,10250
"48041000700",1609,265,240,172,603,100,1495,209,4693
"48041000800",3652,325,223,15,314,69,1209,204,6011
"48041000900",1030,473,286,119,636,171,1202,566,4483
"48041001000",2612,2436,279,601,1067,1336,1581,1198,11110
"48041001100",2931,515,283,1,733,143,1190,173,5969
"48041001301",1297,1060,121,20,135,110,142,208,3093
"48041001302",1997,1344,163,0,255,254,349,324,4686
"48041001303",1589,1813,463,100,772,507,740,199,6183
"48041001400",441,768,27,132,404,334,158,254,2518
"48041001601",1497,1503,255,433,555,523,532,105,5403
"48041001604",1956,1905,155,31,672,500,391,197,5807
"48041001605",988,1078,601,313,365,380,349,411,4485
"48041001606",1566,984,15,78,241,313,530,162,3889
"48041001701",1505,2323,248,123,660,378,518,558,6313
"48041001702",954,1255,311,545,102,123,253,243,3786
"48041001801",3701,252,477,47,139,70,755,28,5469
"48041001803",3280,1689,250,41,817,449,486,368,7380
"48041001804",627,138,179,0,183,20,281,28,1456
"48041001900",4690,306,387,153,207,59,362,59,6223
"48041002001",4099,402,85,9,352,0,512,90,5549
"48041002002",5143,573,468,0,565,68,526,129,7472
"48041002006",862,199,8,8,594,0,39,78,1788
"48041002007",5112,1073,558,0,492,58,584,40,7917
"48041002008",5787,197,512,3,763,7,737,32,8038
"48041002009",3851,89,0,3,465,4,268,22,4702
"48041002010",2309,138,41,0,340,12,418,42,3300
"48041002011",3185,220,38,12,64,0,547,63,4129
"48041002012",1668,4349,61,202,160,429,79,870,7818
"48041002013",4136,1681,157,6,74,26,1093,170,7343
"48041002014",792,713,35,141,36,64,83,117,1981
"48041002015",0,0,0,0,0,0,0,0,0
"48041980000",0,0,0,0,0,0,0,0,0
"48043950300",3545,342,55,35,85,81,1187,236,5566
"48043950400",1608,320,0,0,109,10,1397,283,3727
"48043950500",2315,431,0,0,198,19,704,186,3853
"48045950200",1224,258,28,44,93,5,349,195,2196
"48047950100",795,459,0,0,270,12,964,455,2955
"48047950200",2536,2006,0,5,558,244,2885,2071,10305
"48049950100",1815,176,0,0,42,38,146,20,2237
"48049950200",3620,383,39,0,59,36,409,10,4556
"48049950300",2669,583,0,12,32,10,282,107,3695
"48049950500",2458,210,117,32,31,0,434,37,3319
"48049950600",1572,699,22,127,73,80,647,362,3582
"48049950700",341,236,85,112,56,53,130,217,1230
"48049950800",1792,691,215,0,172,18,811,437,4136
"48049950900",2968,714,270,204,91,10,771,220,5248
"48049951000",1606,617,54,4,103,54,497,110,3045
"48049951100",2718,758,83,26,129,73,467,252,4506
"48049951200",3361,360,12,6,191,0,613,26,4569
"48049951300",2438,259,0,0,66,0,318,20,3101
"48051970100",859,125,93,12,138,0,62,15,1304
"48051970200",3056,322,195,42,234,207,732,124,4912
"48051970300",2282,459,386,373,523,45,786,69,4923
"48051970400",2181,324,430,27,100,0,636,33,3731
"48051970500",3109,647,403,144,254,34,687,227,5505
"48053960100",5154,678,51,62,254,21,966,220,7406
"48053960200",2836,206,123,0,20,0,295,123,3603
"48053960300",4568,1434,83,108,325,19,601,760,7898
"48053960400",4234,703,0,1,265,0,638,375,6216
"48053960500",3898,1746,0,0,243,342,1426,1049,8704
"48053960600",3612,274,52,0,81,0,327,24,4370
"48053960700",5424,604,352,3,155,50,1513,363,8464
"48053960800",4687,708,139,12,158,18,506,182,6410
"48055960101",3974,873,113,7,1033,186,2937,658,9781
"48055960102",2258,463,50,118,345,97,785,248,4364
"48055960200",1900,131,277,85,1172,31,2141,103,5840
"48055960300",2987,330,223,32,582,178,1484,417,6233
"48055960400",2428,459,69,33,637,238,1996,603,6463
"48055960500",3602,1704,154,582,1670,401,3121,1405,12639
"48055960600",1727,110,55,8,106,0,136,0,2142
"48055960700",3671,948,319,155,578,0,1839,554,8064
"48057000100",3772,958,133,4,633,90,1859,690,8139
"48057000200",2620,801,195,183,303,52,2084,737,6975
"48057000300",1248,67,30,12,86,5,322,0,1770
"48057000400",4855,898,35,0,447,251,2638,831,9955
"48057000500",2772,744,0,9,123,62,649,414,4773
"48057990000",0,0,0,0,0,0,0,0,0
"48059030101",3561,871,51,33,99,99,340,27,5081
"48059030102",3302,720,130,12,99,50,154,120,4587
"48059030200",3477,715,0,0,136,48,448,138,4962
"48061010100",5693,2440,15,0,255,57,4458,2175,15093
"48061010201",1450,771,0,0,107,33,1378,673,4412
"48061010203",4220,2132,263,21,142,169,3296,2126,12369
"48061010301",3343,2118,0,0,100,166,3251,2275,11253
"48061010302",7243,1132,0,0,236,0,5695,1101,15407
"48061010401",3954,1330,25,0,209,128,3844,1396,10886
"48061010402",4600,1769,120,0,212,90,3184,1775,11750
"48061010500",1095,1158,35,0,41,27,1089,1185,4630
"48061010601",5490,2341,27,0,370,133,4511,2310,15182
"48061010602",1247,263,10,0,65,0,786,213,2584
"48061010700",1922,948,0,0,39,42,1467,890,5308
"48061010800",3934,2735,90,0,68,68,2654,2550,12099
"48061010900",733,652,6,0,72,38,763,683,2947
"48061011000",1288,1492,0,0,281,141,1552,1620,6374
"48061011100",1382,1017,0,3,51,73,1413,1042,4981
"48061011200",945,507,38,0,81,0,902,507,2980
"48061011301",1175,404,0,0,55,0,743,314,2691
"48061011302",3410,155,1,0,212,50,1924,113,5865
"48061011400",4539,1576,0,0,811,120,4693,1677,13416
"48061011500",2815,2245,0,31,358,367,2957,2518,11291
"48061011600",3624,2489,0,0,165,357,3713,2828,13176
"48061011700",3393,1913,0,1,625,629,3961,2432,12954
"48061011801",3265,1826,160,89,259,0,2948,1761,10308
"48061011802",1541,2327,92,63,330,137,1478,2430,8398
"48061011901",3302,2115,13,0,245,26,2979,2051,10731
"48061011902",3100,1324,35,0,152,161,2471,1411,8654
"48061011903",1502,1156,0,0,121,47,1543,1199,5568
"48061012001",4353,1633,70,1,342,29,2958,1488,10874
"48061012002",4761,936,23,1,186,124,3509,980,10520
"48061012101",2657,1162,0,6,432,75,2078,1034,7444
"48061012102",3057,2484,11,0,569,198,3478,2680,12477
"48061012200",6979,3626,16,0,1222,442,7295,3669,23249
"48061012301",2792,981,0,0,210,45,1190,677,5895
"48061012304",2614,1116,45,0,302,324,1872,1221,7494
"48061012305",2329,676,16,0,86,114,504,314,4039
"48061012401",4140,1942,40,0,664,671,4524,2535,14516
"48061012402",3859,1174,0,10,341,94,3735,1116,10329
"48061012504",12789,3282,57,0,689,203,12446,3425,32891
"48061012505",5032,3474,0,0,623,318,5317,3763,18527
"48061012506",2639,711,0,0,196,55,2118,634,6353
"48061012507",3643,2386,12,6,235,88,3720,2480,12570
"48061012508",2783,987,0,0,32,0,2277,964,7043
"48061012607",1544,1005,0,0,279,22,1807,1027,5684
"48061012608",2975,1045,20,0,141,33,2626,1034,7874
"48061012609",3521,3852,18,0,184,161,3357,4013,15106
"48061012612",5286,364,45,0,246,40,5127,351,11459
"48061012613",3585,637,46,0,487,45,3549,668,9017
"48061012700",3349,1985,0,0,198,126,3371,1943,10972
"48061012800",3675,1150,84,14,138,93,3784,1238,10176
"48061012900",3299,954,10,20,286,132,3043,992,8736
"48061013002",2906,1335,6,0,172,80,2598,1351,8448
"48061013003",1112,746,0,0,42,33,1089,775,3797
"48061013004",1891,846,0,0,213,60,1857,879,5746
"48061013102",2555,1898,0,0,275,44,2429,1912,9113
"48061013104",2750,1037,0,0,225,27,2618,999,7656
"48061013106",1947,2118,0,0,290,157,2121,2253,8886
"48061013203",987,952,6,0,59,14,965,966,3949
"48061013204",1266,855,0,46,274,32,1480,901,4854
"48061013205",2198,1190,41,0,237,69,2430,1259,7424
"48061013206",1062,2101,7,0,142,60,1138,2134,6644
"48061013207",2258,2253,0,0,353,153,2308,2398,9723
"48061013303",2199,1497,0,24,210,0,2205,1383,7518
"48061013305",2689,1656,0,0,188,66,2804,1635,9038
"48061013306",1226,1188,0,0,56,73,1282,1241,5066
"48061013307",907,992,0,0,3,4,900,996,3802
"48061013308",1806,1418,0,9,144,27,1859,1454,6717
"48061013309",1620,1253,0,0,99,56,1687,1309,6024
"48061013401",863,981,8,0,199,40,950,1010,4051
"48061013402",1047,746,0,0,55,57,1102,803,3810
"48061013500",1542,491,0,3,72,35,1385,511,4039
"48061013600",1675,1189,0,0,43,8,1571,1163,5649
"48061013700",1427,2245,0,0,227,58,1626,2303,7886
"48061013801",1007,1586,6,0,32,44,1005,1595,5275
"48061013802",1620,1983,0,0,240,48,1785,1997,7673
"48061013901",1390,1373,17,0,25,26,1399,1399,5629
"48061013902",1934,1566,26,0,106,145,2066,1690,7533
"48061013903",2242,1476,0,0,145,237,2363,1713,8176
"48061014001",953,927,0,31,25,136,854,1079,4005
"48061014002",889,1514,33,0,74,44,901,1546,5001
"48061014100",7086,4264,0,0,639,290,7469,4434,24182
"48061014200",2824,1885,11,0,235,368,2831,2120,10274
"48061014300",2423,1806,23,0,222,133,2354,1927,8888
"48061014400",13312,2513,121,0,1333,0,13032,2362,32673
"48061014500",5318,2352,103,0,588,145,5078,2346,15930
"48061980001",0,0,0,0,0,0,0,0,0
"48061980100",0,0,0,0,0,0,0,0,0
"48061990000",0,0,0,0,0,0,0,0,0
"48063950101",2154,232,368,104,245,76,455,85,3719
"48063950102",3003,527,305,243,218,69,272,95,4732
"48063950200",2465,597,822,294,402,312,1165,800,6857
"48065950100",2083,104,0,1,73,0,181,11,2453
"48065950200",3242,309,53,0,72,21,375,8,4080
"48067950100",4765,845,803,60,197,117,75,232,7094
"48067950200",1376,399,482,63,0,18,30,0,2368
"48067950300",1398,211,176,175,40,44,14,10,2068
"48067950400",2944,463,897,699,101,1,190,22,5317
"48067950500",2071,380,132,14,28,70,37,88,2820
"48067950600",4005,731,427,201,131,81,284,31,5891
"48067950700",3310,673,431,573,185,97,85,108,5462
"48069950100",1129,120,0,0,57,0,311,81,1698
"48069950200",3114,690,9,0,376,99,2404,668,7360
"48069950300",1618,251,7,19,186,160,1050,372,3663
"48071710100",6677,701,421,0,312,8,953,16,9088
"48071710200",13494,920,1151,0,1252,266,3705,540,21328
"48071710300",1401,172,363,295,123,38,136,0,2528
"48071710401",4322,586,444,14,253,240,892,292,7043
"48071710500",2412,496,191,12,271,173,861,312,4728
"48071710600",0,0,0,0,0,0,0,0,0
"48071990000",0,0,0,0,0,0,0,0,0
"48073950100",3500,698,306,62,120,43,1274,400,6403
"48073950200",4731,856,106,42,267,0,542,0,6544
"48073950300",5381,911,453,90,277,17,835,580,8544
"48073950400",588,163,512,324,44,22,369,162,2184
"48073950500",1466,1029,380,583,213,100,1123,591,5485
"48073950600",3555,755,66,467,522,0,974,406,6745
"48073950700",1908,1012,182,519,296,0,1145,774,5836
"48073950801",2895,505,230,77,128,0,168,23,4026
"48073950802",2966,542,325,20,107,20,197,319,4496
"48073950900",1820,264,250,231,118,81,279,186,3229
"48073951000",2082,444,551,311,6,69,112,194,3769
"48073951100",1200,299,152,103,25,29,80,32,1920
"48075950100",668,52,13,9,85,8,108,23,966
"48075950200",3188,1008,238,16,454,84,438,410,5836
"48077030200",2683,385,36,0,42,15,39,28,3228
"48077030301",3930,392,5,3,107,67,226,3,4733
"48077030302",2210,235,3,17,73,132,120,101,2891
"48079950100",2068,469,57,51,232,71,1262,415,4625
"48081950100",1373,120,0,0,38,7,217,35,1790
"48081950200",1241,230,0,0,97,4,322,54,1948
"48083950300",3183,1065,120,5,97,20,664,181,5335
"48083950600",1179,126,0,0,80,19,185,12,1601
"48083950700",1841,543,19,58,57,88,235,193,3034
"48085030100",5838,492,5,56,64,11,307,119,6892
"48085030201",2724,59,52,2,44,0,397,25,3303
"48085030202",1654,240,11,0,171,1,189,13,2279
"48085030203",12642,1408,1756,0,764,88,2001,741,19400
"48085030301",4018,149,391,14,358,22,824,28,5804
"48085030302",2121,135,152,0,196,0,103,12,2719
"48085030303",5722,363,296,29,347,42,575,0,7374
"48085030304",2291,656,150,0,93,14,314,50,3568
"48085030305",7689,482,81,80,301,539,751,687,10610
"48085030403",4298,162,91,68,1106,254,1118,254,7351
"48085030404",3806,176,447,0,918,328,378,320,6373
"48085030405",3303,165,527,39,839,99,658,35,5665
"48085030406",2330,81,68,0,543,210,1371,192,4795
"48085030407",3349,37,195,8,457,34,525,0,4605
"48085030408",4532,531,531,34,1307,135,2304,484,9858
"48085030504",1961,93,244,29,497,187,307,0,3318
"48085030505",2334,63,196,36,1055,21,320,0,4025
"48085030506",2292,41,161,0,435,16,65,16,3026
"48085030507",1389,8,63,0,404,0,153,0,2017
"48085030508",4947,290,143,16,661,13,616,39,6725
"48085030509",1546,0,154,0,714,0,140,0,2554
"48085030510",1920,114,209,0,757,25,485,0,3510
"48085030511",3997,129,241,0,1010,37,505,0,5919
"48085030512",3343,8,11,18,1235,9,363,0,4987
"48085030513",5026,178,1115,0,1036,59,1199,0,8613
"48085030514",5445,32,1084,0,693,67,933,0,8254
"48085030515",4582,359,884,87,675,0,772,114,7473
"48085030516",3726,757,809,25,818,191,676,715,7717
"48085030517",4872,132,388,0,662,102,548,58,6762
"48085030518",1989,0,104,0,998,14,338,0,3443
"48085030519",1565,4,368,0,340,5,272,0,2554
"48085030520",3384,70,1077,96,1106,122,727,120,6702
"48085030521",2223,16,590,0,979,25,476,0,4309
"48085030522",4092,170,645,0,2041,0,838,5,7791
"48085030523",7078,197,632,104,1720,74,1148,56,11009
"48085030524",1591,50,571,0,168,37,388,64,2869
"48085030525",5319,257,499,0,256,63,465,0,6859
"48085030526",7616,183,845,0,899,0,1148,0,10691
"48085030527",3607,168,655,0,393,8,648,68,5547
"48085030528",6202,160,447,74,566,283,714,26,8472
"48085030529",2228,65,584,31,205,0,307,0,3420
"48085030530",5449,195,136,0,341,21,308,0,6450
"48085030531",4915,189,373,0,505,119,331,90,6522
"48085030601",7925,624,355,0,294,28,476,279,9981
"48085030603",5557,386,1204,43,271,0,1610,0,9071
"48085030604",1570,69,226,12,111,0,214,13,2215
"48085030605",5007,54,1340,73,1006,0,1549,0,9029
"48085030701",1934,738,90,265,413,75,1003,482,5000
"48085030702",3424,901,133,130,134,0,1322,577,6621
"48085030801",2721,247,674,13,126,23,652,82,4538
"48085030802",3940,405,330,553,363,148,1790,373,7902
"48085030900",6685,1170,932,341,604,178,5166,989,16065
"48085031001",5923,1430,37,64,374,6,2124,303,10261
"48085031003",3159,771,396,52,89,14,832,203,5516
"48085031004",4689,762,319,45,190,44,1454,419,7922
"48085031100",7121,969,184,296,538,51,1338,388,10885
"48085031201",4104,640,150,0,406,6,742,213,6261
"48085031202",3231,327,536,4,176,0,305,252,4831
"48085031308",4786,672,513,49,546,3,862,416,7847
"48085031309",5999,140,1229,93,1443,139,1716,75,10834
"48085031310",7817,360,738,18,973,179,1313,218,11616
"48085031311",8304,445,713,0,1415,43,1757,63,12740
"48085031312",4974,88,494,0,1059,0,812,0,7427
"48085031313",8146,604,1066,0,3322,54,1349,142,14683
"48085031314",2458,141,26,0,96,0,206,6,2933
"48085031315",10680,1360,3679,0,2498,184,1733,777,20911
"48085031316",2957,12,639,0,3114,27,751,0,7500
"48085031317",5095,136,1685,0,1846,82,901,0,9745
"48085031405",14240,81,694,0,5682,46,1415,28,22186
"48085031406",12506,842,1460,168,2587,75,1584,249,19471
"48085031407",6874,546,0,1,361,3,248,3,8036
"48085031408",2267,347,316,0,525,0,254,0,3709
"48085031409",7188,260,876,0,2536,213,915,104,12092
"48085031410",6090,513,623,382,1267,46,706,254,9881
"48085031411",3122,51,824,61,1365,57,438,0,5918
"48085031504",5821,110,425,0,525,0,760,0,7641
"48085031505",5543,147,350,38,2224,250,403,16,8971
"48085031506",5506,1036,978,138,750,312,1644,721,11085
"48085031507",3546,131,468,0,901,69,487,0,5602
"48085031508",4296,302,663,135,862,55,849,42,7204
"48085031611",2440,344,586,229,320,16,720,249,4904
"48085031612",4667,214,67,0,1172,17,316,106,6559
"48085031613",4599,54,65,35,342,14,848,4,5961
"48085031621",3966,434,372,18,751,150,530,13,6234
"48085031622",3805,95,466,0,1166,104,424,0,6060
"48085031623",1948,177,181,86,295,13,607,91,3398
"48085031624",2105,451,527,123,647,114,1170,293,5430
"48085031625",3947,71,147,20,478,22,342,27,5054
"48085031626",1871,39,139,10,345,36,131,0,2571
"48085031627",4533,195,275,73,241,106,704,103,6230
"48085031628",2809,114,208,0,416,8,558,0,4113
"48085031629",2659,501,102,128,442,59,652,349,4892
"48085031630",3316,128,202,0,792,44,370,0,4852
"48085031631",2715,329,964,40,676,290,257,142,5413
"48085031632",3258,372,252,99,1771,30,392,0,6174
"48085031633",2642,83,528,37,428,26,448,0,4192
"48085031634",2441,184,98,22,511,52,902,53,4263
"48085031635",2486,222,754,12,911,24,683,114,5206
"48085031636",4475,187,292,51,1689,37,447,84,7262
"48085031637",4604,113,192,0,1792,112,369,0,7182
"48085031638",3560,0,20,138,3675,40,403,0,7836
"48085031639",3961,107,639,0,1669,42,791,0,7209
"48085031640",4369,506,1065,306,1865,57,341,28,8537
"48085031641",2536,63,313,0,3706,119,260,9,7006
"48085031642",3138,134,164,13,1191,18,317,14,4989
"48085031643",2985,263,140,135,1165,96,272,128,5184
"48085031645",1599,12,52,0,360,3,28,0,2054
"48085031646",4038,52,171,0,1364,71,335,16,6047
"48085031647",2274,21,179,0,546,0,190,0,3210
"48085031648",4945,170,301,235,1712,97,272,79,7811
"48085031649",3343,209,183,0,680,23,119,0,4557
"48085031652",3900,137,465,0,2961,52,388,16,7919
"48085031653",4646,352,435,28,1776,153,628,215,8233
"48085031654",2563,141,103,0,1214,0,251,0,4272
"48085031655",2743,151,437,0,1025,263,526,94,5239
"48085031656",1761,24,209,0,619,0,212,0,2825
"48085031657",1411,88,245,0,510,45,96,24,2419
"48085031658",3326,107,288,0,837,74,522,45,5199
"48085031659",768,59,90,0,911,138,225,7,2198
"48085031660",1605,41,468,34,2021,132,298,42,4641
"48085031661",1136,8,36,0,1850,0,150,0,3180
"48085031662",2397,90,444,0,2188,0,201,24,5344
"48085031663",2271,30,40,0,1197,56,335,10,3939
"48085031664",2702,28,208,0,1245,10,113,0,4306
"48085031704",2750,75,429,19,542,96,733,90,4734
"48085031706",1719,38,23,0,322,6,82,0,2190
"48085031708",2353,74,590,81,611,166,298,113,4286
"48085031709",2441,212,460,159,960,266,408,52,4958
"48085031711",2204,56,420,34,364,62,143,0,3283
"48085031712",2353,266,1020,0,1643,51,966,0,6299
"48085031713",1371,67,797,158,1171,453,334,357,4708
"48085031714",2527,78,1677,428,1076,441,875,240,7342
"48085031715",1846,67,241,0,443,10,201,32,2840
"48085031716",1567,92,208,0,291,72,255,18,2503
"48085031717",809,52,370,16,877,92,288,0,2504
"48085031718",2121,16,68,0,426,56,162,0,2849
"48085031719",889,83,88,5,569,105,98,0,1837
"48085031720",653,330,431,251,1461,1517,881,1085,6609
"48085031802",3772,343,483,1,1055,163,820,145,6782
"48085031804",2313,655,38,11,287,349,369,119,4141
"48085031805",4316,279,9,0,654,102,345,114,5819
"48085031806",670,62,105,39,1116,159,325,35,2511
"48085031807",4104,318,75,0,467,0,512,40,5516
"48085031900",2681,747,380,211,437,316,2111,925,7808
"48085032003",2861,1285,636,173,552,132,1779,1156,8574
"48085032004",4545,1172,807,179,993,14,2114,927,10751
"48085032008",2824,409,243,20,421,43,706,327,4993
"48085032009",3989,283,697,2,2049,130,645,110,7905
"48085032010",2950,574,679,250,533,78,1171,493,6728
"48085032011",3577,110,590,17,2214,162,457,0,7127
"48085032012",2711,743,253,105,290,50,1694,563,6409
"48085032013",2434,575,931,69,1887,323,1128,597,7944
"48087950300",2033,464,62,38,216,173,593,360,3939
"48089750100",2407,837,890,426,313,50,1395,652,6970
"48089750200",1389,244,53,22,55,45,318,212,2338
"48089750300",3786,293,452,147,89,31,716,166,5680
"48089750400",3867,547,188,30,600,1,777,392,6402
"48089750500",2778,128,365,246,66,34,993,34,4644
"48091310100",2655,539,67,14,166,36,1164,337,4978
"48091310200",2023,537,21,5,266,0,1053,513,4418
"48091310300",6078,502,156,37,143,66,1235,297,8514
"48091310401",3428,743,70,34,567,26,3060,728,8656
"48091310403",4943,288,154,1,578,0,2216,12,8192
"48091310404",2994,648,52,0,338,215,978,679,5904
"48091310501",3157,369,74,22,268,72,1438,336,5736
"48091310502",4128,651,207,0,362,30,1890,297,7565
"48091310503",3666,123,7,0,170,2,1018,24,5010
"48091310603",2505,487,62,0,276,10,388,186,3914
"48091310604",2394,101,18,0,215,72,229,57,3086
"48091310605",4470,453,55,0,167,56,678,206,6085
"48091310606",3820,417,112,0,417,0,519,87,5372
"48091310607",4037,289,72,0,280,0,753,0,5431
"48091310608",2667,588,8,0,131,7,574,212,4187
"48091310701",5745,534,0,0,222,18,408,53,6980
"48091310702",4994,253,23,0,77,0,724,30,6101
"48091310703",4798,530,28,0,209,0,735,232,6532
"48091310704",4609,624,64,1,1430,96,2009,114,8947
"48091310801",4883,79,248,9,392,0,896,17,6524
"48091310802",5787,282,449,0,245,126,1224,221,8334
"48091310901",4364,162,43,0,87,2,573,43,5274
"48091310902",6027,179,154,0,294,0,1636,58,8348
"48091310903",4105,88,11,0,248,0,978,0,5430
"48093950100",3161,784,22,0,188,67,447,354,5023
"48093950200",2681,606,14,0,21,27,132,198,3679
"48093950300",2587,1142,0,11,91,21,970,855,5677
"48093950400",1461,447,0,1,64,1,379,310,2663
"48095950300",2330,288,11,0,39,10,827,139,3644
"48097000100",4356,672,12,0,306,0,261,290,5897
"48097000200",4468,286,7,10,197,0,192,30,5190
"48097000400",1194,383,119,80,169,45,438,135,2563
"48097000500",1883,887,106,21,112,212,525,442,4188
"48097000600",3581,639,191,8,499,31,1109,309,6367
"48097000700",6540,279,0,0,183,0,607,0,7609
"48097000900",4267,367,1,0,115,2,309,49,5110
"48097001100",4115,1315,221,55,113,0,949,753,7521
"48099010101",2783,526,36,0,194,24,367,67,3997
"48099010102",2612,308,26,2,110,15,192,18,3283
"48099010201",208,68,0,11,0,0,35,54,376
"48099010202",3984,599,58,70,51,90,608,90,5550
"48099010300",1323,338,10,57,260,113,284,187,2572
"48099010400",3160,389,70,14,255,103,286,111,4388
"48099010501",2498,512,758,142,591,190,921,139,5751
"48099010502",1242,547,497,9,374,229,319,229,3446
"48099010503",0,0,0,0,0,0,0,0,0
"48099010504",1213,79,973,56,194,33,421,7,2976
"48099010601",1771,415,602,253,495,758,435,438,5167
"48099010603",3374,217,570,246,771,141,616,48,5983
"48099010604",3263,441,888,59,406,25,739,170,5991
"48099010701",3063,61,273,61,669,33,863,0,5023
"48099010702",2360,176,332,48,169,33,306,49,3473
"48099010802",3867,224,846,4,556,20,538,79,6134
"48099010803",1907,18,541,59,173,8,497,8,3211
"48099010804",2332,391,468,96,557,300,729,253,5126
"48099980000",15,20,0,0,0,0,0,14,49
"48101950100",1014,228,86,72,55,40,260,149,1904
"48103950100",2116,438,162,0,1737,168,2407,368,7396
"48105950100",1804,225,0,0,1180,410,1768,494,5881
"48107950100",1313,520,55,75,51,68,689,404,3175
"48107950200",1849,359,46,28,66,37,976,353,3714
"48107950300",1073,220,10,13,100,38,552,249,2255
"48109950300",1413,646,0,6,193,25,1238,559,4080
"48111950100",1261,160,0,0,71,3,222,74,1791
"48111950300",3957,824,62,22,424,174,1866,788,8117
"48113000100",3343,195,159,62,192,0,309,104,4364
"48113000201",2709,70,11,0,83,34,450,34,3391
"48113000202",3245,115,100,13,275,11,627,33,4419
"48113000300",3732,280,26,36,210,32,214,46,4576
"48113000401",2114,815,281,678,1826,689,2385,828,9616
"48113000404",1879,393,130,0,1053,243,1395,438,5531
"48113000405",845,205,164,310,573,163,772,235,3267
"48113000406",4188,1059,274,0,1952,493,4342,1124,13432
"48113000500",2644,207,161,155,1165,250,1173,375,6130
"48113000601",3152,362,250,320,1103,894,1841,968,8890
"48113000603",2980,174,118,0,776,82,683,59,4872
"48113000605",1700,136,65,20,394,128,371,117,2931
"48113000606",2432,67,33,20,228,28,161,9,2978
"48113000701",3344,200,305,39,461,25,230,0,4604
"48113000702",2145,137,0,0,607,30,335,0,3254
"48113000800",3287,875,846,253,1305,449,2368,954,10337
"48113000900",2318,1247,76,65,740,198,1426,953,7023
"48113001001",1556,67,14,0,162,6,263,41,2109
"48113001002",1362,153,84,0,358,43,731,116,2847
"48113001101",2863,327,16,6,263,70,727,213,4485
"48113001102",2341,49,53,0,80,0,229,12,2764
"48113001202",2216,263,449,159,303,74,969,179,4612
"48113001203",1179,233,22,0,46,4,678,216,2378
"48113001204",2260,472,0,0,289,117,2406,577,6121
"48113001301",1795,260,60,12,77,104,193,170,2671
"48113001302",1543,287,249,140,164,35,938,221,3577
"48113001400",2291,769,238,211,208,111,1013,485,5326
"48113001502",1597,835,370,266,171,57,1300,693,5289
"48113001503",944,1283,226,159,433,508,839,1621,6013
"48113001504",929,426,325,311,514,189,629,363,3686
"48113001600",1858,157,556,1034,521,148,429,78,4781
"48113001701",285,0,38,23,120,0,42,23,531
"48113001703",3018,125,103,41,161,75,311,0,3834
"48113001704",1126,84,22,0,129,0,156,10,1527
"48113001800",3319,187,224,42,430,46,598,0,4846
"48113001900",3805,183,172,205,441,289,338,60,5493
"48113002000",2877,675,791,129,559,297,2520,832,8680
"48113002100",888,69,321,116,200,80,133,36,1843
"48113002200",1080,245,217,209,224,74,158,48,2255
"48113002400",2088,713,40,23,362,113,2050,708,6097
"48113002500",1893,1251,816,496,300,98,2085,1210,8149
"48113002701",116,443,1161,1284,0,39,116,468,3627
"48113002702",125,89,929,560,39,0,144,75,1961
"48113003101",1943,212,328,18,494,76,390,50,3511
"48113003400",258,97,621,310,25,65,117,130,1623
"48113003700",136,331,1943,626,25,0,119,365,3545
"48113003800",79,59,1129,779,0,0,14,67,2127
"48113003901",30,0,859,937,0,0,0,0,1826
"48113003902",163,154,973,260,132,0,250,52,1984
"48113004000",0,100,537,343,0,0,0,93,1073
"48113004100",318,221,237,303,41,0,313,228,1661
"48113004201",2744,805,164,99,323,49,1678,783,6645
"48113004202",1457,645,38,0,295,68,1078,671,4252
"48113004300",1048,318,146,65,194,0,1096,245,3112
"48113004400",2582,197,185,25,400,0,809,70,4268
"48113004500",4290,895,163,54,296,30,3628,589,9945
"48113004600",1148,114,159,35,96,7,531,67,2157
"48113004700",1960,992,42,112,250,307,1912,1167,6742
"48113004800",1456,1028,22,12,235,85,1617,1069,5524
"48113004900",576,936,1527,1113,107,126,623,1017,6025
"48113005000",2423,1129,142,89,355,257,2572,1269,8236
"48113005100",2164,664,0,0,148,60,1999,684,5719
"48113005200",2971,582,0,10,473,202,2876,701,7815
"48113005300",4412,1810,56,0,734,203,4496,1941,13652
"48113005400",2409,854,867,816,110,168,2338,906,8468
"48113005500",770,854,1544,699,205,0,1032,781,5885
"48113005600",3517,1982,797,639,618,342,4140,2053,14088
"48113005700",1009,647,1438,1067,345,139,1262,691,6598
"48113005901",741,518,2707,688,134,259,726,770,6543
"48113005902",422,562,1665,1158,78,120,481,672,5158
"48113006001",2210,1034,537,203,209,216,2373,1238,8020
"48113006002",954,402,1766,1291,144,379,666,354,5956
"48113006100",1992,386,1287,435,140,49,1753,396,6438
"48113006200",2578,1334,1049,450,557,344,2441,1650,10403
"48113006301",3324,787,527,78,551,424,3518,1008,10217
"48113006302",2707,649,79,49,684,220,2814,769,7971
"48113006401",1769,282,24,7,455,68,2061,337,5003
"48113006402",3643,1448,116,8,633,88,3938,1378,11252
"48113006501",4114,1516,89,18,506,376,4405,1887,12911
"48113006502",2825,680,139,0,604,10,3073,685,8016
"48113006700",4538,1960,95,0,1071,248,4905,2032,14849
"48113006800",2895,1205,512,264,573,193,3032,1343,10017
"48113006900",1275,1529,151,304,223,21,1128,1471,6102
"48113007101",1718,90,7,0,276,0,98,8,2197
"48113007102",2400,77,1647,310,911,161,1568,97,7171
"48113007201",4527,1822,255,87,1188,595,4180,1969,14623
"48113007202",4364,1789,95,144,1158,522,4044,1387,13503
"48113007301",1942,44,2,1,79,0,120,0,2188
"48113007302",3706,243,90,0,493,247,1071,310,6160
"48113007601",1729,48,44,0,162,0,291,0,2274
"48113007604",2741,38,274,0,127,0,84,0,3264
"48113007605",1642,46,0,0,91,5,107,8,1899
"48113007700",4417,202,0,0,398,17,359,15,5408
"48113007801",1837,176,10,0,136,20,158,0,2337
"48113007804",1358,545,2795,225,149,53,576,350,6051
"48113007805",1773,122,603,122,167,85,450,57,3379
"48113007809",1796,120,95,125,19,101,333,61,2650
"48113007810",2575,336,576,198,186,57,564,248,4740
"48113007811",1713,254,1869,1115,267,466,978,505,7167
"48113007812",2614,9,70,0,187,13,82,0,2975
"48113007815",1010,1546,603,210,480,1165,565,1461,7040
"48113007818",2367,1000,741,792,433,410,2041,1136,8920
"48113007819",1030,478,415,139,188,71,615,429,3365
"48113007820",1394,1219,1195,972,530,664,854,1445,8273
"48113007821",1164,554,580,330,473,258,1339,570,5268
"48113007822",697,232,208,0,111,19,202,115,1584
"48113007823",345,221,76,145,113,128,396,349,1773
"48113007824",1707,10,20,0,92,0,133,0,1962
"48113007825",2852,624,1192,834,245,250,952,762,7711
"48113007826",138,12,134,17,41,11,52,0,405
"48113007827",642,120,986,477,268,92,374,107,3066
"48113007902",3843,320,348,15,169,19,258,73,5045
"48113007903",1864,128,38,39,70,58,62,56,2315
"48113007906",2174,10,31,0,113,0,37,0,2365
"48113007909",1222,103,278,14,451,56,244,16,2384
"48113007910",1668,451,88,24,755,163,422,64,3635
"48113007911",1999,369,131,33,397,52,262,145,3388
"48113007912",1518,87,72,33,174,25,300,8,2217
"48113007913",2084,61,229,221,198,9,575,14,3391
"48113007914",1240,764,274,50,224,117,135,109,2913
"48113008000",6499,43,0,0,347,0,557,0,7446
"48113008100",5472,449,309,1,140,16,806,41,7234
"48113008200",2711,565,296,256,78,108,496,367,4877
"48113008400",5503,2347,191,96,647,391,5343,2520,17038
"48113008500",2919,980,157,235,531,367,3077,1162,9428
"48113008603",115,155,320,326,15,11,130,159,1231
"48113008604",451,345,865,1149,17,33,441,339,3640
"48113008701",97,76,1885,1999,101,0,204,96,4458
"48113008703",505,655,1187,633,160,23,631,650,4444
"48113008704",82,402,1964,936,0,18,77,346,3825
"48113008705",395,68,553,199,139,3,529,54,1940
"48113008801",287,282,1332,703,107,0,401,269,3381
"48113008802",843,1345,1879,1499,139,227,1041,1419,8392
"48113008900",441,310,1231,799,57,21,465,294,3618
"48113009000",3434,1487,1376,1093,951,329,3635,1687,13992
"48113009101",2198,1174,829,542,816,206,2627,1225,9617
"48113009103",1483,790,756,196,163,188,1552,959,6087
"48113009104",1842,906,474,238,271,96,1989,1034,6850
"48113009105",2048,581,235,104,861,231,2508,789,7357
"48113009201",3496,1356,652,390,340,108,3157,1392,10891
"48113009202",2491,1196,377,327,1061,388,3140,1352,10332
"48113009301",3571,1387,44,32,337,333,3543,1601,10848
"48113009303",2069,904,409,39,351,304,2245,1150,7471
"48113009304",488,1207,1592,2386,139,345,575,1417,8149
"48113009401",2803,351,124,8,431,37,1612,328,5694
"48113009402",2141,121,0,0,180,0,391,0,2833
"48113009500",2069,51,78,39,128,0,261,0,2626
"48113009603",4117,90,173,91,387,50,596,12,5516
"48113009604",3543,431,343,19,177,32,1002,182,5729
"48113009605",1900,306,192,0,991,248,2047,404,6088
"48113009607",2883,113,159,7,243,0,764,56,4225
"48113009608",2818,265,207,58,368,103,952,138,4909
"48113009609",2591,47,27,0,121,0,206,0,2992
"48113009610",2821,1705,0,64,297,178,2329,1153,8547
"48113009611",2743,308,224,73,319,0,1752,174,5593
"48113009701",3452,747,135,70,731,257,2387,670,8449
"48113009702",2677,340,29,0,79,0,455,0,3580
"48113009802",3830,1016,101,0,1022,552,3844,1211,11576
"48113009803",1330,428,190,20,217,52,875,324,3436
"48113009804",4096,2493,87,250,797,503,3916,1907,14049
"48113009900",1577,180,359,16,466,277,967,215,4057
"48113010000",1724,332,968,524,270,309,348,102,4577
"48113010101",1377,749,1164,682,611,21,1764,572,6940
"48113010102",1940,646,110,83,167,83,1775,711,5515
"48113010500",1252,337,935,200,191,196,1014,533,4658
"48113010601",4436,967,90,30,498,49,4092,951,11113
"48113010602",1876,569,47,254,238,196,1521,677,5378
"48113010701",2816,1418,143,10,703,83,3215,1328,9716
"48113010703",1551,501,144,121,336,85,1645,568,4951
"48113010704",2626,798,642,409,371,0,2452,793,8091
"48113010801",5036,1986,779,492,975,447,5397,2352,17464
"48113010803",2745,686,2531,474,294,37,1937,529,9233
"48113010804",1340,1065,710,650,544,282,1781,1117,7489
"48113010805",2753,992,891,616,788,81,3293,901,10315
"48113010902",590,106,4573,1476,161,14,535,151,7606
"48113010903",1018,149,1247,521,468,109,1376,219,5107
"48113010904",355,325,1699,718,85,89,397,340,4008
"48113011001",977,34,4379,1355,114,19,746,35,7659
"48113011002",539,94,2249,339,65,43,460,126,3915
"48113011101",381,4,3061,419,65,29,292,30,4281
"48113011103",1051,372,1165,276,104,309,915,654,4846
"48113011104",522,446,1480,1187,62,209,536,652,5094
"48113011105",727,839,1509,1130,0,0,599,785,5589
"48113011200",696,307,4525,1072,153,97,990,228,8068
"48113011300",60,330,3464,873,39,0,33,328,5127
"48113011401",375,164,2399,1532,36,87,382,138,5113
"48113011500",867,834,719,415,125,102,967,925,4954
"48113011601",1111,525,1901,639,48,151,1081,609,6065
"48113011602",3856,1398,618,233,755,86,4155,1271,12372
"48113011701",3160,1077,1337,476,317,338,3237,1338,11280
"48113011702",2561,1793,292,243,786,123,2822,1814,10434
"48113011800",3159,1928,2200,744,541,679,3123,2586,14960
"48113011900",4388,1986,2110,464,505,276,4484,2175,16388
"48113012000",3107,1098,1810,1069,215,162,2977,1216,11654
"48113012100",2073,616,1846,813,551,75,2266,681,8921
"48113012204",3100,365,769,732,922,466,1546,504,8404
"48113012206",1774,187,1479,466,469,96,1264,255,5990
"48113012207",1694,1571,3747,699,498,76,1819,1426,11530
"48113012208",494,410,581,423,695,513,1041,876,5033
"48113012209",1680,96,271,294,887,297,1271,374,5170
"48113012210",1007,337,840,726,684,254,920,445,5213
"48113012211",796,225,1072,654,1042,192,1523,382,5886
"48113012301",1859,1025,388,171,1099,505,2217,1362,8626
"48113012302",1184,796,771,2012,2488,396,3011,1025,11683
"48113012400",3696,443,501,0,852,63,1999,168,7722
"48113012500",3442,821,413,234,1827,1141,3335,1191,12404
"48113012601",1345,100,1010,142,2743,1233,2650,1083,10306
"48113012603",1153,185,79,4,462,147,882,242,3154
"48113012604",2423,387,1356,796,1585,365,2419,553,9884
"48113012701",2338,756,219,72,2017,1209,3205,1636,11452
"48113012702",1408,400,198,70,999,423,1768,700,5966
"48113012800",5936,738,353,112,377,60,2068,628,10272
"48113012900",3408,189,287,187,30,54,527,98,4780
"48113013004",5420,169,205,83,240,22,262,29,6430
"48113013005",2865,219,0,0,151,26,193,207,3661
"48113013007",1793,322,85,76,911,88,396,283,3954
"48113013008",2408,256,241,90,345,119,191,233,3883
"48113013009",2763,175,1106,536,283,17,943,86,5909
"48113013010",2076,1058,870,345,436,104,1765,985,7639
"48113013011",1925,1044,894,510,489,367,1922,1323,8474
"48113013101",2292,153,18,0,149,0,66,10,2688
"48113013102",1519,48,19,0,36,5,39,5,1671
"48113013104",904,0,34,14,57,20,124,0,1153
"48113013105",3222,714,1078,486,903,260,2059,385,9107
"48113013200",5068,548,258,0,568,135,314,213,7104
"48113013300",1789,23,48,0,200,5,97,0,2162
"48113013400",1778,20,0,0,127,0,119,0,2044
"48113013500",2313,25,33,0,75,0,96,0,2542
"48113013605",4187,104,96,0,1088,221,610,211,6517
"48113013606",3004,152,696,151,1795,303,1795,337,8233
"48113013607",2663,101,85,64,505,191,525,231,4365
"48113013608",2374,46,56,0,52,13,164,0,2705
"48113013609",2123,152,258,27,532,791,645,748,5276
"48113013610",2305,74,214,82,1658,293,1545,243,6414
"48113013611",2045,83,23,0,324,8,128,0,2611
"48113013615",1117,200,790,611,2008,908,2214,1009,8857
"48113013616",3478,324,303,237,1659,174,1244,237,7656
"48113013617",2179,151,0,60,305,89,343,12,3139
"48113013618",1628,45,20,22,458,74,189,37,2473
"48113013619",3955,108,71,42,677,89,604,75,5621
"48113013620",2503,150,1002,12,615,12,415,0,4709
"48113013621",1859,122,743,12,1051,164,1017,83,5051
"48113013622",1098,108,427,37,757,364,380,427,3598
"48113013623",1504,502,1804,150,2391,765,2252,934,10302
"48113013624",1284,91,838,154,1190,97,762,38,4454
"48113013625",589,213,448,26,1069,507,1110,580,4542
"48113013626",1171,171,362,9,712,334,831,320,3910
"48113013711",1610,657,108,31,821,236,2014,735,6212
"48113013712",1544,377,0,39,408,82,997,331,3778
"48113013713",713,354,0,0,137,296,763,585,2848
"48113013714",4980,895,57,15,799,238,4358,1070,12412
"48113013715",1990,123,46,0,445,0,1933,119,4656
"48113013716",3488,290,187,97,939,91,1825,339,7256
"48113013717",1945,454,26,0,352,108,1730,440,5055
"48113013718",2938,823,344,111,635,249,2755,959,8814
"48113013719",1861,251,241,48,1273,268,573,189,4704
"48113013720",3829,612,327,103,656,343,2251,850,8971
"48113013721",4612,71,245,2,1073,48,807,36,6894
"48113013722",1976,336,706,43,542,0,656,216,4475
"48113013725",2552,665,429,56,330,183,1590,678,6483
"48113013726",1981,47,172,0,750,29,795,24,3798
"48113013727",1856,79,532,0,474,90,538,43,3612
"48113013803",5113,201,90,0,367,17,1432,87,7307
"48113013804",2445,102,103,89,555,0,1326,84,4704
"48113013805",1774,381,304,175,686,198,1133,249,4900
"48113013806",1856,40,395,0,906,30,335,0,3562
"48113013901",2104,467,103,0,758,115,2093,489,6129
"48113013902",3316,757,14,0,343,42,1587,465,6524
"48113014001",2642,165,59,0,791,186,1105,262,5210
"48113014002",55,0,0,0,0,16,0,16,87
"48113014103",1013,275,1010,134,766,153,1046,338,4735
"48113014113",1436,49,1831,376,852,193,653,71,5461
"48113014114",1115,264,564,74,1028,246,1145,296,4732
"48113014115",3671,387,907,138,2266,209,3157,144,10879
"48113014116",1844,370,1254,81,1453,0,1157,194,6353
"48113014119",3084,143,174,35,586,66,380,19,4487
"48113014120",3744,116,171,14,1091,12,337,7,5492
"48113014121",3196,139,480,71,885,350,462,67,5650
"48113014123",4138,21,130,0,1740,66,507,31,6633
"48113014124",2652,75,186,8,1445,69,729,11,5175
"48113014126",4930,295,243,0,1279,124,969,211,8051
"48113014127",1846,179,809,205,5232,161,466,46,8944
"48113014128",1448,12,517,71,1478,182,332,19,4059
"48113014129",1509,46,426,12,3420,139,255,12,5819
"48113014130",1789,24,321,106,2092,138,498,0,4968
"48113014131",1469,76,1363,226,1168,42,434,0,4778
"48113014132",840,54,237,270,643,222,134,0,2400
"48113014133",1554,346,1333,413,629,407,316,313,5311
"48113014134",2593,41,213,0,1256,0,353,0,4456
"48113014135",2796,293,203,10,1137,151,508,128,5226
"48113014136",1820,295,1317,47,2433,136,606,233,6887
"48113014137",1763,97,334,40,2398,0,429,13,5074
"48113014138",1413,188,261,8,2033,119,284,18,4324
"48113014203",1992,220,180,265,732,23,1129,174,4715
"48113014204",441,386,197,158,469,105,154,113,2023
"48113014205",1134,51,76,0,292,4,101,5,1663
"48113014206",2330,459,824,32,1114,30,848,49,5686
"48113014302",5001,531,281,3,686,275,2638,488,9903
"48113014306",3368,837,274,87,1116,311,3154,894,10041
"48113014307",2603,151,364,30,536,30,836,35,4585
"48113014308",1597,927,399,243,766,45,1477,818,6272
"48113014309",1637,876,739,267,1148,491,1941,923,8022
"48113014310",2017,367,756,330,774,242,1412,348,6246
"48113014311",590,46,266,184,3743,319,329,87,5564
"48113014312",2554,182,584,57,2187,80,1006,52,6702
"48113014403",1558,312,1140,106,821,264,1259,300,5760
"48113014405",1835,418,190,0,1102,48,2098,364,6055
"48113014406",2886,351,169,0,537,158,2097,444,6642
"48113014407",2505,254,830,348,1065,194,2595,315,8106
"48113014408",1544,394,1043,74,1094,168,1393,412,6122
"48113014501",2110,295,117,0,988,8,1978,109,5605
"48113014502",2522,931,46,63,1068,87,2440,688,7845
"48113014601",1212,231,22,11,582,16,1074,235,3383
"48113014602",2610,448,139,45,1040,395,2724,736,8137
"48113014603",679,405,38,14,359,131,749,463,2838
"48113014701",2303,749,193,105,775,353,2473,929,7880
"48113014702",1871,587,117,3,505,705,1546,1239,6573
"48113014703",968,185,21,34,503,128,1043,209,3091
"48113014901",787,218,21,9,490,119,1111,329,3084
"48113014902",1267,330,70,0,616,161,1340,415,4199
"48113015000",3873,1492,211,72,1797,551,3984,1760,13740
"48113015100",3780,777,311,28,1555,305,3364,704,10824
"48113015202",1872,1146,99,29,390,296,1729,1235,6796
"48113015204",4964,512,185,0,1310,116,2907,340,10334
"48113015205",2144,725,65,108,741,399,2087,1032,7301
"48113015206",2848,238,136,49,685,129,2013,169,6267
"48113015303",1189,526,151,0,182,56,896,496,3496
"48113015304",2373,544,0,0,634,211,1426,566,5754
"48113015305",2602,480,476,61,710,86,2050,341,6806
"48113015306",3114,275,403,77,1443,45,1945,131,7433
"48113015401",4300,498,1525,64,353,71,1707,193,8711
"48113015403",1857,533,402,239,300,26,1168,468,4993
"48113015404",2232,997,437,307,303,148,1918,951,7293
"48113015500",2058,691,79,200,410,102,1546,738,5824
"48113015600",3437,850,34,4,707,92,3392,871,9387
"48113015700",1805,633,94,7,241,56,1699,657,5192
"48113015800",1669,436,0,0,43,169,1215,596,4128
"48113015900",1955,837,598,366,325,94,1454,785,6414
"48113016001",3043,694,97,60,748,145,2961,516,8264
"48113016002",1741,560,164,66,239,116,1445,454,4785
"48113016100",1557,227,873,509,80,93,722,202,4263
"48113016201",3014,569,463,334,381,119,2585,389,7854
"48113016202",5142,1279,386,419,816,25,3863,1155,13085
"48113016301",3555,1095,709,60,1228,128,3726,1054,11555
"48113016302",1373,310,81,52,224,59,879,304,3282
"48113016401",5398,282,2391,227,1910,109,4468,224,15009
"48113016406",2929,636,472,322,469,50,2075,638,7591
"48113016407",3582,1343,1045,316,749,245,2937,1403,11620
"48113016408",3641,679,1347,0,1171,94,3142,514,10588
"48113016409",2017,271,706,0,566,63,996,292,4911
"48113016410",3176,365,1037,91,712,21,1575,159,7136
"48113016411",4913,688,1652,96,1122,3,2819,490,11783
"48113016412",2323,114,1294,20,729,0,900,11,5391
"48113016413",3069,207,1751,208,1235,162,1950,55,8637
"48113016502",3788,534,1325,668,561,141,2622,433,10072
"48113016509",3148,227,2082,208,294,31,1520,79,7589
"48113016510",4916,430,5324,620,1429,115,4151,476,17461
"48113016511",1271,79,1368,824,372,134,827,160,5035
"48113016513",2843,113,1568,245,524,0,1121,0,6414
"48113016514",2579,108,3453,417,543,80,1584,106,8870
"48113016516",3485,458,849,228,570,71,2800,420,8881
"48113016517",2200,279,1123,271,213,201,1198,415,5900
"48113016518",2615,140,1285,671,213,1,1391,96,6412
"48113016519",1895,126,418,25,136,4,949,88,3641
"48113016520",2992,847,2060,454,812,97,2899,759,10920
"48113016521",1398,752,2043,313,351,109,1189,401,6556
"48113016522",1735,312,670,0,263,8,780,236,4004
"48113016523",2571,84,1342,37,488,37,664,0,5223
"48113016605",1632,1493,2390,1938,100,12,1324,1333,10222
"48113016606",2415,318,3395,425,136,59,1398,181,8327
"48113016607",188,62,2013,998,291,32,197,50,3831
"48113016610",585,160,2773,825,143,7,410,104,5007
"48113016611",1130,510,3299,674,48,203,513,363,6740
"48113016612",2648,3,10727,291,374,39,1708,41,15831
"48113016615",1094,145,2143,296,205,32,614,104,4633
"48113016616",2083,357,2828,426,367,21,1212,314,7608
"48113016617",1363,25,2779,80,185,0,428,0,4860
"48113016618",1186,92,2557,498,233,43,513,12,5134
"48113016619",946,104,2027,336,102,0,575,90,4180
"48113016620",1342,292,3245,330,172,0,337,173,5891
"48113016621",1113,470,2816,404,149,87,605,468,6112
"48113016622",707,105,3125,192,101,16,119,0,4365
"48113016623",1731,198,3430,276,447,63,1448,209,7802
"48113016624",749,66,2012,68,97,85,475,73,3625
"48113016625",2294,390,5980,622,610,24,1401,319,11640
"48113016626",1215,415,2078,564,338,498,621,668,6397
"48113016701",279,127,4698,1480,96,61,251,176,7168
"48113016703",2598,800,5548,1268,509,103,2045,874,13745
"48113016704",895,312,2201,549,190,0,810,269,5226
"48113016705",1325,485,4137,879,237,0,1081,295,8439
"48113016802",1438,140,1798,85,117,8,834,75,4495
"48113016803",1998,224,2491,746,90,30,883,0,6462
"48113016804",1117,15,6198,745,351,107,1082,0,9615
"48113016902",1497,730,1313,163,238,119,1023,749,5832
"48113016903",2167,1176,865,343,99,175,1250,1187,7262
"48113017001",4657,1207,687,133,217,130,1330,618,8979
"48113017003",7055,1039,833,350,403,376,3817,1104,14977
"48113017004",4461,2477,670,0,369,828,3381,2697,14883
"48113017101",3251,600,606,187,356,25,2493,553,8071
"48113017102",2586,519,739,136,841,287,2733,492,8333
"48113017201",2640,1641,744,347,164,115,2022,1495,9168
"48113017202",4188,1194,1990,587,565,66,3161,852,12603
"48113017301",3404,619,1333,106,551,111,2426,591,9141
"48113017303",3914,1054,1599,99,793,26,1452,882,9819
"48113017304",5675,819,2442,161,1529,0,3156,747,14529
"48113017305",4786,298,3403,655,985,14,2276,73,12490
"48113017306",4114,940,2537,110,341,91,2226,771,11130
"48113017400",3405,893,758,294,97,0,1277,464,7188
"48113017500",2441,490,450,117,76,135,762,87,4558
"48113017602",2309,866,673,110,77,38,1126,655,5854
"48113017604",2465,293,341,153,97,136,1642,360,5487
"48113017605",1677,599,636,460,656,100,2226,684,7038
"48113017606",2605,387,1038,240,514,0,2133,301,7218
"48113017702",4102,719,1632,928,652,0,1454,244,9731
"48113017703",2425,688,589,798,181,125,1461,385,6652
"48113017704",3137,1094,629,292,473,25,2130,859,8639
"48113017804",3667,1099,764,181,504,363,1900,1271,9749
"48113017805",2696,485,1496,642,162,18,1346,518,7363
"48113017806",2595,855,539,127,625,41,1551,764,7097
"48113017807",4993,554,406,143,301,41,2753,260,9451
"48113017808",2688,246,830,80,654,0,678,34,5210
"48113017811",2904,360,395,46,466,27,1361,97,5656
"48113017812",1359,96,345,10,282,72,524,100,2788
"48113017813",2792,232,2146,150,859,302,1452,203,8136
"48113017814",3434,122,651,291,1258,89,1556,8,7409
"48113017900",3109,505,148,407,716,144,2505,534,8068
"48113018001",4000,229,1216,113,540,267,2429,70,8864
"48113018002",2163,554,301,36,353,41,1506,440,5394
"48113018104",4633,196,826,39,1407,0,1119,13,8233
"48113018105",2316,334,597,401,2036,720,3159,802,10365
"48113018110",3929,138,412,12,185,68,425,79,5248
"48113018111",3371,242,813,674,1133,524,1924,617,9298
"48113018118",3241,196,1921,249,2358,73,1279,133,9450
"48113018120",1848,268,678,19,2208,127,1524,266,6938
"48113018121",2509,296,934,279,1629,92,1654,186,7579
"48113018122",9469,207,1776,61,2100,457,2563,104,16737
"48113018123",4310,240,719,1,2222,264,1954,40,9750
"48113018124",11448,396,3233,0,2392,195,3013,321,20998
"48113018126",3841,212,1115,0,2029,138,3208,177,10720
"48113018127",1638,199,349,35,993,155,1428,266,5063
"48113018128",2323,296,1063,439,1579,263,2222,458,8643
"48113018129",1909,141,858,37,753,222,693,233,4846
"48113018130",2020,311,1103,321,223,144,896,273,5291
"48113018132",2959,190,818,562,1004,54,1221,47,6855
"48113018133",2865,123,231,0,286,103,889,124,4621
"48113018134",3780,197,1145,0,475,41,967,94,6699
"48113018135",2733,43,626,249,317,0,957,0,4925
"48113018136",5743,270,704,0,953,130,1005,51,8856
"48113018137",1672,138,675,96,1116,27,674,7,4405
"48113018138",1563,126,1387,227,1428,319,1192,107,6349
"48113018139",4580,895,854,55,838,265,1524,614,9625
"48113018140",3391,105,967,0,552,402,1172,367,6956
"48113018141",1768,228,754,477,412,119,695,256,4709
"48113018142",1596,90,312,41,1127,167,870,197,4400
"48113018203",2039,163,1480,197,2189,432,2920,522,9942
"48113018204",1242,366,503,213,1777,574,2683,885,8243
"48113018205",2132,32,579,7,1238,597,2326,541,7452
"48113018206",2169,566,132,29,1233,695,2623,1098,8545
"48113018300",2709,539,411,18,2493,386,3255,734,10545
"48113018401",1769,386,311,206,1312,1332,1587,1525,8428
"48113018402",2690,573,98,0,848,49,1476,494,6228
"48113018403",356,123,255,0,233,92,424,181,1664
"48113018501",1733,469,73,163,934,677,1531,1071,6651
"48113018503",1089,727,2227,1648,144,132,770,635,7372
"48113018505",1559,490,1178,339,430,48,1527,326,5897
"48113018506",728,575,1730,350,180,51,648,492,4754
"48113018600",2458,271,59,47,482,373,1364,419,5473
"48113018700",2875,589,106,88,1578,1361,3260,1636,11493
"48113018801",2053,678,167,6,1064,774,1502,968,7212
"48113018802",435,156,127,119,160,42,205,128,1372
"48113018900",2478,500,416,103,1923,697,2336,600,9053
"48113019004",4162,239,365,358,1720,275,3145,179,10443
"48113019013",912,557,442,453,1873,1772,2225,1934,10168
"48113019014",2092,1002,457,0,2006,2225,2310,2112,12204
"48113019016",717,799,516,436,461,275,324,556,4084
"48113019018",2288,432,859,628,1017,175,847,268,6514
"48113019019",1956,792,1811,1061,1151,385,1075,589,8820
"48113019020",2236,177,294,52,1833,307,670,0,5569
"48113019021",3260,255,301,285,1981,1301,1588,1088,10059
"48113019023",3322,86,242,12,1189,11,451,0,5313
"48113019024",2062,483,621,42,1032,100,716,286,5342
"48113019025",2514,203,413,0,1724,23,954,181,6012
"48113019026",2586,334,426,17,1521,274,1111,193,6462
"48113019027",2582,314,762,87,1368,122,1225,23,6483
"48113019028",1606,117,329,100,1316,102,1130,89,4789
"48113019029",2491,118,493,142,1355,899,1193,253,6944
"48113019031",3928,201,492,30,1113,120,911,86,6881
"48113019032",1636,103,130,38,1641,589,2141,339,6617
"48113019033",1797,546,121,97,1280,899,2107,1041,7888
"48113019034",1163,197,1794,539,501,202,502,103,5001
"48113019035",1969,1177,834,467,573,317,1381,1100,7818
"48113019036",2146,74,69,0,570,0,311,0,3170
"48113019037",2385,35,171,0,799,179,843,0,4412
"48113019038",547,24,181,7,153,13,45,0,970
"48113019039",3622,257,419,330,923,77,758,184,6570
"48113019040",1434,251,1674,132,2435,284,589,15,6814
"48113019041",1837,71,401,0,538,40,261,1,3149
"48113019042",2699,111,792,12,1384,71,866,11,5946
"48113019043",5580,170,387,0,1458,0,516,0,8111
"48113019100",3491,321,437,134,1404,255,1013,48,7103
"48113019202",2894,799,299,13,493,604,1124,1062,7288
"48113019203",2976,272,45,0,363,239,294,207,4396
"48113019204",5320,937,1019,200,2146,34,4248,792,14696
"48113019205",3293,52,35,0,213,6,156,0,3755
"48113019206",3640,801,142,121,656,938,753,182,7233
"48113019208",1171,391,674,125,2456,1939,2678,1970,11404
"48113019210",3640,100,11,0,250,0,62,0,4063
"48113019211",4008,329,299,10,445,88,1072,171,6422
"48113019212",291,640,44,10,1741,1602,1993,2169,8490
"48113019213",542,499,433,229,684,802,712,931,4832
"48113019301",2937,0,0,0,69,31,101,0,3138
"48113019302",2295,233,0,0,139,0,277,10,2954
"48113019400",3400,341,0,0,266,66,135,0,4208
"48113019501",6791,118,0,0,365,0,236,65,7575
"48113019502",4165,112,0,0,210,38,201,38,4764
"48113019600",1994,70,0,0,177,10,87,10,2348
"48113019700",1576,80,0,0,78,6,87,10,1837
"48113019800",4433,221,0,0,261,0,357,33,5305
"48113019900",2354,910,122,0,781,117,2873,978,8135
"48113020000",2678,80,376,0,1332,5,483,80,5034
"48113020100",1309,319,30,13,563,226,1313,380,4153
"48113020200",369,192,2429,827,4,109,372,225,4527
"48113020300",141,77,1228,550,0,0,69,30,2095
"48113020400",2705,840,1053,1079,567,63,1230,103,7640
"48113020500",665,657,1235,1969,311,286,651,607,6381
"48113020600",2179,27,0,0,203,5,260,0,2674
"48113020700",3301,113,324,15,571,0,720,0,5044
"48113980000",0,0,0,0,0,0,0,0,0
"48113980100",0,0,0,0,0,0,0,0,0
"48115950401",3362,280,35,10,604,251,2126,379,7047
"48115950402",1053,291,7,22,364,27,993,282,3039
"48115950500",2538,519,86,67,175,185,1467,654,5691
"48115950600",1327,270,12,0,134,2,471,131,2347
"48117950300",4519,1147,61,0,369,79,3141,1052,10368
"48117950400",3937,861,44,8,310,364,3139,1225,9888
"48117950500",2151,745,24,23,305,365,2194,933,6740
"48117950600",2997,321,26,0,282,42,1341,258,5267
"48119950100",2347,358,12,34,184,34,111,69,3149
"48119950200",1266,399,103,298,63,54,86,82,2351
"48121020103",9095,802,42,1,1066,124,2159,430,13719
"48121020104",3390,47,221,0,21,0,645,0,4324
"48121020105",5881,239,870,243,1163,0,1205,0,9601
"48121020106",5299,256,261,20,293,0,965,0,7094
"48121020107",4542,265,408,16,502,0,794,19,6546
"48121020108",9041,555,3717,95,1945,0,2146,170,17669
"48121020109",2270,23,385,0,949,58,351,63,4099
"48121020110",3725,94,825,0,1090,0,699,0,6433
"48121020111",3685,56,173,0,268,0,700,7,4889
"48121020112",2370,33,293,23,461,42,426,20,3668
"48121020113",6400,89,2253,62,2138,0,2925,0,13867
"48121020114",6927,642,919,126,403,676,3412,378,13483
"48121020115",3680,550,229,0,574,201,999,507,6740
"48121020202",8626,290,70,62,479,20,1396,143,11086
"48121020203",4273,574,493,23,250,0,488,101,6202
"48121020204",3225,339,44,0,119,20,343,16,4106
"48121020205",1564,188,8,0,71,126,254,47,2258
"48121020303",9866,523,60,36,309,12,1113,142,12061
"48121020305",6556,177,199,0,354,0,360,0,7646
"48121020306",5543,284,218,0,779,68,995,103,7990
"48121020307",8702,320,173,30,457,400,739,38,10859
"48121020308",8911,328,310,61,783,0,1821,9,12223
"48121020309",7543,949,92,7,387,41,840,431,10290
"48121020310",2582,89,47,0,124,0,160,0,3002
"48121020401",6106,1050,413,51,527,106,1315,571,10139
"48121020402",3780,413,265,75,321,19,656,32,5561
"48121020403",2279,884,32,106,253,73,234,241,4102
"48121020503",4286,1192,382,172,357,370,1447,372,8578
"48121020504",1900,385,260,164,252,20,684,178,3843
"48121020505",6123,170,212,1,103,90,753,1,7453
"48121020506",1653,76,0,0,10,0,422,33,2194
"48121020601",1904,781,122,199,263,418,705,592,4984
"48121020602",6175,1051,670,138,696,0,2675,613,12018
"48121020700",1519,662,72,89,252,452,212,138,3396
"48121020800",2481,982,473,798,451,192,740,355,6472
"48121020900",1016,904,59,116,330,293,495,556,3769
"48121021000",1131,1295,37,41,123,217,298,372,3514
"48121021100",1026,853,136,193,135,377,182,184,3086
"48121021201",2933,1059,979,672,331,529,862,478,7843
"48121021202",1726,337,719,490,196,68,1196,184,4916
"48121021301",1491,1540,311,246,212,446,377,224,4847
"48121021303",5256,219,517,1,630,95,800,189,7707
"48121021304",4103,437,411,16,321,62,736,307,6393
"48121021305",2925,431,295,54,273,15,475,125,4593
"48121021403",9663,266,258,8,700,27,1665,59,12646
"48121021404",7526,387,424,0,341,42,1057,56,9833
"48121021405",7478,1164,332,57,734,9,2561,722,13057
"48121021406",5673,153,540,0,1157,35,1665,59,9282
"48121021407",4752,886,604,0,525,0,1463,518,8748
"48121021408",5359,273,306,40,457,70,763,55,7323
"48121021409",6309,289,159,292,400,204,801,86,8540
"48121021502",2928,846,242,74,364,88,1308,635,6485
"48121021505",3809,539,471,137,729,0,512,416,6613
"48121021512",4033,220,185,0,315,5,300,0,5058
"48121021513",3435,59,0,0,168,0,303,10,3975
"48121021514",4102,47,124,0,110,0,302,0,4685
"48121021515",6843,240,494,0,1962,193,2021,259,12012
"48121021516",5078,329,351,118,944,25,893,114,7852
"48121021517",1020,18,397,88,1243,84,240,84,3174
"48121021518",2595,37,136,0,376,13,133,0,3290
"48121021519",9477,668,1110,377,1449,186,2591,101,15959
"48121021520",2838,383,102,74,405,0,753,241,4796
"48121021521",2830,341,542,0,791,0,965,0,5469
"48121021522",907,18,110,0,689,10,279,7,2020
"48121021523",2491,278,82,0,560,0,1086,166,4663
"48121021524",1364,0,79,0,279,12,147,0,1881
"48121021525",6479,120,640,0,2228,0,778,0,10245
"48121021526",4970,57,450,55,954,17,301,0,6804
"48121021527",4934,116,93,111,750,0,360,12,6376
"48121021611",2850,274,434,8,519,242,780,242,5349
"48121021612",2764,97,163,12,885,60,814,105,4900
"48121021613",3255,643,649,148,951,170,1817,472,8105
"48121021614",2793,142,169,42,548,154,1808,187,5843
"48121021615",3556,130,107,249,572,46,1992,143,6795
"48121021616",1948,244,879,200,654,147,773,227,5072
"48121021618",2857,542,226,9,490,87,1477,447,6135
"48121021619",1766,530,168,0,342,95,1136,454,4491
"48121021620",1018,37,315,89,530,69,311,4,2373
"48121021621",2690,129,124,14,679,0,277,52,3965
"48121021622",3173,49,225,0,1848,58,436,0,5789
"48121021623",2122,237,714,40,3116,348,422,206,7205
"48121021624",4263,121,1136,0,1653,337,1682,11,9203
"48121021625",3725,46,393,8,1963,64,465,0,6664
"48121021626",1830,158,16,0,151,0,77,0,2232
"48121021627",5704,272,594,0,740,68,374,76,7828
"48121021628",3885,50,383,16,2393,1,1668,2,8398
"48121021629",3941,160,521,13,1571,64,542,10,6822
"48121021630",3181,85,741,49,1085,15,928,70,6154
"48121021631",3573,142,531,88,1095,36,853,81,6399
"48121021632",2616,212,124,205,471,13,402,129,4172
"48121021633",3866,86,210,0,470,66,791,41,5530
"48121021634",2232,526,1460,464,398,207,949,305,6541
"48121021635",1521,335,1280,139,670,137,413,268,4763
"48121021636",3267,205,2356,395,903,114,1001,35,8276
"48121021637",2515,419,770,246,702,40,1409,380,6481
"48121021638",2122,161,844,74,414,23,906,81,4625
"48121021715",3081,60,390,62,622,86,469,27,4797
"48121021716",3775,262,489,28,304,20,1067,91,6036
"48121021717",5245,120,363,0,355,0,1237,44,7364
"48121021718",8729,148,70,0,686,0,1006,0,10639
"48121021719",3824,22,233,0,372,19,238,10,4718
"48121021720",2314,8,250,11,763,0,276,0,3622
"48121021721",3891,55,53,0,79,0,441,0,4519
"48121021722",3177,164,162,0,396,74,461,55,4489
"48121021723",718,153,189,0,591,0,407,109,2167
"48121021724",3446,65,185,0,563,0,275,0,4534
"48121021725",3091,0,117,0,406,45,298,45,4002
"48121021726",2840,35,54,16,441,22,360,35,3803
"48121021727",3199,135,206,146,979,59,378,0,5102
"48121021728",1889,197,186,0,267,313,1014,411,4277
"48121021729",2278,108,392,10,382,34,548,18,3770
"48121021730",2908,75,211,3,520,9,463,3,4192
"48121021731",3020,109,369,28,453,62,1046,31,5118
"48121021732",1201,71,268,0,526,115,592,0,2773
"48121021733",2492,414,590,5,521,16,1119,418,5575
"48121021734",1575,265,557,153,350,262,498,476,4136
"48121021735",2001,134,851,22,362,15,605,41,4031
"48121021736",1153,29,548,2,540,5,322,29,2628
"48121021737",2399,167,364,213,1281,79,688,44,5235
"48121021738",1831,107,317,0,580,103,665,36,3639
"48121021739",1981,275,397,108,499,289,1232,333,5114
"48121021740",3477,291,443,40,501,52,1120,139,6063
"48121021741",1366,88,69,151,235,89,413,103,2514
"48121021742",3971,208,191,64,1348,140,1507,204,7633
"48121021743",2323,247,430,0,728,7,1710,126,5571
"48121021744",1870,526,126,0,428,264,1118,471,4803
"48121021745",3669,313,154,0,970,486,2172,421,8185
"48121021746",3015,93,78,0,321,27,369,0,3903
"48121021747",3576,146,297,0,408,18,86,18,4549
"48121021748",3572,0,391,0,303,35,347,0,4648
"48121021749",3171,28,62,0,179,0,87,0,3527
"48121021750",3386,0,138,0,481,135,227,4,4371
"48121021751",3741,13,9,12,1264,75,352,0,5466
"48121021752",4138,42,50,0,931,22,606,0,5789
"48121021753",4834,7,152,0,446,28,418,0,5885
"48121021800",3133,60,370,0,461,13,89,0,4126
"48121021900",3771,12,302,0,581,0,216,0,4882
"48123970100",2736,247,108,34,476,228,825,341,4995
"48123970200",1447,449,755,172,1059,417,1417,601,6317
"48123970300",2773,126,187,150,593,129,1014,129,5101
"48123970400",3035,260,38,27,220,188,776,227,4771
"48123970500",1916,206,145,9,390,175,667,290,3798
"48125950300",1526,379,31,14,103,24,310,238,2625
"48127950200",6656,1286,35,0,339,55,5965,1334,15670
"48127950400",1509,654,0,2,45,6,1389,413,4018
"48129950200",1371,223,54,100,8,20,59,17,1852
"48129950300",1249,224,24,10,20,8,149,61,1745
"48131950100",2523,983,0,0,631,215,2831,1169,8352
"48131950200",2107,490,0,41,266,57,1941,488,5390
"48131950500",2601,703,0,0,209,128,2522,822,6985
"48133950100",2788,468,136,0,77,18,886,214,4587
"48133950200",4167,818,20,18,245,27,240,59,5594
"48133950300",3419,656,46,180,74,182,195,182,4934
"48133950400",1547,335,0,0,8,0,140,0,2030
"48133950500",1675,459,0,0,5,1,416,147,2703
"48135000100",2561,414,35,0,271,15,1119,301,4716
"48135000300",1321,339,13,101,216,0,467,49,2506
"48135000400",3424,238,0,38,301,30,1642,149,5822
"48135000500",3525,765,341,89,304,5,2130,490,7649
"48135000600",4257,696,35,0,937,90,3447,582,10044
"48135000700",3445,490,246,0,431,215,2801,401,8029
"48135000800",2852,750,157,10,345,47,2193,691,7045
"48135001000",3917,207,73,0,653,27,2923,127,7927
"48135001100",5244,939,131,13,784,28,4554,841,12534
"48135001300",3848,432,0,0,556,111,2563,421,7931
"48135001500",3790,638,91,41,396,48,3361,492,8857
"48135001600",4738,434,26,0,662,117,2757,321,9055
"48135001700",5721,353,410,357,541,231,2396,393,10402
"48135001800",939,730,758,132,482,276,1394,893,5604
"48135001900",3057,1442,380,0,657,167,3415,1609,10727
"48135002000",2284,602,171,215,73,148,2239,684,6416
"48135002200",2711,449,7,0,219,144,2123,542,6195
"48135002300",3251,39,327,21,227,9,1115,8,4997
"48135002400",4641,216,0,38,332,15,1605,161,7008
"48135002501",4321,125,77,0,407,0,2052,67,7049
"48135002502",4953,527,357,40,493,58,2133,492,9053
"48135002503",4357,341,184,68,846,89,1796,403,8084
"48135002700",7933,1272,306,11,511,338,4801,869,16041
"48135002801",3308,763,82,0,234,63,2511,661,7622
"48135002802",6997,961,0,0,565,239,5402,795,14959
"48135002900",3483,78,52,0,190,0,1231,53,5087
"48135003000",7182,614,594,0,930,58,4002,338,13718
"48135003100",2493,514,83,24,250,28,2262,413,6067
"48137950300",1668,184,0,0,21,21,772,195,2861
"48139060101",4672,621,780,121,548,416,1733,762,9653
"48139060102",5255,604,229,5,967,225,2511,498,10294
"48139060204",6893,354,1416,68,470,73,1852,173,11299
"48139060206",4042,702,1133,0,368,84,1648,287,8264
"48139060207",5083,281,552,122,466,68,1341,101,8014
"48139060208",2844,181,710,36,208,88,321,123,4511
"48139060209",3458,192,104,0,233,0,537,0,4524
"48139060210",1270,55,31,0,47,65,250,65,1783
"48139060211",2852,103,40,1,50,7,381,1,3435
"48139060212",3983,152,380,0,555,32,957,63,6122
"48139060213",5392,451,19,27,586,141,942,323,7881
"48139060214",7262,43,291,0,586,26,689,46,8943
"48139060300",2839,325,109,124,433,264,705,461,5260
"48139060400",1447,292,1162,664,341,33,526,240,4705
"48139060500",2192,484,134,15,148,37,842,297,4149
"48139060600",5582,852,1158,524,596,40,1562,593,10907
"48139060701",1668,135,97,0,180,28,730,69,2907
"48139060702",2652,247,497,9,347,0,659,24,4435
"48139060703",1609,145,126,15,119,16,181,62,2273
"48139060801",6185,177,27,0,121,1,561,11,7083
"48139060802",5891,228,217,103,135,66,278,159,7077
"48139060803",964,203,311,0,34,0,263,124,1899
"48139060900",4838,568,44,1,279,13,717,239,6699
"48139061000",2953,322,294,68,216,11,577,128,4569
"48139061100",3504,611,93,1,595,304,1089,674,6871
"48139061200",1412,247,80,15,170,31,503,161,2619
"48139061300",1720,624,35,0,146,25,383,554,3487
"48139061400",6219,570,185,35,897,123,1588,295,9912
"48139061500",1683,1324,640,340,700,522,1475,1637,8321
"48139061600",2783,1087,585,358,453,546,1664,1207,8683
"48139061700",4312,638,65,0,158,0,866,457,6496
"48141000101",5288,1072,535,0,432,16,3954,1008,12305
"48141000106",4148,326,795,27,761,15,3067,258,9397
"48141000107",3712,842,301,180,611,37,3472,828,9983
"48141000108",1292,713,292,12,244,83,929,742,4307
"48141000109",1994,1225,100,138,339,115,1913,1239,7063
"48141000110",2582,1057,260,96,181,104,2193,982,7455
"48141000111",1854,157,259,105,281,153,902,258,3969
"48141000112",3253,855,75,38,114,90,2270,669,7364
"48141000204",3093,918,286,6,276,221,2450,737,7987
"48141000205",2145,1020,271,61,162,81,1733,1037,6510
"48141000206",3591,828,131,0,237,122,3143,801,8853
"48141000207",2639,1092,268,70,268,41,1973,1032,7383
"48141000208",2129,1302,79,8,183,12,1735,1197,6645
"48141000301",3440,2472,447,53,196,15,3159,2321,12103
"48141000302",2887,1931,41,36,367,205,2777,1998,10242
"48141000401",4511,334,656,39,589,57,3104,293,9583
"48141000403",1960,520,118,59,190,91,1777,580,5295
"48141000404",1448,2095,107,69,92,271,1312,2308,7702
"48141000600",2680,818,103,44,576,162,2749,957,8089
"48141000800",3551,1974,23,83,125,185,3510,2009,11460
"48141000900",6110,1941,361,57,856,706,5443,2502,17976
"48141001001",2241,687,68,8,166,141,2303,794,6408
"48141001002",1947,1275,0,30,509,132,2353,1385,7631
"48141001104",4806,948,68,46,1666,449,4274,1236,13493
"48141001107",5846,485,167,0,690,239,4110,698,12235
"48141001109",3788,152,129,2,497,218,2105,314,7205
"48141001110",3225,778,60,16,895,250,2400,947,8571
"48141001111",3020,492,148,26,477,633,2274,968,8038
"48141001112",3697,328,8,10,643,90,2862,416,8054
"48141001113",4903,719,141,1,1240,474,4218,975,12671
"48141001114",2623,1036,29,0,748,546,2437,1365,8784
"48141001115",1373,681,57,23,507,809,1532,1478,6460
"48141001201",2615,1041,80,60,708,818,3139,1833,10294
"48141001202",2957,582,98,0,943,402,3065,741,8788
"48141001203",411,258,0,0,44,92,406,341,1552
"48141001301",2676,288,11,19,687,39,1833,265,5818
"48141001302",5991,351,0,0,674,285,3917,568,11786
"48141001400",922,486,43,4,277,243,962,609,3546
"48141001501",3762,479,43,0,764,403,3282,495,9228
"48141001502",1650,271,22,0,341,154,865,324,3627
"48141001600",1980,894,30,25,257,868,1830,1612,7496
"48141001700",136,216,5,0,52,38,162,239,848
"48141001800",474,524,0,0,43,164,513,673,2391
"48141001900",881,1179,0,18,119,225,991,1415,4828
"48141002000",839,1199,19,4,86,104,864,1296,4411
"48141002100",655,1350,24,54,83,263,683,1511,4623
"48141002201",1922,550,29,93,344,169,1859,702,5668
"48141002202",1875,1229,59,36,409,375,2115,1579,7677
"48141002300",3272,1096,11,0,94,101,2830,1129,8533
"48141002400",2373,493,0,31,138,113,2134,594,5876
"48141002500",4174,958,66,23,307,219,3854,1070,10671
"48141002600",1954,965,38,24,107,12,2026,977,6103
"48141002800",1459,2480,67,28,265,440,1667,2947,9353
"48141002900",568,438,2,2,107,76,675,513,2381
"48141003000",2385,1304,127,0,55,179,2421,1447,7918
"48141003100",2540,970,33,0,150,129,2711,1061,7594
"48141003200",1539,695,0,7,188,114,1690,782,5015
"48141003300",3498,780,0,0,355,77,3449,787,8946
"48141003402",4013,1787,369,0,284,307,3733,2013,12506
"48141003403",4258,287,347,37,460,11,3746,265,9411
"48141003404",5026,439,85,11,800,57,4253,290,10961
"48141003501",1818,629,32,0,126,85,1812,714,5216
"48141003502",2691,1393,0,85,222,505,2636,1857,9389
"48141003601",2197,1370,180,0,187,135,2351,1493,7913
"48141003602",1591,539,0,35,88,96,1612,638,4599
"48141003701",2539,878,139,8,469,180,2952,1066,8231
"48141003702",2785,1137,0,6,259,257,2951,1345,8740
"48141003801",3735,1116,13,0,509,63,4215,1171,10822
"48141003803",1991,586,31,0,333,41,2231,571,5784
"48141003804",2563,1157,0,0,81,220,2557,1366,7944
"48141003901",2109,1170,38,8,410,46,2447,1214,7442
"48141003902",1418,737,0,2,387,57,1580,754,4935
"48141003903",2675,3741,0,0,212,457,2794,4172,14051
"48141004002",6742,1574,0,1,857,2,7561,1475,18212
"48141004003",5224,1833,45,34,628,73,5734,1899,15470
"48141004004",3998,1581,29,0,405,195,4340,1658,12206
"48141004103",4292,1966,56,28,149,233,4153,2172,13049
"48141004104",4258,1459,20,79,746,205,4754,1647,13168
"48141004105",2360,679,0,37,129,282,2431,998,6916
"48141004106",3343,1219,38,13,478,84,3598,1301,10074
"48141004107",1195,173,0,0,167,26,1263,194,3018
"48141004201",3642,1342,131,0,256,484,3831,1808,11494
"48141004202",3276,1142,161,93,348,85,3407,1236,9748
"48141004303",4835,211,0,15,726,31,4087,153,10058
"48141004307",4063,914,118,2,380,148,3202,985,9812
"48141004309",3686,1039,222,17,688,241,3537,1137,10567
"48141004310",3329,1394,89,32,242,216,3020,1521,9843
"48141004311",3660,346,46,28,420,76,3196,367,8139
"48141004312",3988,1043,54,47,557,68,3959,1070,10786
"48141004313",1876,688,211,2,306,153,1754,695,5685
"48141004314",4024,323,13,0,597,18,4041,288,9304
"48141004316",5355,877,47,0,426,0,5267,862,12834
"48141004317",2746,353,167,134,281,210,1826,547,6264
"48141004318",3780,188,86,2,255,156,3262,342,8071
"48141004319",4824,492,172,0,461,54,4270,524,10797
"48141004320",2414,510,72,0,194,37,2384,529,6140
"48141010101",1398,43,653,15,243,15,329,0,2696
"48141010102",1611,345,314,166,197,3,664,139,3439
"48141010103",978,68,236,42,99,82,267,48,1820
"48141010203",1653,469,15,0,618,527,2179,978,6439
"48141010207",5295,612,596,37,354,89,3129,524,10636
"48141010210",4423,409,1066,26,742,120,3109,370,10265
"48141010211",2259,48,245,125,276,0,1341,35,4329
"48141010212",4973,335,1110,73,773,15,3862,270,11411
"48141010213",5507,175,464,0,1289,17,4115,179,11746
"48141010214",4503,278,29,0,1345,30,3188,147,9520
"48141010215",5157,426,89,28,1658,9,5123,213,12703
"48141010216",4744,1219,149,54,1711,704,5606,1977,16164
"48141010217",4176,280,68,102,954,0,3652,382,9614
"48141010218",2456,35,39,0,929,0,2450,17,5926
"48141010219",5729,625,101,0,1396,246,5299,731,14127
"48141010220",1477,695,6,0,1123,1056,2473,1670,8500
"48141010221",2778,1164,353,12,981,830,3510,1908,11536
"48141010222",1550,155,0,0,144,152,1365,200,3566
"48141010303",2426,453,134,2,286,64,2143,353,5861
"48141010307",4073,1341,260,30,199,312,3638,1459,11312
"48141010311",5525,1158,254,1,548,143,4913,1254,13796
"48141010312",2929,579,91,0,729,95,2960,465,7848
"48141010316",3165,1114,65,0,208,17,2898,1113,8580
"48141010317",2979,565,85,5,585,68,3223,560,8070
"48141010319",453,45,33,0,40,0,391,45,1007
"48141010322",3322,1211,16,0,432,54,3131,1203,9369
"48141010323",3717,686,102,0,93,21,3268,406,8293
"48141010324",6802,584,310,17,756,157,6811,639,16076
"48141010325",6339,1252,155,16,831,124,6751,1367,16835
"48141010326",4177,599,23,0,244,0,3389,583,9015
"48141010327",3108,389,49,0,251,10,3051,399,7257
"48141010328",2872,146,142,0,263,10,2763,156,6352
"48141010329",3948,1076,0,0,372,137,3949,1188,10670
"48141010330",7464,1987,772,49,1136,234,7082,2270,20994
"48141010331",8675,1893,820,0,802,226,7984,1705,22105
"48141010332",5218,2715,95,22,478,117,4759,2768,16172
"48141010333",2874,1464,0,0,284,19,3098,1447,9186
"48141010334",2938,642,0,0,156,132,3004,756,7628
"48141010335",1937,1931,0,0,42,9,1900,1930,7749
"48141010336",4987,802,0,0,788,163,5349,955,13044
"48141010337",4838,815,69,0,390,16,4941,831,11900
"48141010338",6152,768,0,0,420,18,5386,753,13497
"48141010339",4420,1879,25,0,391,172,4181,2008,13076
"48141010340",1157,924,0,0,119,34,1223,958,4415
"48141010341",21848,2858,1463,530,2376,131,21735,3026,53967
"48141010342",10959,968,650,14,1690,432,11276,1236,27225
"48141010343",5614,348,144,18,869,0,4979,202,12174
"48141010344",1878,682,0,0,212,173,2057,830,5832
"48141010345",5198,2032,0,0,982,235,5571,2242,16260
"48141010346",2697,1624,16,9,280,187,2832,1792,9437
"48141010347",2139,1094,0,72,437,1062,2424,2214,9442
"48141010401",3707,1548,0,8,351,201,3813,1722,11350
"48141010404",2080,1099,8,5,748,421,2672,1469,8502
"48141010405",3245,1494,0,0,1276,281,4405,1680,12381
"48141010406",1154,708,0,0,733,618,1887,1326,6426
"48141010407",2074,2276,0,0,1354,1405,3428,3678,14215
"48141010408",2583,934,0,0,508,59,2913,982,7979
"48141010409",3527,2103,34,0,644,86,4089,2181,12664
"48141010501",1501,1343,0,38,643,451,2037,1829,7842
"48141010502",958,683,0,60,63,91,861,834,3550
"48141010504",809,561,0,0,100,139,887,700,3196
"48141010505",1158,1489,0,0,578,292,1637,1695,6849
"48141010506",2027,1228,0,5,142,140,2169,1373,7084
"48141010600",3698,322,1288,125,1017,131,1342,192,8115
"48141980000",0,0,0,0,0,0,0,0,0
"48143950100",2578,274,0,0,15,0,111,27,3005
"48143950201",2417,459,0,0,129,460,477,544,4486
"48143950202",5241,1365,16,0,324,52,442,544,7984
"48143950300",3818,1085,0,2,692,92,1685,495,7869
"48143950400",3193,1487,17,96,581,20,565,187,6146
"48143950500",5048,2228,125,99,159,71,776,539,9045
"48143950600",2231,1090,41,0,89,120,487,211,4269
"48143950700",2028,335,0,0,188,5,572,167,3295
"48145000200",1898,342,100,92,49,5,431,165,3082
"48145000300",1389,804,510,359,112,84,732,698,4688
"48145000400",243,39,890,424,80,33,202,39,1950
"48145000500",2128,231,63,132,97,7,253,97,3008
"48145000700",1897,285,236,215,58,12,327,172,3202
"48145000800",1884,156,436,197,17,0,158,32,2880
"48147950100",2172,336,142,180,35,41,303,115,3324
"48147950300",2270,390,20,2,181,28,46,39,2976
"48147950401",1512,542,65,50,106,89,170,107,2641
"48147950402",4335,824,181,257,103,69,777,0,6546
"48147950500",1948,302,132,87,96,40,46,10,2661
"48147950600",1919,259,33,10,105,59,79,19,2483
"48147950701",3631,457,91,27,95,155,206,197,4859
"48147950702",2640,460,93,18,105,48,249,180,3793
"48147950800",3237,538,109,0,149,37,140,105,4315
"48149970100",1653,153,125,10,9,0,136,32,2118
"48149970200",1822,197,217,33,27,0,168,6,2470
"48149970300",4116,792,192,284,147,45,1264,457,7297
"48149970400",2947,366,157,21,69,38,424,29,4051
"48149970500",3162,411,151,23,188,65,994,263,5257
"48149970600",4117,319,355,124,22,5,866,16,5824
"48149970700",1830,135,68,0,0,0,147,0,2180
"48151950300",1371,204,23,0,41,27,254,197,2117
"48151950400",1514,321,63,46,128,68,556,161,2857
"48153950500",1811,463,37,2,71,35,894,407,3720
"48153950600",2566,778,63,67,203,30,1527,618,5852
"48155950100",938,114,35,0,77,0,102,30,1296
"48157670101",1730,762,2200,423,1362,905,2877,1667,11926
"48157670102",489,72,1751,122,640,190,1078,255,4597
"48157670200",1527,473,4517,469,1229,273,2530,740,11758
"48157670300",617,41,2319,213,176,379,710,305,4760
"48157670400",528,127,3754,331,430,89,693,141,6093
"48157670500",606,1,2368,406,608,175,643,203,5010
"48157670601",615,103,7227,253,1151,9,1110,103,10571
"48157670602",218,51,1017,204,245,28,434,50,2247
"48157670700",859,48,2185,136,1174,194,803,1,5400
"48157670800",1682,898,9548,697,3269,353,4221,1103,21771
"48157670901",2991,31,5172,46,3937,26,1138,13,13354
"48157670902",735,103,3246,254,1261,340,1637,432,8008
"48157671001",3239,187,1241,68,539,19,595,53,5941
"48157671002",2732,488,2780,105,702,12,1218,321,8358
"48157671100",2558,908,2796,258,1468,304,2153,1089,11534
"48157671200",1900,365,3141,458,558,109,1644,370,8545
"48157671300",1334,179,982,327,1039,69,1335,135,5400
"48157671400",2185,696,2145,54,3524,269,1445,270,10588
"48157671501",2551,31,1779,189,2895,112,808,16,8381
"48157671502",378,16,447,34,769,16,118,0,1778
"48157671601",3823,54,571,45,2237,60,620,24,7434
"48157671602",2019,54,48,0,1173,94,285,0,3673
"48157671700",3302,218,449,51,570,43,195,14,4842
"48157671800",1528,76,759,0,839,18,658,13,3891
"48157671900",2216,177,229,19,771,90,649,82,4233
"48157672001",2042,807,930,106,3788,451,802,150,9076
"48157672002",1959,308,1050,271,1975,586,590,348,7087
"48157672100",2276,60,47,0,1006,115,168,0,3672
"48157672200",2466,140,239,101,428,0,951,10,4335
"48157672301",1981,1,1373,27,4127,501,1899,242,10151
"48157672302",5054,273,305,0,2989,86,1402,152,10261
"48157672400",3932,1097,1998,313,1903,439,2479,1288,13449
"48157672500",1950,647,1861,161,2696,204,1835,820,10174
"48157672601",4315,666,1720,453,2232,452,4560,847,15245
"48157672602",2154,52,2214,295,1567,276,2268,118,8944
"48157672701",3179,382,3303,274,7074,1349,3446,1215,20222
"48157672702",3538,98,1118,263,1668,348,1106,0,8139
"48157672800",2254,66,1251,355,3195,168,716,44,8049
"48157672900",14631,598,9864,1170,10959,915,8761,347,47245
"48157673001",6020,108,365,0,1384,0,683,55,8615
"48157673002",5298,299,539,388,2253,0,1603,79,10459
"48157673003",8211,298,474,0,3523,234,1836,92,14668
"48157673101",35062,845,4122,79,13235,285,9627,276,63531
"48157673102",12503,140,815,0,3607,0,2843,0,19908
"48157673200",8096,192,515,26,1073,46,1497,52,11497
"48157673300",4505,97,191,22,206,196,435,142,5794
"48157673400",14059,198,2264,0,1968,209,3002,41,21741
"48157673500",6396,112,508,0,699,0,1162,57,8934
"48157673600",6559,265,0,0,290,158,1156,214,8642
"48157673700",7,2,0,2,0,2,0,0,13
"48157673800",3501,207,854,48,4765,253,1512,260,11400
"48157673901",4572,287,475,4,3570,0,445,4,9357
"48157673902",1722,26,550,0,7752,176,384,0,10610
"48157674000",4279,163,299,0,2732,364,865,25,8727
"48157674100",4420,126,517,2,1842,82,742,81,7812
"48157674200",3017,136,119,0,2277,5,251,16,5821
"48157674300",3201,0,1448,0,4191,147,857,0,9844
"48157674400",4860,250,484,0,8345,55,1068,0,15062
"48157674501",3649,0,3034,0,2983,55,777,45,10543
"48157674502",10624,766,3223,438,3304,484,2452,1047,22338
"48157674601",2749,23,224,0,444,0,330,0,3770
"48157674602",6218,0,394,44,1128,55,1377,39,9255
"48157674603",4763,427,588,19,274,59,1961,210,8301
"48157674604",2148,0,1200,182,1422,0,1184,0,6136
"48157674700",5613,297,2332,1,3018,801,1998,482,14542
"48157674800",3199,1059,717,501,85,2,2256,940,8759
"48157674900",2585,1593,743,202,496,137,2954,1663,10373
"48157675000",1990,500,377,174,94,118,1803,568,5624
"48157675100",6250,1245,1250,386,1144,162,4261,1112,15810
"48157675200",4314,1070,130,95,426,20,3540,932,10527
"48157675300",4146,901,203,511,921,359,3339,911,11291
"48157675400",5359,1271,511,48,192,87,3116,931,11515
"48157675500",8898,784,2416,19,1909,259,5324,779,20388
"48157675600",5335,620,0,8,137,38,1837,500,8475
"48157675700",5060,560,462,56,219,37,1030,327,7751
"48157675800",2397,141,438,223,14,19,1273,94,4599
"48159950100",4725,302,37,0,123,122,165,122,5596
"48159950200",1617,385,174,306,166,29,348,74,3099
"48159950300",1854,486,9,0,60,96,301,357,3163
"48161000100",3637,844,484,57,159,66,419,612,6278
"48161000200",924,66,110,6,36,21,114,48,1325
"48161000300",527,120,378,21,11,0,167,17,1241
"48161000400",1642,154,403,119,45,15,98,17,2493
"48161000600",2937,177,117,3,97,9,198,46,3584
"48161000700",2118,402,342,185,91,67,334,128,3667
"48161000900",840,227,407,115,19,9,42,172,1831
"48163950100",4384,482,173,2,464,672,3455,1027,10659
"48163950200",2665,981,0,0,1618,241,3873,1076,10454
"48163950300",1842,834,0,0,567,109,1767,903,6022
"48165950100",2978,501,57,1,181,83,2187,524,6512
"48165950200",7638,906,108,0,259,257,1388,314,10870
"48165950300",4834,337,169,0,381,92,2737,231,8781
"48167720100",4562,326,229,0,171,270,631,19,6208
"48167720200",3921,196,115,0,519,0,389,19,5159
"48167720301",1823,102,85,0,114,13,317,25,2479
"48167720302",6648,285,98,0,417,0,1179,219,8846
"48167720400",5597,154,135,0,628,16,712,2,7244
"48167720501",2989,299,256,44,455,7,436,0,4486
"48167720502",8398,1242,549,0,1100,25,2042,38,13394
"48167720503",12026,285,1107,0,1513,187,2629,0,17747
"48167720600",9790,784,1517,136,1057,43,2635,583,16545
"48167720700",7216,172,793,119,1985,52,2373,43,12753
"48167720800",1999,76,989,32,320,162,502,165,4245
"48167720900",3822,733,599,89,373,17,1378,565,7576
"48167721000",1564,190,8,0,104,24,391,131,2412
"48167721100",7347,1365,1177,250,858,557,3975,1460,16989
"48167721201",14301,326,1877,214,1481,951,2902,970,23022
"48167721202",3542,33,385,91,452,0,399,8,4910
"48167721300",4149,270,185,56,352,63,943,155,6173
"48167721400",6590,297,57,72,337,53,760,17,8183
"48167721500",5936,118,102,33,451,16,749,3,7408
"48167721600",1467,372,0,0,158,0,483,174,2654
"48167721700",5040,1723,69,62,673,555,1272,1599,10993
"48167721800",2700,992,10,78,638,95,581,347,5441
"48167721900",4639,1136,1928,545,639,35,2391,493,11806
"48167722001",4225,399,267,205,283,34,1379,325,7117
"48167722002",2531,465,487,162,122,16,1155,304,5242
"48167722100",5451,511,500,62,358,201,1522,440,9045
"48167722200",1128,593,647,366,100,90,453,429,3806
"48167722300",3442,1526,284,405,603,215,1778,1031,9284
"48167722600",665,240,683,275,107,44,352,93,2459
"48167722700",727,80,2212,988,102,46,290,0,4445
"48167722800",927,461,642,150,194,36,597,373,3380
"48167722900",1654,296,306,66,135,115,977,329,3878
"48167723000",870,297,1509,319,156,96,502,82,3831
"48167723100",1568,399,1057,157,212,19,309,211,3932
"48167723200",2589,280,887,492,85,0,1205,27,5565
"48167723300",4856,521,248,1,197,1,671,195,6690
"48167723400",6042,343,0,0,290,17,708,58,7458
"48167723501",912,61,0,4,56,0,87,45,1165
"48167723502",7543,660,0,0,495,31,1027,142,9898
"48167723600",3302,459,624,278,102,0,855,306,5926
"48167723700",924,99,395,529,84,0,479,75,2585
"48167723800",3467,242,217,127,108,0,397,0,4558
"48167723900",2002,191,0,0,0,3,188,22,2406
"48167724000",316,125,9,11,34,3,169,61,728
"48167724101",550,241,158,65,36,14,60,190,1314
"48167724200",1532,480,170,175,551,162,238,120,3428
"48167724300",1232,646,378,96,311,319,263,455,3700
"48167724400",1418,767,565,202,158,27,571,255,3963
"48167724500",464,103,98,122,71,13,85,42,998
"48167724600",307,156,404,862,27,15,209,178,2158
"48167724700",501,265,590,357,25,26,314,171,2249
"48167724800",804,173,176,238,25,58,225,107,1806
"48167724900",1178,284,293,71,36,10,446,124,2442
"48167725000",1247,239,247,127,91,0,649,220,2820
"48167725100",701,262,472,162,59,33,426,172,2287
"48167725200",786,302,348,272,88,29,692,239,2756
"48167725300",1619,261,346,54,119,65,804,187,3455
"48167725400",2223,170,235,245,120,42,1487,136,4658
"48167725500",889,9,89,0,107,22,225,0,1341
"48167725600",1976,832,443,106,333,72,747,526,5035
"48167725700",1999,180,18,40,191,0,557,141,3126
"48167725800",2103,626,429,234,261,28,837,315,4833
"48167725900",1621,395,103,18,115,57,310,146,2765
"48167726000",1248,48,52,0,64,13,228,8,1661
"48167726100",2037,174,7,0,17,0,206,18,2459
"48167726200",1284,320,615,289,48,62,759,204,3581
"48167990000",0,0,0,0,0,0,0,0,0
"48169950100",3319,306,148,4,249,122,1315,261,5724
"48171950100",3175,286,45,0,170,0,450,76,4202
"48171950200",3488,333,0,0,181,7,438,21,4468
"48171950300",5647,926,38,2,363,1,1127,333,8437
"48171950400",5762,677,0,0,302,49,1491,378,8659
"48171950500",2893,502,0,0,157,8,681,372,4613
"48173950100",1026,40,0,0,114,0,402,0,1582
"48175960100",2632,268,213,82,468,454,839,504,5460
"48175960200",1927,468,69,31,648,55,1039,217,4454
"48177000100",1402,227,141,73,1340,199,1437,211,5030
"48177000200",3092,207,146,37,844,299,1529,336,6490
"48177000300",1150,153,332,384,783,771,1027,852,5452
"48177000400",1043,174,89,7,319,377,703,409,3121
"48177000500",1849,435,14,15,1282,294,1744,627,6260
"48177000600",1311,138,20,32,600,187,588,223,3099
"48179950100",2887,254,6,7,166,18,403,13,3754
"48179950300",3718,524,107,1,161,5,327,305,5148
"48179950400",3552,201,49,0,311,0,673,17,4803
"48179950500",2361,338,58,4,426,117,1036,306,4646
"48179950600",1267,434,38,48,245,61,645,258,2996
"48179950700",1324,488,20,0,215,38,604,186,2875
"48179950800",1132,220,82,22,313,44,811,91,2715
"48181000101",3657,439,30,74,298,51,290,19,4858
"48181000102",2347,342,259,104,126,7,72,8,3265
"48181000200",1501,511,68,92,115,94,77,17,2475
"48181000302",3896,377,7,0,247,85,393,15,5020
"48181000303",3769,519,18,34,112,28,174,10,4664
"48181000304",2749,311,0,0,96,0,68,68,3292
"48181000400",1681,1020,137,45,306,54,119,258,3620
"48181000501",1623,546,577,57,118,29,156,192,3298
"48181000502",846,172,32,17,136,31,252,52,1538
"48181000600",2708,449,13,12,191,40,203,47,3663
"48181000700",2296,854,452,104,277,143,304,142,4572
"48181000800",4963,547,65,7,154,35,264,168,6203
"48181000901",2618,481,23,26,222,52,25,23,3470
"48181000902",4618,651,446,432,242,303,342,245,7279
"48181001101",3436,272,39,73,150,73,189,180,4412
"48181001102",5453,953,83,0,182,65,402,29,7167
"48181001200",4357,488,299,312,508,21,861,16,6862
"48181001300",2604,356,394,80,340,0,312,8,4094
"48181001400",2743,718,523,122,125,82,958,201,5472
"48181001500",3781,1333,476,737,452,509,1403,1051,9742
"48181001700",3147,496,198,31,478,156,698,216,5420
"48181001801",5159,511,5,0,334,297,496,90,6892
"48181001802",4499,388,27,43,195,0,324,70,5546
"48181001803",4851,474,6,10,107,0,322,83,5853
"48181001900",9042,794,62,0,347,117,1070,384,11816
"48181002000",1310,583,327,131,445,20,1198,181,4195
"48183000200",3790,762,722,227,133,40,993,330,6997
"48183000300",3460,361,400,126,236,12,514,24,5133
"48183000401",2290,340,214,90,212,24,214,19,3403
"48183000402",2236,210,306,258,51,26,200,28,3315
"48183000501",4444,72,243,62,397,0,259,2,5479
"48183000502",2967,312,1020,287,312,111,211,203,5423
"48183000600",6412,266,354,90,317,44,401,1,7885
"48183000700",3720,543,486,166,240,1,628,112,5896
"48183000800",4848,665,684,680,817,169,1883,590,10336
"48183000900",1974,373,294,275,117,26,794,130,3983
"48183001000",1543,391,365,164,94,27,892,176,3652
"48183001100",1473,449,548,746,115,37,593,130,4091
"48183001200",938,474,1107,417,77,60,885,483,4441
"48183001300",1227,1009,1171,652,139,64,1075,790,6127
"48183001400",1117,362,1528,620,321,10,824,271,5053
"48183001500",1352,637,1611,402,50,14,862,384,5312
"48183010100",5089,172,818,92,272,0,640,85,7168
"48183010200",4332,1393,640,587,326,32,367,258,7935
"48183010301",3496,710,422,192,298,37,494,226,5875
"48183010302",4061,945,79,574,26,38,400,318,6441
"48183010400",5750,820,679,196,247,47,897,357,8993
"48183010500",2740,551,1253,571,48,6,553,122,5844
"48183010600",4668,433,281,338,285,17,382,13,6417
"48183010700",2532,615,577,206,262,44,1201,287,5724
"48183980000",0,0,0,0,0,0,0,0,0
"48185180101",2132,560,952,439,434,39,1530,416,6502
"48185180102",2431,853,52,23,529,69,627,115,4699
"48185180200",4163,705,495,708,445,42,1247,377,8182
"48185180301",4094,243,113,266,377,21,645,15,5774
"48185180302",2298,528,280,112,83,13,301,66,3681
"48185180400",110,31,27,49,3,0,2,17,239
"48187210100",2583,650,163,64,990,281,2647,859,8237
"48187210200",2097,1107,343,150,671,189,2417,1133,8107
"48187210300",2367,966,607,249,455,769,1606,1485,8504
"48187210400",2903,384,329,44,455,104,1454,279,5952
"48187210504",4623,457,94,79,843,1,2137,202,8436
"48187210505",2900,711,63,0,1030,448,3557,1030,9739
"48187210506",2146,337,124,33,387,18,915,54,4014
"48187210507",4463,291,114,12,350,87,1697,156,7170
"48187210508",1923,131,7,0,455,30,923,106,3575
"48187210603",1426,118,124,8,210,42,509,104,2541
"48187210604",6995,387,789,0,1078,62,2433,185,11929
"48187210606",2597,112,63,24,262,31,760,63,3912
"48187210607",7013,223,251,11,563,236,2295,236,10828
"48187210608",3504,435,92,0,393,57,2121,336,6938
"48187210705",2262,218,510,75,452,60,728,41,4346
"48187210706",3853,327,128,38,1295,73,1888,143,7745
"48187210707",3381,114,569,42,654,175,1289,186,6410
"48187210708",4492,126,459,0,994,0,1765,34,7870
"48187210709",3178,225,319,27,790,36,847,161,5583
"48187210710",2862,139,334,0,339,28,947,0,4649
"48187210711",1982,25,538,48,720,7,773,14,4107
"48187210712",4071,75,585,0,287,6,1157,31,6212
"48187210713",3460,91,528,47,894,0,1561,93,6674
"48187210714",6006,517,1459,97,456,76,2780,216,11607
"48187210801",4318,591,60,20,432,0,1776,42,7239
"48187210803",3112,156,157,0,461,7,958,0,4851
"48187210804",3599,221,29,0,482,227,764,253,5575
"48187210901",4604,354,140,34,230,69,765,69,6265
"48187210902",2859,177,39,0,231,38,845,98,4287
"48189950100",2479,1571,143,100,519,153,2150,1658,8773
"48189950200",1888,1059,133,182,354,200,1922,1075,6813
"48189950300",4503,649,78,4,508,250,1986,560,8538
"48189950400",3237,502,139,33,416,27,2276,502,7132
"48189950500",1968,857,0,71,393,21,1319,607,5236
"48189950600",2143,274,0,0,309,8,1154,164,4052
"48189950700",2352,656,29,34,129,14,1474,471,5159
"48189950800",1032,289,4,27,71,18,518,182,2141
"48189950900",2287,384,5,3,149,162,1071,411,4472
"48191950500",1906,655,128,108,265,81,676,402,4221
"48193950100",2315,380,9,3,7,43,271,75,3103
"48193950200",1944,224,0,10,32,0,210,20,2440
"48193950300",2472,476,0,0,62,23,120,183,3336
"48195950100",1404,237,0,0,61,0,583,193,2478
"48195950300",2852,684,0,0,228,18,1235,501,5518
"48197950100",2908,479,288,67,183,39,614,179,4757
"48199030100",2955,349,0,3,269,0,294,3,3873
"48199030200",4838,218,123,14,271,7,174,15,5660
"48199030300",7905,1288,478,0,272,0,314,135,10392
"48199030400",1630,311,170,87,93,10,230,0,2531
"48199030501",3741,458,93,25,163,23,83,0,4586
"48199030502",7884,460,0,0,90,7,352,17,8810
"48199030600",3439,231,0,0,26,19,213,9,3937
"48199030700",2134,765,801,150,110,68,327,219,4574
"48199030800",2566,338,415,826,188,12,193,45,4583
"48199030900",3826,589,0,0,38,0,76,21,4550
"48199031000",3610,426,10,0,47,0,123,0,4216
"48201100000",2103,365,140,238,275,42,216,72,3451
"48201210100",83,0,45,0,5,0,5,0,138
"48201210400",2629,791,242,794,222,138,2645,814,8275
"48201210500",2885,1139,438,818,543,238,3293,1280,10634
"48201210600",3550,1015,10,22,794,0,3383,918,9692
"48201210700",948,493,301,110,195,128,1050,608,3833
"48201210800",918,663,393,309,170,110,989,789,4341
"48201210900",33,130,901,233,136,41,157,171,1802
"48201211000",292,132,978,293,154,0,437,122,2408
"48201211100",1205,1453,1351,1372,134,108,1261,1476,8360
"48201211200",361,492,1089,532,60,19,420,511,3484
"48201211300",808,820,1491,1720,230,94,1144,834,7141
"48201211400",1028,290,882,1367,270,7,880,309,5033
"48201211500",4025,1792,332,152,782,235,4694,2025,14037
"48201211600",1435,502,187,243,303,49,1537,519,4775
"48201211700",759,364,1321,1081,202,60,873,423,5083
"48201211900",3336,1445,0,39,301,171,3411,1578,10281
"48201212300",2728,2486,75,48,560,144,2974,2529,11544
"48201212400",1662,775,94,63,341,88,1851,871,5745
"48201212500",816,582,1559,343,205,15,1004,567,5091
"48201220100",861,267,721,302,111,48,973,345,3628
"48201220200",1895,470,40,0,167,92,1964,536,5164
"48201220300",2760,816,83,14,408,324,2850,1029,8284
"48201220400",2526,1166,104,64,220,177,2664,1321,8242
"48201220500",1954,1034,375,256,295,140,1954,1057,7065
"48201220600",2032,718,86,500,391,61,2312,726,6826
"48201220700",1748,1317,837,639,495,412,2190,1447,9085
"48201220800",650,547,497,848,74,171,711,680,4178
"48201220900",863,312,138,115,138,39,976,330,2911
"48201221000",1745,935,181,151,299,209,1918,1001,6439
"48201221100",1889,872,20,3,784,149,2375,846,6938
"48201221200",4061,1308,158,52,718,84,4470,1307,12158
"48201221300",5370,2287,218,12,459,497,5581,2653,17077
"48201221400",2282,3300,88,44,323,88,2316,3170,11611
"48201221500",4171,3098,379,528,747,201,4587,3230,16941
"48201221600",6949,2234,232,83,535,29,6424,2180,18666
"48201221700",5816,2340,0,26,227,146,5462,2279,16296
"48201221800",2397,1009,64,0,129,164,2442,957,7162
"48201221900",2264,1133,31,29,729,98,2853,1182,8319
"48201222000",1448,640,90,51,267,69,1509,588,4662
"48201222100",2906,1029,69,5,774,519,2982,1466,9750
"48201222200",2015,1132,223,53,366,162,2208,1229,7388
"48201222300",2536,1680,74,92,353,28,2429,1590,8782
"48201222401",1543,1376,7,8,130,31,1427,1390,5912
"48201222402",3347,2315,454,246,359,0,3152,2279,12152
"48201222501",2150,1605,77,13,112,34,2168,1633,7792
"48201222502",2517,987,98,66,185,75,2268,1007,7203
"48201222503",3628,3781,143,44,193,0,3607,3620,15016
"48201222600",1711,1962,387,233,213,142,1699,2057,8404
"48201222700",1095,107,1604,2314,162,239,1038,263,6822
"48201222800",1874,765,0,0,236,46,1811,710,5442
"48201222900",5059,2026,717,37,1028,173,5595,2158,16793
"48201223001",2079,1590,366,41,135,198,2071,1766,8246
"48201223002",1757,1689,385,157,75,34,1758,1689,7544
"48201223100",1033,540,79,91,135,83,906,410,3277
"48201230100",92,208,607,322,0,15,64,205,1513
"48201230200",127,272,2597,1270,144,256,179,411,5256
"48201230300",391,197,698,400,71,11,383,173,2324
"48201230400",960,193,929,442,449,28,1352,212,4565
"48201230500",1744,863,440,86,298,145,1872,979,6427
"48201230600",586,324,1122,533,43,103,611,427,3749
"48201230700",510,90,1118,695,155,50,658,137,3413
"48201230800",459,244,1526,278,72,11,526,232,3348
"48201230900",687,164,1840,913,15,44,644,208,4515
"48201231000",1181,110,1756,510,152,45,1192,137,5083
"48201231100",2035,603,974,543,604,148,2384,652,7943
"48201231200",1055,319,3789,1982,206,436,921,696,9404
"48201231300",527,103,2188,1201,100,30,607,116,4872
"48201231400",105,10,1959,319,150,0,258,0,2801
"48201231500",69,24,1823,732,129,4,181,22,2984
"48201231600",390,28,1914,373,88,12,454,24,3283
"48201231700",1586,757,75,24,750,225,2134,964,6515
"48201231800",804,573,686,88,317,79,1040,550,4137
"48201231900",1363,275,3563,1334,0,35,1316,245,8131
"48201232000",1062,408,1588,40,593,114,1583,482,5870
"48201232100",1410,541,481,171,304,101,1531,612,5151
"48201232200",6227,1606,2911,334,2206,819,3760,1885,19748
"48201232301",4367,1556,1942,547,968,426,4248,1671,15725
"48201232302",4998,787,3649,597,1201,0,5156,736,17124
"48201232401",4334,1120,1884,366,923,126,3391,1036,13180
"48201232402",1486,239,716,615,849,41,1887,360,6193
"48201232403",2278,397,815,304,467,0,2597,342,7200
"48201232500",1788,285,154,187,398,35,1932,201,4980
"48201232600",2013,231,256,6,415,69,2036,281,5307
"48201232701",3919,1948,962,688,884,259,4656,1935,15251
"48201232702",2806,1129,800,334,622,636,2928,1690,10945
"48201232800",2320,181,1793,432,723,312,2591,441,8793
"48201232900",2589,230,2588,574,1361,195,2546,290,10373
"48201233001",1330,158,957,517,253,180,908,144,4447
"48201233002",2154,422,863,35,535,200,1914,534,6657
"48201233003",1521,67,381,11,368,37,1208,64,3657
"48201233101",2367,825,38,81,660,376,2309,1004,7660
"48201233102",3351,1786,0,6,1293,747,4178,2277,13638
"48201233103",2999,1582,27,0,375,484,2981,1981,10429
"48201233200",3439,520,65,76,1359,98,3220,448,9225
"48201233300",3136,804,0,0,1007,200,3822,928,9897
"48201233400",1367,646,182,198,205,154,1404,712,4868
"48201233500",4654,2625,0,0,440,152,4506,2645,15022
"48201233600",294,409,739,360,74,119,347,402,2744
"48201233701",2961,770,897,313,416,86,2772,794,9009
"48201233702",2191,516,18,0,202,159,2048,617,5751
"48201233703",1395,518,0,0,582,11,1725,460,4691
"48201240100",1240,1205,740,468,580,55,1405,1180,6873
"48201240400",3134,1097,984,631,1064,176,2901,846,10833
"48201240501",1981,1566,1560,782,270,180,2163,1582,10084
"48201240502",1432,696,1117,1700,315,78,1618,665,7621
"48201240600",816,692,705,419,23,75,813,718,4261
"48201240701",4777,520,6246,371,3453,573,6865,983,23788
"48201240702",3709,831,2974,870,3996,513,6439,1089,20421
"48201240801",2775,404,1477,389,1055,950,2399,1194,10643
"48201240802",1807,89,1475,306,604,175,1615,187,6258
"48201240901",3357,424,3597,351,1708,383,2865,554,13239
"48201240902",4723,655,4401,505,2345,355,4391,686,18061
"48201241000",4680,640,1253,342,1475,39,2855,75,11359
"48201241101",3455,134,710,175,478,151,1393,110,6606
"48201241102",5393,1102,3222,553,1535,245,2978,417,15445
"48201241103",1793,263,812,259,662,107,1031,219,5146
"48201241200",4042,208,1138,395,1009,302,2351,432,9877
"48201241300",6878,441,2062,127,2104,238,2361,355,14566
"48201241400",5535,531,627,13,1394,47,1999,280,10426
"48201241500",2332,604,2780,628,2246,292,3232,710,12824
"48201250100",3506,379,2375,474,1661,114,3749,390,12648
"48201250200",2998,1013,3084,461,1243,137,3592,987,13515
"48201250301",2059,124,3112,101,799,19,1525,115,7854
"48201250302",6411,130,2617,284,869,382,3540,402,14635
"48201250401",8219,466,1508,126,1751,104,3580,113,15867
"48201250402",11889,591,3480,239,1122,83,2455,222,20081
"48201250500",2960,241,1202,153,876,102,1089,217,6840
"48201250600",3157,935,1482,516,1277,814,2453,1727,12361
"48201250701",4167,395,645,294,286,83,1401,103,7374
"48201250702",3701,216,558,0,401,10,787,0,5673
"48201250800",6607,152,466,0,1165,35,1058,0,9483
"48201250900",9182,382,132,0,548,24,731,0,10999
"48201251000",2205,171,208,24,412,170,324,256,3770
"48201251100",6433,92,436,6,415,186,818,188,8574
"48201251200",4509,825,99,63,589,95,791,217,7188
"48201251300",6880,151,264,1,213,320,614,0,8443
"48201251401",2320,43,104,0,178,0,435,0,3080
"48201251402",5081,379,0,0,487,58,628,195,6828
"48201251501",4474,23,116,0,742,37,594,37,6023
"48201251502",8699,325,306,0,621,57,935,24,10967
"48201251503",2003,54,17,0,124,0,89,30,2317
"48201251600",5550,325,75,1,239,0,420,48,6658
"48201251700",6619,430,397,0,268,7,837,128,8686
"48201251800",2074,69,6,0,65,0,506,0,2720
"48201251901",8103,529,80,21,733,69,1895,350,11780
"48201251902",3577,359,366,54,766,24,1023,45,6214
"48201252000",9167,832,2890,0,1899,0,3790,729,19307
"48201252100",1438,79,245,0,155,0,677,7,2601
"48201252200",4195,602,1031,44,1743,136,4278,570,12599
"48201252301",3931,1164,2791,179,1005,439,3978,1262,14749
"48201252302",6645,716,2808,272,1703,409,6816,959,20328
"48201252400",3876,1684,113,83,875,0,3151,1494,11276
"48201252500",2077,1321,134,0,509,211,1501,1173,6926
"48201252600",3862,1496,0,39,1284,450,2856,1613,11600
"48201252700",2859,671,272,3,208,152,815,477,5457
"48201252800",2027,354,2788,1001,586,502,1139,630,9027
"48201252900",6152,1128,385,60,274,87,2039,318,10443
"48201253000",2354,222,1077,175,132,93,1153,217,5423
"48201253100",6475,304,1923,59,1117,70,3793,111,13852
"48201253200",6789,1925,1041,492,198,135,2332,1529,14441
"48201253300",2321,78,367,27,581,177,799,177,4527
"48201253400",304,20,12,0,240,0,337,13,926
"48201253500",3610,861,1964,990,873,111,2829,647,11885
"48201253600",2655,617,938,815,511,33,1359,398,7326
"48201253700",3145,375,1458,14,271,20,1659,265,7207
"48201253800",4708,1285,827,297,387,194,2465,1170,11333
"48201253900",2333,635,322,129,690,200,972,414,5695
"48201254000",2340,253,713,59,816,191,1629,257,6258
"48201254100",2835,636,458,516,1015,166,2327,608,8561
"48201254200",1503,352,107,26,748,61,1813,321,4931
"48201254300",2651,681,356,348,424,432,1842,973,7707
"48201254400",1027,656,223,230,729,184,1492,790,5331
"48201254500",1038,303,244,137,480,180,1345,364,4091
"48201254600",1944,392,244,419,1157,200,2575,598,7529
"48201254700",1839,212,225,79,312,10,771,59,3507
"48201310100",2119,1334,467,900,662,130,1530,975,8117
"48201310200",778,66,358,59,310,24,290,30,1915
"48201310300",2705,750,136,25,625,125,2434,723,7523
"48201310400",1756,1143,23,58,395,253,2021,1343,6992
"48201310500",3123,1294,24,140,389,54,3397,1256,9677
"48201310600",3784,862,143,13,651,193,4090,1010,10746
"48201310700",2260,896,193,14,225,215,2055,998,6856
"48201310800",1471,682,46,66,107,89,1459,748,4668
"48201310900",2866,1736,7,97,494,160,3198,1826,10384
"48201311000",4112,2471,16,0,608,139,4523,2536,14405
"48201311100",3233,710,158,0,1545,233,4732,930,11541
"48201311200",3154,1551,17,85,396,124,3094,1591,10012
"48201311300",2662,1067,14,11,967,222,3480,1127,9550
"48201311400",520,354,300,67,255,99,745,443,2783
"48201311500",4123,1424,216,0,1049,300,4911,1645,13668
"48201311600",1685,1073,93,64,880,376,2534,1300,8005
"48201311700",2925,1386,242,347,394,250,2970,1576,10090
"48201311800",2425,1346,39,48,621,374,2914,1678,9445
"48201311900",1516,423,0,32,249,155,1668,538,4581
"48201312000",385,245,917,97,86,123,57,56,1966
"48201312100",0,0,0,0,0,0,0,0,0
"48201312200",110,239,1049,695,72,67,148,239,2619
"48201312300",228,126,784,525,108,48,202,154,2175
"48201312400",315,132,1016,586,27,30,277,162,2545
"48201312500",1858,569,431,414,432,16,403,199,4322
"48201312600",4229,387,868,125,1296,167,1074,88,8234
"48201312700",201,0,1261,531,27,12,37,12,2081
"48201312800",29,15,491,867,6,4,6,24,1442
"48201312900",267,72,1626,725,150,137,131,51,3159
"48201313000",340,22,1682,459,65,1,159,0,2728
"48201313100",1450,296,413,112,621,45,341,35,3313
"48201313200",485,164,2268,766,114,48,261,112,4218
"48201313300",373,34,1457,641,115,0,220,25,2865
"48201313400",384,65,1676,619,151,42,558,50,3545
"48201313500",204,125,1330,855,30,66,196,201,3007
"48201313600",727,643,1644,1184,277,91,888,762,6216
"48201313700",231,10,1829,367,69,1,118,6,2631
"48201313800",285,168,2599,1371,44,23,351,263,5104
"48201313900",1648,575,1130,250,1201,153,740,64,5761
"48201314001",1121,357,283,66,919,173,360,9,3288
"48201314002",1718,670,1295,665,1928,499,194,170,7139
"48201314300",332,122,2705,809,287,71,272,67,4665
"48201314400",1147,402,151,19,1430,291,195,58,3693
"48201320100",1169,536,137,63,742,194,1768,713,5322
"48201320200",3502,929,123,80,1839,990,4689,1693,13845
"48201320500",2807,464,9,3,1306,59,3652,504,8804
"48201320601",1346,624,30,21,410,42,1540,617,4630
"48201320602",2622,629,81,79,1049,163,3224,775,8622
"48201320700",1678,479,547,42,1042,136,2294,519,6737
"48201320800",3383,648,16,0,956,471,3917,1053,10444
"48201320900",4766,1106,564,163,794,233,4846,1212,13684
"48201321000",5315,1576,424,266,965,935,4972,2284,16737
"48201321100",5192,362,692,191,1470,259,4940,594,13700
"48201321200",1517,1090,198,86,439,201,1799,1171,6501
"48201321300",4051,862,312,87,867,461,4311,1242,12193
"48201321401",2560,772,21,0,763,516,2925,1170,8727
"48201321402",2405,515,66,14,1015,323,3051,819,8208
"48201321500",1302,611,63,52,563,386,1649,949,5575
"48201321600",5262,1179,0,1,526,178,4607,1268,13021
"48201321700",2440,458,0,1,422,30,2376,408,6135
"48201321800",2331,721,0,0,1063,56,3020,712,7903
"48201321900",4021,894,35,25,895,220,4175,1097,11362
"48201322000",2893,1494,79,17,842,306,3372,1693,10696
"48201322100",2641,1121,19,22,375,48,2396,1104,7726
"48201322200",961,283,1,1,213,0,990,254,2703
"48201322600",4113,697,67,18,639,216,3237,760,9747
"48201322700",4028,1132,127,207,1454,326,4304,1336,12914
"48201322800",3797,1093,34,0,1032,139,3975,1091,11161
"48201322900",2216,862,0,0,751,270,2652,1076,7827
"48201323000",3323,1929,67,134,770,593,3500,2034,12350
"48201323100",1576,908,106,181,571,395,1825,1158,6720
"48201323200",3906,392,82,89,600,39,3062,454,8624
"48201323300",2356,745,182,103,356,74,2221,707,6744
"48201323400",3905,2248,63,6,1224,226,4136,1635,13443
"48201323500",2894,1189,338,292,418,237,2487,1210,9065
"48201323600",6366,537,21,30,727,389,3838,636,12544
"48201323701",3040,340,128,84,219,59,1415,250,5535
"48201323702",2070,413,102,17,185,235,1085,585,4692
"48201323801",2929,142,0,0,412,0,2187,126,5796
"48201323802",3245,1153,64,11,379,116,2504,1021,8493
"48201323900",2541,835,25,59,180,187,1306,576,5709
"48201324000",4755,154,0,0,558,37,2493,112,8109
"48201324100",2075,1562,0,31,875,426,2494,1695,9158
"48201324200",815,165,0,0,339,219,1143,355,3036
"48201330100",3926,329,2444,1851,454,403,3963,734,14104
"48201330200",1384,753,1288,632,259,59,1408,766,6549
"48201330301",3469,598,2306,253,1463,133,4447,588,13257
"48201330302",2365,431,1991,223,931,58,2852,489,9340
"48201330303",1866,305,1539,239,254,0,1704,253,6160
"48201330400",1921,673,1836,473,203,37,1879,701,7723
"48201330500",2192,701,904,487,204,49,2204,750,7491
"48201330600",1644,237,2606,1015,937,25,2310,253,9027
"48201330700",3146,855,2003,414,1446,619,3811,1432,13726
"48201330800",3433,157,4738,1066,1834,60,3850,85,15223
"48201330900",2242,1146,3434,991,1143,236,2312,1326,12830
"48201331100",77,155,1964,777,227,0,244,151,3595
"48201331200",105,93,1738,787,93,17,83,73,2989
"48201331300",226,36,3382,1756,137,0,336,44,5917
"48201331400",0,12,437,1723,49,82,49,12,2364
"48201331500",643,16,6016,1068,498,60,596,136,9033
"48201331601",228,0,4570,1566,300,43,258,0,6965
"48201331602",327,83,679,620,224,0,482,83,2498
"48201331700",484,104,2124,1027,290,0,866,72,4967
"48201331800",455,314,2425,979,158,0,565,301,5197
"48201331900",189,8,2067,457,16,1,188,1,2927
"48201332000",502,341,2091,1960,403,78,820,425,6620
"48201332100",928,451,907,254,282,195,1184,639,4840
"48201332200",998,547,1763,860,431,409,1417,692,7117
"48201332300",360,186,1760,508,83,29,449,215,3590
"48201332400",415,119,2351,814,47,118,417,231,4512
"48201332500",955,384,1210,323,240,14,1118,368,4612
"48201332600",2367,1034,2007,592,696,1030,2957,1875,12558
"48201332700",830,803,4,0,718,279,1456,1042,5132
"48201332800",2359,801,167,512,559,245,2565,972,8180
"48201332900",2479,1619,35,67,562,56,2651,1607,9076
"48201333000",1954,295,0,77,742,222,2406,470,6166
"48201333100",1123,446,148,319,1453,338,1316,525,5668
"48201333201",1783,675,572,455,1019,601,2515,1181,8801
"48201333202",2341,484,1845,750,434,164,2230,559,8807
"48201333300",4630,1183,1182,993,1898,936,5953,2032,18807
"48201333500",2685,695,742,414,728,678,3067,1373,10382
"48201333600",2376,297,147,23,820,0,2227,265,6155
"48201333700",1515,573,240,30,620,82,1875,620,5555
"48201333800",3856,1049,1424,377,2743,436,5915,1228,17028
"48201333901",4143,474,1987,73,2296,409,4290,532,14204
"48201333902",4769,667,1339,520,1622,167,4750,528,14362
"48201334001",1216,249,874,141,623,11,1215,219,4548
"48201334002",1238,52,470,109,598,6,813,0,3286
"48201334003",3974,491,944,97,1183,265,2837,251,10042
"48201334100",2774,612,4688,2016,1457,115,2521,465,14648
"48201340100",2839,433,1067,63,1160,538,1814,582,8496
"48201340201",1029,6,57,0,565,6,217,0,1880
"48201340202",3115,33,160,0,1631,16,591,20,5566
"48201340203",3951,83,20,0,674,63,457,0,5248
"48201340301",2570,83,44,0,1449,0,307,0,4453
"48201340302",5868,100,264,0,922,54,846,0,8054
"48201340400",1161,42,43,0,185,0,104,35,1570
"48201340500",4423,702,86,289,956,404,1423,296,8579
"48201340600",2261,54,79,18,122,0,231,48,2813
"48201340700",3415,467,570,407,2813,149,1786,279,9886
"48201340800",3981,205,199,0,1365,83,694,0,6527
"48201340900",2970,229,646,154,690,136,1672,142,6639
"48201341000",4053,283,1015,52,870,359,1485,289,8406
"48201341100",2252,397,239,34,423,294,1199,515,5353
"48201341201",2447,334,548,252,504,71,1042,52,5250
"48201341202",4175,284,74,99,246,16,965,92,5951
"48201341301",2557,643,232,87,879,595,492,172,5657
"48201341302",1704,362,315,16,578,162,803,318,4258
"48201341400",4281,147,180,13,496,66,526,89,5798
"48201341501",5696,418,216,4,384,0,771,174,7663
"48201341502",3294,416,68,87,568,21,432,101,4987
"48201341600",4559,395,240,0,705,0,744,0,6643
"48201341700",2081,218,26,34,301,0,542,34,3236
"48201341800",1435,156,56,14,85,24,243,8,2021
"48201342001",5286,65,0,0,1407,0,1634,0,8392
"48201342002",2682,195,192,0,461,19,1064,19,4632
"48201342100",3157,352,52,19,298,96,1507,331,5812
"48201342200",2583,315,183,0,365,105,2021,269,5841
"48201342300",5489,496,155,239,967,85,3834,310,11575
"48201342400",2619,233,28,0,617,113,1798,180,5588
"48201342500",5473,185,3,0,182,18,974,89,6924
"48201342700",4215,455,69,4,319,0,864,91,6017
"48201342800",7298,351,119,0,985,0,2161,192,11106
"48201342900",4951,813,0,3,122,112,818,587,7406
"48201343000",5291,887,189,107,1206,325,2412,854,11271
"48201343100",3502,388,280,69,366,0,995,145,5745
"48201343200",4370,168,166,0,471,0,1598,9,6782
"48201343301",3710,261,129,0,459,6,1361,79,6005
"48201343302",4619,193,100,3,229,7,1481,114,6746
"48201343600",2400,291,60,52,400,130,979,155,4467
"48201343700",1826,255,436,263,335,127,537,338,4117
"48201350100",8166,207,3338,490,4449,380,5099,69,22198
"48201350200",6152,222,1050,75,1387,185,5083,142,14296
"48201350300",4837,209,332,27,1207,0,2236,125,8973
"48201350400",1966,577,1095,330,2008,328,2116,574,8994
"48201350500",3675,660,1337,427,1517,268,3531,721,12136
"48201350601",3376,85,301,24,678,8,1287,27,5786
"48201350602",6334,107,1056,0,1493,99,1610,18,10717
"48201350700",1926,65,219,9,107,0,429,8,2763
"48201350801",3773,492,189,77,318,86,903,311,6149
"48201350802",4969,163,470,318,1936,14,1548,87,9505
"48201410100",1885,184,737,490,430,186,686,10,4608
"48201410200",4387,296,186,25,378,24,721,77,6094
"48201410300",1709,223,90,26,358,9,318,0,2733
"48201410401",3154,324,196,0,303,38,625,87,4727
"48201410402",2015,224,31,0,529,16,557,109,3481
"48201410500",3695,179,43,6,408,54,735,48,5168
"48201410600",2728,174,306,65,181,1,250,58,3763
"48201410701",3184,367,224,126,402,0,683,20,5006
"48201410702",1473,406,164,102,243,142,237,77,2844
"48201410800",2710,510,9,19,243,172,340,267,4270
"48201410900",1926,391,30,0,262,28,479,189,3305
"48201411000",3963,321,95,44,401,31,287,14,5156
"48201411100",3064,110,142,71,393,23,296,58,4157
"48201411200",1593,51,6,0,173,0,93,0,1916
"48201411300",2638,146,225,78,426,130,458,208,4309
"48201411400",2515,46,117,0,127,0,40,0,2845
"48201411501",4596,276,94,0,699,17,757,28,6467
"48201411502",2873,188,238,0,518,16,481,79,4393
"48201411600",2114,37,8,0,256,7,320,12,2754
"48201411700",2035,179,132,39,392,20,594,32,3423
"48201411800",3109,152,634,0,626,69,565,42,5197
"48201411900",2946,97,92,0,297,98,262,0,3792
"48201412000",2776,162,27,0,321,68,141,40,3535
"48201412100",0,0,0,0,0,0,0,0,0
"48201412200",3924,212,138,0,1023,111,361,53,5822
"48201412300",5918,246,0,0,813,0,297,0,7274
"48201412400",3885,29,68,0,502,0,280,0,4764
"48201412500",1316,77,3,18,297,51,114,28,1904
"48201412600",3566,69,35,0,379,0,264,0,4313
"48201412700",2469,149,26,0,565,9,478,0,3696
"48201412800",4235,18,52,0,1184,0,522,0,6011
"48201412900",2446,218,333,76,1243,221,362,17,4916
"48201413000",2825,113,136,0,750,10,565,11,4410
"48201413100",2828,114,0,15,460,6,270,68,3761
"48201413201",1522,353,215,34,559,57,274,61,3075
"48201413202",1623,286,273,120,724,82,343,44,3495
"48201413300",4328,362,1244,52,1316,66,830,102,8300
"48201420100",536,384,904,355,766,187,637,476,4245
"48201420200",1240,85,433,13,973,77,997,72,3890
"48201420300",2373,200,494,115,304,17,241,37,3781
"48201420400",2653,257,23,77,334,0,473,110,3927
"48201420500",997,1073,271,235,719,273,1395,1161,6124
"48201420600",1643,77,90,0,323,129,312,166,2740
"48201420700",2817,55,59,0,283,0,203,16,3433
"48201420800",1857,71,28,0,387,13,142,10,2508
"48201420900",4843,81,70,0,1469,0,379,55,6897
"48201421000",1917,29,55,0,635,4,309,11,2960
"48201421101",1362,950,335,62,342,195,1075,879,5200
"48201421102",1973,1658,591,143,504,73,2183,1605,8730
"48201421201",1904,853,453,151,400,144,1798,898,6601
"48201421202",1647,1709,52,42,152,212,1620,1709,7143
"48201421300",2014,1611,635,991,995,516,1815,1642,10219
"48201421401",1595,1108,221,349,346,27,1797,1030,6473
"48201421402",1126,1733,300,221,120,386,1193,2110,7189
"48201421403",1740,1161,78,269,270,298,1773,1438,7027
"48201421500",2244,970,681,545,1352,203,2134,911,9040
"48201421600",2110,2825,539,30,1264,370,2176,2993,12307
"48201421700",2168,552,186,74,1499,118,1034,461,6092
"48201421800",2288,197,1160,278,1396,59,859,117,6354
"48201421900",2246,174,50,0,102,105,157,55,2889
"48201422000",2112,190,85,0,374,0,302,170,3233
"48201422100",3070,396,632,151,817,0,1687,295,7048
"48201422200",540,505,2136,1111,511,162,876,631,6472
"48201422301",1309,657,2101,2043,618,1301,1222,950,10201
"48201422302",584,67,1092,367,367,27,386,60,2950
"48201422401",845,169,1906,357,753,274,1060,127,5491
"48201422402",2992,763,468,127,781,593,2680,1225,9629
"48201422500",2224,441,597,1284,1831,993,2204,1300,10874
"48201422600",4089,991,627,202,620,82,2052,615,9278
"48201422701",3069,1298,181,122,225,204,2473,1395,8967
"48201422702",2236,259,22,10,599,9,1870,183,5188
"48201422800",1585,871,215,96,473,23,801,836,4900
"48201422900",1958,1079,710,319,254,265,1716,1114,7415
"48201423000",2071,1628,493,514,372,311,1753,1632,8774
"48201423100",948,928,315,196,90,133,973,1024,4607
"48201423201",2041,197,876,108,257,196,1308,264,5247
"48201423202",1317,1514,2755,1029,1519,532,1965,1962,12593
"48201423301",1632,210,1107,816,678,130,566,253,5392
"48201423302",1571,22,2531,876,92,211,608,22,5933
"48201423401",1497,109,2525,864,619,253,1027,258,7152
"48201423402",627,15,2412,161,1242,116,922,116,5611
"48201423500",918,126,566,0,359,46,498,0,2513
"48201423600",1931,106,2884,490,1379,159,1428,204,8581
"48201430100",5058,377,154,43,583,48,714,166,7143
"48201430200",1303,88,22,4,177,25,231,15,1865
"48201430300",4050,15,113,0,404,38,261,0,4881
"48201430400",2612,128,21,0,509,0,277,12,3559
"48201430500",2060,68,57,0,293,168,443,5,3094
"48201430600",3130,69,2,13,628,0,264,0,4106
"48201430700",2202,94,61,10,732,0,198,15,3312
"48201430800",3812,54,32,0,1125,30,482,0,5535
"48201430900",4696,109,20,0,1100,77,300,16,6318
"48201431000",4292,64,551,3,606,0,878,0,6394
"48201431101",2059,229,322,303,163,200,706,77,4059
"48201431102",1525,1023,293,251,388,388,304,736,4908
"48201431201",1547,545,531,126,834,414,516,624,5137
"48201431202",2381,342,632,32,1199,44,511,170,5311
"48201431301",2568,189,781,0,1161,593,1318,360,6970
"48201431302",3298,190,159,35,272,28,308,52,4342
"48201431401",1386,231,78,31,273,96,464,119,2678
"48201431402",2322,100,177,0,688,116,604,98,4105
"48201431501",2849,160,66,0,417,0,299,0,3791
"48201431502",2890,104,88,44,392,10,329,54,3911
"48201431600",2802,54,0,21,199,0,338,0,3414
"48201431700",4202,246,0,0,89,0,224,111,4872
"48201431801",2146,23,171,32,1105,0,302,0,3779
"48201431802",2243,206,178,0,1150,0,1243,61,5081
"48201431900",2243,73,257,0,716,55,448,69,3861
"48201432001",2040,200,404,63,755,77,701,15,4255
"48201432002",2433,880,510,239,468,0,1660,528,6718
"48201432100",2760,306,693,88,1403,341,1700,254,7545
"48201432200",2288,337,786,68,593,191,1208,387,5858
"48201432300",2965,940,1763,494,1050,130,2215,575,10132
"48201432400",1779,487,1884,537,445,391,1039,346,6908
"48201432500",1730,1522,955,343,812,370,1556,1455,8743
"48201432600",1287,85,214,191,290,36,446,89,2638
"48201432701",1812,1991,41,144,1490,1490,2848,3264,13080
"48201432702",2263,327,433,44,269,21,1273,296,4926
"48201432801",1532,611,863,396,1132,634,1870,1218,8256
"48201432802",1813,1386,663,387,824,749,2002,1737,9561
"48201432901",1457,323,234,45,817,135,1852,410,5273
"48201432902",2446,814,701,213,1678,788,2634,1241,10515
"48201433001",1091,1237,131,61,1657,1327,1936,1666,9106
"48201433002",1335,1062,160,157,1283,608,1850,1384,7839
"48201433003",1271,749,602,92,1370,1595,1503,1047,8229
"48201433100",1194,1078,508,470,290,251,1367,1287,6445
"48201433201",1463,483,978,420,1446,678,1276,653,7397
"48201433202",1933,603,275,96,1394,428,1945,909,7583
"48201433300",2826,701,185,13,1160,380,1513,760,7538
"48201433400",2244,412,633,237,1089,267,2300,523,7705
"48201433501",1023,2510,550,269,460,682,1485,3132,10111
"48201433502",1431,1678,937,483,879,1126,1945,2920,11399
"48201433600",443,1075,1243,776,577,510,777,1306,6707
"48201440100",3083,694,2165,47,1146,63,2562,533,10293
"48201450100",1561,57,18,0,177,0,166,0,1979
"48201450200",4189,39,10,0,482,4,182,0,4906
"48201450300",4401,968,890,240,961,205,1751,727,10143
"48201450400",3485,237,301,634,643,0,1275,85,6660
"48201450500",2683,22,0,0,118,36,183,0,3042
"48201450600",3352,98,269,16,363,93,795,77,5063
"48201450700",6269,32,0,0,671,0,313,0,7285
"48201450801",1393,103,198,28,93,30,394,19,2258
"48201450802",3951,1012,1213,449,1169,834,2628,1496,12752
"48201450900",2137,65,281,24,252,41,466,0,3266
"48201451001",1755,699,1415,502,396,339,780,714,6600
"48201451002",1502,500,2606,414,511,56,1026,486,7101
"48201451100",2455,171,340,94,573,516,803,164,5116
"48201451200",2401,45,20,0,217,0,285,0,2968
"48201451300",4314,318,736,117,1230,83,1171,148,8117
"48201451401",1869,174,507,17,769,26,582,59,4003
"48201451402",2245,430,1153,612,350,80,1106,134,6110
"48201451403",2541,96,980,177,1019,20,901,98,5832
"48201451500",2677,210,291,0,1421,35,839,23,5496
"48201451601",4031,311,670,0,1361,186,843,136,7538
"48201451602",4163,529,326,18,2447,159,1513,169,9324
"48201451700",1728,68,1074,224,739,54,965,8,4860
"48201451800",1770,167,1702,2,1569,503,1660,406,7779
"48201451901",2222,123,2725,1171,1124,181,1431,228,9205
"48201451902",1280,18,98,43,1110,74,105,11,2739
"48201452000",3721,879,2338,374,1194,67,2440,889,11902
"48201452100",3912,957,1833,237,1642,427,986,847,10841
"48201452201",1129,586,1788,150,517,192,728,405,5495
"48201452202",528,26,656,478,605,164,324,9,2790
"48201452300",659,93,307,35,991,356,989,177,3607
"48201452400",2692,572,778,40,2811,928,3231,895,11947
"48201452500",1463,963,1312,534,2640,1659,1975,1624,12170
"48201452600",1155,825,1510,1656,2422,402,1704,769,10443
"48201452700",2789,330,2501,619,4119,741,2439,392,13930
"48201452801",1594,252,1575,278,1325,514,1796,354,7688
"48201452802",1176,458,1041,656,1704,843,1717,1002,8597
"48201452900",1276,377,362,83,1576,754,2077,590,7095
"48201453000",2601,947,555,114,2819,604,3923,1290,12853
"48201453100",1293,657,791,256,1189,377,1833,823,7219
"48201453200",2291,1061,1017,480,1859,959,2901,1801,12369
"48201453300",428,349,792,333,602,238,640,487,3869
"48201453401",1471,209,452,87,942,248,1566,204,5179
"48201453402",2986,283,1073,553,2086,1182,3275,681,12119
"48201453403",420,196,1091,605,727,690,532,766,5027
"48201453501",1621,607,1311,244,2145,427,2011,857,9223
"48201453502",1600,238,981,141,572,48,1407,252,5239
"48201453601",673,252,469,59,606,147,901,260,3367
"48201453602",2798,519,1201,1106,1915,817,3716,503,12575
"48201453700",1502,286,1840,613,2986,616,3077,450,11370
"48201453800",1235,424,608,173,967,317,1140,473,5337
"48201453900",2619,195,1501,580,4474,747,2750,398,13264
"48201454000",1728,189,1445,187,1191,344,1473,375,6932
"48201454100",1717,59,890,92,975,42,1274,27,5076
"48201454200",2124,370,1501,12,471,0,1703,360,6541
"48201454301",4864,242,3823,540,1720,567,3766,241,15763
"48201454302",3470,332,1445,0,1348,89,2374,263,9321
"48201454400",359,4,0,0,140,42,174,28,747
"48201454501",6350,182,157,0,1800,0,1172,0,9661
"48201454502",1453,101,94,0,884,0,256,51,2839
"48201454600",3654,149,78,52,907,129,1387,129,6485
"48201454700",5824,163,271,0,576,14,972,63,7883
"48201454800",5561,369,556,73,841,233,1730,102,9465
"48201454900",7828,233,779,0,2606,144,2335,65,13990
"48201455000",2116,81,214,0,500,0,686,27,3624
"48201455101",5834,450,431,0,414,0,1948,259,9336
"48201455102",3050,268,64,0,177,82,657,0,4298
"48201455200",3516,325,378,6,259,0,1180,168,5832
"48201455300",2750,188,431,111,658,0,1055,43,5236
"48201510100",1273,133,155,21,524,145,747,238,3236
"48201510200",3925,561,216,139,840,269,1403,523,7876
"48201510300",4601,184,52,28,469,46,861,192,6433
"48201510400",3005,226,45,0,250,0,553,14,4093
"48201510500",2369,296,125,18,394,10,687,235,4134
"48201510600",3352,280,269,61,616,58,666,172,5474
"48201510700",2880,59,98,3,653,35,669,37,4434
"48201510800",6074,172,137,17,1061,83,958,40,8542
"48201510900",4175,1121,361,28,1183,67,1844,772,9551
"48201511001",2313,60,69,0,170,60,646,48,3366
"48201511002",2979,268,240,0,599,0,930,0,5016
"48201511100",2075,81,91,137,530,96,947,124,4081
"48201511200",3702,136,288,47,620,335,1652,350,7130
"48201511301",3101,168,0,0,366,16,688,127,4466
"48201511302",3230,383,46,1,266,1,650,19,4596
"48201511400",2519,497,33,58,153,0,813,340,4413
"48201511500",5098,565,72,17,590,140,2336,398,9216
"48201511600",2663,917,12,29,367,24,2107,929,7048
"48201520100",1580,33,33,12,457,79,863,90,3147
"48201520200",2524,456,40,56,697,145,928,359,5205
"48201520300",2484,592,285,82,858,558,2132,863,7854
"48201520400",1062,601,39,29,868,412,1225,924,5160
"48201520500",3700,2057,696,141,1032,1339,3695,2851,15511
"48201520601",937,493,16,0,514,583,1240,999,4782
"48201520602",1690,1810,113,59,1562,826,2570,2508,11138
"48201520700",2345,474,84,97,787,350,834,650,5621
"48201521000",1090,236,81,71,187,150,724,350,2889
"48201521100",663,366,4,0,643,626,1086,926,4314
"48201521200",1204,1180,523,20,2533,980,3038,2082,11560
"48201521300",2413,648,163,97,1780,908,2786,1455,10250
"48201521400",1922,1455,15,0,2545,1334,4123,2768,14162
"48201521500",2815,659,202,82,1796,455,2824,958,9791
"48201521600",2109,220,580,33,427,302,2209,497,6377
"48201521700",2314,1342,903,531,833,801,1970,1751,10445
"48201521800",2265,562,359,137,1666,113,1920,494,7516
"48201521900",5366,645,278,8,697,127,3439,371,10931
"48201522000",2165,659,353,10,922,481,1723,947,7260
"48201522100",3824,550,464,119,2116,665,3075,1090,11903
"48201522201",1538,754,256,0,1371,485,1782,1178,7364
"48201522202",1875,432,26,170,470,1234,1272,1618,7097
"48201522301",1920,468,138,45,1188,191,1867,476,6293
"48201522302",1792,396,216,50,1337,200,1856,535,6382
"48201522401",3983,701,97,58,683,253,1927,591,8293
"48201522402",2296,946,33,0,180,51,575,949,5030
"48201522500",4237,98,0,0,411,12,360,19,5137
"48201530100",3044,1276,490,296,1144,442,3303,1665,11660
"48201530200",3209,221,75,37,421,8,1273,70,5314
"48201530300",771,123,1157,434,26,3,845,113,3472
"48201530400",853,437,724,493,132,46,950,420,4055
"48201530500",1902,878,1226,301,179,187,1957,1034,7664
"48201530600",878,1295,575,285,304,345,944,1433,6059
"48201530700",2399,1118,676,1365,52,27,2092,1110,8839
"48201530800",397,203,1994,628,334,204,589,281,4630
"48201530900",3215,224,272,132,416,168,1453,262,6142
"48201531000",2902,284,40,39,216,0,676,227,4384
"48201531100",2407,147,10,0,82,9,549,73,3277
"48201531200",2276,506,116,84,195,21,973,436,4607
"48201531300",3147,972,354,69,953,480,3164,1076,10215
"48201531400",1480,174,51,9,189,78,578,158,2717
"48201531500",2083,76,198,13,482,80,1201,107,4240
"48201531600",2333,166,59,0,497,25,1118,174,4372
"48201531700",2884,139,0,17,88,24,736,0,3888
"48201531800",271,191,988,350,206,31,438,203,2678
"48201531900",540,359,2327,1092,205,0,802,171,5496
"48201532001",2171,377,1411,901,301,248,1832,451,7692
"48201532002",850,8,163,0,32,0,234,8,1295
"48201532100",1916,1208,1138,578,1136,869,1822,1967,10634
"48201532200",982,863,677,248,257,172,867,951,5017
"48201532300",2878,593,1662,267,752,173,2485,527,9337
"48201532400",4169,511,816,0,992,114,3310,475,10387
"48201532501",4434,443,351,223,3561,227,5667,632,15538
"48201532502",2598,817,592,36,1492,127,3418,900,9980
"48201532600",2442,693,993,717,1431,410,2781,786,10253
"48201532700",2267,357,1621,815,773,106,1981,317,8237
"48201532800",865,145,307,80,240,55,754,164,2610
"48201532900",1841,323,1827,219,749,325,1820,587,7691
"48201533000",435,327,1029,615,280,68,727,413,3894
"48201533100",1837,135,3288,989,419,164,1680,268,8780
"48201533200",753,236,1913,463,187,0,603,205,4360
"48201533300",694,97,2856,2650,146,0,825,97,7365
"48201533400",4333,1134,2954,1760,1134,179,5060,1233,17787
"48201533500",2069,825,536,36,754,28,1927,848,7023
"48201533600",2108,739,1264,519,744,97,2383,775,8629
"48201533701",3095,1284,601,98,312,436,3155,1627,10608
"48201533702",1928,578,399,9,559,83,2155,656,6367
"48201533801",4134,1695,1551,404,1529,272,4412,1802,15799
"48201533802",2991,1691,737,81,972,179,3249,1685,11585
"48201533901",2998,1951,2605,299,1842,505,3873,2223,16296
"48201533902",1387,768,1033,814,308,279,1490,874,6953
"48201534001",1130,925,95,8,666,229,1352,943,5348
"48201534002",3671,473,640,300,571,50,3328,466,9499
"48201534003",893,253,850,12,411,204,1093,277,3993
"48201534100",2790,1409,850,194,2360,620,2429,1729,12381
"48201534201",1100,497,106,15,622,96,896,478,3810
"48201534202",6312,186,653,0,1567,202,2198,165,11283
"48201534203",619,125,254,0,514,190,584,256,2542
"48201540100",6824,426,549,0,4015,269,3028,280,15391
"48201540200",1842,190,173,115,745,80,1750,193,5088
"48201540501",2745,998,1004,16,1377,284,2748,1198,10370
"48201540502",4050,399,263,0,229,62,1324,283,6610
"48201540601",2567,278,793,60,606,43,1422,213,5982
"48201540602",3505,512,1272,113,1186,631,2574,734,10527
"48201540700",4483,510,474,4,1697,245,2521,477,10411
"48201540800",3910,800,823,280,2132,65,3941,730,12681
"48201540901",1654,189,91,57,380,0,337,120,2828
"48201540902",3983,477,1425,63,1392,185,1043,430,8998
"48201541001",5761,990,1674,503,1773,297,2426,920,14344
"48201541002",5261,61,1012,293,1830,153,2097,0,10707
"48201541003",7846,233,2510,552,3195,229,3336,108,18009
"48201541100",4862,148,710,298,888,86,1115,0,8107
"48201541201",5855,192,537,0,1483,67,1805,62,10001
"48201541202",4942,684,394,199,2204,858,2589,608,12478
"48201541203",2334,10,42,0,150,0,304,0,2840
"48201541300",5739,1428,2111,367,2834,52,5619,1202,19352
"48201541400",6359,1019,3259,307,4828,428,5603,1107,22910
"48201541500",3013,241,478,0,1304,226,2040,261,7563
"48201541601",3526,422,490,4,973,0,990,180,6585
"48201541602",6020,951,1007,2,1583,374,4444,833,15214
"48201541700",5755,967,2306,308,1636,168,3499,966,15605
"48201541800",3914,298,929,163,440,141,1768,141,7794
"48201541900",5058,43,826,0,863,44,2539,18,9391
"48201542000",9731,664,2022,142,2069,253,5535,551,20967
"48201542101",9046,2670,3774,902,3700,52,8011,2380,30535
"48201542102",7569,2421,3297,941,2083,176,5384,2299,24170
"48201542200",11150,722,3938,412,2472,509,9409,869,29481
"48201542301",7950,1059,1417,249,2693,595,5884,1496,21343
"48201542302",4588,307,1494,113,1168,50,3424,258,11402
"48201542400",6115,504,652,274,2429,525,5031,684,16214
"48201542500",2343,122,98,0,113,19,313,94,3102
"48201542600",3261,68,426,0,1061,19,1625,19,6479
"48201542700",3855,410,72,16,257,54,1308,158,6130
"48201542800",6137,348,65,0,686,126,1853,438,9653
"48201542900",7897,837,1625,59,2674,313,4654,597,18656
"48201543001",6475,297,2310,129,1568,50,2252,140,13221
"48201543002",9665,421,1907,0,2904,19,2648,283,17847
"48201543003",10625,1290,3581,17,3058,790,8413,1548,29322
"48201543100",1610,590,164,0,544,4,1068,525,4505
"48201543200",3433,470,189,345,1658,144,1873,340,8452
"48201550100",826,1125,1145,958,897,279,1410,1316,7956
"48201550200",827,352,1600,953,226,131,844,391,5324
"48201550301",2036,336,3404,1069,397,258,1782,573,9855
"48201550302",2054,899,4048,1668,1647,326,2204,866,13712
"48201550401",4282,2469,2878,1446,1374,414,4253,2441,19557
"48201550402",1520,446,6191,1135,1134,166,1577,536,12705
"48201550500",1857,447,1731,461,1013,117,2217,475,8318
"48201550601",2947,239,2721,218,885,197,3105,413,10725
"48201550602",939,275,981,146,493,31,1020,289,4174
"48201550603",2221,514,1388,166,1045,185,2768,659,8946
"48201550700",1006,355,909,88,732,14,1021,320,4445
"48201550800",960,249,1407,798,470,32,1136,238,5290
"48201550900",3820,1142,1478,109,2192,526,3685,1102,14054
"48201551000",1533,547,677,126,341,130,1684,514,5552
"48201551100",2672,1387,2974,623,2414,495,2683,1532,14780
"48201551200",3362,659,569,117,1674,310,1351,586,8628
"48201551300",1778,66,934,101,1098,18,792,37,4824
"48201551400",2887,163,1043,20,1201,50,1359,138,6861
"48201551500",3605,284,2116,387,1840,155,2422,245,11054
"48201551600",5564,621,577,260,1435,118,3957,490,13022
"48201551701",5164,164,1226,0,1651,161,2197,85,10648
"48201551702",2641,38,112,0,1316,59,1015,8,5189
"48201551703",4762,421,387,0,1655,28,1559,408,9220
"48201551800",4081,18,100,76,293,28,491,1,5088
"48201551900",2125,614,1834,381,688,444,1567,383,8036
"48201552001",4020,559,1783,492,2535,58,2679,169,12295
"48201552002",1050,63,382,14,221,17,313,23,2083
"48201552101",1732,87,772,19,1075,138,630,40,4493
"48201552102",4563,124,464,0,1070,0,1206,20,7447
"48201552103",2109,144,411,27,219,304,630,330,4174
"48201552200",3621,405,497,613,940,228,1441,390,8135
"48201552301",3383,159,289,0,105,0,485,8,4429
"48201552302",3067,387,232,202,1137,19,878,47,5969
"48201552400",4271,262,1058,328,1260,126,2030,224,9559
"48201552500",6808,616,1468,121,1679,336,3171,181,14380
"48201552601",2229,301,1094,702,862,116,1051,174,6529
"48201552602",4334,367,962,0,916,67,1199,175,8020
"48201552700",5480,618,860,41,1242,0,1683,366,10290
"48201552800",6523,168,1286,99,1032,0,1223,0,10331
"48201552900",4621,358,1445,470,462,42,679,43,8120
"48201553001",3194,262,1211,50,900,82,1390,249,7338
"48201553002",2094,443,1062,25,975,82,815,430,5926
"48201553100",2482,484,1696,92,975,73,1446,467,7715
"48201553200",2376,390,1793,630,656,19,1346,379,7589
"48201553300",944,255,2399,825,958,345,1270,325,7321
"48201553401",3322,33,300,0,333,0,655,0,4643
"48201553402",4515,223,824,268,1519,56,1005,128,8538
"48201553403",4654,147,483,76,1095,20,1326,60,7861
"48201553500",5226,247,231,3,623,4,1143,194,7671
"48201553600",4992,209,684,1,1035,0,1306,52,8279
"48201553700",2698,485,526,4,263,13,577,281,4847
"48201553801",2305,170,47,17,124,60,406,202,3331
"48201553802",6073,768,311,0,974,68,1107,297,9598
"48201553900",5862,131,905,0,1149,72,833,21,8973
"48201554001",2493,172,613,26,460,111,779,153,4807
"48201554002",3564,150,33,0,749,151,617,0,5264
"48201554101",1255,22,33,0,31,17,184,19,1561
"48201554102",6428,257,648,172,2743,0,1993,0,12241
"48201554200",5759,236,909,133,1009,420,2392,337,11195
"48201554301",6385,33,362,23,276,17,876,17,7989
"48201554302",2907,127,335,238,1107,46,655,0,5415
"48201554401",13564,145,279,0,1341,0,2496,29,17854
"48201554402",10517,328,1171,111,1338,186,1708,148,15507
"48201554403",7800,295,1006,17,1003,62,1990,149,12322
"48201554501",5305,106,426,0,438,80,1116,28,7499
"48201554502",5941,67,128,0,418,0,817,0,7371
"48201554600",3997,59,154,0,337,10,538,0,5095
"48201554700",6187,85,420,79,1206,39,966,23,9005
"48201554801",10860,945,1684,71,2259,579,3402,650,20450
"48201554802",11807,1515,946,0,2285,25,2659,765,20002
"48201554901",5442,328,867,79,2088,90,2274,130,11298
"48201554902",6002,84,83,30,961,0,1380,61,8601
"48201554903",8994,38,587,0,1630,80,2041,0,13370
"48201555000",5516,307,848,0,808,64,2128,37,9708
"48201555100",6371,376,508,334,1476,0,1999,255,11319
"48201555200",5506,384,470,39,350,174,2066,424,9413
"48201555301",709,72,0,3,13,0,139,0,936
"48201555302",13670,510,397,0,1349,77,3558,270,19831
"48201555303",4824,180,387,62,248,6,1134,95,6936
"48201555401",2054,339,122,67,166,16,453,231,3448
"48201555402",4697,1603,179,358,603,12,841,724,9017
"48201555501",3859,489,37,2,194,1,1084,268,5934
"48201555502",14955,995,954,186,2613,999,3904,1336,25942
"48201555600",3911,836,359,61,248,3,796,485,6699
"48201555701",6594,56,946,0,712,20,1532,0,9860
"48201555702",9309,118,773,118,716,122,1458,68,12682
"48201556000",4982,1249,930,107,265,0,2002,593,10128
"48201980000",4,4,0,0,0,0,0,0,8
"48201980100",204,84,231,166,130,21,294,49,1179
"48203020102",3708,473,643,387,213,47,416,156,6043
"48203020103",2757,658,296,273,173,51,164,204,4576
"48203020104",2644,247,418,237,25,43,216,91,3921
"48203020200",5152,634,692,402,135,1,172,1,7189
"48203020301",3202,168,679,66,197,0,365,0,4677
"48203020302",2169,554,544,578,9,44,658,325,4881
"48203020401",1215,375,1297,775,205,130,691,377,5065
"48203020402",847,428,2005,835,184,131,503,357,5290
"48203020501",1103,394,593,335,243,8,766,180,3622
"48203020502",2758,584,658,58,193,39,531,202,5023
"48203020603",4447,219,241,0,298,132,250,132,5719
"48203020604",2893,373,632,30,390,55,334,6,4713
"48203020605",4074,788,569,16,247,35,60,51,5840
"48203020606",4472,388,406,2,142,158,452,160,6180
"48205950200",3959,198,28,1,342,96,943,210,5777
"48207950300",2068,534,79,2,224,91,262,154,3414
"48207950400",1464,320,27,53,129,30,225,165,2413
"48209010100",1389,871,102,75,93,58,257,330,3175
"48209010200",419,518,30,0,93,21,70,54,1205
"48209010302",2583,1075,78,27,378,317,1974,930,7362
"48209010303",4039,2432,204,247,471,150,1826,773,10142
"48209010304",2567,2692,90,108,179,543,1610,1866,9655
"48209010400",5522,2166,589,113,1410,251,3714,1481,15246
"48209010500",2335,1336,140,42,410,74,1469,790,6596
"48209010600",7972,887,116,50,1175,105,2613,492,13410
"48209010701",4206,3353,0,0,232,147,1046,1297,10281
"48209010702",2041,996,0,34,40,99,397,240,3847
"48209010803",3340,660,0,0,155,5,495,91,4746
"48209010804",8263,262,126,0,385,0,554,39,9629
"48209010805",6606,192,71,0,666,0,1014,76,8625
"48209010806",3553,312,33,4,61,3,193,123,4282
"48209010807",1777,123,0,0,93,54,335,86,2468
"48209010808",4679,652,8,2,243,17,294,100,5995
"48209010809",4365,271,0,0,708,6,1309,97,6756
"48209010901",6907,272,224,0,511,25,1377,15,9331
"48209010902",9982,711,528,0,1326,89,4032,363,17031
"48209010905",5012,272,171,0,245,116,1995,256,8067
"48209010906",8323,1097,642,36,2129,488,5010,1257,18982
"48209010907",7299,988,396,0,1547,1124,5944,1856,19154
"48209010908",6904,1357,149,34,1588,354,5311,1287,16984
"48209010909",4890,60,237,0,635,41,1699,0,7562
"48209010910",6649,252,603,106,753,11,4459,93,12926
"48211950300",3234,304,40,0,292,198,968,384,5420
"48213950100",5244,714,320,58,110,60,201,84,6791
"48213950200",4243,850,34,0,177,13,536,336,6189
"48213950300",6320,910,138,73,121,47,770,121,8500
"48213950400",3426,576,266,68,148,0,229,93,4806
"48213950500",1984,326,7,3,17,0,79,28,2444
"48213950601",2004,1107,22,34,104,12,200,173,3656
"48213950602",3905,1036,50,0,171,36,154,318,5670
"48213950700",3271,1143,0,0,34,73,539,249,5309
"48213950800",4024,341,169,0,217,0,406,0,5157
"48213950901",4337,761,33,12,232,20,94,33,5522
"48213950902",1495,214,128,111,52,12,57,20,2089
"48213950903",1562,296,41,4,127,20,0,0,2050
"48213951000",1270,488,335,345,106,13,372,70,2999
"48213951100",2809,514,39,0,115,26,77,74,3654
"48213951200",2934,1626,1072,244,253,143,1291,1353,8916
"48213951300",3424,438,322,295,203,198,644,195,5719
"48213951400",4599,1166,794,115,127,31,252,63,7147
"48215020101",2700,3383,0,1,145,253,2639,3621,12742
"48215020102",5867,2627,0,0,19,82,4522,2670,15787
"48215020201",4915,2392,4,0,401,89,5225,2461,15487
"48215020202",4534,2060,0,13,215,224,4670,2259,13975
"48215020204",5545,3303,41,0,349,49,5545,3115,17947
"48215020205",3911,1250,36,0,174,118,3733,1368,10590
"48215020301",9246,761,84,0,370,75,6952,772,18260
"48215020302",7858,796,111,0,564,0,7255,737,17321
"48215020402",6107,1505,116,0,1672,0,5666,1378,16444
"48215020403",2375,1710,0,0,197,411,2257,2102,9052
"48215020404",4150,1046,31,0,162,96,2643,1035,9163
"48215020501",3439,1106,0,2,505,215,3502,1264,10033
"48215020503",7129,2827,300,0,728,250,7524,3077,21835
"48215020504",4388,2645,146,0,1100,342,4784,2968,16373
"48215020600",1216,914,17,0,106,112,1294,924,4583
"48215020701",7308,1624,17,42,755,88,6544,1754,18132
"48215020721",4919,1995,0,0,820,158,4903,2118,14913
"48215020723",2026,2431,0,19,398,380,2375,2672,10301
"48215020724",3094,711,63,0,323,87,2688,720,7686
"48215020725",3212,1063,0,106,188,298,2873,1358,9098
"48215020726",3229,2115,0,0,310,366,2953,2446,11419
"48215020802",4663,2132,0,0,586,658,4014,2739,14792
"48215020803",4121,817,86,0,454,69,3305,886,9738
"48215020804",2851,648,60,23,86,191,2305,772,6936
"48215020901",3425,637,46,0,697,46,2788,619,8258
"48215020903",3772,854,5,0,667,173,3641,991,10103
"48215020904",2679,830,0,0,564,147,2210,864,7294
"48215021000",3058,1899,0,45,189,911,2936,2779,11817
"48215021100",1239,880,77,0,272,256,1436,1128,5288
"48215021201",1978,523,0,0,490,13,1769,474,5247
"48215021202",3636,752,0,0,596,10,3310,751,9055
"48215021302",8118,7390,35,0,289,404,8334,7775,32345
"48215021303",4538,3097,0,0,505,144,4926,3241,16451
"48215021304",4214,1582,0,0,204,241,4331,1822,12394
"48215021305",4781,1890,0,0,397,348,5127,2238,14781
"48215021401",2579,3025,0,3,209,53,2594,2939,11402
"48215021403",3150,1172,21,41,495,110,3100,1306,9395
"48215021404",7061,1324,0,0,312,11,5756,1322,15786
"48215021500",2212,1231,0,0,168,81,2380,1312,7384
"48215021600",2333,2022,11,0,105,117,2392,2050,9030
"48215021701",6459,2261,0,0,667,72,6579,2020,18058
"48215021702",9536,2833,0,0,435,0,9363,2654,24821
"48215021803",3180,2147,0,0,167,57,3264,2204,11019
"48215021804",2357,2280,27,0,58,80,2407,2360,9569
"48215021805",6183,2758,0,0,355,70,6418,2828,18612
"48215021806",6028,2430,0,0,207,43,6133,2473,17314
"48215021901",5283,3891,0,15,114,189,4286,4004,17782
"48215021903",2802,1450,0,25,162,18,2773,1458,8688
"48215021904",3164,1712,26,0,83,20,2562,1709,9276
"48215022001",8191,2902,0,1,508,114,8348,2925,22989
"48215022003",3738,3324,0,0,100,276,3014,3538,13990
"48215022004",5964,3783,76,0,296,195,5778,3857,19949
"48215022103",3457,1849,0,153,219,172,2950,2004,10804
"48215022104",4803,6300,27,0,429,46,5039,6274,22918
"48215022105",2291,1493,0,1,67,0,2287,1479,7618
"48215022106",3580,1684,40,0,508,102,3460,1729,11103
"48215022201",3813,2973,0,0,228,41,3734,2943,13732
"48215022203",2491,1692,0,1,136,168,2376,1835,8699
"48215022204",3263,1652,25,0,121,235,3345,1887,10528
"48215022300",7519,1299,14,0,544,131,6162,1357,17026
"48215022401",2730,1533,53,0,259,168,2716,1682,9141
"48215022402",4104,1270,8,1,244,147,4110,1396,11280
"48215022501",3737,2533,8,0,231,244,3920,2764,13437
"48215022502",3494,1819,81,0,230,84,3626,1874,11208
"48215022600",1230,548,0,0,217,72,1432,620,4119
"48215022701",3456,981,0,0,437,173,2258,1001,8306
"48215022702",3694,2131,0,0,56,9,2824,2010,10724
"48215022800",5018,3523,2,0,156,286,4823,3790,17598
"48215022900",2871,1183,7,0,226,316,2692,1376,8671
"48215023000",3055,1352,87,0,204,129,3069,1475,9371
"48215023102",4499,2600,12,23,483,589,4870,3212,16288
"48215023103",3463,3333,49,0,171,201,3495,3501,14213
"48215023104",3042,2286,56,8,112,72,3058,2356,10990
"48215023503",6033,1886,0,0,282,186,6148,2055,16590
"48215023504",6700,2539,182,0,245,335,6279,2694,18974
"48215023507",4941,3373,0,0,728,251,5397,3624,18314
"48215023509",8693,1640,0,158,989,47,7015,1704,20246
"48215023510",7009,661,14,0,1602,410,6257,928,16881
"48215023511",4496,4844,0,0,531,709,4847,5553,20980
"48215023512",183,108,0,0,0,15,172,123,601
"48215023513",4249,3473,54,0,257,203,4049,3655,15940
"48215023514",4040,3743,61,0,429,589,4343,3913,17118
"48215023515",7621,3324,0,0,334,200,7435,3524,22438
"48215023600",5499,2959,0,7,512,401,5775,3252,18405
"48215023700",1858,2773,16,0,316,224,2155,2862,10204
"48215023801",6221,1760,0,0,686,332,6347,2018,17364
"48215023802",7137,1076,177,1,717,39,6645,1114,16906
"48215023902",8505,688,514,0,1421,655,7637,806,20226
"48215023903",2230,1204,95,0,296,245,2303,1384,7757
"48215023904",6135,2049,0,0,654,260,5600,2246,16944
"48215024000",9523,5213,75,0,1281,418,9995,5280,31785
"48215024105",5250,3695,14,0,546,176,5264,3751,18696
"48215024106",7064,2965,61,0,942,24,6788,2863,20707
"48215024107",2564,1421,0,0,232,67,2365,1469,8118
"48215024108",2348,3092,0,128,834,186,3123,3278,12989
"48215024109",3684,3083,14,0,125,112,3666,3190,13874
"48215024110",6230,3094,0,0,348,143,6476,3237,19528
"48215024111",2732,1274,0,0,185,130,2698,1381,8400
"48215024112",3401,10056,0,0,159,539,3479,10595,28229
"48215024113",2374,3474,0,0,266,288,2555,3744,12701
"48215024114",3563,5250,0,0,400,141,3889,5357,18600
"48215024201",6579,7458,15,14,435,188,6813,7613,29115
"48215024203",5191,1619,0,0,206,65,3581,1520,12182
"48215024204",2255,2238,0,0,143,127,2106,2345,9214
"48215024205",4854,2103,0,0,394,91,5181,2105,14728
"48215024301",767,188,0,0,174,4,747,180,2060
"48215024302",373,518,0,0,0,38,290,543,1762
"48215024402",5468,2997,0,0,220,340,5593,3232,17850
"48215024403",3151,2772,18,0,348,24,3508,2791,12612
"48215024404",2760,1007,0,16,175,0,2847,1023,7828
"48215024500",4064,4105,0,123,346,461,4311,4618,18028
"48215024600",3844,2510,15,0,124,270,3900,2759,13422
"48215980000",0,0,0,0,0,0,0,0,0
"48217960100",2558,667,184,93,139,34,361,280,4316
"48217960200",3743,533,0,0,71,2,174,58,4581
"48217960400",1286,259,0,5,59,1,78,36,1724
"48217960500",4705,894,18,94,157,18,528,65,6479
"48217960600",777,275,25,13,66,24,133,42,1355
"48217960700",1366,333,2,7,49,0,211,85,2053
"48217960800",2018,792,262,218,130,16,691,401,4528
"48217960900",973,683,115,246,43,39,754,639,3492
"48217961000",892,282,386,164,3,34,603,268,2632
"48217961100",2874,446,47,38,89,67,515,222,4298
"48217961400",3434,641,316,130,69,1,397,134,5122
"48219950100",960,230,47,58,210,43,475,160,2183
"48219950200",3317,441,32,8,392,52,1091,247,5580
"48219950300",3777,175,72,1,410,142,2177,262,7016
"48219950400",3182,965,182,71,485,183,2765,880,8713
"48219950500",3352,508,72,87,306,28,1183,138,5674
"48219950600",988,114,14,3,148,11,394,80,1752
"48219950700",1126,159,13,0,187,18,574,79,2156
"48221160100",3440,435,41,9,190,0,419,12,4546
"48221160204",2312,299,19,71,20,15,223,0,2959
"48221160205",4879,1179,0,79,351,45,412,298,7243
"48221160206",3497,299,16,0,31,0,388,31,4262
"48221160207",5860,470,0,1,86,1,194,45,6657
"48221160208",3532,1143,0,0,1060,127,1610,331,7803
"48221160209",7247,647,0,7,268,6,846,90,9111
"48221160210",4988,264,0,0,115,0,322,55,5744
"48221160301",4701,324,117,0,227,25,293,18,5705
"48221160302",3155,538,2,2,131,175,166,175,4344
"48223950100",2465,366,6,18,80,40,262,43,3280
"48223950200",3669,699,9,9,126,8,284,76,4880
"48223950300",4165,674,76,13,508,75,760,275,6546
"48223950401",2682,629,269,238,345,60,765,228,5216
"48223950402",2674,552,196,0,115,177,434,247,4395
"48223950500",1584,719,191,85,158,16,208,252,3213
"48223950600",1921,518,826,222,146,381,31,322,4367
"48223950700",3224,650,74,25,326,179,598,378,5454
"48223950800",2155,496,19,123,131,0,424,54,3402
"48225950100",3518,634,422,237,27,346,34,328,5546
"48225950200",952,75,142,71,71,24,69,42,1446
"48225950300",1129,104,419,624,93,239,135,121,2864
"48225950400",703,371,841,851,87,174,137,336,3500
"48225950500",2739,264,412,71,193,95,344,78,4196
"48225950600",882,197,177,143,83,6,51,6,1545
"48225950700",1649,291,158,93,48,8,29,18,2294
"48227950100",1689,211,131,0,257,107,648,129,3172
"48227950200",1770,256,1,0,29,0,278,75,2409
"48227950300",827,488,71,11,252,95,818,511,3073
"48227950400",2376,611,243,42,187,65,909,433,4866
"48227950500",2313,688,25,112,516,74,1575,395,5698
"48227950600",3467,241,151,1,434,0,840,112,5246
"48227950700",2192,703,168,57,145,85,1158,405,4913
"48227950801",2953,167,105,132,514,129,814,270,5084
"48227950802",1222,197,246,0,154,68,424,199,2510
"48227950900",3117,229,10,9,267,9,600,96,4337
"48229950300",1596,1137,24,0,147,55,1225,1028,5212
"48231960100",1689,278,63,105,242,126,411,9,2923
"48231960200",1736,243,106,179,86,26,54,38,2468
"48231960300",3121,270,22,36,170,243,162,258,4282
"48231960400",3034,431,257,91,1041,92,1020,88,6054
"48231960500",1437,1149,455,215,199,197,179,190,4021
"48231960600",893,709,436,278,266,229,196,338,3345
"48231960700",4443,420,241,0,287,37,368,23,5819
"48231960800",960,398,541,187,499,674,694,873,4826
"48231960900",1775,608,561,462,687,480,865,480,5918
"48231961000",1770,922,190,212,930,90,951,173,5238
"48231961100",5641,461,358,3,296,259,260,249,7527
"48231961200",3376,246,790,46,426,46,429,30,5389
"48231961300",4887,927,286,138,407,23,505,339,7512
"48231961400",6238,729,239,65,670,369,949,365,9624
"48231961501",2866,216,0,0,123,0,137,0,3342
"48231961502",3747,421,145,0,276,235,407,235,5466
"48231961503",3288,595,17,0,403,119,377,120,4919
"48231961600",3424,1515,25,1,436,50,401,114,5966
"48231961700",2403,254,24,7,95,0,36,9,2828
"48233950200",1960,233,0,0,132,7,285,46,2663
"48233950500",4555,380,23,0,209,18,293,0,5478
"48233950600",2212,793,141,90,452,241,1291,489,5709
"48233950700",1049,642,54,26,51,42,235,169,2268
"48233950800",349,208,28,0,95,31,190,190,1091
"48233950900",3130,266,21,46,258,59,610,97,4487
"48233951000",3320,255,13,108,139,48,776,78,4737
"48235950100",1291,190,0,0,162,1,349,63,2056
"48237950100",1361,204,0,0,16,1,187,59,1828
"48237950300",2520,454,73,0,22,14,313,258,3654
"48237950500",2260,620,2,23,115,8,217,36,3281
"48239950100",4517,488,81,50,152,123,1223,249,6883
"48239950200",2483,481,572,153,175,14,1051,271,5200
"48239950300",4165,412,88,44,198,0,1349,232,6488
"48241950100",3925,422,354,91,0,48,162,71,5073
"48241950200",1115,370,936,450,352,0,456,286,3965
"48241950300",685,399,1536,829,23,0,89,170,3731
"48241950400",3409,628,300,183,455,46,166,161,5348
"48241950500",3045,696,347,0,162,21,108,0,4379
"48241950600",1432,385,255,193,82,42,274,39,2702
"48241950700",7812,621,0,0,115,10,89,0,8647
"48241950800",2389,320,25,54,76,104,14,0,2982
"48243950100",1866,122,0,0,180,1,807,37,3013
"48245000101",3119,305,1883,421,207,0,603,15,6553
"48245000102",796,201,1126,115,39,31,76,80,2464
"48245000103",333,64,1150,1546,18,60,126,81,3378
"48245000200",977,108,2932,434,284,194,299,235,5463
"48245000302",5000,32,1117,178,724,0,450,0,7501
"48245000304",3576,1035,1871,299,286,46,964,439,8516
"48245000306",2803,243,306,119,289,37,222,51,4070
"48245000307",1537,150,969,34,729,30,334,12,3795
"48245000308",2714,235,1800,516,572,228,295,36,6396
"48245000309",1772,104,707,181,142,29,373,29,3337
"48245000310",3735,135,1169,42,139,80,534,1,5835
"48245000400",2537,176,919,527,93,15,193,2,4462
"48245000500",986,121,841,306,39,15,474,0,2782
"48245000600",1121,153,2841,1308,111,97,947,154,6732
"48245000700",167,75,1919,914,12,8,169,18,3282
"48245000900",146,161,712,811,0,0,123,120,2073
"48245001100",918,309,601,261,127,88,107,184,2595
"48245001200",1135,122,639,234,242,42,717,39,3170
"48245001301",2023,375,1770,178,238,60,638,108,5390
"48245001302",1194,130,1056,393,403,28,485,0,3689
"48245001303",1733,223,819,275,332,31,231,129,3773
"48245001700",130,69,970,575,34,19,11,13,1821
"48245001900",797,621,830,281,367,122,628,494,4140
"48245002000",548,432,692,205,216,91,378,279,2841
"48245002100",254,288,1589,889,58,0,180,209,3467
"48245002200",228,111,1252,1263,12,33,83,86,3068
"48245002300",117,92,2085,739,12,0,119,70,3234
"48245002400",812,259,1056,562,23,91,409,268,3480
"48245002500",932,229,1480,814,397,42,765,160,4819
"48245002600",687,267,1410,1435,353,312,352,9,4825
"48245005100",63,0,502,346,0,8,0,8,927
"48245005400",238,41,732,252,71,16,114,24,1488
"48245005500",1029,82,787,401,469,173,927,6,3874
"48245005600",2032,827,470,195,393,57,1933,526,6433
"48245005900",5,62,780,701,4,0,5,0,1557
"48245006100",28,93,681,288,15,15,28,21,1169
"48245006300",72,133,825,289,31,4,32,15,1401
"48245006400",464,129,705,212,70,12,430,88,2110
"48245006500",1312,626,736,151,427,205,1044,755,5256
"48245006600",1348,691,507,713,339,376,697,593,5264
"48245006700",1378,463,561,58,352,98,1406,486,4802
"48245006800",957,321,404,65,373,24,484,294,2922
"48245006900",751,313,1433,408,296,7,131,0,3339
"48245007001",1557,832,1412,1233,713,120,514,442,6823
"48245007002",1815,155,658,100,1167,213,626,199,4933
"48245007100",2493,474,196,0,189,193,900,448,4893
"48245010100",1610,748,380,54,316,19,1540,649,5316
"48245010200",917,391,479,168,91,37,520,347,2950
"48245010300",1712,134,246,258,199,97,1245,161,4052
"48245010400",2276,287,38,55,115,86,224,95,3176
"48245010500",2772,601,337,142,355,27,1141,429,5804
"48245010600",4267,604,49,0,268,17,964,121,6290
"48245010700",2863,191,9,58,95,0,269,51,3536
"48245010800",3428,925,205,0,146,97,305,47,5153
"48245010901",2696,172,175,0,182,61,61,25,3372
"48245010902",3799,170,154,0,445,167,475,35,5245
"48245011001",4199,448,49,1,160,134,633,20,5644
"48245011002",3230,124,60,11,98,0,306,49,3878
"48245011101",3973,389,104,14,86,41,544,65,5216
"48245011102",2344,218,38,0,173,0,531,10,3314
"48245011201",6447,318,70,66,547,20,946,20,8434
"48245011202",0,0,0,0,0,0,0,0,0
"48245011203",0,0,0,0,0,0,0,0,0
"48245011302",0,0,0,0,0,0,0,0,0
"48245011303",2174,76,0,0,58,0,182,0,2490
"48245011304",2578,213,307,95,110,10,119,26,3458
"48245011400",5040,844,1409,103,121,183,580,607,8887
"48245011500",2051,292,77,7,20,11,155,84,2697
"48245011600",1460,212,21,0,97,18,227,95,2130
"48245011700",671,152,421,235,90,0,590,113,2272
"48245011800",108,107,861,478,39,0,66,64,1723
"48245980000",57,0,0,0,85,25,23,0,190
"48245990000",0,0,0,0,0,0,0,0,0
"48247950200",2338,337,0,0,83,4,2292,326,5380
"48247950400",1700,566,65,0,115,8,1630,550,4634
"48249950100",7421,1553,54,55,209,140,4654,1079,15165
"48249950200",5400,1258,62,0,346,145,4763,1317,13291
"48249950300",5341,1287,0,0,441,12,4360,1124,12565
"48249950400",2547,802,0,2,94,51,2231,720,6447
"48249950500",4114,1582,0,0,268,273,3992,1513,11742
"48249950600",2922,1253,31,0,75,33,2855,1248,8417
"48249950700",2417,651,0,0,113,31,2136,670,6018
"48251130100",3551,352,0,0,120,0,572,94,4689
"48251130204",9097,1290,366,0,456,12,1204,240,12665
"48251130205",3347,420,85,0,174,0,509,33,4568
"48251130207",6023,289,175,0,180,0,719,25,7411
"48251130208",5282,423,0,0,77,0,646,0,6428
"48251130210",4265,558,32,2,277,9,400,186,5729
"48251130211",5231,700,0,0,139,65,549,321,7005
"48251130212",3505,803,188,0,168,61,717,446,5888
"48251130213",3299,454,131,0,215,20,654,117,4890
"48251130214",4229,375,90,11,169,53,488,80,5495
"48251130215",3790,97,265,0,236,4,486,4,4882
"48251130302",3245,822,72,0,232,53,424,229,5077
"48251130303",2536,688,7,196,722,41,1172,287,5649
"48251130304",3686,690,261,118,318,164,1031,338,6606
"48251130405",5636,61,0,1,166,2,909,1,6776
"48251130406",5683,262,9,11,79,0,474,63,6581
"48251130407",6130,1298,267,9,640,311,2565,1269,12489
"48251130408",5093,469,132,40,690,49,1401,146,8020
"48251130409",5541,454,0,2,409,32,412,29,6879
"48251130410",5747,484,49,96,564,32,1175,165,8312
"48251130500",5669,544,39,45,97,0,215,117,6726
"48251130601",5816,855,48,19,138,69,705,315,7965
"48251130602",1511,280,0,0,138,0,170,218,2317
"48251130700",3715,489,11,0,348,0,1223,146,5932
"48251130800",2217,1231,25,69,113,216,1022,869,5762
"48251130900",1522,827,227,183,48,11,744,632,4194
"48251131000",3853,628,124,18,88,12,777,410,5910
"48251131100",4876,436,0,77,131,0,1553,1,7074
"48253020101",876,181,4,0,68,0,122,7,1258
"48253020102",0,0,0,0,0,0,0,0,0
"48253020200",1494,380,43,8,250,22,685,140,3022
"48253020300",1391,412,59,64,79,45,387,147,2584
"48253020400",2225,408,50,245,290,103,779,183,4283
"48253020500",3299,267,1,45,106,105,189,112,4124
"48255970100",2106,175,0,0,141,40,217,53,2732
"48255970200",1740,468,90,10,844,468,1471,716,5807
"48255970300",2070,434,67,154,784,1073,1894,1280,7756
"48255970400",816,37,6,0,400,220,757,254,2490
"48257050201",4430,689,253,0,801,0,1404,584,8161
"48257050203",7045,112,1137,160,468,6,1006,4,9938
"48257050204",3798,410,888,7,463,0,1286,163,7015
"48257050205",5492,237,461,113,338,42,841,10,7534
"48257050206",8939,424,753,194,884,15,1767,135,13111
"48257050300",2303,450,277,257,411,98,790,329,4915
"48257050400",4707,1402,55,27,769,386,1398,1038,9782
"48257050500",1530,370,2503,529,220,36,737,173,6098
"48257050600",5178,995,537,46,484,0,922,470,8632
"48257050701",3737,383,163,122,294,134,414,377,5624
"48257050703",1925,193,36,90,209,22,431,97,3003
"48257050704",3868,963,124,130,173,482,522,956,7218
"48257050800",8019,932,175,66,228,35,730,133,10318
"48257051000",882,350,210,64,69,134,400,409,2518
"48257051100",3092,579,176,78,265,169,780,384,5523
"48257051201",1976,798,38,0,42,34,308,264,3460
"48257051202",4369,534,24,31,90,57,398,18,5521
"48257051300",6667,1456,313,120,186,55,534,110,9441
"48259970100",5181,682,0,0,0,376,1212,759,8210
"48259970301",5112,341,51,1,145,0,1285,30,6965
"48259970302",4331,65,48,0,111,0,581,15,5151
"48259970401",7067,155,76,4,677,73,1203,3,9258
"48259970402",6150,387,0,0,59,154,706,316,7772
"48259970500",4445,222,108,8,480,394,1481,492,7630
"48261950100",403,151,0,0,11,0,236,138,939
"48261990000",0,0,0,0,0,0,0,0,0
"48263950100",639,74,0,0,56,0,95,43,907
"48265960100",4302,889,0,0,314,158,633,208,6504
"48265960200",3196,124,0,0,58,0,441,0,3819
"48265960301",3245,1266,0,0,86,0,874,619,6090
"48265960302",5618,669,10,33,372,8,950,76,7736
"48265960401",1374,209,0,0,505,43,899,26,3056
"48265960402",4777,562,86,0,174,0,1441,60,7100
"48265960500",3274,703,118,130,354,224,1401,558,6762
"48265960600",4968,1659,183,11,273,0,2019,573,9686
"48265960700",4545,167,18,55,210,0,565,0,5560
"48265960800",2661,771,7,19,70,18,538,398,4482
"48267950100",1853,273,0,0,184,7,458,33,2808
"48267950200",1436,595,0,0,35,37,299,275,2677
"48269950100",240,19,0,0,8,0,58,8,333
"48271950100",2624,538,21,22,4,12,1471,394,5086
"48273020100",4092,451,0,32,157,150,2728,419,8029
"48273020200",2917,1805,0,0,393,127,2955,1849,10046
"48273020300",3252,1783,236,104,322,576,2495,1985,10753
"48273020400",4353,1272,270,60,521,134,3388,1196,11194
"48273020500",4966,1038,291,94,477,223,3824,824,11737
"48273990000",0,0,0,0,0,0,0,0,0
"48275950100",1390,153,16,30,95,15,417,63,2179
"48275950200",1344,297,135,89,78,21,547,201,2712
"48277000101",4009,227,65,0,230,17,308,7,4863
"48277000102",3904,656,85,34,146,8,130,129,5092
"48277000200",2555,594,56,85,118,32,104,248,3792
"48277000300",4402,641,229,37,249,56,423,63,6100
"48277000401",2204,391,508,147,221,48,63,78,3660
"48277000402",6066,267,78,9,362,0,727,7,7516
"48277000500",793,420,1081,623,40,229,61,62,3309
"48277000600",824,377,368,218,172,51,50,0,2060
"48277000700",1989,401,369,262,196,15,164,59,3455
"48277000800",1451,819,538,485,95,235,134,172,3929
"48277000900",3352,659,48,85,305,75,71,195,4790
"48277001000",2128,439,314,302,136,132,151,87,3689
"48279950100",1635,391,28,5,122,23,1103,321,3628
"48279950200",1144,229,21,1,59,1,494,219,2168
"48279950300",1732,546,17,10,126,69,745,456,3701
"48279950500",2032,728,225,177,220,119,1600,807,5908
"48279950600",2712,675,116,179,136,20,1218,292,5348
"48281950100",2038,434,7,66,51,6,255,286,3143
"48281950301",5531,472,313,0,668,22,775,55,7836
"48281950302",2437,234,35,0,121,0,340,0,3167
"48281950400",2233,850,20,133,307,226,844,526,5139
"48281950500",2898,473,236,7,179,0,585,95,4473
"48283950300",3951,958,0,0,1319,14,4310,931,11483
"48285000100",3374,337,80,28,79,37,103,29,4067
"48285000200",2407,214,276,103,227,80,347,105,3759
"48285000300",1955,135,27,2,320,103,355,119,3016
"48285000400",2652,167,187,77,208,34,217,57,3599
"48285000500",2203,193,16,10,595,29,675,37,3758
"48285000600",1238,58,449,33,1044,125,1231,102,4280
"48287000100",4081,343,76,125,90,139,272,152,5278
"48287000200",1827,96,482,148,262,47,427,61,3350
"48287000300",2466,207,19,54,151,0,465,49,3411
"48287000400",3002,1053,686,162,652,0,1630,649,7834
"48289950100",5398,841,393,201,379,71,1280,356,8919
"48289950200",3294,631,122,23,73,70,135,253,4601
"48289950300",4126,368,453,117,148,0,251,55,5518
"48291700100",2591,732,86,113,476,242,820,542,5602
"48291700200",727,345,1022,245,130,58,154,204,2885
"48291700300",6920,1564,20,94,781,546,1549,1529,13003
"48291700400",5314,1316,0,46,101,108,428,267,7580
"48291700500",1629,333,102,19,20,15,78,17,2213
"48291700600",1730,402,180,21,65,113,150,73,2734
"48291700700",2089,251,36,6,132,0,151,0,2665
"48291700800",7153,669,654,196,687,42,936,84,10421
"48291700900",1563,165,339,19,152,7,238,0,2483
"48291701000",4048,584,365,89,1382,170,2808,432,9878
"48291701100",4027,833,221,22,163,128,204,288,5886
"48291701200",4509,747,91,934,185,0,484,369,7319
"48291701300",2460,159,65,9,66,0,72,33,2864
"48291701400",4634,675,1115,439,649,92,1399,428,9431
"48293970100",1261,399,232,45,32,18,289,259,2535
"48293970200",2712,402,806,325,87,25,414,259,5030
"48293970300",1160,547,549,208,53,58,401,516,3492
"48293970400",458,211,604,45,105,41,224,187,1875
"48293970500",1067,319,317,93,3,15,434,166,2414
"48293970600",3006,973,309,396,168,76,628,235,5791
"48293970700",1373,441,16,3,56,0,136,0,2025
"48293970800",2627,509,52,23,105,17,162,69,3564
"48295950200",1558,150,8,0,329,49,716,140,2950
"48295950300",1145,112,0,0,79,6,146,29,1517
"48297950100",2429,596,12,13,53,0,906,227,4236
"48297950200",1462,372,0,0,225,22,742,317,3140
"48297950300",2456,230,0,2,21,3,530,119,3361
"48297950400",1789,329,0,0,241,0,456,119,2934
"48299970100",2330,185,0,0,24,3,157,0,2699
"48299970200",2435,869,0,1,85,0,419,211,4020
"48299970300",1548,155,0,12,2,0,65,8,1790
"48299970400",3019,176,138,0,37,0,172,0,3542
"48299970500",4995,1091,265,0,144,166,368,324,7353
"48299970600",1256,183,0,0,4,0,31,16,1490
"48301950100",48,13,0,0,33,20,20,18,152
"48303000100",1449,451,95,32,486,18,1405,458,4394
"48303000201",873,286,23,6,327,37,703,136,2391
"48303000202",933,497,12,26,233,356,1084,753,3894
"48303000301",1334,1399,154,112,433,523,1014,643,5612
"48303000302",3106,985,42,191,1532,786,3612,1187,11441
"48303000402",3085,898,187,107,439,137,1222,358,6433
"48303000403",2992,611,110,2,165,2,706,124,4712
"48303000404",4941,1056,341,26,1332,162,1700,219,9777
"48303000405",5732,2315,649,421,1370,298,3144,1093,15022
"48303000500",596,231,0,0,16,56,72,53,1024
"48303000603",418,2067,74,282,188,131,99,213,3472
"48303000605",91,597,0,21,6,174,5,224,1118
"48303000607",891,810,223,206,232,142,460,121,3085
"48303000700",777,72,38,28,216,49,748,102,2030
"48303000900",713,837,1625,448,583,223,1343,739,6511
"48303001000",670,678,1037,382,421,15,817,534,4554
"48303001200",449,185,1193,690,63,28,374,112,3094
"48303001300",1635,667,0,85,677,219,1966,796,6045
"48303001400",2893,1413,105,32,633,354,1399,633,7462
"48303001501",1561,713,34,0,184,16,288,44,2840
"48303001502",1125,848,0,2,97,38,164,138,2412
"48303001601",1477,254,98,15,181,48,218,38,2329
"48303001602",1601,713,40,137,493,131,865,214,4194
"48303001702",3166,571,280,105,255,8,653,349,5387
"48303001705",4936,633,111,18,614,248,712,364,7636
"48303001706",4203,571,121,243,645,137,2235,198,8353
"48303001707",3809,356,133,6,500,106,987,91,5988
"48303001708",1398,1016,156,37,169,40,460,479,3755
"48303001709",2710,635,350,290,482,453,1110,899,6929
"48303001801",4046,777,83,97,792,100,2677,446,9018
"48303001803",3426,415,695,79,487,76,911,212,6301
"48303001804",3251,160,103,56,324,70,696,202,4862
"48303001901",3442,843,515,38,371,25,1313,344,6891
"48303001903",4820,343,27,39,152,0,659,157,6197
"48303001904",1267,123,11,0,84,12,184,36,1717
"48303002001",1596,428,45,58,239,10,597,128,3101
"48303002002",1663,769,161,40,296,234,890,475,4528
"48303002101",4379,500,122,0,299,532,1866,171,7869
"48303002102",2423,115,237,8,174,34,560,62,3613
"48303002202",3416,424,361,20,745,186,2074,340,7566
"48303002203",1801,597,250,18,142,13,332,317,3470
"48303002204",2326,1174,343,282,352,437,1419,1455,7788
"48303002300",2929,805,188,252,508,111,2645,794,8232
"48303002400",3147,1864,436,288,1057,265,3273,1932,12262
"48303002500",1329,510,158,127,157,304,1053,635,4273
"48303010101",1422,88,0,0,89,0,439,12,2050
"48303010102",1968,232,34,7,153,33,794,141,3362
"48303010200",5163,981,64,129,765,161,2435,671,10369
"48303010301",3333,341,0,0,33,108,756,230,4801
"48303010302",2243,239,0,0,196,9,633,127,3447
"48303010402",1369,392,78,29,242,115,628,300,3153
"48303010403",4999,140,128,0,463,61,1023,45,6859
"48303010404",2130,443,66,127,224,191,776,301,4258
"48303010405",3625,329,0,0,514,65,882,143,5558
"48303010406",3801,557,0,1,410,0,569,2,5340
"48303010407",6345,88,170,0,914,0,1039,19,8575
"48303010408",7407,453,157,0,882,334,1452,246,10931
"48303010502",2865,92,24,0,285,19,182,12,3479
"48303010504",3439,39,44,8,312,0,440,10,4292
"48303010505",3399,192,251,12,529,156,1125,132,5796
"48303010506",3277,257,46,31,502,45,1276,80,5514
"48303010508",5926,672,208,32,869,224,2375,279,10585
"48303010509",2642,16,48,0,227,3,166,0,3102
"48303010510",2385,103,33,0,21,0,208,46,2796
"48303010511",3827,569,71,0,331,48,1001,476,6323
"48303010600",3607,296,880,138,601,468,1956,700,8646
"48303010700",3423,174,167,0,119,0,477,48,4408
"48303980000",0,0,0,0,0,0,0,0,0
"48305950400",1286,288,0,0,261,61,509,234,2639
"48305950500",1674,444,62,1,283,25,800,421,3710
"48305950600",916,270,0,0,138,17,526,222,2089
"48307950300",3782,922,119,0,171,314,1418,410,7136
"48307950400",1232,174,0,0,187,0,416,81,2090
"48307950500",995,85,0,2,86,25,127,69,1389
"48309000100",672,803,43,91,294,80,487,168,2638
"48309000200",508,2190,87,190,189,155,165,351,3835
"48309000300",0,0,0,0,0,0,0,0,0
"48309000400",1256,1876,303,764,236,552,698,471,6156
"48309000598",2306,1555,157,176,767,224,2645,1550,9380
"48309000700",2116,797,397,194,45,63,1361,422,5395
"48309000800",1471,482,392,151,328,118,1049,427,4418
"48309000900",2746,945,483,415,437,180,1862,860,7928
"48309001000",916,665,338,458,344,184,917,731,4553
"48309001100",2718,1208,522,664,323,262,2220,1281,9198
"48309001200",798,439,766,395,125,170,819,552,4064
"48309001300",1188,234,347,355,147,12,828,188,3299
"48309001400",1437,686,3292,1757,238,312,518,515,8755
"48309001500",199,139,1155,482,7,84,163,62,2291
"48309001600",2503,1833,459,370,867,87,1179,1334,8632
"48309001700",2658,971,998,335,281,7,1104,498,6852
"48309001800",907,3,276,58,119,10,270,19,1662
"48309001900",833,1908,577,770,190,280,570,370,5498
"48309002000",3359,251,77,0,77,50,391,123,4328
"48309002100",2334,879,584,590,328,547,1668,937,7867
"48309002302",1988,997,1185,505,179,114,615,448,6031
"48309002498",3144,655,312,228,100,0,930,566,5935
"48309002501",2640,401,594,498,347,141,778,512,5911
"48309002503",4725,169,247,22,33,0,508,19,5723
"48309002504",3191,188,81,16,46,0,507,0,4029
"48309002600",4706,562,256,73,396,0,835,441,7269
"48309002700",1916,562,702,203,373,353,1153,730,5992
"48309002800",2907,489,231,61,299,14,323,155,4479
"48309002900",3647,124,26,3,324,20,560,0,4704
"48309003000",2673,371,285,247,172,41,746,75,4610
"48309003200",2554,601,695,452,499,132,911,458,6302
"48309003300",525,494,96,124,58,108,114,65,1584
"48309003400",4725,657,307,23,65,120,417,96,6410
"48309003500",3241,710,8,0,72,8,243,9,4291
"48309003601",1791,324,413,211,68,15,210,125,3157
"48309003602",1842,443,31,31,114,37,191,105,2794
"48309003701",2321,216,250,0,245,42,544,42,3660
"48309003703",4592,480,130,0,142,16,724,42,6126
"48309003706",8587,209,908,253,840,0,1591,0,12388
"48309003707",6055,318,932,92,742,302,1302,21,9764
"48309003708",5670,417,639,0,552,47,1028,104,8457
"48309003801",6606,291,60,52,394,13,699,40,8155
"48309003802",4071,766,320,39,83,134,873,193,6479
"48309003900",6560,788,469,0,476,54,1617,306,10270
"48309004000",4604,248,30,13,80,14,252,12,5253
"48309004102",4432,737,9,0,367,0,393,58,5996
"48309004103",7038,552,348,29,412,0,924,5,9308
"48309004201",3322,451,110,75,87,7,174,107,4333
"48309004202",2664,399,42,17,107,2,237,37,3505
"48309004300",3874,1521,465,35,517,249,2798,1546,11005
"48309980000",0,0,0,0,0,0,0,0,0
"48311950100",639,92,0,0,47,0,332,42,1152
"48313000100",805,80,51,24,24,17,13,47,1061
"48313000200",1416,168,18,7,38,4,93,67,1811
"48313000300",1786,309,12,0,87,10,110,28,2342
"48313000400",2883,901,437,360,121,58,668,391,5819
"48315950100",1493,62,243,331,26,0,117,0,2272
"48315950200",1696,379,467,181,29,143,0,48,2943
"48315950300",1851,709,149,44,16,6,110,0,2885
"48315950400",1183,97,598,312,19,0,64,0,2273
"48317950100",1282,137,0,0,182,7,310,67,1985
"48317950200",2638,321,40,65,353,162,1707,290,5576
"48319950100",1205,458,0,0,291,17,530,206,2707
"48319950200",1919,95,0,0,57,7,238,19,2335
"48321730100",1527,551,160,169,231,110,1126,560,4434
"48321730201",4392,1571,260,78,235,194,2045,821,9596
"48321730202",1083,40,124,0,32,8,409,10,1706
"48321730301",2866,903,26,35,173,33,1173,546,5755
"48321730302",2758,570,985,175,267,216,1528,431,6930
"48321730303",529,82,41,132,92,0,146,0,1022
"48321730400",1422,9,642,410,242,47,697,0,3469
"48321730501",1954,431,203,56,120,0,275,67,3106
"48321730600",3716,694,63,0,768,542,2194,864,8841
"48321730700",3171,751,87,26,115,0,941,609,5700
"48321990000",0,0,0,0,0,0,0,0,0
"48323950201",4444,1938,0,0,519,309,4787,1959,13956
"48323950204",3580,1045,0,0,196,0,3687,1045,9553
"48323950205",6548,1629,0,0,318,218,6790,1847,17350
"48323950300",5628,1007,0,0,479,21,5629,1028,13792
"48323950400",2625,1060,0,10,160,48,2766,1068,7737
"48323950500",3133,2753,34,0,402,66,3070,2729,12187
"48323950601",1473,969,5,5,143,37,1440,933,5005
"48323950602",3636,846,7,0,320,126,3928,972,9835
"48323950700",6906,2685,12,0,333,100,6738,2659,19433
"48325000101",5984,870,12,0,287,12,3594,411,11170
"48325000102",6600,658,151,7,833,100,2014,586,10949
"48325000200",1450,188,0,0,13,9,368,147,2175
"48325000300",4403,974,52,1,477,0,2447,814,9168
"48325000401",4408,746,5,0,193,28,3448,725,9553
"48325000402",2997,743,0,20,153,119,1195,442,5669
"48325000500",3872,1127,0,8,195,0,2088,880,8170
"48325000800",5363,979,0,5,483,62,3081,553,10526
"48327950300",1599,257,8,14,204,46,625,165,2918
"48329000100",3088,340,1850,236,607,528,2958,865,10472
"48329000200",3540,393,28,59,280,16,1023,37,5376
"48329000302",4813,282,644,1,463,93,1209,255,7760
"48329000303",3942,212,0,1,128,0,597,109,4989
"48329000304",3030,36,70,97,655,101,747,100,4836
"48329000305",4529,147,248,3,397,70,951,15,6360
"48329000401",2843,15,20,3,673,4,1773,5,5336
"48329000402",4256,131,139,0,552,69,2038,110,7295
"48329000500",3749,490,119,161,218,28,1214,200,6179
"48329000600",3423,102,379,14,468,0,1475,5,5866
"48329001100",3509,836,183,12,751,82,2746,729,8848
"48329001200",5569,292,497,49,1593,31,4765,218,13014
"48329001300",5130,610,434,0,707,98,3692,276,10947
"48329001400",3333,734,201,22,356,302,3207,909,9064
"48329001500",2719,367,611,166,729,132,2967,499,8190
"48329001700",2842,660,531,229,423,298,3135,878,8996
"48329010104",6540,163,774,44,490,7,1861,8,9887
"48329010105",2636,445,132,69,452,15,988,303,5040
"48329010106",4211,449,195,22,449,0,837,17,6180
"48329010107",4098,349,62,3,574,22,1535,133,6776
"48329010108",2869,194,223,9,322,0,620,104,4341
"48329010109",5915,483,149,16,738,48,3988,317,11654
"48329010112",9352,651,164,0,662,145,2035,350,13359
"48329010113",10074,269,41,0,700,36,3259,83,14462
"48329010114",5796,482,27,0,696,63,2390,217,9671
"48329010200",1980,570,272,100,567,32,2461,598,6580
"48329980000",0,0,0,0,0,0,0,0,0
"48331950100",1651,448,19,42,195,46,536,165,3102
"48331950300",3068,601,35,13,134,72,735,346,5004
"48331950401",1867,416,199,70,472,12,578,195,3809
"48331950402",1816,200,465,341,186,51,670,81,3810
"48331950500",2099,259,146,43,65,0,216,47,2875
"48331950700",3789,908,294,211,684,117,1384,497,7884
"48331950800",2345,241,48,48,149,20,447,53,3351
"48333950100",1373,275,0,3,10,2,145,86,1894
"48333950200",2585,406,0,0,47,2,452,61,3553
"48335950200",4025,472,186,46,255,0,1679,297,6960
"48335950400",1358,210,32,5,58,33,377,100,2173
"48337950100",2364,270,0,0,51,3,109,12,2809
"48337950200",1720,149,12,12,54,0,54,27,2028
"48337950300",1666,864,0,1,140,71,219,326,3287
"48337950400",4310,167,0,0,80,91,366,116,5130
"48337950500",3946,947,0,0,168,126,280,334,5801
"48337950600",1739,170,0,0,42,7,65,49,2072
"48339690100",7736,1424,28,0,1102,13,1785,578,12666
"48339690201",8821,607,62,39,570,477,808,352,11736
"48339690202",5646,836,61,0,451,53,1149,716,8912
"48339690300",2953,868,132,19,767,11,1225,466,6441
"48339690401",5212,289,220,0,727,92,959,18,7517
"48339690402",13428,2126,109,4,929,644,2357,1681,21278
"48339690500",7974,122,163,0,483,36,443,36,9257
"48339690601",17098,919,252,9,1960,2,1763,2,22005
"48339690602",18389,527,664,0,2131,30,4072,363,26176
"48339690700",8651,364,209,0,381,89,891,77,10662
"48339690800",3771,112,51,0,310,0,347,30,4621
"48339690900",4021,99,15,8,484,0,427,0,5054
"48339691000",3949,71,75,0,353,0,369,0,4817
"48339691100",3965,71,0,0,239,0,492,0,4767
"48339691200",6113,205,209,57,950,0,830,28,8392
"48339691301",3802,120,80,0,552,0,366,7,4927
"48339691302",4191,573,214,443,146,46,575,27,6215
"48339691400",7620,463,527,23,1585,128,1943,61,12350
"48339691500",2773,343,156,357,562,32,545,284,5052
"48339691601",3541,189,47,6,358,95,524,120,4880
"48339691602",3892,900,155,0,563,102,1035,530,7177
"48339691700",1746,51,44,6,147,0,279,4,2277
"48339691800",6383,230,524,9,757,153,1565,171,9792
"48339691900",5058,465,297,0,91,337,995,373,7616
"48339692001",25305,872,2013,6,3155,142,5269,95,36857
"48339692002",7289,135,435,13,1209,0,1697,64,10842
"48339692100",9886,1163,652,27,1198,401,2876,444,16647
"48339692200",7089,1368,33,0,245,91,1688,643,11157
"48339692300",11553,1978,760,18,1408,366,2976,1243,20302
"48339692400",5902,1108,218,0,1295,725,964,864,11076
"48339692500",6353,1597,25,98,806,25,1569,588,11061
"48339692601",2978,1153,10,53,326,69,1756,667,7012
"48339692602",6157,2151,126,0,1636,1156,2141,2189,15556
"48339692700",5053,1310,55,0,613,177,1712,354,9274
"48339692801",6815,1352,86,0,851,273,1067,589,11033
"48339692802",3310,1137,106,2,375,377,1375,1086,7768
"48339692900",3804,769,21,38,406,26,1140,228,6432
"48339693000",6418,2394,168,0,830,419,3042,2121,15392
"48339693101",2848,1710,622,314,519,22,2367,1399,9801
"48339693102",3336,939,239,42,376,84,2128,928,8072
"48339693200",6868,547,89,49,389,0,1134,344,9420
"48339693300",5461,524,417,296,470,29,1622,11,8830
"48339693400",1973,1078,372,536,68,127,1552,870,6576
"48339693500",4846,935,268,278,276,3,1576,373,8555
"48339693600",2665,406,230,49,201,61,363,336,4311
"48339693700",7546,721,330,52,557,11,889,189,10295
"48339693800",3057,747,394,86,425,75,1425,444,6653
"48339693900",6854,2368,112,102,360,0,3901,2121,15818
"48339694000",7494,1535,77,0,402,590,2171,1069,13338
"48339694101",8030,925,536,164,1139,356,2278,776,14204
"48339694102",4418,700,59,0,419,21,1259,244,7120
"48339694201",4584,730,140,10,966,208,844,279,7761
"48339694202",9945,172,110,6,496,2,792,42,11565
"48339694301",10860,675,103,5,683,0,670,0,12996
"48339694302",7428,294,19,0,335,0,491,18,8585
"48339694400",5733,759,325,2,711,494,988,515,9527
"48339694500",7062,487,115,0,634,0,664,0,8962
"48339694600",5415,559,270,69,832,116,796,301,8358
"48339694700",2388,483,160,20,167,0,81,57,3356
"48341950100",1796,352,4,0,167,5,778,233,3335
"48341950200",4120,754,274,0,792,268,2670,642,9520
"48341950300",5227,1199,53,15,698,341,2843,916,11292
"48341950400",3291,723,152,142,990,622,2922,676,9518
"48343950100",2814,476,491,297,134,16,90,9,4327
"48343950200",3402,447,850,461,345,176,363,171,6215
"48343950300",1368,147,641,180,162,146,250,192,3086
"48345950100",856,158,9,4,23,19,96,65,1230
"48347950100",1777,154,163,67,125,20,117,54,2477
"48347950200",3879,448,100,27,150,109,211,173,5097
"48347950301",5127,1302,101,187,108,148,1098,794,8865
"48347950302",4466,1407,582,342,383,114,1848,1385,10527
"48347950400",5592,981,706,181,356,0,359,297,8472
"48347950501",1317,372,296,137,122,39,115,0,2398
"48347950502",4163,694,156,31,263,0,562,0,5869
"48347950600",896,692,376,195,38,140,101,46,2484
"48347950700",1602,679,918,983,89,7,719,407,5404
"48347950800",1942,604,559,200,337,128,1232,453,5455
"48347950900",196,382,925,927,27,54,72,303,2886
"48347951000",2118,1201,929,573,317,200,439,413,6190
"48347951100",3841,895,168,38,93,94,239,65,5433
"48349970100",2191,735,78,15,444,242,722,697,5124
"48349970200",3498,351,631,681,333,193,960,225,6872
"48349970300",5287,770,717,305,372,64,1494,296,9305
"48349970400",2950,783,130,0,243,18,463,246,4833
"48349970500",2556,499,330,515,205,55,623,379,5162
"48349970600",2002,344,545,104,79,32,58,103,3267
"48349970700",3314,581,802,451,174,106,244,103,5775
"48349970800",728,415,138,59,192,0,504,287,2323
"48349970900",4733,1506,673,86,1351,315,2935,1083,12682
"48349971000",2597,467,44,76,94,26,471,85,3860
"48351950100",1696,122,701,4,4,0,12,0,2539
"48351950200",3086,456,1200,314,80,53,65,38,5292
"48351950300",1208,201,613,27,54,0,115,26,2244
"48351950400",3357,611,0,0,103,10,141,9,4231
"48353950100",1726,144,0,0,78,11,215,53,2227
"48353950200",2877,713,177,0,241,31,822,330,5191
"48353950300",1048,612,102,61,170,45,524,469,3031
"48353950400",2341,924,167,62,383,72,1500,580,6029
"48353950500",2119,411,0,0,115,22,545,232,3444
"48355000500",421,289,436,333,34,103,404,365,2385
"48355000600",5124,761,181,21,718,188,5137,859,12989
"48355000700",3241,884,92,93,452,446,2718,1074,9000
"48355000800",2249,404,268,29,156,12,2069,277,5464
"48355000900",2492,1938,47,18,380,38,2808,1954,9675
"48355001000",1711,1065,10,59,284,386,1864,1373,6752
"48355001100",977,602,28,166,28,52,928,554,3335
"48355001200",2202,1115,70,83,212,131,1548,998,6359
"48355001300",2917,949,134,4,298,355,3281,1264,9202
"48355001400",3993,428,26,47,267,181,1727,450,7119
"48355001500",2024,1627,115,114,176,179,2122,1785,8142
"48355001601",2804,981,452,14,324,48,3079,1023,8725
"48355001602",1906,958,18,0,325,267,2182,1190,6846
"48355001701",3699,1634,862,82,503,1,4145,1644,12570
"48355001702",1235,170,83,0,166,94,1311,242,3301
"48355001801",4040,1521,244,208,345,119,4247,1633,12357
"48355001802",2060,133,184,7,296,34,2297,146,5157
"48355001902",5078,2073,322,0,597,47,4877,1897,14891
"48355001903",2562,605,90,29,418,38,2825,518,7085
"48355001904",2739,1176,162,0,119,157,2657,1219,8229
"48355002001",2303,1410,23,13,369,0,2127,1253,7498
"48355002002",3033,523,12,0,180,69,2830,421,7068
"48355002101",2663,464,242,181,285,68,2177,481,6561
"48355002102",2823,281,12,0,152,41,1010,250,4569
"48355002200",3763,1223,11,0,1001,0,3249,1015,10262
"48355002301",3281,425,30,0,256,120,2966,487,7565
"48355002303",3214,594,246,0,92,140,2640,565,7491
"48355002304",4653,651,177,1,349,28,3932,410,10201
"48355002400",4464,543,172,41,456,53,3238,517,9484
"48355002500",3774,735,154,0,52,140,1426,481,6762
"48355002601",1679,463,25,35,77,22,648,397,3346
"48355002602",1740,255,35,0,22,13,1375,114,3554
"48355002603",2574,522,16,10,102,15,1425,361,5025
"48355002703",3980,666,77,22,207,221,2531,611,8315
"48355002704",3909,884,178,48,343,457,1563,900,8282
"48355002705",3896,470,68,257,420,259,1701,361,7432
"48355002706",0,0,0,0,0,0,0,0,0
"48355002900",762,26,104,0,45,25,222,28,1212
"48355003001",3249,1183,173,88,441,143,1432,860,7569
"48355003002",3635,647,36,8,660,191,1550,158,6885
"48355003101",4166,693,173,0,466,86,689,142,6415
"48355003102",3735,681,0,182,244,109,1263,359,6573
"48355003202",4956,172,176,29,532,43,2952,68,8928
"48355003203",4144,1320,209,0,220,112,2681,793,9479
"48355003204",3542,289,51,0,549,56,2077,223,6787
"48355003303",1160,209,22,7,81,0,914,203,2596
"48355003304",4175,525,345,32,526,80,2614,436,8733
"48355003305",2743,1483,264,93,193,419,2173,1759,9127
"48355003306",3188,758,126,110,473,93,2235,666,7649
"48355003401",2826,459,205,136,395,167,2139,478,6805
"48355003402",4810,723,149,21,298,0,3515,586,10102
"48355003500",1908,239,36,24,164,93,1567,290,4321
"48355003601",4700,909,7,39,859,38,2954,721,10227
"48355003602",5156,934,166,30,271,44,2980,707,10288
"48355003603",3149,648,59,0,310,8,2309,430,6913
"48355003700",2960,167,3,0,182,13,1893,142,5360
"48355005102",3041,358,19,0,157,40,111,8,3734
"48355005404",2232,104,185,0,334,0,1122,39,4016
"48355005406",2481,227,101,0,238,53,1396,206,4702
"48355005407",1859,55,55,5,187,20,1326,49,3556
"48355005408",3784,222,128,33,199,0,2736,166,7268
"48355005409",2910,37,146,0,417,84,1723,37,5354
"48355005410",2837,325,109,0,216,2,1861,257,5607
"48355005411",2877,231,237,81,289,42,1591,201,5549
"48355005412",3497,369,366,0,782,0,2138,200,7352
"48355005413",2422,90,158,0,356,8,1737,98,4869
"48355005414",1842,16,65,172,219,66,1147,16,3543
"48355005415",4184,43,121,0,949,2,2979,5,8283
"48355005416",2943,0,115,0,432,0,1255,0,4745
"48355005417",3612,86,372,65,789,28,1820,83,6855
"48355005601",4615,1751,68,9,178,45,4442,1724,12832
"48355005602",3105,2579,0,0,235,73,3143,2596,11731
"48355005801",5664,218,37,22,141,116,1569,317,8084
"48355005802",5534,914,20,23,162,0,3102,628,10383
"48355005900",2274,533,0,0,302,27,2038,447,5621
"48355006000",1984,264,0,0,253,22,1789,237,4549
"48355006100",2586,537,5,0,142,27,1899,514,5710
"48355006200",8700,267,107,0,340,0,794,26,10234
"48355006300",1594,472,57,21,207,43,832,290,3516
"48355006400",1072,429,222,172,18,94,572,311,2890
"48355980000",22,0,0,0,0,0,15,0,37
"48355990000",0,0,0,0,0,0,0,0,0
"48357950100",1374,106,7,0,171,8,248,17,1931
"48357950300",2424,781,10,20,503,19,1963,629,6349
"48357950400",3927,484,0,0,719,29,2311,235,7705
"48359950100",1368,197,4,5,51,12,158,48,1843
"48361020200",1020,77,1805,508,191,4,0,40,3645
"48361020300",1261,426,141,186,103,34,62,83,2296
"48361020500",2347,510,332,0,22,30,511,153,3905
"48361020700",2768,689,527,301,210,166,139,162,4962
"48361020800",1081,168,293,98,19,46,118,0,1823
"48361020900",1644,450,982,438,56,60,285,109,4024
"48361021000",1908,144,34,1,93,0,67,14,2261
"48361021100",1707,137,0,0,36,11,50,17,1958
"48361021200",4030,463,32,0,122,0,176,58,4881
"48361021300",4017,637,576,250,232,223,138,72,6145
"48361021400",3273,655,9,0,70,0,117,95,4219
"48361021501",1842,186,0,0,133,71,130,0,2362
"48361021502",6147,687,0,19,269,0,470,0,7592
"48361021600",3230,574,2,6,32,1,437,3,4285
"48361021700",1837,434,0,0,41,2,166,59,2539
"48361021800",2348,232,18,8,25,0,177,14,2822
"48361021900",5265,691,0,0,235,33,171,0,6395
"48361022000",3072,938,4,0,25,17,127,17,4200
"48361022200",3274,539,0,0,169,0,144,0,4126
"48361022300",6094,541,68,0,241,189,404,95,7632
"48361022400",3907,622,68,0,147,189,266,338,5537
"48363000100",2320,359,6,0,175,31,306,49,3246
"48363000200",1615,179,3,49,59,37,248,50,2240
"48363000300",3170,248,5,0,47,0,161,72,3703
"48363000400",4542,641,91,89,120,11,451,76,6021
"48363000500",1161,342,1,1,140,42,223,65,1975
"48363000600",2226,728,103,16,188,183,749,183,4376
"48363000700",2165,572,89,8,271,82,768,236,4191
"48363000800",1701,747,76,57,146,220,709,362,4018
"48363000900",1339,776,65,0,168,7,437,187,2979
"48365950100",2834,457,667,137,54,0,73,0,4222
"48365950200",2126,421,324,36,55,3,95,239,3299
"48365950300",3546,312,566,270,135,59,835,88,5811
"48365950400",4353,461,1070,666,0,0,480,23,7053
"48365950500",2029,199,163,48,8,0,28,29,2504
"48365950600",1811,419,63,21,18,0,99,65,2496
"48367140101",3652,657,168,109,515,64,944,46,6155
"48367140102",3536,512,0,0,57,62,186,163,4516
"48367140200",5244,611,0,19,206,0,707,82,6869
"48367140300",4967,337,191,26,344,76,1129,136,7206
"48367140403",5896,900,53,0,132,25,303,124,7433
"48367140405",5400,626,19,1,219,35,498,47,6845
"48367140407",9204,313,90,0,393,57,655,0,10712
"48367140408",3753,365,6,11,59,0,488,74,4756
"48367140409",2549,923,17,35,70,62,679,545,4880
"48367140410",2922,443,0,0,92,0,89,30,3576
"48367140411",3317,621,0,188,388,60,349,270,5193
"48367140501",6401,416,0,0,228,123,575,127,7870
"48367140502",3465,264,20,3,332,14,350,103,4551
"48367140601",6264,485,30,33,130,39,196,205,7382
"48367140602",8232,901,222,0,672,74,1400,50,11551
"48367140703",5609,402,0,0,376,3,241,3,6634
"48367140704",7169,477,63,5,348,46,669,77,8854
"48367140705",6493,1199,72,0,339,7,479,634,9223
"48367140706",6624,156,134,0,102,0,372,0,7388
"48369950200",3129,513,32,0,514,330,2552,763,7833
"48369950300",4138,696,80,43,256,114,2085,656,8068
"48371950100",1463,178,56,0,591,54,1245,201,3788
"48371950300",2696,208,0,0,283,55,2818,231,6291
"48371950400",3845,419,7,21,204,99,2419,462,7476
"48371950500",2724,468,8,1,211,140,1967,565,6084
"48373210101",4181,660,37,50,62,0,287,42,5319
"48373210102",4671,1021,31,14,215,67,587,67,6673
"48373210203",2293,322,154,187,40,14,440,14,3464
"48373210204",2320,946,812,45,199,120,337,622,5401
"48373210205",2044,201,22,83,23,0,145,38,2556
"48373210206",2956,343,5,98,67,57,83,45,3654
"48373210301",2669,603,129,1,48,8,126,5,3589
"48373210302",2930,485,723,212,160,66,224,204,5004
"48373210400",2961,766,610,247,227,25,943,333,6112
"48373210500",2892,349,526,132,598,157,275,53,4982
"48375010100",1762,405,40,34,82,2,364,22,2711
"48375010200",1882,92,0,0,35,0,193,5,2207
"48375010300",553,330,142,157,120,54,243,101,1700
"48375010400",3035,284,20,0,128,13,524,24,4028
"48375010600",1340,678,5,111,171,177,1155,824,4461
"48375010700",2558,409,216,0,364,10,1903,281,5741
"48375011000",1184,715,7,64,80,52,884,696,3682
"48375011500",2904,359,46,20,218,23,587,147,4304
"48375011600",2735,316,158,25,990,479,697,91,5491
"48375011700",2434,550,435,264,331,130,671,487,5302
"48375011800",3065,280,54,95,207,121,621,55,4498
"48375011900",1905,555,179,73,273,117,697,315,4114
"48375012000",885,453,28,25,99,97,268,339,2194
"48375012200",2646,866,175,0,123,111,2112,753,6786
"48375012600",1025,1317,197,195,415,185,944,984,5262
"48375012800",2056,925,444,287,595,130,1851,913,7201
"48375013000",424,111,622,314,85,14,328,99,1997
"48375013200",1269,32,43,40,21,61,156,68,1690
"48375013300",4696,77,114,0,532,0,418,0,5837
"48375013400",2352,371,0,0,83,12,310,23,3151
"48375013900",1386,501,1056,477,187,46,846,391,4890
"48375014100",1725,862,339,0,94,52,784,582,4438
"48375014300",4975,177,36,0,340,44,467,40,6079
"48375014401",1468,216,84,9,187,0,406,22,2392
"48375014500",3493,1398,90,22,364,49,2440,1177,9033
"48375014700",3514,821,31,22,352,98,1074,459,6371
"48375014800",723,466,550,308,136,82,546,510,3321
"48375014900",1768,616,151,148,2456,952,1390,549,8030
"48375015000",5035,1667,166,488,761,89,4079,1620,13905
"48375015100",2662,377,16,0,139,76,546,134,3950
"48375015200",2066,135,33,38,64,78,224,78,2716
"48375015300",2893,1121,396,365,326,218,1431,568,7318
"48375015400",1093,633,45,102,321,96,1179,618,4087
"48375980000",0,0,0,0,0,0,0,0,0
"48377950100",1908,395,0,0,172,14,1324,231,4044
"48377950200",3188,1177,0,0,445,0,3182,1177,9169
"48379950100",5291,428,66,0,135,79,256,85,6340
"48379950200",3652,527,148,32,444,140,415,149,5507
"48381020100",1850,87,27,22,158,12,219,23,2398
"48381020200",1813,272,0,77,129,159,313,38,2801
"48381020300",1518,237,121,17,54,11,202,109,2269
"48381020400",1474,220,0,0,106,8,111,96,2015
"48381020500",2407,701,228,24,145,36,1151,318,5010
"48381020600",3295,332,42,38,443,30,1639,129,5948
"48381020800",4776,1223,0,0,722,196,1525,439,8881
"48381020900",2135,395,41,1,238,66,685,111,3672
"48381021000",1949,258,79,2,98,37,519,170,3112
"48381021101",3359,346,49,87,233,37,530,232,4873
"48381021102",1354,346,110,37,141,32,486,128,2634
"48381021200",4888,132,0,91,171,0,652,11,5945
"48381021300",4146,258,442,81,313,0,801,33,6074
"48381021500",4655,183,17,0,75,13,567,27,5537
"48381021602",4515,279,55,0,244,24,498,147,5762
"48381021603",1722,39,99,2,100,0,283,2,2247
"48381021604",3933,221,33,0,233,0,533,0,4953
"48381021605",1685,70,87,2,134,11,221,28,2238
"48381021606",4119,246,82,24,449,13,427,110,5470
"48381021608",6498,671,35,4,276,37,962,266,8749
"48381021609",3356,79,75,0,470,0,586,41,4607
"48381021702",3156,290,34,0,231,27,373,70,4181
"48381021703",4648,791,32,0,218,27,904,218,6838
"48381021704",7133,281,43,22,245,0,544,0,8268
"48381021801",4987,1234,28,48,191,105,872,413,7878
"48381021802",2923,790,57,136,331,157,480,212,5086
"48381021900",4471,311,0,0,66,0,337,34,5219
"48381022001",4609,220,159,59,397,0,923,184,6551
"48381022002",4437,600,317,76,532,76,1766,276,8080
"48383950100",1897,187,54,9,1063,356,1888,508,5962
"48385950100",2673,529,1,1,46,11,484,171,3916
"48387950100",1907,262,144,136,111,55,108,79,2802
"48387950500",2207,590,1232,374,28,52,250,321,5054
"48387950600",2128,408,37,37,58,1,85,0,2754
"48387950700",1949,317,120,77,89,12,38,0,2602
"48389950100",880,478,5,22,81,117,622,528,2733
"48389950200",1758,355,37,9,368,57,1880,389,4853
"48389950300",1478,221,4,105,198,75,1315,294,3690
"48389950400",2904,311,153,0,587,14,2191,301,6461
"48389950500",826,126,0,0,97,5,542,121,1717
"48391950200",2304,468,225,110,264,83,1298,444,5196
"48391950400",2790,400,88,8,230,134,1427,344,5421
"48393950100",893,14,0,0,19,0,26,0,952
"48395960100",1280,137,136,142,39,12,91,5,1842
"48395960200",480,157,413,414,59,97,137,61,1818
"48395960300",3405,460,178,139,173,0,302,0,4657
"48395960400",2558,254,49,4,19,0,589,15,3488
"48395960500",3165,426,1361,561,179,38,1702,258,7690
"48397040101",5544,28,279,0,565,58,768,0,7242
"48397040102",6109,345,201,0,557,0,821,44,8077
"48397040200",4362,137,53,18,576,46,682,0,5874
"48397040301",3855,270,241,157,665,0,870,87,6145
"48397040302",5716,556,313,0,359,93,356,212,7605
"48397040401",7699,952,393,142,815,152,1878,306,12337
"48397040402",9203,389,916,0,1090,76,2463,231,14368
"48397040503",4571,970,441,21,726,63,2390,730,9912
"48397040504",6496,82,18,0,68,17,691,0,7372
"48397040505",9125,179,963,214,445,206,1480,103,12715
"48397040506",6549,139,14,0,466,0,118,13,7299
"48399950100",1090,107,0,0,64,11,125,66,1463
"48399950200",1624,520,32,0,54,38,836,382,3486
"48399950500",2009,266,0,0,42,10,494,97,2918
"48399950600",2816,931,59,110,336,78,1113,309,5752
"48401950100",3654,382,758,55,51,18,399,153,5470
"48401950200",2423,340,533,131,10,37,240,134,3848
"48401950300",4807,606,371,521,302,77,750,78,7512
"48401950400",3976,660,256,138,61,36,648,105,5880
"48401950501",3242,967,351,661,0,20,358,605,6204
"48401950502",2016,453,83,80,54,42,333,150,3211
"48401950600",1720,139,98,8,139,0,82,0,2186
"48401950700",2286,286,671,242,23,17,401,20,3946
"48401950800",2230,389,735,151,258,4,646,208,4621
"48401950900",2408,327,480,222,97,67,516,208,4325
"48401951000",1864,231,152,29,62,22,725,95,3180
"48401951100",1961,401,352,117,27,97,288,143,3386
"48401951200",1249,288,352,240,86,9,18,33,2275
"48403950100",1429,615,185,6,0,47,0,0,2282
"48403950200",2400,725,54,80,21,2,128,32,3442
"48403950300",3271,913,133,452,21,0,55,180,5025
"48405950100",1682,332,364,257,90,0,137,0,2862
"48405950200",1245,318,677,522,70,30,162,130,3154
"48405950300",2197,547,45,12,0,87,72,55,3015
"48407200101",4183,1625,390,305,134,166,738,0,7541
"48407200102",7453,1719,848,251,170,104,1102,903,12550
"48407200200",3667,568,643,118,185,0,215,31,5427
"48407200300",3374,359,296,204,14,0,149,0,4396
"48409010201",3167,383,77,0,64,34,1212,169,5106
"48409010202",3753,788,7,101,233,77,1722,416,7097
"48409010301",3619,358,93,0,229,15,1633,288,6235
"48409010302",3406,536,0,0,554,0,1684,138,6318
"48409010500",1490,507,0,1,140,8,1467,475,4088
"48409010601",5277,452,36,114,510,0,2669,391,9449
"48409010602",3328,292,93,0,85,0,1640,180,5618
"48409010603",2290,118,18,0,177,0,449,25,3077
"48409010604",2667,100,0,36,105,0,795,23,3726
"48409010700",2975,163,93,2,54,17,1009,71,4384
"48409010800",3322,760,26,0,179,80,2815,820,8002
"48409010900",3733,482,0,0,114,63,2132,327,6851
"48409011000",4453,1150,489,24,501,148,3803,1259,11827
"48409011100",2001,666,11,0,64,0,1512,636,4890
"48409011200",2558,738,5,0,78,0,1391,579,5349
"48409011300",2932,1725,76,0,179,11,2926,1693,9542
"48411950100",1728,388,0,0,146,54,747,247,3310
"48411950200",2470,346,1,0,60,4,384,146,3411
"48413950300",1852,581,3,0,739,49,1327,300,4851
"48415950100",2837,290,59,0,195,26,1799,238,5444
"48415950200",1095,74,0,1,19,4,409,19,1621
"48415950300",5333,387,234,11,185,32,1253,254,7689
"48415950600",3452,503,136,0,418,199,1598,501,6807
"48417950300",2577,635,0,0,113,0,181,170,3676
"48419950100",3874,708,432,430,52,0,577,271,6344
"48419950200",2252,707,218,276,34,50,253,131,3921
"48419950300",3390,1303,276,0,98,0,651,683,6401
"48419950400",2607,531,1559,520,405,21,1280,314,7237
"48419950500",2382,242,27,62,2,48,170,0,2933
"48419950600",1811,415,434,206,21,34,15,185,3121
"48421950200",2437,331,0,0,218,45,1026,245,4302
"48423000100",2057,1246,1685,831,533,48,2187,1029,9616
"48423000201",439,257,1963,904,211,25,606,223,4628
"48423000202",570,211,549,340,5,19,518,211,2423
"48423000300",2975,967,805,310,417,131,2908,991,9504
"48423000400",764,375,973,374,238,42,926,325,4017
"48423000500",696,655,374,402,219,7,483,440,3276
"48423000600",1071,809,223,38,110,97,885,723,3956
"48423000700",804,806,1776,1236,22,0,336,597,5577
"48423000800",3209,764,603,688,295,120,1331,354,7364
"48423000900",2022,498,434,332,223,26,1167,339,5041
"48423001000",3648,299,595,461,257,0,850,112,6222
"48423001101",2852,273,268,49,150,4,619,8,4223
"48423001102",2173,154,134,0,74,0,206,64,2805
"48423001200",2235,138,413,66,239,47,487,0,3625
"48423001300",1529,236,144,51,230,0,398,68,2656
"48423001401",7052,544,173,33,356,0,180,0,8338
"48423001403",6151,860,281,96,40,0,391,204,8023
"48423001404",5406,941,240,442,241,0,164,140,7574
"48423001500",3505,875,379,265,209,5,283,192,5713
"48423001601",3456,432,1297,571,391,0,1159,380,7686
"48423001602",2474,364,762,173,176,8,438,24,4419
"48423001604",3723,1163,1079,358,98,8,1777,640,8846
"48423001700",5256,1299,1275,146,508,87,3224,1211,13006
"48423001801",2843,752,1986,391,132,0,614,364,7082
"48423001802",6044,2315,442,391,347,1,1498,1429,12467
"48423001803",3490,455,246,258,259,393,519,87,5707
"48423001901",3896,582,770,96,534,38,489,79,6484
"48423001905",6870,427,825,21,517,66,419,123,9268
"48423001906",4964,170,419,59,81,0,211,0,5904
"48423001907",4919,943,296,0,18,73,293,154,6696
"48423001908",8108,205,433,323,449,5,452,45,10020
"48423002003",1633,479,640,304,200,87,159,136,3638
"48423002004",2254,142,132,0,6,0,107,40,2681
"48423002006",2829,56,276,187,168,15,344,45,3920
"48423002007",4939,942,1119,331,746,255,302,62,8696
"48423002008",4214,222,239,176,382,26,293,0,5552
"48423002009",6525,705,319,51,104,68,448,102,8322
"48423002101",2429,407,822,286,133,7,191,84,4359
"48423002102",4682,709,195,14,158,0,179,44,5981
"48423002200",5181,333,325,192,240,84,295,0,6650
"48423980000",0,0,0,0,0,0,0,0,0
"48425000100",5449,917,4,26,290,53,1089,275,8103
"48425000200",1416,126,0,0,43,36,249,26,1896
"48427950101",979,153,0,0,23,17,972,156,2300
"48427950104",2411,780,9,8,249,82,2640,843,7022
"48427950105",3267,902,0,0,126,0,3377,855,8527
"48427950106",1684,1156,0,0,423,66,2086,1222,6637
"48427950107",2149,2407,0,0,169,89,2318,2496,9628
"48427950108",2488,688,0,0,48,36,2443,679,6382
"48427950202",1191,1048,0,0,50,3,1181,1042,4515
"48427950203",1769,2021,0,0,185,34,1939,2055,8003
"48427950204",2336,2870,0,5,63,49,2372,2915,10610
"48427950401",3683,2527,0,0,105,8,3730,2535,12588
"48427950402",3129,1464,0,0,181,271,3248,1735,10028
"48427950500",2677,973,0,1,189,81,2826,1054,7801
"48427950600",5032,2153,0,0,226,33,5102,2186,14732
"48427950701",2237,1426,0,0,133,40,2370,1466,7672
"48427950702",2047,1125,0,10,15,137,2053,1248,6635
"48429950200",2981,529,71,0,221,164,704,328,4998
"48429950300",1103,801,37,35,179,35,243,488,2921
"48429950500",2292,187,0,0,121,0,74,56,2730
"48431950100",1039,198,0,0,51,10,523,78,1899
"48433950300",1081,136,0,45,11,83,173,100,1629
"48435950300",2886,268,24,1,679,59,2028,284,6229
"48437950200",1104,312,4,1,47,9,91,227,1795
"48437950300",2761,867,189,87,248,202,1353,769,6476
"48437950400",974,73,68,4,74,40,449,69,1751
"48439100101",3818,1299,24,0,1342,382,3445,1465,11775
"48439100102",3507,1272,18,0,434,78,2460,1143,8912
"48439100201",1854,1706,190,9,653,372,2413,2064,9261
"48439100202",3292,1213,11,0,832,27,3786,1122,10283
"48439100300",2478,1181,249,253,483,161,2831,1245,8881
"48439100400",4026,1387,0,39,648,469,4290,1770,12629
"48439100501",5497,1564,1156,397,1935,305,5943,1499,18296
"48439100502",3375,1688,104,3,1974,306,4327,1647,13424
"48439100601",1715,387,0,24,74,7,172,42,2421
"48439100602",1207,233,131,12,286,13,805,155,2842
"48439100700",2492,1083,80,40,290,514,1594,1130,7223
"48439100800",3508,895,9,88,1211,431,4235,1210,11587
"48439100900",920,463,0,0,453,161,1341,550,3888
"48439101201",967,393,21,35,421,51,636,272,2796
"48439101202",2650,1055,42,24,470,213,2214,1140,7808
"48439101301",2824,448,1050,353,255,131,1400,262,6723
"48439101302",1076,727,643,269,303,219,503,808,4548
"48439101401",2913,126,1158,231,473,310,1657,138,7006
"48439101402",1495,860,210,278,531,469,1612,1286,6741
"48439101403",984,919,927,453,632,394,982,1062,6353
"48439101500",1715,494,620,25,561,303,1369,472,5559
"48439101700",289,675,271,1174,56,548,213,537,3763
"48439102000",1608,226,14,85,344,76,452,191,2996
"48439102100",3706,527,104,203,338,101,632,288,5899
"48439102201",2717,339,160,0,178,16,665,8,4083
"48439102202",2273,233,44,0,169,0,194,32,2945
"48439102301",1559,455,239,102,406,22,989,323,4095
"48439102302",2744,976,182,165,999,311,1962,809,8148
"48439102401",2485,613,639,143,259,92,422,265,4918
"48439102402",3699,180,80,0,316,0,443,8,4726
"48439102500",391,313,936,1377,312,156,668,373,4526
"48439102601",1765,357,186,119,843,83,1349,154,4856
"48439102602",2421,297,149,19,824,122,1447,268,5547
"48439102700",2972,294,25,0,252,53,440,35,4071
"48439102800",1221,13,17,0,41,0,161,0,1453
"48439103500",1622,1235,549,243,1138,489,2498,1593,9367
"48439103601",221,268,570,1090,86,375,277,459,3346
"48439103602",325,296,963,393,299,6,564,296,3142
"48439103701",1619,1262,548,342,281,167,1542,1379,7140
"48439103702",604,514,600,485,269,118,869,523,3982
"48439103800",207,361,884,1244,199,339,386,424,4044
"48439104100",2473,340,79,6,251,35,1013,185,4382
"48439104201",2269,294,0,0,62,0,182,12,2819
"48439104202",2331,742,0,77,172,125,290,201,3938
"48439104300",3131,1310,143,175,211,493,624,329,6416
"48439104400",3007,600,112,103,754,343,1964,771,7654
"48439104502",915,578,174,39,569,473,1399,981,5128
"48439104503",1304,405,41,0,522,265,1774,666,4977
"48439104504",1554,770,278,29,430,141,1786,816,5804
"48439104505",697,487,1633,1060,700,79,1125,562,6343
"48439104601",1389,216,1196,391,686,21,1917,191,6007
"48439104602",1369,1093,852,709,450,1021,1626,2017,9137
"48439104603",1287,775,463,429,437,396,1475,1124,6386
"48439104604",373,233,951,751,405,137,753,322,3925
"48439104605",657,960,1737,694,192,143,688,934,6005
"48439104701",2127,1615,15,12,620,187,2528,1752,8856
"48439104702",1327,739,27,69,1005,169,1980,738,6054
"48439104802",2780,1162,184,47,1037,297,2812,1315,9634
"48439104803",3539,1784,58,54,445,751,3434,2116,12181
"48439104804",1299,971,16,0,320,293,1180,907,4986
"48439104900",1323,482,43,13,920,55,1646,438,4920
"48439105001",2664,1892,30,0,892,371,3274,2097,11220
"48439105006",515,84,12,0,381,16,729,100,1837
"48439105007",3459,315,742,27,480,41,1032,27,6123
"48439105008",4692,426,1369,116,1018,242,1362,311,9536
"48439105201",1830,1293,606,708,299,485,728,1465,7414
"48439105203",1746,131,243,58,17,26,371,25,2617
"48439105204",1411,466,387,268,219,247,681,413,4092
"48439105205",1481,1022,1318,568,451,239,618,611,6308
"48439105403",5282,341,139,103,258,138,553,73,6887
"48439105404",3401,578,77,34,179,23,244,0,4536
"48439105405",2413,332,421,116,250,14,507,43,4096
"48439105406",4479,275,342,12,338,116,596,29,6187
"48439105502",3937,757,410,592,221,205,896,874,7892
"48439105503",4485,265,581,122,189,0,909,29,6580
"48439105505",2707,583,456,301,494,474,763,304,6082
"48439105507",5288,120,384,0,657,0,428,0,6877
"48439105508",4443,506,1297,163,572,63,1389,84,8517
"48439105510",3237,287,2032,902,1210,323,1643,256,9890
"48439105511",2705,594,1637,658,326,25,1091,493,7529
"48439105512",2844,100,768,32,195,44,683,12,4678
"48439105513",1037,165,911,264,237,103,480,24,3221
"48439105514",1767,174,614,141,131,28,735,108,3698
"48439105600",4396,598,99,54,338,11,2614,431,8541
"48439105701",2724,492,289,0,332,30,1305,440,5612
"48439105703",1927,431,650,224,159,0,753,233,4377
"48439105704",3882,1346,2741,537,794,52,3070,1107,13529
"48439105800",2960,378,55,25,509,222,2643,450,7242
"48439105901",1448,995,137,382,783,306,1992,1231,7274
"48439105902",588,340,686,776,1300,1017,701,446,5854
"48439106001",3993,1029,2447,439,340,0,2531,1000,11779
"48439106002",1054,377,1563,593,273,86,1145,440,5531
"48439106004",2094,899,1937,451,540,186,1206,832,8145
"48439106101",472,115,616,105,178,5,605,109,2205
"48439106102",1424,245,862,536,334,139,984,213,4737
"48439106201",804,82,1751,910,79,184,667,163,4640
"48439106202",577,294,2433,1354,23,394,506,645,6226
"48439106300",473,190,1585,644,146,71,563,163,3835
"48439106400",1072,701,394,172,286,92,743,490,3950
"48439106502",1336,131,748,301,295,103,600,99,3613
"48439106503",1969,232,2202,358,166,158,544,117,5746
"48439106507",1182,116,277,145,72,0,101,0,1893
"48439106509",1996,341,1514,435,505,122,318,208,5439
"48439106510",5181,89,1119,134,1840,137,1401,20,9921
"48439106511",3935,494,1771,970,1137,115,2167,411,11000
"48439106512",1079,300,2113,967,489,56,472,26,5502
"48439106513",720,86,1360,361,233,340,312,61,3473
"48439106514",1887,534,1530,1135,222,76,698,95,6177
"48439106515",1339,421,1179,345,406,43,519,339,4591
"48439106516",1122,571,1275,1028,558,421,1230,816,7021
"48439106517",2588,175,2576,1100,1843,83,625,99,9089
"48439106518",1421,194,1321,102,747,319,502,127,4733
"48439106600",1339,687,0,96,59,21,500,297,2999
"48439106700",1689,316,78,21,249,39,532,155,3079
"48439110101",3751,472,581,187,893,539,1494,325,8242
"48439110102",2606,566,11,97,549,190,1065,720,5804
"48439110202",3478,135,0,0,641,106,2165,121,6646
"48439110203",5360,735,1042,0,1392,7,2143,548,11227
"48439110204",4261,289,358,35,1488,114,2468,176,9189
"48439110301",2367,1032,0,0,464,462,1524,864,6713
"48439110302",3359,1201,0,165,471,247,2420,913,8776
"48439110401",3782,465,0,23,239,51,1305,87,5952
"48439110402",2538,902,11,0,821,394,1945,806,7417
"48439110500",5599,1107,121,23,1349,215,3281,1043,12738
"48439110600",1947,207,39,5,339,42,622,57,3258
"48439110701",4708,860,252,237,667,128,1591,96,8539
"48439110703",3403,739,271,3,675,106,1347,378,6922
"48439110704",2457,1003,274,134,269,57,793,316,5303
"48439110805",4997,373,439,6,559,2,1236,49,7661
"48439110806",4392,169,439,17,307,31,898,38,6291
"48439110807",4135,497,610,408,748,81,1599,290,8368
"48439110808",2061,61,0,0,102,68,185,0,2477
"48439110809",1500,226,209,0,27,2,143,35,2142
"48439110901",3778,103,61,0,309,32,314,9,4606
"48439110903",1209,148,211,0,33,0,135,17,1753
"48439110905",3828,237,159,26,390,0,506,116,5262
"48439110906",3749,247,72,1,362,50,478,64,5023
"48439110907",2651,67,112,0,198,0,139,0,3167
"48439111003",2044,282,346,41,206,15,820,202,3956
"48439111005",3426,804,3145,1638,456,552,2410,720,13151
"48439111008",5245,713,993,262,473,267,1573,127,9653
"48439111010",2782,163,155,11,29,0,681,0,3821
"48439111011",3855,465,3652,354,1152,122,1882,200,11682
"48439111012",3148,526,3782,389,263,275,1867,213,10463
"48439111013",5277,436,1615,431,527,49,2118,150,10603
"48439111015",1718,302,335,9,25,40,288,97,2814
"48439111016",7659,869,678,132,645,0,1236,51,11270
"48439111017",6673,243,2536,117,1146,25,1631,125,12496
"48439111018",1740,88,210,0,7,59,362,0,2466
"48439111102",1445,214,2286,889,725,350,1832,528,8269
"48439111103",1222,228,805,333,773,633,1518,795,6307
"48439111104",597,288,1428,135,257,18,496,289,3508
"48439111202",3276,690,699,705,728,181,2162,649,9090
"48439111203",4388,274,184,522,620,23,964,24,6999
"48439111204",4602,548,85,19,51,0,591,109,6005
"48439111301",7690,337,911,26,699,42,1320,42,11067
"48439111304",5638,493,627,12,828,10,668,0,8276
"48439111306",3531,644,478,123,369,100,979,525,6749
"48439111307",1684,293,521,52,307,170,548,231,3806
"48439111308",1195,97,67,39,51,2,89,2,1542
"48439111309",2830,244,346,24,686,0,1303,59,5492
"48439111310",4086,367,2559,266,1253,191,1356,348,10426
"48439111311",4521,71,802,374,869,20,715,50,7422
"48439111312",3114,86,56,0,153,0,232,8,3649
"48439111313",4608,117,1505,21,755,15,528,49,7598
"48439111314",3751,83,1342,20,856,0,854,0,6906
"48439111402",4624,359,925,0,360,223,1004,272,7767
"48439111404",5268,362,1129,730,1252,81,1291,145,10258
"48439111405",1827,446,66,0,125,0,232,175,2871
"48439111406",2921,29,599,0,456,8,790,0,4803
"48439111407",2258,161,279,0,329,5,240,47,3319
"48439111408",1938,455,351,78,224,44,203,384,3677
"48439111409",4225,76,413,37,568,22,657,0,5998
"48439111505",3456,210,119,192,109,69,480,27,4662
"48439111506",4165,540,610,278,394,85,830,0,6902
"48439111513",2184,100,913,98,749,85,1322,94,5545
"48439111514",3195,68,1666,175,1502,139,2104,34,8883
"48439111516",2973,344,2221,152,1021,72,1219,1,8003
"48439111521",2939,697,1903,644,1623,114,2522,396,10838
"48439111522",5955,207,309,382,895,565,4239,437,12989
"48439111523",3419,664,1930,1397,1337,520,2409,635,12311
"48439111524",3073,808,1648,126,1164,427,2465,722,10433
"48439111525",2602,813,970,350,1108,604,1752,538,8737
"48439111526",2576,365,642,220,527,16,766,298,5410
"48439111529",3288,113,78,0,397,27,544,0,4447
"48439111530",4436,255,470,0,556,8,234,27,5986
"48439111531",3324,489,463,6,574,63,344,36,5299
"48439111532",4788,821,921,0,674,0,549,119,7872
"48439111533",3928,197,446,83,371,34,986,59,6104
"48439111534",4658,197,950,24,549,15,863,32,7288
"48439111536",1048,174,1038,179,565,112,930,156,4202
"48439111537",2910,281,1918,295,1075,63,1421,67,8030
"48439111538",2974,193,1794,330,577,97,1459,140,7564
"48439111539",4526,228,2706,458,1327,137,1921,110,11413
"48439111540",2632,542,1513,70,1431,16,1421,72,7697
"48439111541",2027,155,1075,128,583,0,879,117,4964
"48439111542",3106,279,1835,0,1382,106,1600,223,8531
"48439111543",1791,850,2143,482,1074,296,816,633,8085
"48439111544",3809,196,1783,158,1017,84,1631,98,8776
"48439111545",1897,157,74,5,285,4,105,5,2532
"48439111546",5583,145,644,0,577,0,1122,13,8084
"48439111547",5896,593,4844,1007,5168,107,4936,515,23066
"48439111548",3038,57,3014,36,1229,85,1291,0,8750
"48439111549",4291,188,2088,99,1555,115,1266,157,9759
"48439111550",5652,236,4529,254,2481,258,2988,34,16432
"48439111551",4331,35,1200,286,1057,169,461,0,7539
"48439111552",2686,270,288,82,214,45,315,40,3940
"48439111553",2528,315,479,165,452,72,728,169,4908
"48439113001",2119,63,591,18,481,0,470,12,3754
"48439113002",3303,636,2071,534,593,277,2853,696,10963
"48439113102",2504,384,716,384,236,31,241,43,4539
"48439113104",1647,417,1008,143,413,44,236,93,4001
"48439113107",1810,84,228,0,153,13,94,3,2385
"48439113108",3938,359,108,0,436,0,383,60,5284
"48439113109",2047,255,955,215,402,7,408,55,4344
"48439113110",2413,516,754,445,238,106,408,318,5198
"48439113111",1521,725,878,1038,166,116,847,744,6035
"48439113112",1372,653,498,177,251,9,465,466,3891
"48439113113",1204,121,1856,64,608,143,196,53,4245
"48439113114",1787,279,1558,194,312,20,419,179,4748
"48439113115",2051,391,689,102,294,30,1432,120,5109
"48439113116",1954,485,1002,420,509,30,687,267,5354
"48439113206",5101,486,317,0,503,143,2038,36,8624
"48439113207",4032,76,33,0,235,11,340,0,4727
"48439113210",5517,318,482,0,688,0,700,91,7796
"48439113212",3453,160,212,0,152,0,409,0,4386
"48439113213",2512,406,100,0,128,9,614,194,3963
"48439113214",3861,232,151,0,915,0,996,38,6193
"48439113215",3938,114,111,0,422,229,429,226,5469
"48439113216",3734,755,201,0,294,69,517,295,5865
"48439113217",3420,278,184,37,476,6,745,78,5224
"48439113218",2353,140,19,0,217,0,300,84,3113
"48439113220",3992,804,487,345,1567,132,2195,403,9925
"48439113221",4273,164,158,0,434,13,357,81,5480
"48439113301",3569,351,0,22,195,45,797,19,4998
"48439113302",3161,754,165,106,224,28,1070,436,5944
"48439113403",2205,117,10,4,111,4,337,31,2819
"48439113404",4525,624,358,85,538,0,1182,296,7608
"48439113405",4460,437,256,144,364,76,652,113,6502
"48439113407",3395,1457,299,147,312,463,1554,1457,9084
"48439113408",4134,496,120,0,705,0,1083,28,6566
"48439113509",2789,363,203,0,988,127,1432,116,6018
"48439113510",2286,84,452,45,1335,138,721,0,5061
"48439113511",2289,258,317,33,1109,76,533,145,4760
"48439113512",3960,271,445,0,598,16,799,27,6116
"48439113513",3791,678,614,18,1160,99,987,61,7408
"48439113514",2029,832,358,174,1208,345,1069,606,6621
"48439113516",2927,114,265,169,789,227,823,103,5417
"48439113517",2314,253,321,21,558,32,649,4,4152
"48439113518",2975,317,594,171,842,419,1026,161,6505
"48439113519",4490,144,717,16,750,140,984,51,7292
"48439113520",3080,247,373,57,981,136,597,170,5641
"48439113607",2970,290,272,53,388,68,526,33,4600
"48439113610",9364,198,223,0,1715,0,1012,0,12512
"48439113611",3848,170,214,136,190,0,451,0,5009
"48439113612",4065,83,0,0,223,0,252,0,4623
"48439113613",3643,106,116,20,117,34,458,2,4496
"48439113618",4460,466,330,18,400,59,670,89,6492
"48439113619",2499,674,765,227,475,77,1272,322,6311
"48439113622",5518,113,0,0,466,0,306,0,6403
"48439113623",3282,71,38,0,189,0,388,10,3978
"48439113624",3900,71,46,0,498,69,759,7,5350
"48439113625",3170,25,45,0,212,30,388,0,3870
"48439113626",3390,135,91,0,303,16,528,0,4463
"48439113627",3828,537,630,128,667,117,742,142,6791
"48439113628",2722,161,869,151,826,222,510,169,5630
"48439113629",3551,128,213,0,448,16,513,18,4887
"48439113630",2617,218,341,0,297,51,338,91,3953
"48439113631",4965,878,300,39,977,535,1904,1136,10734
"48439113632",4321,81,173,32,380,12,345,11,5355
"48439113633",3604,37,71,15,564,0,407,12,4710
"48439113634",4179,193,204,1,597,1,235,19,5429
"48439113703",6948,774,828,24,561,1482,1042,1741,13400
"48439113705",3878,703,22,14,596,338,1779,696,8026
"48439113707",4602,272,63,0,299,0,435,0,5671
"48439113709",3920,26,102,0,703,0,399,0,5150
"48439113710",2779,404,192,0,555,0,679,269,4878
"48439113711",3185,196,33,0,327,28,236,8,4013
"48439113803",4496,240,386,9,739,10,1041,14,6935
"48439113808",5217,349,65,0,552,69,916,195,7363
"48439113809",3755,179,294,111,618,30,1108,56,6151
"48439113810",3351,237,189,0,444,155,782,44,5202
"48439113811",2788,257,131,0,376,9,751,30,4342
"48439113812",4920,172,258,0,552,16,451,16,6385
"48439113813",4192,61,55,0,595,20,346,12,5281
"48439113814",3593,29,205,0,383,29,83,29,4351
"48439113815",5257,102,104,0,449,0,574,0,6486
"48439113816",4615,123,104,0,558,0,440,0,5840
"48439113906",5261,67,221,0,696,0,535,0,6780
"48439113907",5669,222,339,0,868,0,552,0,7650
"48439113908",4934,0,68,0,647,28,180,0,5857
"48439113909",6076,266,118,0,590,56,389,0,7495
"48439113910",8593,225,180,15,601,4,449,22,10089
"48439113911",6143,677,55,52,823,130,686,205,8771
"48439113912",5394,156,72,0,506,0,360,13,6501
"48439113916",2869,380,482,188,632,166,1086,218,6021
"48439113917",3468,284,755,115,1753,509,1066,646,8596
"48439113918",3734,122,439,0,1168,67,1032,41,6603
"48439113919",6170,183,405,0,585,276,877,203,8699
"48439113920",4385,17,300,0,907,0,632,0,6241
"48439113921",19298,306,1918,0,3225,0,3580,36,28363
"48439113922",13289,589,1573,0,3876,396,3488,0,23211
"48439113923",2360,52,208,0,806,19,741,0,4186
"48439113924",3233,349,561,19,964,60,1031,117,6334
"48439113925",3147,206,122,180,456,41,1072,36,5260
"48439113926",10463,269,1781,24,2362,257,3106,142,18404
"48439113927",11298,528,1111,0,892,138,1446,147,15560
"48439113928",6928,61,518,1,1324,56,2239,0,11127
"48439113929",7495,79,388,0,1226,0,924,0,10112
"48439114003",5890,673,464,77,1560,90,3028,328,12110
"48439114005",6949,493,421,33,654,164,1233,353,10300
"48439114006",5731,444,24,0,403,96,1240,144,8082
"48439114007",11058,365,1027,48,2475,335,4640,32,19980
"48439114008",9197,289,1076,264,2583,90,4244,184,17927
"48439114102",6696,229,309,0,456,15,615,80,8400
"48439114103",19103,647,1316,95,1581,359,2829,595,26525
"48439114104",6603,18,354,0,671,0,898,0,8544
"48439114203",3565,908,120,0,150,25,443,175,5386
"48439114204",5424,604,11,0,103,19,415,66,6642
"48439114205",2610,499,0,1,104,161,633,40,4048
"48439114206",3721,382,13,0,184,57,458,287,5102
"48439114207",5232,382,160,1,575,22,975,31,7378
"48439121601",4678,1659,691,90,375,103,882,1087,9565
"48439121604",3252,1090,875,224,192,187,928,704,7452
"48439121605",2098,329,129,9,160,7,332,39,3103
"48439121606",2553,72,319,182,323,0,510,0,3959
"48439121608",4199,306,209,0,437,135,496,192,5974
"48439121609",4550,101,274,1,1055,0,220,1,6202
"48439121610",1973,78,152,11,88,0,263,6,2571
"48439121611",2984,299,421,257,810,0,574,111,5456
"48439121702",1188,367,295,113,76,118,485,266,2908
"48439121703",2266,1178,661,439,442,151,1872,1184,8193
"48439121704",2282,636,331,79,187,45,1420,455,5435
"48439121903",2067,2051,916,305,534,529,1952,2303,10657
"48439121904",2490,843,577,271,238,33,2092,741,7285
"48439121905",1401,1278,765,700,667,824,1151,1421,8207
"48439121906",1785,1219,470,166,584,52,1652,1121,7049
"48439122001",2573,1758,23,0,181,0,1515,1560,7610
"48439122002",2707,1242,269,306,468,210,2454,1261,8917
"48439122100",3845,1389,114,139,327,250,2350,1088,9502
"48439122200",808,789,120,193,114,31,692,621,3368
"48439122300",744,459,177,151,268,803,397,144,3143
"48439122400",2399,1294,380,167,484,411,727,940,6802
"48439122500",3091,303,245,55,184,7,463,76,4424
"48439122600",2529,602,331,122,71,250,196,305,4406
"48439122700",3003,531,399,350,299,103,785,194,5664
"48439122801",1664,662,345,666,302,241,1089,639,5608
"48439122802",2631,763,600,353,393,127,1693,614,7174
"48439122900",3686,2169,564,143,878,284,3072,2032,12828
"48439123000",3701,772,300,182,698,103,883,238,6877
"48439123100",683,598,509,664,137,108,636,590,3925
"48439123200",1438,259,201,66,151,237,579,360,3291
"48439123300",2203,143,192,26,163,2,205,0,2934
"48439123400",950,301,41,198,249,42,314,142,2237
"48439123500",491,293,700,533,364,415,756,678,4230
"48439123600",1224,419,94,406,322,171,1172,314,4122
"48439980000",0,0,0,0,0,0,0,0,0
"48441010100",2733,1524,154,66,233,316,252,177,5455
"48441010200",881,533,237,33,115,162,471,362,2794
"48441010300",1141,257,203,271,114,182,554,288,3010
"48441010400",784,273,7,90,538,263,1009,405,3369
"48441010500",2120,716,105,5,155,140,1048,649,4938
"48441010600",3013,382,365,36,193,15,1006,232,5242
"48441010700",2095,269,96,65,606,438,1806,581,5956
"48441010800",589,459,93,61,206,237,377,530,2552
"48441010900",3248,1147,637,359,371,116,502,331,6711
"48441011000",491,480,122,9,150,6,352,226,1836
"48441011200",1665,490,166,77,487,97,1073,293,4348
"48441011300",1796,602,438,315,339,131,644,412,4677
"48441011400",3148,559,261,150,264,0,666,39,5087
"48441011500",2520,230,9,2,152,0,543,121,3577
"48441011600",2044,240,120,35,170,17,463,97,3186
"48441011700",1175,399,84,42,138,30,511,185,2564
"48441011900",1198,534,80,49,284,111,761,450,3467
"48441012000",1673,91,0,0,161,13,121,30,2089
"48441012100",74,363,12,57,12,7,9,51,585
"48441012200",1498,189,4,6,148,4,454,69,2372
"48441012300",2506,259,184,143,337,62,591,122,4204
"48441012400",1887,291,96,0,104,24,452,61,2915
"48441012500",2458,248,187,2,166,33,510,148,3752
"48441012600",2488,200,64,0,284,20,212,20,3288
"48441012700",5781,474,612,5,559,47,512,32,8022
"48441012801",2597,418,120,0,319,86,734,62,4336
"48441012802",2109,510,789,85,438,242,536,176,4885
"48441012900",1635,211,112,25,328,107,399,0,2817
"48441013000",9,6,0,0,0,0,9,0,24
"48441013100",3405,982,804,423,573,362,1528,639,8716
"48441013200",1373,231,7,9,110,56,292,73,2151
"48441013300",2454,276,55,4,438,60,577,57,3921
"48441013401",3025,139,246,25,213,60,714,27,4449
"48441013402",4769,510,296,1,614,298,755,327,7570
"48441013404",7382,326,66,91,487,186,1031,1,9570
"48441013500",7100,379,53,0,243,8,439,34,8256
"48441013600",3972,662,23,4,381,55,821,95,6013
"48441980000",0,0,0,0,0,0,0,0,0
"48443950100",581,102,0,15,154,69,485,141,1547
"48445950100",1698,401,35,0,347,45,813,239,3578
"48445950300",1335,372,52,6,214,26,1124,386,3515
"48445950400",5711,682,172,87,172,137,2863,640,10464
"48447950300",1287,189,0,2,34,8,149,47,1716
"48449950100",1325,383,255,75,89,0,266,232,2625
"48449950200",1762,329,86,0,251,171,540,362,3501
"48449950300",5707,1418,223,118,445,619,1349,1631,11510
"48449950400",3991,641,240,10,482,254,630,426,6674
"48449950500",1712,103,157,199,359,66,1604,162,4362
"48449950600",1592,614,646,299,784,382,1851,825,6993
"48449950700",737,35,213,163,53,176,545,192,2114
"48449950800",3237,313,392,4,440,476,1952,640,7454
"48451000100",2332,219,85,13,83,0,942,105,3779
"48451000200",2588,801,58,9,369,223,1631,499,6178
"48451000300",4314,1112,525,80,703,32,2310,881,9957
"48451000400",4239,1329,213,130,546,7,3689,1095,11248
"48451000700",2283,1143,116,137,301,99,1655,944,6678
"48451000801",3367,300,42,2,550,7,1477,126,5871
"48451000802",3854,581,223,13,330,0,2373,318,7692
"48451000900",1452,268,1,11,520,87,1481,277,4097
"48451001000",4061,644,0,33,307,73,876,142,6136
"48451001101",4250,484,39,126,233,252,1593,202,7179
"48451001102",2880,694,175,0,360,83,1536,300,6028
"48451001200",5239,775,263,95,1005,296,3093,750,11516
"48451001301",4402,284,120,284,204,38,1230,115,6677
"48451001303",3334,358,436,14,379,73,1011,138,5743
"48451001304",2163,312,39,0,371,10,507,121,3523
"48451001400",3522,1001,121,0,279,89,1919,987,7918
"48451001500",315,8,0,0,19,0,97,4,443
"48451001600",3922,505,6,3,371,26,973,222,6028
"48451001702",2441,332,0,0,147,0,694,35,3649
"48451001704",7058,530,55,18,423,45,1159,135,9423
"48451001706",2852,308,97,0,260,83,577,219,4396
"48451001707",4332,281,162,0,214,6,824,226,6045
"48451001708",5210,648,0,0,340,0,663,505,7366
"48451001800",965,551,209,183,159,54,795,425,3341
"48451980000",0,0,0,0,0,0,0,0,0
"48453000101",3472,238,16,0,233,29,376,23,4387
"48453000102",2337,76,72,4,36,0,74,9,2608
"48453000203",734,319,30,1,87,97,113,58,1439
"48453000204",2231,480,0,15,235,84,322,86,3453
"48453000205",2845,414,136,39,590,130,305,130,4589
"48453000206",2562,251,107,22,259,50,371,44,3666
"48453000302",3051,989,40,66,739,195,623,353,6056
"48453000304",2233,762,5,16,266,62,282,329,3955
"48453000305",2284,533,28,5,171,251,231,286,3789
"48453000306",2103,502,314,204,370,93,606,299,4491
"48453000307",1494,109,60,37,59,250,323,232,2564
"48453000401",2118,588,79,41,220,229,337,234,3846
"48453000402",1559,331,553,45,370,188,325,73,3444
"48453000500",2768,1301,36,19,376,330,362,346,5538
"48453000601",130,512,20,0,97,79,13,182,1033
"48453000603",724,3582,115,211,132,1981,291,1154,8190
"48453000604",401,2467,45,64,121,1362,17,363,4840
"48453000700",846,118,24,0,51,37,135,59,1270
"48453000801",985,200,154,24,136,69,846,194,2608
"48453000802",1087,797,579,625,62,344,405,1064,4963
"48453000803",1471,116,267,55,296,13,504,77,2799
"48453000804",986,460,280,345,192,32,553,398,3246
"48453000901",1183,255,230,36,193,25,606,197,2725
"48453000902",3088,895,74,132,531,311,2486,709,8226
"48453001000",2093,569,42,32,814,109,1773,464,5896
"48453001100",3762,487,102,92,726,22,483,121,5795
"48453001200",3736,349,134,0,658,0,583,25,5485
"48453001303",2808,206,10,14,203,40,404,34,3719
"48453001304",3223,252,55,2,237,0,423,32,4224
"48453001305",4223,1000,71,152,192,101,863,671,7273
"48453001307",2509,564,87,205,319,35,713,357,4789
"48453001308",2152,373,50,10,149,45,988,194,3961
"48453001401",2598,265,32,0,201,63,273,0,3432
"48453001402",2327,305,57,22,93,0,482,6,3292
"48453001403",1070,217,16,37,213,24,438,135,2150
"48453001501",4741,217,29,11,233,20,571,46,5868
"48453001503",2752,451,271,0,420,93,1017,151,5155
"48453001504",3931,367,0,2,568,10,515,250,5643
"48453001505",3220,552,41,0,405,21,383,190,4812
"48453001602",2196,100,77,0,763,240,332,67,3775
"48453001603",4380,109,18,0,314,0,221,0,5042
"48453001604",3803,174,0,0,204,0,352,11,4544
"48453001605",3007,402,34,1,275,0,321,83,4123
"48453001606",36,32,0,28,0,0,0,14,110
"48453001705",4209,100,0,0,242,27,301,0,4879
"48453001706",2968,146,210,0,318,14,466,0,4122
"48453001707",3864,323,110,21,173,132,536,109,5268
"48453001712",3472,818,174,21,233,11,1252,584,6565
"48453001713",3291,403,169,54,406,166,1151,188,5828
"48453001714",8792,959,711,14,3058,31,1609,326,15500
"48453001716",4137,198,127,24,796,0,460,0,5742
"48453001718",4545,439,104,1,673,50,389,39,6240
"48453001719",3459,116,8,0,462,0,471,0,4516
"48453001722",2538,98,235,16,548,53,469,11,3968
"48453001728",5638,356,309,24,885,30,1196,109,8547
"48453001729",3833,292,78,0,525,0,1157,72,5957
"48453001733",3504,159,35,2,51,3,598,3,4355
"48453001737",9025,301,178,0,1206,0,1842,0,12552
"48453001738",6105,247,96,0,404,91,1503,33,8479
"48453001740",3615,321,101,10,663,75,999,11,5795
"48453001741",2695,190,10,0,373,17,475,84,3844
"48453001742",5518,914,0,0,374,0,1485,641,8932
"48453001745",1867,123,60,16,210,43,259,43,2621
"48453001746",2959,236,77,28,510,0,919,135,4864
"48453001747",3722,852,397,1,463,178,1325,420,7358
"48453001748",5237,599,250,2,934,0,1699,443,9164
"48453001749",4240,279,64,36,1539,59,827,39,7083
"48453001750",3859,408,13,32,619,12,1291,137,6371
"48453001751",1817,28,203,8,20,50,104,0,2230
"48453001752",1711,754,63,60,866,483,510,13,4460
"48453001753",694,91,77,0,160,14,160,30,1226
"48453001754",4064,268,169,0,210,27,641,77,5456
"48453001755",3749,79,9,0,2390,52,510,14,6803
"48453001756",3261,93,139,2,736,2,350,2,4585
"48453001757",1753,142,86,0,259,0,288,4,2532
"48453001760",14019,243,293,0,2211,0,1323,59,18148
"48453001761",5860,349,0,0,819,66,615,0,7709
"48453001764",5847,354,37,0,225,16,709,56,7244
"48453001765",12195,391,233,0,1129,45,1474,45,15512
"48453001766",5884,927,0,2,95,22,720,355,8005
"48453001768",5851,225,25,30,489,14,669,0,7303
"48453001769",4704,177,21,2,390,48,1263,0,6605
"48453001770",9883,328,87,0,2155,0,1854,0,14307
"48453001771",3648,170,100,0,259,0,490,0,4667
"48453001772",2676,175,154,37,602,61,1170,149,5024
"48453001773",6038,161,111,10,778,101,539,19,7757
"48453001774",6873,165,268,27,923,23,2301,84,10664
"48453001775",4462,69,95,0,753,29,898,0,6306
"48453001776",2003,204,349,9,346,76,526,111,3624
"48453001777",4812,343,268,120,492,0,1516,44,7595
"48453001778",3724,221,0,0,43,8,281,21,4298
"48453001779",5477,409,54,0,225,0,628,231,7024
"48453001780",3301,391,12,23,289,13,244,89,4362
"48453001781",1985,143,6,0,245,18,151,0,2548
"48453001782",2998,299,39,0,1644,268,396,205,5849
"48453001783",4804,134,0,0,514,15,564,24,6055
"48453001784",4767,153,21,0,1071,39,655,2,6708
"48453001785",2904,103,304,53,1119,158,703,13,5357
"48453001786",3168,148,49,1,1977,232,699,62,6336
"48453001804",2679,1601,436,116,2108,659,2799,1898,12296
"48453001805",1684,672,285,182,1562,610,2285,1060,8340
"48453001806",3099,538,482,265,1300,964,3363,1269,11280
"48453001811",863,874,464,173,683,504,1037,1268,5866
"48453001812",3373,1782,602,400,1259,629,3762,2065,13872
"48453001813",4365,678,472,522,861,526,3903,1074,12401
"48453001817",2905,304,82,0,386,107,520,104,4408
"48453001818",2522,946,11,168,765,1321,833,1978,8544
"48453001819",1460,1159,181,171,787,679,1507,1585,7529
"48453001820",3097,848,436,180,1191,1152,2889,1629,11422
"48453001821",3619,561,374,387,772,518,2603,872,9706
"48453001822",3386,1430,544,79,1273,574,3485,1863,12634
"48453001823",3076,1296,548,461,1468,794,3869,1627,13139
"48453001824",1181,148,23,0,204,83,267,121,2027
"48453001826",1193,130,212,0,818,67,544,53,3017
"48453001828",3557,77,138,4,478,0,458,11,4723
"48453001829",1847,107,38,0,410,63,500,43,3008
"48453001832",1979,232,382,174,233,12,936,133,4081
"48453001833",3281,1439,650,375,2129,536,3727,1628,13765
"48453001834",3325,695,1637,196,2362,337,1653,647,10852
"48453001835",2856,636,518,202,994,776,2089,1356,9427
"48453001839",3376,361,927,21,1993,68,1288,289,8323
"48453001840",5467,963,1227,326,1942,326,4163,1046,15460
"48453001841",10329,1824,2341,94,3042,125,4757,1618,24130
"48453001842",6271,1043,1164,117,1556,161,4646,980,15938
"48453001843",1448,454,57,0,509,53,410,414,3345
"48453001844",2178,357,433,184,374,0,938,173,4637
"48453001845",2091,524,148,2,227,67,382,400,3841
"48453001846",1837,126,45,1,265,15,261,2,2552
"48453001847",3823,467,651,226,1664,228,1324,333,8716
"48453001848",2999,187,310,106,1345,54,991,92,6084
"48453001849",3230,384,665,52,1501,181,1030,287,7330
"48453001850",2583,364,197,64,628,63,974,160,5033
"48453001851",5693,606,1965,198,1220,76,1680,346,11784
"48453001853",2279,61,202,19,480,74,531,34,3680
"48453001854",2359,409,1169,51,730,479,1849,809,7855
"48453001855",8809,750,2939,574,1506,0,2719,396,17693
"48453001856",3772,115,2131,215,666,144,2103,182,9328
"48453001857",4162,89,665,156,970,280,1951,46,8319
"48453001858",13914,185,2643,2,2191,0,4168,35,23138
"48453001859",1278,188,75,5,217,6,577,46,2392
"48453001860",2829,359,563,127,384,0,1487,285,6034
"48453001861",3556,331,345,66,507,0,1489,79,6373
"48453001862",3605,516,1199,201,1196,33,1543,292,8585
"48453001863",1655,328,665,260,536,233,1044,309,5030
"48453001864",1614,226,460,65,333,71,588,53,3410
"48453001901",5023,370,10,9,259,0,943,34,6648
"48453001908",7211,843,130,24,845,0,1202,537,10792
"48453001910",3674,166,28,12,502,46,362,0,4790
"48453001911",2437,191,40,0,368,47,566,63,3712
"48453001912",2911,258,0,42,486,31,159,76,3963
"48453001913",3870,84,71,0,727,0,502,0,5254
"48453001914",5484,110,37,19,455,24,723,38,6890
"48453001915",1367,126,0,0,146,0,232,31,1902
"48453001916",2759,96,16,0,388,0,261,48,3568
"48453001917",4095,242,0,0,562,86,406,0,5391
"48453001918",2032,146,0,0,258,5,279,0,2720
"48453001919",3438,88,33,0,362,0,341,18,4280
"48453002002",2594,187,132,10,144,12,923,80,4082
"48453002003",2729,847,100,75,331,27,1800,502,6411
"48453002004",1763,180,19,49,151,102,544,82,2890
"48453002005",2912,1373,122,21,324,30,842,1126,6750
"48453002104",1895,629,65,365,437,191,829,777,5188
"48453002105",2639,760,418,344,710,340,1959,793,7963
"48453002106",1734,916,151,94,116,0,697,800,4508
"48453002107",1785,712,868,389,363,72,1169,626,5984
"48453002108",1039,1224,1271,170,131,22,633,991,5481
"48453002109",1156,529,1508,296,218,199,730,602,5238
"48453002110",1660,539,623,610,697,245,1720,651,6745
"48453002111",2531,1062,445,413,679,288,2222,1264,8904
"48453002112",2239,1070,685,507,571,244,1636,1010,7962
"48453002113",1920,785,559,159,205,0,717,592,4937
"48453002201",766,170,737,113,148,98,907,262,3201
"48453002202",3522,1664,1541,908,435,383,3544,1960,13957
"48453002207",4670,1442,2112,362,694,132,4478,1375,15265
"48453002208",3276,1702,1241,639,444,310,3138,1961,12711
"48453002209",4668,1232,1533,194,1296,199,3797,1218,14137
"48453002210",2497,462,286,0,214,102,1206,428,5195
"48453002211",1317,303,410,28,364,58,1195,308,3983
"48453002212",193,72,297,0,266,0,365,72,1265
"48453002304",1777,898,133,64,247,124,724,858,4825
"48453002307",3419,927,167,135,734,190,2265,638,8475
"48453002308",3252,1480,90,51,205,220,1322,1255,7875
"48453002310",1449,997,177,73,564,187,1709,1063,6219
"48453002312",3487,2050,269,205,756,646,3753,2477,13643
"48453002313",2098,1006,703,195,602,279,1450,860,7193
"48453002314",1780,972,357,588,575,572,1107,1283,7234
"48453002315",1584,713,131,27,371,227,1289,683,5025
"48453002316",2800,1404,241,133,493,308,2250,1476,9105
"48453002317",1285,1992,403,455,395,620,867,1397,7414
"48453002318",2822,4192,649,693,828,1106,2400,3601,16291
"48453002319",4,8,0,4,0,0,1,1,18
"48453002402",5348,1050,328,1,464,133,2513,934,10771
"48453002403",1983,218,145,90,52,87,687,138,3400
"48453002407",4633,180,163,12,842,66,2116,156,8168
"48453002409",2756,344,67,89,214,31,1694,145,5340
"48453002410",2766,788,216,35,144,183,1721,506,6359
"48453002411",2188,1941,423,144,1641,512,3248,2346,12443
"48453002412",3388,917,484,15,1048,230,3941,1126,11149
"48453002413",1330,1863,205,84,1034,400,1852,2109,8877
"48453002419",2003,934,295,223,630,197,1728,1011,7021
"48453002421",6958,598,547,49,1130,64,3418,268,13032
"48453002422",4022,697,283,65,250,194,2324,288,8123
"48453002423",4281,498,296,19,534,30,2481,169,8308
"48453002424",2791,582,239,12,174,4,1479,392,5673
"48453002425",2909,67,120,0,407,0,2003,48,5554
"48453002426",6904,705,824,0,1048,49,6206,659,16395
"48453002427",3954,1830,545,0,1240,692,4535,2318,15114
"48453002428",5327,179,225,0,628,170,2462,208,9199
"48453002429",513,63,58,0,123,5,255,48,1065
"48453002430",1861,613,153,0,704,146,2153,605,6235
"48453002431",4424,1808,372,25,1205,254,3901,1767,13756
"48453002432",850,616,97,125,378,21,925,518,3530
"48453002433",3499,740,1138,177,1004,203,3002,619,10382
"48453002434",1051,364,56,0,197,64,778,285,2795
"48453002435",3559,830,925,138,1621,946,3339,1676,13034
"48453002436",1638,319,4,0,291,15,1449,286,4002
"48453002500",4150,366,94,193,697,111,680,28,6319
"48453980000",0,0,0,0,0,0,0,0,0
"48455950100",2169,391,385,0,11,34,122,0,3112
"48455950200",2492,599,170,45,20,0,208,126,3660
"48455950300",1380,220,0,0,51,0,98,17,1766
"48455950400",3012,387,102,0,124,96,86,112,3919
"48455950500",1574,246,400,363,6,0,348,162,3099
"48457950100",2540,344,37,23,65,0,100,2,3111
"48457950200",4120,811,495,90,146,110,299,26,6097
"48457950300",1412,294,240,244,51,45,78,9,2373
"48457950400",3984,805,127,49,33,20,7,86,5111
"48457950500",2313,167,78,7,64,150,135,150,3064
"48459950100",6093,983,164,226,518,89,430,225,8728
"48459950200",2705,428,351,43,250,0,289,13,4079
"48459950300",6367,551,379,89,458,226,563,129,8762
"48459950400",2354,428,820,74,257,116,504,90,4643
"48459950500",4458,668,485,99,260,92,130,66,6258
"48459950600",3104,366,323,147,109,55,18,24,4146
"48459950700",4414,486,88,101,166,55,394,39,5743
"48461950100",749,35,15,0,241,27,311,45,1423
"48461950200",987,138,98,40,590,417,843,471,3584
"48463950100",2578,527,51,0,31,0,1218,368,4773
"48463950200",5497,1632,0,0,541,68,3142,1392,12272
"48463950300",4664,221,0,0,827,12,4095,219,10038
"48463950400",2613,781,5,17,151,12,1764,750,6093
"48463950500",3881,1939,0,0,239,39,3694,1925,11717
"48465950201",7059,849,187,4,190,0,4727,398,13414
"48465950301",2882,1353,0,0,254,19,2671,1323,8502
"48465950302",3096,561,3,0,267,34,3230,595,7786
"48465950400",2679,918,124,0,196,44,2511,885,7357
"48465950500",4584,1275,177,0,598,117,3359,1330,11440
"48465950601",3189,991,0,0,227,90,3187,1081,8765
"48465950602",3151,1095,0,0,114,91,3230,1177,8858
"48465950700",4420,1241,0,0,162,129,3975,1336,11263
"48465950800",3762,927,0,0,159,0,2314,773,7935
"48465980000",0,0,0,0,0,0,0,0,0
"48467950100",3936,648,44,17,91,3,195,46,4980
"48467950200",2195,914,0,53,131,71,471,411,4246
"48467950300",3613,573,116,15,151,9,314,0,4791
"48467950400",3646,692,17,0,70,21,470,42,4958
"48467950500",2830,712,254,178,100,5,210,149,4438
"48467950600",5915,640,0,0,334,277,160,189,7515
"48467950700",2930,540,112,6,159,123,92,88,4050
"48467950800",4676,1140,0,0,141,46,531,383,6917
"48467950900",5621,862,187,23,157,61,720,63,7694
"48467951000",5355,1007,161,28,225,123,298,343,7540
"48469000100",1311,370,115,85,91,0,1108,284,3364
"48469000201",1627,974,224,42,359,70,1707,900,5903
"48469000202",3520,1318,706,18,640,18,3107,1265,10592
"48469000301",930,488,157,47,171,145,908,562,3408
"48469000302",1222,564,384,26,163,19,1201,530,4109
"48469000400",1475,218,28,0,65,23,698,146,2653
"48469000501",3370,199,58,119,310,62,1683,61,5862
"48469000502",1952,1065,113,19,150,164,1108,1063,5634
"48469000601",1513,777,186,110,283,122,1144,843,4978
"48469000602",2505,985,288,119,220,82,1441,622,6262
"48469000700",2301,643,145,21,237,150,1235,564,5296
"48469000800",1528,223,0,82,127,0,674,110,2744
"48469001300",1664,314,42,0,159,44,452,295,2970
"48469001400",7187,581,116,88,243,56,2063,424,10758
"48469001501",2863,164,69,5,135,3,689,49,3977
"48469001503",1570,25,42,0,229,72,211,12,2161
"48469001504",6045,373,66,0,350,86,1307,129,8356
"48469001601",4359,947,311,93,171,339,1831,896,8947
"48469001604",4964,526,590,0,303,145,2776,554,9858
"48469001605",2470,234,164,67,270,4,1124,183,4516
"48469001606",6724,286,363,25,838,56,1539,121,9952
"48469001700",2821,560,377,64,72,7,1655,477,6033
"48469980000",0,0,0,0,0,0,0,0,0
"48471790101",1475,123,15,68,12,0,84,0,1777
"48471790102",2581,631,350,185,25,1,556,395,4724
"48471790103",3447,358,755,116,155,339,384,319,5873
"48471790200",4522,590,304,335,322,69,542,52,6736
"48471790300",5731,230,708,146,228,0,519,14,7576
"48471790400",3862,649,594,334,76,19,693,150,6377
"48471790500",2500,1449,600,815,255,45,266,325,6255
"48471790600",1094,1049,871,294,118,59,709,885,5079
"48471790700",1725,1718,1053,728,490,122,683,447,6966
"48471790800",1854,1335,383,816,239,19,34,156,4836
"48473680100",2826,277,18,0,110,37,850,291,4409
"48473680200",5893,1282,1635,565,477,211,3776,854,14693
"48473680300",7277,572,1772,1075,409,161,2993,480,14739
"48473680400",0,0,14,0,0,0,0,0,14
"48473680500",3960,1028,2128,1141,113,94,1215,944,10623
"48473680600",6380,1029,85,0,545,33,820,599,9491
"48475950100",3228,510,134,1,204,44,1477,322,5920
"48475950200",2992,674,235,33,313,161,1794,651,6853
"48475950300",1649,315,236,38,260,55,1212,182,3947
"48477170100",1833,264,715,389,71,23,498,172,3965
"48477170200",4210,596,509,227,456,0,642,302,6942
"48477170300",3809,609,579,204,502,17,441,218,6379
"48477170400",4103,704,324,0,38,0,524,427,6120
"48477170500",5175,475,678,415,258,0,391,251,7643
"48477170600",3524,256,986,145,45,1,761,183,5901
"48479000101",2132,2400,10,0,73,154,2070,2534,9373
"48479000105",1607,1114,0,0,237,7,1826,1111,5902
"48479000106",1896,1758,0,0,56,208,1952,1929,7799
"48479000107",1926,1322,0,0,101,57,1939,1379,6724
"48479000108",2406,1522,0,1,124,4,2507,1526,8090
"48479000109",890,1183,0,0,231,107,1121,1290,4822
"48479000200",2100,2117,46,0,100,115,2207,2232,8917
"48479000300",873,1883,0,4,10,175,861,2055,5861
"48479000601",1133,1384,0,0,100,83,1204,1467,5371
"48479000602",1807,1031,59,4,34,27,1855,1054,5871
"48479000700",1417,1660,0,0,148,0,1526,1660,6411
"48479000800",1142,1545,0,8,12,4,1154,1515,5380
"48479000901",2747,1672,0,0,87,113,2824,1743,9186
"48479000903",1261,1336,5,0,15,73,1274,1409,5373
"48479000904",1539,1293,0,0,116,71,1619,1340,5978
"48479001001",3407,1319,0,0,43,27,3191,1212,9199
"48479001003",1679,841,5,0,54,164,1722,984,5449
"48479001004",776,713,5,0,62,54,837,767,3214
"48479001101",2463,1154,20,0,244,40,2557,1194,7672
"48479001103",919,412,0,0,49,7,954,419,2760
"48479001104",2094,1241,0,1,12,0,2044,1217,6609
"48479001105",1756,1058,0,0,96,100,1771,1080,5861
"48479001201",1275,1121,0,0,93,27,1364,1148,5028
"48479001202",942,1747,0,0,87,93,1010,1788,5667
"48479001300",1911,1597,7,1,77,17,1993,1589,7192
"48479001401",1892,2304,0,0,120,99,1921,2351,8687
"48479001402",1793,1553,0,0,0,315,1793,1868,7322
"48479001501",1344,1340,2,0,91,49,1437,1360,5623
"48479001502",2702,1705,0,9,60,117,2667,1819,9079
"48479001601",2947,816,38,0,49,104,2932,897,7783
"48479001602",4124,421,0,12,281,48,3688,388,8962
"48479001706",2751,1859,0,20,121,8,2810,1887,9456
"48479001709",4470,882,0,0,382,65,4180,729,10708
"48479001710",910,570,0,0,0,0,855,570,2905
"48479001711",5092,598,0,0,418,0,4863,585,11556
"48479001712",6050,505,13,0,754,23,6097,528,13970
"48479001713",13869,902,465,2,619,17,13280,900,30054
"48479001714",2539,398,39,0,125,0,2284,398,5783
"48479001715",5755,988,0,0,311,8,5701,771,13534
"48479001716",5044,1195,0,0,71,41,5037,1177,12565
"48479001717",1582,1242,0,25,185,59,1629,1248,5970
"48479001718",1792,216,0,0,96,24,1709,240,4077
"48479001719",2443,708,13,0,75,23,2272,729,6263
"48479001720",4562,412,11,0,204,85,4314,496,10084
"48479001721",2281,530,0,0,36,0,2039,519,5405
"48479001722",6117,389,0,2,400,24,5836,305,13073
"48479001806",2567,1946,8,0,234,154,2702,2100,9711
"48479001807",5582,2754,38,25,351,70,5904,2816,17540
"48479001808",3534,2613,0,0,568,164,4102,2777,13758
"48479001809",4387,2378,0,0,367,270,4661,2519,14582
"48479001810",4138,1477,0,0,93,72,4105,1451,11336
"48479001811",3732,467,0,0,137,37,3728,501,8602
"48479001812",6668,1533,7,0,546,111,7001,1491,17357
"48479001813",528,492,0,0,0,0,506,479,2005
"48479001814",4149,3070,0,0,124,78,4213,3127,14761
"48479001815",844,678,0,0,6,145,827,823,3323
"48479001816",2552,1394,47,0,105,191,2594,1585,8468
"48479001817",2615,2065,0,0,99,81,2590,2104,9554
"48479001818",1584,1427,0,10,43,233,1625,1635,6557
"48479001900",1609,1411,0,2,59,78,1475,1449,6083
"48479980000",0,0,0,0,0,0,0,0,0
"48481740100",4391,487,774,29,7,0,926,349,6963
"48481740200",1006,199,128,139,11,0,554,190,2227
"48481740300",766,274,468,202,12,3,518,118,2361
"48481740400",3672,444,723,477,87,55,1728,288,7474
"48481740500",1448,316,684,432,70,69,813,310,4142
"48481740600",3139,322,154,51,277,82,1478,237,5740
"48481740700",775,450,175,509,35,31,342,391,2708
"48481740800",2409,790,227,296,9,73,1471,663,5938
"48481740900",6351,511,0,16,46,0,2341,247,9512
"48481741000",3177,666,244,72,217,14,2158,607,7155
"48481741100",2054,133,0,34,0,2,236,13,2472
"48483950100",2479,320,0,0,240,37,733,277,4086
"48483950300",1649,386,90,28,178,91,277,191,2890
"48485010100",384,285,191,145,60,145,158,313,1681
"48485010200",432,316,11,57,94,22,91,236,1259
"48485010400",541,129,772,574,150,41,376,44,2627
"48485010600",1455,149,34,73,356,76,555,104,2802
"48485010700",1702,427,113,84,172,236,886,403,4023
"48485010800",1083,535,89,181,303,102,677,424,3394
"48485010900",1304,272,42,18,48,7,139,42,1872
"48485011000",1490,358,99,116,190,126,517,170,3066
"48485011100",539,421,13,27,135,179,337,405,2056
"48485011200",940,533,148,237,33,97,54,345,2387
"48485011300",396,218,573,44,59,82,75,28,1475
"48485011400",949,1147,182,50,129,132,347,967,3903
"48485011500",1413,173,109,120,161,132,201,213,2522
"48485011600",2610,986,137,230,361,39,727,488,5578
"48485011700",1862,105,37,0,94,12,93,22,2225
"48485011800",1645,132,11,0,146,64,239,3,2240
"48485011900",2681,669,166,101,266,8,208,158,4257
"48485012000",4024,472,225,509,402,128,350,67,6177
"48485012100",2016,710,66,0,322,0,383,210,3707
"48485012200",4457,815,390,155,331,28,637,41,6854
"48485012300",6124,336,39,302,595,478,1160,113,9147
"48485012400",5778,453,222,27,536,137,676,138,7967
"48485012600",3207,141,144,0,172,0,519,0,4183
"48485012700",1818,544,48,22,186,177,586,481,3862
"48485012800",3500,451,119,202,183,0,597,105,5157
"48485012900",1857,154,6,0,104,63,223,74,2481
"48485013000",1208,560,122,105,240,84,175,193,2687
"48485013100",3348,209,458,85,273,41,601,41,5056
"48485013200",3403,504,1157,122,697,39,925,17,6864
"48485013300",947,6,285,0,189,0,292,0,1719
"48485013401",506,25,39,0,17,0,56,3,646
"48485013501",4030,798,192,2,92,265,426,265,6070
"48485013502",4532,144,319,0,287,0,340,23,5645
"48485013600",4986,476,0,10,286,0,188,0,5946
"48485013700",2137,309,55,7,199,28,137,34,2906
"48485013800",3169,156,0,0,123,21,90,8,3567
"48485980000",0,0,0,0,0,0,0,0,0
"48487950300",1609,117,0,0,43,0,97,45,1911
"48487950500",994,424,320,286,313,89,504,82,3012
"48487950600",4709,469,363,48,258,143,1445,259,7694
"48487950700",1754,533,65,77,96,89,794,308,3716
"48489950300",3052,2826,1,22,130,135,2711,2812,11689
"48489950400",3278,1487,55,9,157,63,2938,1464,9451
"48489950500",2104,1045,0,0,118,17,1918,1062,6264
"48489950600",1479,993,0,0,18,0,1273,939,4702
"48489950700",1392,991,0,2,98,14,1224,924,4645
"48489990000",0,0,0,0,0,0,0,0,0
"48491020105",5146,205,0,0,52,0,120,26,5549
"48491020106",3616,53,80,0,277,0,445,0,4471
"48491020107",5055,234,32,0,75,0,133,0,5529
"48491020108",2468,90,335,1,69,2,198,2,3165
"48491020109",2980,79,88,6,247,0,177,0,3577
"48491020110",3595,134,0,49,50,0,331,22,4181
"48491020111",3002,152,148,45,108,0,311,0,3766
"48491020112",2763,57,42,0,80,0,284,0,3226
"48491020113",2363,147,42,0,184,18,782,25,3561
"48491020114",4061,854,211,119,157,98,807,495,6802
"48491020115",2979,319,121,0,160,8,205,51,3843
"48491020201",1314,109,0,0,55,0,326,33,1837
"48491020202",5014,374,20,0,204,12,577,12,6213
"48491020203",3074,71,12,0,12,0,61,10,3240
"48491020204",4320,146,0,1,173,0,851,45,5536
"48491020301",5907,442,93,0,660,37,841,242,8222
"48491020302",3679,127,0,0,241,0,963,54,5064
"48491020310",2496,97,50,5,233,0,232,11,3124
"48491020311",2745,130,186,0,1176,0,767,82,5086
"48491020312",7127,168,227,0,584,164,3275,267,11812
"48491020313",7389,219,110,31,1599,98,1968,51,11465
"48491020314",4468,313,204,0,730,32,1620,126,7493
"48491020315",4503,135,0,104,1395,0,678,27,6842
"48491020316",2940,232,69,3,498,31,431,50,4254
"48491020317",2806,80,260,0,649,0,615,0,4410
"48491020318",6585,229,291,36,1275,0,1239,21,9676
"48491020319",4975,127,104,36,473,0,1258,0,6973
"48491020320",6877,242,150,0,644,20,1608,5,9546
"48491020321",1296,149,71,0,251,4,452,119,2342
"48491020322",8029,489,420,0,669,30,1304,221,11162
"48491020323",2260,246,281,0,155,108,555,176,3781
"48491020324",6325,195,390,13,732,52,1768,0,9475
"48491020325",2127,187,1027,57,126,28,1212,59,4823
"48491020326",5652,203,24,0,402,69,932,60,7342
"48491020327",2066,49,53,20,65,286,407,14,2960
"48491020328",5700,287,469,138,879,17,1527,0,9017
"48491020403",1555,220,17,21,205,150,241,55,2464
"48491020404",2751,139,77,0,606,0,487,23,4083
"48491020405",4772,653,234,0,884,110,1699,345,8697
"48491020406",4014,585,655,117,815,71,1423,395,8075
"48491020408",3755,322,284,26,397,107,942,78,5911
"48491020409",3870,75,344,0,673,34,1460,13,6469
"48491020410",4103,330,519,207,914,27,713,98,6911
"48491020411",4167,294,218,0,875,0,813,110,6477
"48491020503",4210,178,12,94,469,21,695,55,5734
"48491020504",5369,2484,527,89,1301,195,2886,1531,14382
"48491020505",2083,27,57,0,439,0,412,0,3018
"48491020506",5849,183,294,0,1245,101,967,147,8786
"48491020507",2287,30,358,0,552,0,309,0,3536
"48491020508",3363,135,292,0,852,54,753,0,5449
"48491020509",5169,69,74,0,1502,0,549,0,7363
"48491020510",6962,192,371,0,2780,54,1238,0,11597
"48491020602",3942,314,324,101,503,20,1568,282,7054
"48491020603",7352,324,270,0,1925,0,1009,50,10930
"48491020604",4960,180,177,0,757,195,655,195,7119
"48491020605",4903,226,455,11,1009,15,1103,185,7907
"48491020701",1269,565,203,19,250,83,938,439,3766
"48491020703",7450,379,1901,345,823,15,3648,19,14580
"48491020704",4086,1020,322,0,379,185,2052,812,8856
"48491020706",3113,181,347,13,290,0,876,0,4820
"48491020707",3473,64,435,400,360,25,1610,49,6416
"48491020708",5300,260,573,0,1397,11,1274,146,8961
"48491020803",3351,260,26,0,575,0,1437,71,5720
"48491020804",7871,167,710,25,1083,121,755,58,10790
"48491020805",6706,502,240,97,183,0,1825,387,9940
"48491020806",2864,74,630,53,305,15,1333,54,5328
"48491020807",5863,313,904,241,754,0,2787,42,10904
"48491020808",953,455,110,21,137,11,212,322,2221
"48491020809",4667,209,876,72,831,23,1945,44,8667
"48491020900",3308,510,98,45,74,3,438,219,4695
"48491021000",1449,510,396,237,24,45,1072,480,4213
"48491021100",1847,461,175,87,316,65,1451,468,4870
"48491021201",2415,124,97,42,336,9,1079,34,4136
"48491021202",2476,78,308,58,344,0,849,31,4144
"48491021203",1896,286,195,35,432,56,894,150,3944
"48491021300",2254,443,162,74,92,56,624,247,3952
"48491021401",8389,489,100,39,346,0,3497,212,13072
"48491021402",2525,448,332,42,214,149,1026,277,5013
"48491021403",3143,595,249,76,256,47,1439,233,6038
"48491021502",3047,898,548,498,650,199,2181,960,8981
"48491021503",3299,675,389,79,173,85,1555,458,6713
"48491021504",5103,393,850,135,1250,179,1158,179,9247
"48491021505",5288,375,543,11,1427,115,3425,249,11433
"48491021506",2464,40,328,0,406,26,1154,38,4456
"48491021507",6774,488,699,530,1300,28,2837,336,12992
"48491021508",5878,239,761,14,688,85,1206,88,8959
"48491021601",3097,308,54,0,243,19,962,122,4805
"48491021602",2574,237,79,0,48,13,736,98,3785
"48491021603",1215,46,19,0,114,38,395,48,1875
"48493000102",2649,385,81,0,158,0,604,131,4008
"48493000103",2664,161,70,5,55,8,448,8,3419
"48493000104",3818,377,45,0,144,0,759,270,5413
"48493000201",1688,437,0,0,139,14,977,368,3623
"48493000202",1772,257,18,0,167,0,972,230,3416
"48493000300",4299,866,18,1,263,13,2821,687,8968
"48493000402",2113,138,0,42,207,37,1016,116,3669
"48493000403",6537,295,0,0,190,102,2494,242,9860
"48493000404",5155,322,213,48,433,4,1913,216,8304
"48493000500",3384,845,86,5,61,17,828,407,5633
"48493000600",3305,307,0,0,133,97,1518,281,5641
"48495950200",1770,317,73,7,149,10,1268,186,3780
"48495950300",2697,456,127,0,296,91,1785,375,5827
"48495950400",1200,152,29,0,79,7,497,122,2086
"48497150101",3096,312,40,0,83,44,456,11,4042
"48497150102",5559,731,0,0,239,0,809,95,7433
"48497150200",4942,947,140,0,87,188,929,350,7583
"48497150300",2518,263,5,0,63,0,232,4,3085
"48497150401",4686,667,54,0,256,12,864,64,6603
"48497150402",4578,417,0,0,350,0,487,5,5837
"48497150403",3306,249,0,0,94,8,298,38,3993
"48497150500",4546,993,25,6,448,50,2027,611,8706
"48497150601",6364,687,0,0,305,12,424,17,7809
"48497150602",6081,967,63,11,344,7,1363,669,9505
"48497150603",4366,427,105,2,167,15,822,234,6138
"48499950100",3563,525,4,0,21,0,282,182,4577
"48499950200",1697,530,229,0,177,69,297,124,3123
"48499950301",3066,422,15,14,148,95,92,0,3852
"48499950302",4730,562,2,37,269,15,501,29,6145
"48499950400",3369,1078,0,0,121,71,225,126,4990
"48499950500",1913,258,109,8,111,8,155,10,2572
"48499950601",2639,575,556,112,57,72,80,89,4180
"48499950602",3580,195,0,0,45,0,296,0,4116
"48499950700",4677,660,0,0,137,37,591,76,6178
"48499950800",3178,452,316,216,506,62,651,39,5420
"48501950100",1933,208,15,0,43,74,916,218,3407
"48501950200",4824,576,95,8,313,113,3638,319,9886
"48503950200",3336,575,6,6,124,152,739,130,5068
"48503950400",5236,670,0,0,35,76,308,49,6374
"48503950500",1822,588,73,28,170,0,668,325,3674
"48503950600",4177,606,18,35,308,15,683,260,6102
"48505950301",2183,2372,0,0,12,0,2166,2372,9105
"48505950302",2842,667,127,17,67,0,2710,667,7097
"48505950400",3602,2199,0,15,99,64,3215,2236,11430
"48507950100",573,523,0,0,63,8,591,483,2241
"48507950200",1329,548,0,0,12,50,1067,562,3568
"48507950301",962,727,0,0,131,121,873,839,3653
"48507950302",4280,1882,11,0,502,84,4713,1896,13368
"49001100100",3036,448,0,0,0,8,134,117,3743
"49001100200",2431,248,0,0,112,93,309,101,3294
"49003960100",2522,307,15,0,39,12,60,18,2973
"49003960200",6162,688,0,0,171,7,370,48,7446
"49003960300",6129,963,0,0,1016,220,1047,469,9844
"49003960400",4287,217,0,0,248,0,234,13,4999
"49003960500",4203,220,26,11,290,21,380,33,5184
"49003960601",3406,181,57,0,17,0,111,0,3772
"49003960602",2053,271,0,0,97,19,80,28,2548
"49003960701",4354,475,0,0,225,19,763,0,5836
"49003960702",1916,322,0,0,126,88,118,133,2703
"49003960801",3872,432,30,0,268,27,190,172,4991
"49003960802",3911,232,11,0,302,47,231,8,4742
"49005000101",4301,367,19,0,102,66,184,101,5140
"49005000102",1393,209,1,0,46,14,103,86,1852
"49005000201",3060,327,0,0,89,0,86,133,3695
"49005000202",6406,381,0,0,497,10,374,0,7668
"49005000300",5502,1314,58,0,375,18,992,153,8412
"49005000401",2806,584,16,0,444,27,209,49,4135
"49005000402",3094,147,0,0,175,0,51,16,3483
"49005000403",5382,498,0,8,349,79,172,58,6546
"49005000501",3572,985,41,0,597,199,908,252,6554
"49005000502",3665,1089,115,9,799,508,899,438,7522
"49005000600",2912,2165,22,9,276,223,498,203,6308
"49005000701",3365,311,152,0,69,59,65,21,4042
"49005000702",600,484,31,15,89,134,25,47,1425
"49005000800",2563,1988,14,51,83,209,315,125,5348
"49005000900",2349,528,0,0,136,210,214,20,3457
"49005001001",1672,120,18,0,852,99,618,16,3395
"49005001002",2556,1416,31,0,970,71,717,659,6420
"49005001101",4737,446,0,0,261,0,269,27,5740
"49005001102",4026,255,0,22,159,29,60,14,4565
"49005001201",4612,176,15,0,264,0,124,48,5239
"49005001202",5203,343,0,53,458,0,685,22,6764
"49005001300",5593,222,83,0,121,3,143,0,6165
"49005001401",3269,534,87,0,256,68,326,230,4770
"49005001402",2992,382,0,0,164,113,544,339,4534
"49005001500",1886,134,5,0,40,2,89,0,2156
"49005980100",118,0,0,0,0,0,0,0,118
"49007000100",3287,405,0,0,123,16,504,22,4357
"49007000200",3459,682,0,0,306,105,464,119,5135
"49007000300",2509,889,88,14,361,172,360,284,4677
"49007000500",3524,248,0,0,179,5,496,23,4475
"49007000600",3276,515,0,1,74,61,298,70,4295
"49009960100",604,45,0,0,0,2,3,0,654
"49011125102",4049,203,31,0,163,0,15,0,4461
"49011125103",4214,185,124,12,416,111,406,111,5579
"49011125104",5729,312,25,16,252,101,366,36,6837
"49011125200",2069,259,184,0,495,33,609,51,3700
"49011125301",3383,703,148,13,629,236,850,219,6181
"49011125303",9886,41,128,10,536,14,942,0,11557
"49011125304",4240,309,36,11,785,8,599,0,5988
"49011125305",5252,203,65,0,1003,206,943,223,7895
"49011125401",10810,575,59,0,532,0,439,78,12493
"49011125403",11338,215,204,0,734,0,836,14,13341
"49011125405",8340,882,115,0,842,0,1048,330,11557
"49011125406",6059,320,219,0,752,106,755,62,8273
"49011125501",4483,239,0,0,877,269,644,249,6761
"49011125502",4228,543,92,0,551,29,857,94,6394
"49011125503",4163,427,43,0,415,0,434,0,5482
"49011125600",95,17,27,0,0,24,27,12,202
"49011125701",2178,869,54,116,457,180,133,334,4321
"49011125702",2977,186,67,98,382,0,474,20,4204
"49011125801",5037,525,118,0,530,641,1132,597,8580
"49011125804",5652,285,215,0,670,0,334,0,7156
"49011125805",5398,423,63,25,634,45,732,40,7360
"49011125807",1668,211,148,24,336,574,437,618,4016
"49011125808",3592,947,77,0,1228,16,857,268,6985
"49011125905",4260,690,80,1,443,366,354,164,6358
"49011125906",5745,267,42,0,890,0,557,0,7501
"49011125907",1768,150,22,0,52,11,33,49,2085
"49011125908",4077,57,39,0,456,66,325,0,5020
"49011126001",3735,475,63,31,655,34,683,149,5825
"49011126002",5493,294,16,0,332,106,365,113,6719
"49011126101",5638,202,28,0,177,13,235,0,6293
"49011126104",10802,1064,89,0,398,12,235,225,12825
"49011126105",6843,40,0,0,71,0,115,0,7069
"49011126202",9691,192,229,0,358,16,293,0,10779
"49011126203",4038,88,83,13,155,29,62,0,4468
"49011126204",4381,395,0,0,192,8,104,0,5080
"49011126303",4274,34,8,0,196,6,156,0,4674
"49011126304",5637,123,0,0,276,0,173,33,6242
"49011126305",2172,86,23,0,105,0,99,0,2485
"49011126306",6572,528,22,0,272,26,313,106,7839
"49011126402",3008,232,0,0,300,0,406,11,3957
"49011126404",5569,201,0,0,641,28,489,9,6937
"49011126405",3650,21,0,0,177,22,166,0,4036
"49011126406",3487,507,10,0,452,43,531,35,5065
"49011126500",5050,571,0,0,460,6,193,0,6280
"49011126600",4216,259,138,0,315,15,245,15,5203
"49011126700",3341,329,14,5,342,67,277,58,4433
"49011126801",2919,172,24,0,109,0,70,0,3294
"49011126802",4158,215,0,36,105,0,104,47,4665
"49011126901",4750,1029,0,0,452,0,440,670,7341
"49011126902",4637,660,0,18,528,202,535,0,6580
"49011127002",4923,760,52,0,1347,706,1328,188,9304
"49011127003",6197,176,29,10,299,35,119,36,6901
"49011127004",6879,547,58,0,561,0,330,65,8440
"49011127100",6307,288,26,100,361,238,276,96,7692
"49013940300",4197,330,0,0,33,5,209,5,4779
"49013940500",6396,716,16,0,790,226,768,143,9055
"49013940600",5536,533,6,0,406,209,200,146,7036
"49015976200",3392,337,0,0,55,0,164,11,3959
"49015976300",3176,266,12,0,7,10,23,41,3535
"49015976500",2801,566,0,6,11,3,154,266,3807
"49017000300",1605,465,10,0,118,15,100,0,2313
"49017000400",2173,375,21,0,37,18,91,65,2780
"49019000200",3404,695,12,0,327,88,267,168,4961
"49019000300",3676,868,3,7,140,82,123,369,5268
"49021110100",3265,394,0,27,50,47,69,86,3938
"49021110200",6273,1193,93,60,168,153,34,539,8513
"49021110300",2389,718,16,1,168,214,143,185,3834
"49021110400",3135,1042,0,0,76,33,61,69,4416
"49021110500",6014,1672,50,3,1000,781,804,807,11131
"49021110600",3985,1593,30,0,367,193,290,41,6499
"49021110701",5003,936,0,0,304,37,110,82,6472
"49021110702",3891,615,2,0,248,15,331,48,5150
"49023010100",4522,635,0,0,250,27,314,25,5773
"49023010200",3803,737,11,0,180,65,58,23,4877
"49025130100",1911,246,0,0,133,9,121,32,2452
"49025130200",4222,307,13,0,269,0,133,0,4944
"49027974100",4079,587,0,0,281,184,372,199,5702
"49027974200",2135,256,21,0,237,0,324,49,3022
"49027974300",3629,370,21,0,439,205,406,212,5282
"49029970100",8266,394,37,0,161,120,169,106,9253
"49029970200",1246,43,0,0,4,0,0,0,1293
"49031960100",1410,376,0,0,40,0,47,48,1921
"49033950100",1927,286,2,0,20,47,42,107,2431
"49035100100",959,274,29,15,286,24,260,87,1934
"49035100200",1055,40,94,0,105,2,113,1,1410
"49035100306",1875,717,64,47,1758,779,1491,868,7599
"49035100307",1803,193,237,139,2022,804,1431,813,7442
"49035100308",1198,447,512,97,1162,719,1146,802,6083
"49035100500",3193,472,104,102,1262,799,1710,787,8429
"49035100600",3449,1237,103,65,2709,561,3725,916,12765
"49035100700",2001,339,22,38,179,117,242,77,3015
"49035100800",1533,482,67,12,225,80,169,174,2742
"49035101000",2837,114,12,0,179,76,126,0,3344
"49035101101",1582,258,0,0,123,15,84,19,2081
"49035101102",2681,342,67,23,526,12,267,58,3976
"49035101200",3099,419,9,0,457,139,324,185,4632
"49035101400",1181,890,0,0,584,553,123,121,3452
"49035101500",1456,883,54,24,525,263,80,108,3393
"49035101600",2743,750,18,10,273,183,236,38,4251
"49035101700",2067,411,63,55,482,165,222,29,3494
"49035101800",2430,601,10,0,268,115,210,28,3662
"49035101900",1265,572,78,51,205,226,174,143,2714
"49035102000",1488,411,0,0,494,145,352,177,3067
"49035102100",837,314,0,24,163,26,78,35,1477
"49035102300",1442,447,230,0,423,274,490,124,3430
"49035102500",1653,550,83,34,530,256,246,166,3518
"49035102600",1160,476,195,0,1123,807,990,1050,5801
"49035102701",1624,319,127,106,1385,1539,1136,1288,7524
"49035102702",786,316,146,0,1601,1139,1705,1078,6771
"49035102801",2208,716,86,0,1857,1323,1675,842,8707
"49035102802",1722,363,196,32,1365,1329,885,794,6686
"49035102900",2169,1315,347,252,457,429,374,627,5970
"49035103000",2090,275,30,0,484,56,633,97,3665
"49035103100",3010,677,21,9,353,312,786,258,5426
"49035103200",3080,842,0,0,451,79,394,18,4864
"49035103300",2644,425,123,10,448,52,189,46,3937
"49035103400",3036,294,24,8,343,91,196,120,4112
"49035103500",3290,375,140,3,201,0,92,33,4134
"49035103600",2320,120,0,0,75,16,54,25,2610
"49035103700",2306,136,0,0,75,0,62,8,2587
"49035103800",2104,186,23,6,104,41,84,0,2548
"49035103900",3060,421,13,0,345,10,287,0,4136
"49035104000",2882,240,0,0,111,0,123,11,3367
"49035104100",2465,261,0,0,134,42,38,0,2940
"49035104200",5004,338,0,0,922,0,209,0,6473
"49035104300",2156,468,28,0,248,117,157,4,3178
"49035104400",1696,50,0,0,158,12,42,0,1958
"49035104700",4596,389,0,0,125,192,288,0,5590
"49035104800",4330,291,0,0,372,13,96,0,5102
"49035104900",2562,236,149,32,287,27,251,75,3619
"49035110102",4012,185,27,0,130,48,189,0,4591
"49035110103",3504,247,0,0,179,0,130,76,4136
"49035110104",4641,134,0,0,361,31,268,0,5435
"49035110200",5200,201,0,5,175,2,173,13,5769
"49035110300",5074,329,0,0,160,0,84,42,5689
"49035110401",2908,155,26,0,371,65,93,8,3626
"49035110402",3134,249,75,0,330,32,159,7,3986
"49035110500",5074,469,0,0,282,20,160,29,6034
"49035110600",4954,121,36,0,207,28,102,0,5448
"49035110701",2767,492,46,0,630,33,170,31,4169
"49035110702",4458,207,18,0,269,87,457,39,5535
"49035110800",4279,441,61,0,97,102,121,68,5169
"49035110900",4241,163,24,0,215,0,92,0,4735
"49035111001",4245,129,0,0,220,31,50,3,4678
"49035111002",4747,409,0,0,588,21,188,155,6108
"49035111101",5369,686,95,0,303,72,546,171,7242
"49035111102",5631,330,236,1,123,0,645,72,7038
"49035111103",5043,326,16,0,325,0,249,0,5959
"49035111201",2506,113,0,0,245,11,50,49,2974
"49035111202",4070,166,68,0,667,51,226,51,5299
"49035111302",5218,71,42,0,154,130,56,0,5671
"49035111304",3330,48,8,0,113,67,63,0,3629
"49035111305",3486,113,112,0,344,0,235,1,4291
"49035111306",2238,87,0,0,269,0,243,0,2837
"49035111400",3346,1103,28,219,487,1503,533,943,8162
"49035111500",750,288,52,22,323,100,379,214,2128
"49035111600",2620,793,83,319,1400,775,963,640,7593
"49035111701",3143,923,46,85,1646,301,1445,608,8197
"49035111702",3201,322,333,0,637,144,1082,180,5899
"49035111801",3456,545,147,369,479,171,387,166,5720
"49035111802",1561,623,6,0,96,103,42,312,2743
"49035111903",3648,320,12,15,281,0,575,0,4851
"49035111904",2736,401,68,5,155,65,180,0,3610
"49035111905",2839,302,92,191,215,9,395,90,4133
"49035111906",2338,717,283,56,588,185,688,149,5004
"49035112001",2613,512,9,0,172,140,299,316,4061
"49035112002",3275,671,76,0,208,34,137,81,4482
"49035112100",5801,1139,164,31,764,206,1217,137,9459
"49035112201",4637,135,61,21,440,143,568,143,6148
"49035112202",3093,410,19,28,185,34,341,30,4140
"49035112301",3229,675,0,0,303,21,540,199,4967
"49035112302",3225,225,0,0,165,210,170,210,4205
"49035112402",4052,701,0,0,1211,372,1555,771,8662
"49035112403",4105,751,166,28,664,340,1314,651,8019
"49035112404",2647,919,103,21,431,340,790,888,6139
"49035112501",3300,379,0,30,158,23,499,81,4470
"49035112502",4659,846,86,13,824,123,470,175,7196
"49035112503",3657,225,145,21,635,105,860,116,5764
"49035112604",4219,203,39,0,370,51,256,33,5171
"49035112605",6036,295,106,0,553,46,253,46,7335
"49035112608",4519,331,0,0,430,21,191,16,5508
"49035112609",4902,109,68,0,316,14,137,0,5546
"49035112610",3269,746,78,36,290,71,289,164,4943
"49035112611",5328,218,0,0,845,182,668,0,7241
"49035112612",3088,644,9,0,460,12,451,164,4828
"49035112613",4200,296,0,0,240,0,178,6,4920
"49035112614",3005,59,27,0,201,0,28,0,3320
"49035112615",2068,80,0,0,110,0,46,14,2318
"49035112616",3661,577,0,23,328,96,191,62,4938
"49035112617",3332,43,17,0,106,157,104,157,3916
"49035112618",2767,131,39,0,265,15,188,12,3417
"49035112619",2780,24,0,0,399,42,237,11,3493
"49035112700",4377,449,53,0,685,45,670,84,6363
"49035112804",4875,312,0,0,467,0,442,5,6101
"49035112805",4768,45,50,0,447,0,350,7,5667
"49035112810",7701,526,53,0,226,0,607,16,9129
"49035112812",4365,591,51,0,319,6,392,4,5728
"49035112813",4594,180,10,0,546,49,220,58,5657
"49035112814",4077,209,19,0,398,20,132,11,4866
"49035112815",5044,75,62,0,362,7,203,0,5753
"49035112816",4860,52,35,0,215,120,177,0,5459
"49035112817",5699,687,22,0,761,147,474,0,7790
"49035112818",0,0,0,0,0,0,0,0,0
"49035112819",6912,355,9,0,509,64,522,0,8371
"49035112820",7191,375,45,20,489,290,329,218,8957
"49035112821",6490,177,35,0,395,0,341,0,7438
"49035112822",4114,367,34,0,256,72,611,153,5607
"49035112823",4086,330,95,5,480,29,616,10,5651
"49035112904",5309,218,31,32,803,212,1382,193,8180
"49035112905",3771,262,65,0,877,153,439,12,5579
"49035112907",3183,1113,50,45,277,74,573,689,6004
"49035112912",2162,129,44,5,369,19,364,1,3093
"49035112913",4551,95,0,0,242,10,545,45,5488
"49035112914",4995,505,118,43,753,51,1209,265,7939
"49035112916",3591,492,32,0,1011,75,1190,284,6675
"49035112917",3412,161,0,50,325,0,470,18,4436
"49035112918",4306,269,125,0,866,163,1175,108,7012
"49035112920",3394,249,66,99,427,34,432,60,4761
"49035112921",3149,195,48,0,496,77,520,77,4562
"49035113007",5023,137,0,0,333,17,468,17,5995
"49035113008",5941,120,30,0,439,0,382,67,6979
"49035113010",6047,297,299,0,337,0,303,53,7336
"49035113011",5703,146,0,0,126,12,229,12,6228
"49035113012",4611,361,0,0,313,0,183,27,5495
"49035113013",5213,153,57,0,199,48,235,42,5947
"49035113014",4665,85,11,11,17,0,188,10,4987
"49035113016",5915,61,38,0,845,0,538,0,7397
"49035113017",6575,171,0,0,289,208,187,208,7638
"49035113019",7013,46,0,13,725,13,330,0,8140
"49035113020",13206,314,19,0,1912,0,1289,0,16740
"49035113101",5532,658,208,0,1068,36,1325,520,9347
"49035113102",3327,116,59,0,348,0,741,0,4591
"49035113105",3983,105,0,0,476,0,564,32,5160
"49035113107",21143,1111,463,71,391,603,1572,0,25354
"49035113108",3204,313,78,0,517,37,198,211,4558
"49035113305",2995,582,297,324,2911,1571,2403,1211,12294
"49035113306",2676,320,87,21,1442,404,1356,242,6548
"49035113307",2816,878,230,99,2105,1816,2347,2041,12332
"49035113308",2026,595,63,105,2109,559,1886,905,8248
"49035113309",2736,547,174,0,1044,1117,842,1218,7678
"49035113310",1410,295,0,0,385,510,460,635,3695
"49035113406",3315,822,28,0,1589,916,2203,1251,10124
"49035113407",6555,436,235,143,2222,791,3253,836,14471
"49035113408",4164,817,0,0,944,417,1457,455,8254
"49035113409",4646,138,56,12,651,145,1528,95,7271
"49035113410",3928,538,191,29,1244,550,1357,361,8198
"49035113411",1909,132,11,0,514,226,561,35,3388
"49035113412",1547,195,0,135,1037,251,723,299,4187
"49035113413",4402,561,112,0,880,73,1217,152,7397
"49035113505",4518,1005,37,42,1047,510,1463,1048,9670
"49035113509",2425,588,38,0,2607,1104,1989,1209,9960
"49035113510",2221,347,48,0,639,0,634,61,3950
"49035113511",2858,348,48,52,585,419,558,357,5225
"49035113512",1807,706,59,52,822,109,381,303,4239
"49035113513",3735,711,289,34,1337,130,1539,414,8189
"49035113514",3580,682,20,9,1448,822,1143,687,8391
"49035113515",4206,348,103,83,675,15,560,0,5990
"49035113520",2648,236,54,8,1086,99,744,153,5028
"49035113521",4566,424,239,0,519,80,1279,206,7313
"49035113522",2976,28,46,0,315,50,211,11,3637
"49035113523",4747,443,41,0,796,23,1718,310,8078
"49035113525",5205,304,173,8,1833,272,2533,207,10535
"49035113526",4034,334,130,0,386,159,989,193,6225
"49035113527",3554,84,0,0,406,197,1111,222,5574
"49035113528",4519,157,21,15,277,259,377,0,5625
"49035113532",2835,186,0,0,279,23,490,62,3875
"49035113533",3922,147,0,0,311,7,410,17,4814
"49035113534",6331,308,17,0,787,16,1357,175,8991
"49035113535",6200,473,40,0,657,214,1015,83,8682
"49035113536",1771,657,0,0,1086,601,1269,800,6184
"49035113537",2302,287,0,0,723,98,1032,57,4499
"49035113538",1809,452,84,0,1040,84,1142,382,4993
"49035113539",2918,437,34,0,822,16,1348,214,5789
"49035113600",3277,1236,11,54,748,138,1197,417,7078
"49035113701",3184,769,25,0,354,9,903,453,5697
"49035113702",2131,369,75,0,286,58,882,155,3956
"49035113801",3793,632,37,53,708,339,1610,213,7385
"49035113802",2788,511,0,0,366,501,1097,471,5734
"49035113803",6693,631,51,0,1751,178,2512,503,12319
"49035113903",3801,481,20,0,578,98,1006,174,6158
"49035113904",3844,678,0,0,548,19,753,187,6029
"49035113905",5448,509,11,15,1626,193,1878,357,10037
"49035113906",2784,984,15,13,413,56,678,299,5242
"49035113907",6357,693,34,0,797,0,1602,210,9693
"49035114000",1245,313,0,33,282,72,234,30,2209
"49035114100",1969,230,13,0,114,53,152,22,2553
"49035114200",3598,195,0,0,383,66,292,42,4576
"49035114300",14799,1708,359,43,1685,222,3212,456,22484
"49035114500",3611,588,66,0,1882,425,2356,478,9406
"49035114600",6996,538,0,0,179,0,416,21,8150
"49035114700",2947,310,140,69,1137,302,1440,292,6637
"49035114800",2811,108,0,0,303,143,118,0,3483
"49035115106",7604,156,0,0,674,90,553,90,9167
"49035115209",5953,482,57,0,282,277,864,163,8078
"49035980000",0,0,0,0,0,0,0,0,0
"49037942000",42,14,0,0,1772,1252,17,8,3105
"49037942100",129,4,0,0,1765,1454,25,0,3377
"49037978100",2657,511,0,0,243,24,239,164,3838
"49037978200",3426,441,7,0,581,449,195,70,5169
"49039972100",6471,921,3,3,354,32,356,59,8199
"49039972200",2967,425,4,0,291,170,461,176,4494
"49039972300",2776,135,3,0,242,57,375,49,3637
"49039972400",3808,1850,0,0,542,74,506,40,6820
"49039972500",3517,362,4,0,115,14,52,13,4077
"49041975100",3710,500,2,0,152,95,180,103,4742
"49041975200",2498,225,0,2,13,77,85,79,2979
"49041975300",3945,731,0,29,169,63,176,52,5165
"49041975400",2443,555,22,0,121,55,82,74,3352
"49041975500",4316,625,0,0,109,16,82,27,5175
"49043964101",1892,160,0,0,28,4,188,28,2300
"49043964102",3089,349,0,0,90,8,411,132,4079
"49043964201",3267,242,20,4,69,18,380,119,4119
"49043964202",2865,130,0,0,6,1,236,65,3303
"49043964203",121,0,0,0,87,0,102,0,310
"49043964303",2642,40,18,0,100,0,149,0,2949
"49043964304",4360,394,0,0,386,0,414,279,5833
"49043964305",1794,178,45,0,344,0,206,49,2616
"49043964306",2262,33,23,0,141,0,283,0,2742
"49043964307",4582,172,7,0,90,0,62,23,4936
"49043964308",2580,350,10,0,114,0,18,168,3240
"49043964401",1373,169,0,0,38,74,8,18,1680
"49043964402",2844,564,12,56,67,55,616,480,4694
"49045130600",1069,290,9,9,485,182,744,382,3170
"49045130701",3509,61,0,15,110,17,346,18,4076
"49045130702",13843,488,99,0,619,89,1293,6,16437
"49045130703",7367,185,0,0,270,21,279,96,8218
"49045130800",4313,636,0,0,199,96,161,138,5543
"49045130900",2917,620,12,0,374,57,488,238,4706
"49045131001",2287,252,44,0,366,0,291,38,3278
"49045131002",7015,468,20,18,959,29,1050,0,9559
"49045131100",6666,457,119,0,510,28,976,152,8908
"49045131200",2542,321,13,0,203,0,330,88,3497
"49045980000",0,0,0,0,0,0,0,0,0
"49047940201",2902,173,19,0,1741,723,181,60,5799
"49047968200",7336,536,0,0,333,20,339,0,8564
"49047968301",5060,755,101,0,239,23,115,340,6633
"49047968302",4191,153,45,0,122,38,383,38,4970
"49047968401",3318,234,28,0,307,13,608,0,4508
"49047968402",5788,541,0,0,458,52,563,158,7560
"49049000102",3908,493,0,0,71,109,429,109,5119
"49049000103",3712,132,31,0,98,59,313,0,4345
"49049000104",2707,216,0,0,61,0,219,0,3203
"49049000105",4043,131,8,0,28,0,218,0,4428
"49049000203",3549,883,0,19,65,31,192,115,4854
"49049000204",4881,471,18,14,351,236,367,260,6598
"49049000205",2991,251,7,0,401,0,112,0,3762
"49049000206",3256,77,64,0,76,0,199,10,3682
"49049000400",3070,703,0,0,56,125,282,101,4337
"49049000504",3440,585,0,30,74,8,32,0,4169
"49049000505",3105,120,13,0,65,0,254,0,3557
"49049000506",3415,520,5,0,213,25,314,37,4529
"49049000507",1838,68,18,0,9,2,76,0,2011
"49049000508",4262,441,24,0,367,0,390,60,5544
"49049000509",5009,1201,29,14,235,0,901,409,7798
"49049000601",2869,256,9,0,109,80,308,135,3766
"49049000603",3607,370,0,0,278,44,214,109,4622
"49049000604",2707,97,0,0,133,0,407,42,3386
"49049000703",3837,1013,15,0,352,224,648,578,6667
"49049000706",4785,604,147,0,162,0,536,89,6323
"49049000707",2956,665,16,0,178,0,405,240,4460
"49049000708",2451,406,0,0,279,7,213,28,3384
"49049000709",2637,207,18,0,154,0,345,5,3366
"49049000710",2576,23,8,0,154,66,128,5,2960
"49049000711",1907,147,19,0,159,0,114,0,2346
"49049000801",3477,979,47,0,789,297,1090,584,7263
"49049000802",3656,993,13,0,654,439,1325,630,7710
"49049000901",3463,1320,6,26,459,261,1283,558,7376
"49049000903",2915,335,6,0,273,0,215,54,3798
"49049000904",2697,148,8,0,136,16,83,0,3088
"49049001001",3082,279,0,0,347,6,166,76,3956
"49049001002",2014,413,0,0,19,0,163,123,2732
"49049001103",1512,547,10,72,210,51,178,140,2720
"49049001105",2710,594,43,0,222,36,388,146,4139
"49049001106",2121,314,0,0,307,55,445,19,3261
"49049001107",3339,355,0,16,148,0,233,0,4091
"49049001108",2442,363,161,0,261,12,858,72,4169
"49049001201",2745,868,47,0,317,185,235,58,4455
"49049001202",3512,705,28,0,654,296,1039,283,6517
"49049001300",2759,516,52,0,83,131,318,107,3966
"49049001401",2023,566,0,59,232,0,54,127,3061
"49049001402",3026,1735,47,76,306,101,794,317,6402
"49049001501",4254,197,0,0,85,29,202,28,4795
"49049001503",3553,316,22,0,135,23,280,0,4329
"49049001504",3735,786,0,36,407,143,372,63,5542
"49049001601",405,946,0,0,63,291,13,49,1767
"49049001602",58,301,0,0,6,17,0,0,382
"49049001603",1052,1313,5,0,173,235,67,178,3023
"49049001701",3518,444,16,13,58,116,89,22,4276
"49049001702",2343,1660,0,0,280,94,685,176,5238
"49049001801",1766,3700,5,8,177,288,77,153,6174
"49049001802",2041,3015,0,0,128,311,113,144,5752
"49049001803",1219,889,0,0,98,106,114,87,2513
"49049001900",1943,1243,53,10,290,272,451,216,4478
"49049002000",5081,903,14,0,356,479,1719,495,9047
"49049002101",3373,599,15,0,278,183,264,11,4723
"49049002102",2268,351,16,63,155,65,264,108,3290
"49049002201",4077,894,9,109,461,68,300,133,6051
"49049002204",3244,168,10,13,488,164,873,114,5074
"49049002205",2961,241,0,0,770,115,988,177,5252
"49049002206",2856,526,43,0,320,38,794,275,4852
"49049002207",2943,166,0,0,238,197,861,222,4627
"49049002300",2315,901,43,27,624,120,756,397,5183
"49049002400",600,339,5,0,136,14,226,46,1366
"49049002500",2835,1460,12,0,405,113,598,530,5953
"49049002701",2530,447,0,0,51,30,555,27,3640
"49049002702",3245,974,0,0,983,76,696,270,6244
"49049002801",1726,1649,0,0,518,548,1014,1355,6810
"49049002802",1106,486,14,0,146,69,444,260,2525
"49049002901",4886,156,53,0,670,96,912,23,6796
"49049002902",2750,374,0,0,196,6,757,140,4223
"49049003001",3667,272,0,0,160,98,403,105,4705
"49049003002",1876,233,0,0,67,21,34,0,2231
"49049003103",2434,84,12,0,200,0,59,0,2789
"49049003104",3708,121,0,0,226,7,59,7,4128
"49049003105",3332,444,0,0,83,165,160,15,4199
"49049003106",2079,297,0,0,261,16,330,128,3111
"49049003201",2125,248,0,0,272,0,451,51,3147
"49049003203",3540,255,19,0,88,0,179,12,4093
"49049003204",2337,301,0,0,37,14,160,49,2898
"49049003205",3932,222,0,0,150,45,367,141,4857
"49049003300",5762,340,21,14,426,31,899,62,7555
"49049003401",3156,403,0,0,56,20,493,36,4164
"49049003402",5706,594,14,0,142,151,748,265,7620
"49049003403",4244,444,50,0,74,155,443,319,5729
"49049010103",6168,611,81,0,311,18,608,205,8002
"49049010104",7790,486,15,0,330,11,569,41,9242
"49049010105",8354,215,119,0,514,0,509,0,9711
"49049010106",4882,58,138,43,344,0,221,0,5686
"49049010107",2162,150,0,0,159,0,31,0,2502
"49049010108",6286,820,0,0,436,0,458,90,8090
"49049010109",7716,47,96,35,362,61,570,0,8887
"49049010110",1792,5,0,0,33,0,14,0,1844
"49049010111",7062,240,0,0,1056,0,362,1,8721
"49049010112",5334,230,55,0,367,10,331,0,6327
"49049010113",6010,66,0,0,199,0,249,0,6524
"49049010208",3810,101,0,0,220,13,95,0,4239
"49049010209",4710,399,0,0,257,11,40,0,5417
"49049010210",5529,294,50,13,454,76,217,0,6633
"49049010211",3282,306,5,0,79,10,92,6,3780
"49049010212",4197,0,25,0,465,0,465,0,5152
"49049010213",2532,152,0,0,109,85,0,38,2916
"49049010214",5696,520,0,0,623,0,282,91,7212
"49049010215",6547,552,64,0,305,33,355,18,7874
"49049010216",2948,49,0,0,59,0,31,0,3087
"49049010217",4593,56,27,0,180,23,67,0,4946
"49049010218",5483,206,70,0,230,0,119,9,6117
"49049010219",4347,199,0,0,295,59,103,0,5003
"49049010220",6304,327,7,0,175,0,304,0,7117
"49049010303",4047,195,33,2,499,49,236,52,5113
"49049010304",6873,619,30,0,326,5,477,131,8461
"49049010305",2639,121,13,0,147,21,126,50,3117
"49049010404",3815,308,0,0,360,7,464,37,4991
"49049010405",3676,126,33,0,149,0,277,38,4299
"49049010406",1924,184,0,0,47,0,20,0,2175
"49049010407",2077,170,27,0,75,52,69,46,2516
"49049010408",3120,327,32,9,156,22,212,22,3900
"49049010409",2538,174,25,0,77,0,167,0,2981
"49049010410",3034,254,7,0,181,53,355,178,4062
"49049010411",4621,254,9,0,131,36,174,23,5248
"49049010503",2059,151,0,0,53,0,38,0,2301
"49049010504",2650,312,0,8,24,58,157,53,3262
"49049010505",3686,408,4,0,107,0,412,25,4642
"49049010506",1425,191,0,0,86,116,209,208,2235
"49049010600",3582,350,5,0,60,25,398,121,4541
"49049010700",4022,384,20,26,261,108,140,31,4992
"49049010900",1071,33,0,0,68,0,57,1,1230
"49049980100",0,0,0,0,0,0,0,0,0
"49051940500",9196,1110,16,0,284,21,1461,603,12691
"49051960100",3118,408,0,0,195,39,213,30,4003
"49051960200",5389,790,0,0,244,0,258,505,7186
"49051960400",5282,265,0,0,32,0,339,9,5927
"49053270100",7692,1468,0,0,114,44,174,46,9538
"49053270200",2638,255,0,0,66,14,50,8,3031
"49053270300",5985,1451,71,72,772,194,586,660,9791
"49053270400",5655,952,9,28,374,44,391,59,7512
"49053270500",6677,439,0,0,568,0,208,15,7907
"49053270600",5829,1570,0,0,120,201,476,510,8706
"49053270700",7474,863,192,22,1090,516,1833,470,12460
"49053270801",12439,1897,39,26,924,0,833,0,16158
"49053270802",4537,740,29,0,586,485,550,440,7367
"49053270901",2614,921,0,0,188,0,141,8,3872
"49053270902",8574,1359,0,0,347,70,762,302,11414
"49053271000",3121,914,45,0,116,35,275,59,4565
"49053271100",7546,1623,36,0,781,0,1138,197,11321
"49053271200",2295,1087,8,37,220,205,182,429,4463
"49053271300",2075,1124,130,19,48,53,488,446,4383
"49053271400",2608,875,0,0,189,7,676,138,4493
"49053271500",5392,863,40,0,413,43,605,116,7472
"49053271600",5943,359,0,0,121,0,140,13,6576
"49053271701",8456,152,78,0,389,39,415,0,9529
"49053271702",4848,483,3,0,656,3,186,0,6179
"49053271800",2590,267,0,0,509,74,303,55,3798
"49055979100",2209,387,13,0,47,27,112,16,2811
"49057200100",3522,510,0,0,351,176,858,213,5630
"49057200202",2132,653,138,22,220,253,541,386,4345
"49057200203",3187,713,54,0,346,740,1011,823,6874
"49057200204",3618,434,8,0,646,82,1138,327,6253
"49057200300",3813,1364,114,0,796,699,1550,1140,9476
"49057200400",1101,391,18,0,305,82,692,116,2705
"49057200500",5252,520,31,45,392,234,1689,402,8565
"49057200600",3644,473,56,0,415,28,782,43,5441
"49057200700",2583,261,69,0,76,0,258,7,3254
"49057200800",2848,918,5,0,650,284,1332,553,6590
"49057200900",1763,1023,21,83,654,355,1238,701,5838
"49057201100",630,646,46,76,150,63,158,104,1873
"49057201200",560,780,113,60,502,243,686,572,3516
"49057201301",1857,408,11,24,247,111,903,174,3735
"49057201302",1875,1011,41,0,528,242,1065,737,5499
"49057201400",2329,245,0,0,444,54,167,113,3352
"49057201500",3144,542,16,0,240,0,238,0,4180
"49057201600",2665,761,53,53,408,139,565,194,4838
"49057201700",2177,749,0,0,390,177,1006,725,5224
"49057201800",896,427,11,0,313,283,589,559,3078
"49057201900",501,261,39,19,114,185,278,250,1647
"49057202000",4554,454,0,135,347,221,280,73,6064
"49057210100",6564,376,63,0,154,7,142,37,7343
"49057210201",4462,76,32,0,149,0,457,25,5201
"49057210203",2671,41,17,0,61,6,56,0,2852
"49057210204",3952,206,31,0,198,14,164,34,4599
"49057210302",7635,199,12,0,498,16,907,0,9267
"49057210303",6600,124,41,0,130,0,248,57,7200
"49057210304",3751,337,0,0,46,0,182,0,4316
"49057210402",5385,322,55,7,633,59,478,136,7075
"49057210403",7977,104,0,0,152,20,164,0,8417
"49057210404",1907,136,0,4,64,4,40,15,2170
"49057210504",8167,337,101,0,492,0,560,0,9657
"49057210505",6903,383,0,6,379,58,469,58,8256
"49057210506",8859,1006,66,0,1397,170,1403,998,13899
"49057210508",1875,18,7,0,306,68,365,68,2707
"49057210509",3358,614,81,0,383,25,812,282,5555
"49057210510",2985,127,0,0,338,22,377,11,3860
"49057210511",3196,234,50,0,559,0,548,0,4587
"49057210512",3642,323,123,0,245,225,653,215,5426
"49057210600",5168,946,43,0,612,308,443,54,7574
"49057210701",4342,478,26,45,503,92,661,80,6227
"49057210703",2063,240,17,0,88,103,295,99,2905
"49057210704",4499,403,73,0,633,6,628,60,6302
"49057210800",1939,522,36,0,387,313,636,271,4104
"49057210900",5819,633,149,0,379,39,691,62,7772
"49057211000",2850,268,0,0,157,83,240,74,3672
"49057211100",3995,662,12,0,114,387,370,460,6000
"49057211201",3728,308,52,0,234,0,167,0,4489
"49057211202",5730,275,0,2,443,48,324,0,6822
"50001960100",3441,246,6,3,105,5,26,0,3832
"50001960200",2574,140,18,1,39,0,38,0,2810
"50001960300",2185,214,16,26,70,59,15,4,2589
"50001960400",4603,329,15,1,109,0,127,23,5207
"50001960500",3426,319,81,0,42,11,61,0,3940
"50001960600",2315,284,0,0,74,9,6,16,2704
"50001960700",3098,366,77,0,338,10,25,0,3914
"50001960800",1582,349,12,0,40,39,36,0,2058
"50001960900",4542,477,30,0,87,3,129,3,5271
"50001961000",2004,224,9,0,62,9,40,4,2352
"50003970200",2081,78,0,0,2,11,32,0,2204
"50003970300",954,66,2,7,22,10,3,15,1079
"50003970400",3975,263,3,7,16,42,59,25,4390
"50003970500",903,55,4,0,6,0,30,0,998
"50003970600",2744,272,1,0,38,4,21,0,3080
"50003970700",2157,234,0,2,55,0,28,0,2476
"50003970800",3012,487,0,0,21,8,57,0,3585
"50003970900",1547,391,2,0,44,28,35,0,2047
"50003971000",2447,321,1,0,68,103,133,0,3073
"50003971100",3468,788,2,0,114,40,50,0,4462
"50003971200",3265,1111,51,26,176,54,64,0,4747
"50003971300",3017,317,0,0,139,10,0,0,3483
"50005957000",3591,542,13,6,58,55,25,13,4303
"50005957100",1765,194,4,4,33,0,13,6,2019
"50005957200",2182,354,0,0,26,0,4,12,2578
"50005957300",2083,661,0,34,14,0,23,0,2815
"50005957400",2815,408,6,0,128,62,48,16,3483
"50005957500",3177,356,0,0,144,7,182,0,3866
"50005957600",2038,153,0,0,4,0,16,5,2216
"50005957700",2392,364,36,0,81,76,0,0,2949
"50005957800",2549,271,9,0,37,15,14,0,2895
"50005957900",2856,171,23,0,77,0,14,0,3141
"50007000100",3331,330,21,261,145,169,219,87,4563
"50007000200",4234,514,138,42,356,33,33,14,5364
"50007000300",1772,521,336,14,761,172,0,0,3576
"50007000400",1673,817,120,103,527,72,17,0,3329
"50007000500",1800,2090,178,94,85,79,32,48,4406
"50007000600",2763,1050,146,39,278,40,62,31,4409
"50007000800",2032,431,0,59,172,24,108,14,2840
"50007000900",1447,593,10,46,66,24,23,9,2218
"50007001000",1584,416,67,100,146,78,74,26,2491
"50007001100",1703,282,20,0,94,59,61,8,2227
"50007002101",2532,78,8,0,102,8,22,0,2750
"50007002102",7416,125,20,0,263,0,30,0,7854
"50007002200",5143,816,26,31,195,202,106,19,6538
"50007002301",2008,182,4,4,117,0,26,0,2341
"50007002302",6097,333,26,35,141,11,45,14,6702
"50007002400",1865,654,150,53,88,235,75,8,3128
"50007002500",2599,798,101,0,362,84,35,34,4013
"50007002601",4725,235,146,0,297,6,38,0,5447
"50007002602",3355,459,71,31,297,21,69,11,4314
"50007002701",4752,259,338,0,228,19,183,0,5779
"50007002702",4658,275,14,4,67,0,96,0,5114
"50007002800",4770,145,12,12,71,5,41,0,5056
"50007002900",5980,137,21,0,163,5,33,0,6339
"50007003000",3765,150,0,50,122,2,8,0,4097
"50007003100",8120,361,104,0,379,35,122,10,9131
"50007003301",3368,56,44,7,319,0,62,0,3856
"50007003304",5016,223,120,0,259,133,49,23,5823
"50007003400",6925,287,0,26,201,7,162,0,7608
"50007003501",3568,108,5,0,107,11,10,0,3809
"50007003502",4592,379,10,1,121,123,19,1,5246
"50007003503",1782,67,10,0,20,9,37,12,1937
"50007003600",3165,578,27,12,302,11,98,70,4263
"50007003900",988,366,0,0,46,19,21,20,1460
"50007004002",3866,152,221,0,312,58,433,15,5057
"50007980000",0,0,0,0,0,0,0,0,0
"50009950100",1638,270,17,1,14,13,24,2,1979
"50009950200",738,178,0,8,44,0,0,0,968
"50009950500",2734,427,9,3,55,29,46,5,3308
"50011010100",6561,427,20,0,368,52,154,2,7584
"50011010200",3679,561,4,0,96,66,67,0,4473
"50011010300",2885,468,0,7,38,5,69,0,3472
"50011010400",2947,124,5,0,31,6,35,15,3163
"50011010500",5170,1007,0,10,251,12,39,31,6520
"50011010600",5471,157,104,0,205,17,35,10,5999
"50011010700",2468,506,29,2,297,81,61,23,3467
"50011010800",2830,417,15,0,156,2,0,1,3421
"50011010900",4401,75,0,0,153,0,43,0,4672
"50011011000",5474,140,0,0,112,5,49,0,5780
"50013020100",2754,269,0,0,160,7,43,3,3236
"50013020200",3261,306,0,0,170,16,58,11,3822
"50015953000",2014,295,18,0,56,17,6,8,2414
"50015953100",3186,429,3,0,100,0,65,0,3783
"50015953200",2239,703,22,24,81,0,87,0,3156
"50015953300",2617,212,0,0,169,7,130,0,3135
"50015953400",2349,158,10,0,34,0,12,4,2567
"50015953500",4341,702,67,0,66,104,33,0,5313
"50015953600",3968,228,22,0,181,8,20,0,4427
"50017959000",1666,413,3,0,55,9,21,0,2167
"50017959101",1763,275,10,4,12,30,12,44,2150
"50017959102",2062,359,14,0,70,8,23,0,2536
"50017959200",3067,263,0,0,0,0,0,0,3330
"50017959300",2175,210,0,0,86,9,18,0,2498
"50017959400",3728,540,0,0,23,25,51,39,4406
"50017959500",3659,372,49,49,151,26,58,0,4364
"50017959600",2247,221,0,0,95,11,29,0,2603
"50017959700",1449,220,3,2,61,24,8,0,1767
"50017959800",2199,428,0,0,105,0,25,0,2757
"50019951100",1914,378,0,0,26,10,44,11,2383
"50019951200",2348,273,15,0,119,9,10,0,2774
"50019951300",1576,111,0,0,26,27,19,0,1759
"50019951400",1467,138,0,0,11,7,5,0,1628
"50019951500",1393,872,8,0,39,8,0,0,2320
"50019951600",3977,566,7,0,107,14,73,0,4744
"50019951700",3373,506,9,1,115,5,131,15,4155
"50019951800",2068,380,27,32,68,56,0,9,2640
"50019951900",1935,426,4,0,35,11,0,0,2411
"50019952000",1451,238,2,0,35,2,23,2,1753
"50021962100",1533,148,0,0,67,4,37,0,1789
"50021962200",3490,297,15,0,51,28,0,0,3881
"50021962300",2171,275,0,0,18,9,11,0,2484
"50021962400",2318,566,5,0,6,0,11,0,2906
"50021962500",1480,81,20,0,13,0,37,0,1631
"50021962600",2091,235,0,0,41,0,25,0,2392
"50021962700",3526,248,83,1,122,0,15,0,3995
"50021962800",2456,301,0,0,126,0,103,0,2986
"50021963000",3335,368,11,0,157,0,30,20,3921
"50021963100",2635,498,67,7,14,10,33,0,3264
"50021963200",2520,544,0,0,21,38,14,19,3156
"50021963300",3857,1174,5,0,150,0,92,0,5278
"50021963400",2265,228,33,0,25,4,88,0,2643
"50021963500",1568,146,0,0,24,0,7,0,1745
"50021963600",3048,693,22,0,6,36,19,0,3824
"50021963700",2242,334,0,0,91,4,28,0,2699
"50021963800",3469,402,12,0,66,11,24,4,3988
"50021964000",2904,259,0,0,122,25,25,0,3335
"50021964200",1491,129,0,0,20,0,56,1,1697
"50021964300",1190,135,11,0,37,38,9,11,1431
"50023954000",3523,620,34,0,127,30,52,19,4405
"50023954100",2091,192,0,0,95,11,73,0,2462
"50023954200",2496,186,16,0,82,31,37,0,2848
"50023954300",4465,449,0,0,128,29,0,45,5116
"50023954400",2818,119,0,0,103,7,84,9,3140
"50023954500",2194,215,7,7,135,17,10,10,2595
"50023954600",1921,195,42,0,59,37,56,0,2310
"50023954700",1225,193,0,0,36,8,13,0,1475
"50023954800",1966,217,30,11,38,37,0,0,2299
"50023954900",1469,152,2,0,50,2,30,0,1705
"50023955000",2360,139,29,0,52,17,86,40,2723
"50023955100",3325,723,0,0,67,24,0,0,4139
"50023955200",3396,860,207,16,93,4,22,113,4711
"50023955300",3564,247,10,0,63,18,42,0,3944
"50023955400",3686,194,24,0,73,0,121,0,4098
"50023955500",4696,476,0,0,128,13,113,4,5430
"50023955600",1470,115,0,0,30,0,0,0,1615
"50023955700",1561,50,5,0,74,0,22,0,1712
"50023955800",1119,63,4,0,23,5,0,0,1214
"50025967000",2433,440,27,0,83,34,34,25,3076
"50025967100",1642,308,0,0,109,7,20,6,2092
"50025967200",2490,454,18,0,83,6,24,7,3082
"50025967300",1446,60,43,0,31,0,0,0,1580
"50025967400",756,121,0,0,37,0,0,0,914
"50025967500",774,91,0,18,39,14,6,0,942
"50025967600",2469,364,6,5,104,33,167,19,3167
"50025967700",1899,273,0,0,28,0,61,0,2261
"50025967800",1607,193,0,0,8,0,11,5,1824
"50025967900",1162,88,0,8,79,0,50,0,1387
"50025968000",1872,84,0,0,106,0,22,0,2084
"50025968100",1154,129,0,0,9,0,8,0,1300
"50025968200",1378,173,8,0,19,0,2,0,1580
"50025968300",1822,112,0,0,5,0,6,0,1945
"50025968400",2962,475,21,18,245,36,126,0,3883
"50025968500",3873,1050,52,2,275,87,193,3,5535
"50025968600",1908,289,58,2,38,27,9,0,2331
"50025968700",3537,385,19,6,111,29,28,5,4120
"50027965000",2862,166,17,0,241,37,70,0,3393
"50027965100",2032,592,23,35,50,35,0,69,2836
"50027965200",2387,327,3,0,43,0,0,0,2760
"50027965300",250,40,0,4,2,6,0,0,302
"50027965400",3350,320,13,0,72,8,44,0,3807
"50027965501",3038,83,7,0,78,26,0,0,3232
"50027965502",2202,318,32,0,92,11,0,0,2655
"50027965600",3360,412,12,3,71,12,0,0,3870
"50027965700",3126,108,10,0,142,0,0,0,3386
"50027965800",2785,135,3,0,27,0,13,0,2963
"50027965900",2788,331,0,0,7,14,0,0,3140
"50027966000",2582,542,113,0,57,4,33,0,3331
"50027966100",2617,144,0,2,27,4,9,0,2803
"50027966200",1604,180,2,7,3,0,30,4,1830
"50027966300",1665,285,13,0,109,9,27,0,2108
"50027966500",3568,361,0,0,242,27,266,0,4464
"50027966600",3486,842,0,0,153,135,0,152,4768
"50027966700",3571,433,0,18,47,25,48,0,4142
"51001090100",2530,197,5,72,94,8,38,0,2944
"51001090200",4069,713,1182,478,9,18,54,275,6798
"51001090300",1357,451,441,81,90,31,43,114,2608
"51001090400",2785,346,1762,592,200,287,1106,297,7375
"51001090500",1360,354,570,179,24,6,150,87,2730
"51001090600",2419,417,357,306,44,8,25,5,3581
"51001090700",2774,171,874,979,145,0,367,0,5310
"51001090800",1938,278,1140,359,29,53,133,75,4005
"51001980100",0,0,0,0,0,0,0,0,0
"51001980200",0,0,0,0,0,0,0,0,0
"51001990100",0,0,0,0,0,0,0,0,0
"51001990200",0,0,0,0,0,0,0,0,0
"51003010100",4533,254,246,86,254,28,54,1,5456
"51003010201",3433,142,455,73,433,0,519,0,5055
"51003010202",2731,148,82,0,176,0,63,91,3291
"51003010300",6987,173,304,93,1189,13,386,0,9145
"51003010401",3796,72,374,122,141,0,0,0,4505
"51003010402",2967,100,8,115,55,0,95,0,3340
"51003010500",3757,180,734,0,286,4,14,0,4975
"51003010601",3987,590,508,125,350,100,119,155,5934
"51003010602",2610,136,325,19,208,43,31,2,3374
"51003010700",3003,474,1168,266,520,77,655,86,6249
"51003010800",3039,320,452,332,522,45,280,9,4999
"51003010901",479,376,35,0,264,104,18,64,1340
"51003010902",450,219,42,21,222,158,25,76,1213
"51003010903",5,59,0,39,0,0,0,0,103
"51003011000",5374,214,221,25,179,43,65,19,6140
"51003011100",6696,347,277,68,646,34,95,17,8180
"51003011201",3142,474,37,0,170,36,79,154,4092
"51003011202",2423,232,343,12,351,0,274,0,3635
"51003011301",4570,692,272,30,84,0,58,0,5706
"51003011302",2034,991,228,326,435,253,731,664,5662
"51003011303",2762,176,119,0,248,60,272,26,3663
"51003011400",3051,503,701,72,141,20,243,3,4734
"51005070100",2490,753,250,198,53,126,75,72,4017
"51005080100",2222,542,88,7,27,0,0,0,2886
"51005080201",2234,331,105,0,21,0,16,44,2751
"51005080202",2297,213,77,67,0,0,13,0,2667
"51005080301",1837,312,12,0,22,0,0,3,2186
"51005080302",1307,123,0,5,41,5,4,5,1490
"51007930100",4535,574,1564,353,250,0,0,130,7406
"51007930200",3951,231,850,313,44,0,0,0,5389
"51009010100",3677,539,495,120,139,69,109,65,5213
"51009010200",4850,390,933,384,176,124,115,68,7040
"51009010300",3099,88,313,2,167,0,26,0,3695
"51009010401",2471,322,653,130,93,28,24,23,3744
"51009010402",2013,318,317,160,202,56,80,0,3146
"51009010502",214,51,60,5,9,0,0,0,339
"51009010503",1364,302,404,166,65,14,114,4,2433
"51009010504",2327,156,692,75,283,1,21,0,3555
"51009010600",1442,475,769,111,58,0,8,0,2863
"51011040100",4088,811,1120,312,121,9,41,28,6530
"51011040200",3126,348,691,215,75,31,63,0,4549
"51011040300",2695,649,449,276,83,17,38,15,4222
"51013100100",4296,120,51,1,597,11,217,0,5293
"51013100200",6292,4,38,1,355,158,434,0,7282
"51013100300",5186,28,13,1,210,0,97,0,5535
"51013100400",3573,93,15,2,224,12,373,8,4300
"51013100500",3617,209,67,6,867,26,533,30,5355
"51013100600",2357,144,155,26,366,0,476,9,3533
"51013100700",3985,375,106,13,1155,24,479,71,6208
"51013100800",811,6,466,16,298,20,210,10,1837
"51013100900",3742,122,122,69,691,9,523,16,5294
"51013101000",2600,90,171,12,371,30,131,8,3413
"51013101100",5080,158,0,4,530,0,234,0,6006
"51013101200",2809,246,157,7,968,124,786,166,5263
"51013101300",5429,122,1,65,1142,143,493,1,7396
"51013101401",1076,26,115,32,103,3,69,0,1424
"51013101402",2238,99,91,0,581,22,193,11,3235
"51013101403",3895,378,127,15,797,266,369,34,5881
"51013101404",3301,166,165,17,851,138,520,0,5158
"51013101500",5838,449,271,0,768,68,727,21,8142
"51013101601",980,97,14,0,100,137,131,77,1536
"51013101602",1220,104,84,0,216,50,119,115,1908
"51013101603",2471,184,79,298,542,47,185,41,3847
"51013101701",2184,473,19,52,371,42,314,330,3785
"51013101702",3145,138,140,19,989,315,621,38,5405
"51013101703",1578,86,148,7,149,16,42,0,2026
"51013101801",2108,24,23,0,509,20,143,0,2827
"51013101802",4378,216,157,37,1307,723,738,642,8198
"51013101803",3054,115,205,20,590,86,458,22,4550
"51013101900",2907,103,0,46,195,9,201,22,3483
"51013102001",1661,219,44,8,883,425,1139,527,4906
"51013102002",898,29,89,3,431,23,161,7,1641
"51013102003",2232,238,473,279,536,220,705,209,4892
"51013102100",1510,114,57,33,453,228,374,5,2774
"51013102200",2271,361,1243,504,2554,699,3233,644,11509
"51013102301",1270,45,166,10,145,0,247,5,1888
"51013102302",2606,305,61,12,834,412,1183,443,5856
"51013102400",2388,123,336,35,429,10,362,0,3683
"51013102500",3821,100,618,178,688,18,477,28,5928
"51013102600",1858,116,267,30,1061,82,1005,54,4473
"51013102701",960,300,803,196,1219,303,1261,359,5401
"51013102702",1432,9,223,0,582,0,756,0,3002
"51013102801",3723,329,1323,146,1505,1271,1609,1369,11275
"51013102802",1114,31,53,23,79,17,176,5,1498
"51013102901",2260,65,98,0,265,9,182,9,2888
"51013102902",3099,104,226,11,911,22,743,0,5116
"51013103000",2920,90,99,0,217,0,340,0,3666
"51013103100",2445,585,1973,657,761,400,1155,715,8691
"51013103200",3050,285,610,23,1319,232,708,53,6280
"51013103300",987,54,682,255,327,26,140,0,2471
"51013103401",136,16,8,4,7,0,0,0,171
"51013103402",3552,130,420,0,1067,314,168,47,5698
"51013103501",1970,113,81,0,690,233,191,16,3294
"51013103502",2075,172,410,93,523,59,340,23,3695
"51013103503",2371,48,364,18,571,54,269,25,3720
"51013103601",2136,89,16,0,242,38,107,1,2629
"51013103602",723,45,28,5,366,196,69,0,1432
"51013103700",2250,84,48,0,200,7,323,31,2943
"51013103800",3020,201,1031,100,746,35,792,119,6044
"51013980100",16,0,0,0,0,0,0,0,16
"51013980200",8,0,0,0,0,0,0,0,8
"51015070100",2313,400,0,0,27,0,19,2,2761
"51015070200",2857,325,27,3,222,0,209,31,3674
"51015070300",5753,321,67,19,188,58,152,58,6616
"51015070400",4241,864,124,0,48,31,39,55,5402
"51015070500",4951,567,3,20,51,49,0,48,5689
"51015070600",7553,429,260,22,440,0,184,0,8888
"51015070700",5115,396,54,43,49,85,49,0,5791
"51015070800",5434,244,90,2,157,0,10,0,5937
"51015070900",4019,383,191,37,6,72,46,38,4792
"51015071000",4910,329,0,43,40,0,53,0,5375
"51015071101",3172,972,140,21,148,50,90,101,4694
"51015071102",5554,228,82,0,22,0,97,0,5983
"51015071200",5053,543,162,54,60,84,17,230,6203
"51017920100",3904,334,137,9,100,4,111,38,4637
"51019030101",5889,332,180,36,110,0,75,10,6632
"51019030103",5382,277,170,0,290,219,37,0,6375
"51019030104",3628,261,237,25,139,0,89,0,4379
"51019030201",7804,294,370,58,159,28,257,0,8970
"51019030202",5028,213,186,163,40,126,209,0,5965
"51019030300",2894,267,208,2,63,10,0,2,3446
"51019030401",2487,143,187,54,82,34,44,0,3031
"51019030402",5353,359,801,112,208,19,86,0,6938
"51019030501",3684,713,340,66,75,79,19,135,5111
"51019030503",2052,160,22,0,28,0,39,9,2310
"51019030504",1998,105,73,5,0,0,14,0,2195
"51019030601",3002,220,91,22,43,18,109,0,3505
"51019030602",3295,400,0,0,90,0,53,0,3838
"51019030603",2231,362,33,0,136,0,83,0,2845
"51019030604",2457,360,0,0,82,0,56,0,2955
"51019030605",2374,235,49,1,4,2,14,18,2697
"51019050100",3300,772,1053,806,77,14,54,14,6090
"51021040100",2642,508,27,0,11,0,60,13,3261
"51021040200",2409,101,0,0,15,12,15,0,2552
"51023040100",2520,486,315,14,35,0,70,0,3440
"51023040200",3568,313,91,10,72,7,7,0,4068
"51023040301",2459,181,156,10,119,0,8,1,2934
"51023040302",7158,81,70,27,89,0,60,0,7485
"51023040401",1927,255,64,0,46,24,39,6,2361
"51023040402",4229,366,122,67,147,88,165,88,5272
"51023040501",5685,421,44,53,118,72,0,0,6393
"51023040502",1063,208,19,18,20,0,14,0,1342
"51025930100",1202,183,1751,365,142,0,15,0,3658
"51025930201",288,49,1252,269,13,44,3,0,1918
"51025930202",0,0,0,0,0,0,0,0,0
"51025930203",1023,435,1856,856,26,31,48,157,4432
"51025930300",2929,364,1037,701,12,1,11,1,5056
"51027010100",2594,1867,0,0,27,0,0,0,4488
"51027010200",2113,1034,0,0,61,0,0,0,3208
"51027010300",2625,527,0,0,14,0,19,0,3185
"51027010400",1703,592,26,49,16,16,0,0,2402
"51027010500",1075,299,0,0,129,7,0,0,1510
"51027010600",2874,464,0,49,42,0,0,0,3429
"51027010700",3172,937,0,0,50,0,0,0,4159
"51029930101",2391,572,917,241,144,0,57,51,4373
"51029930102",1145,244,1287,224,2,1,2,3,2908
"51029930201",2032,171,679,368,51,18,1,0,3320
"51029930202",2664,575,595,387,236,66,162,0,4685
"51031020101",3821,418,1082,32,265,0,271,86,5975
"51031020102",3367,495,194,28,69,88,0,16,4257
"51031020200",3408,520,331,166,132,33,0,0,4590
"51031020300",3072,418,135,0,397,100,59,0,4181
"51031020401",3902,634,688,10,217,70,134,0,5655
"51031020402",2556,105,121,67,19,60,5,0,2933
"51031020403",5215,136,401,87,50,0,110,0,5999
"51031020500",5429,736,778,400,74,45,67,30,7559
"51031020600",2521,738,170,60,119,53,16,84,3761
"51031020700",1699,544,768,116,180,25,109,14,3455
"51031020800",2163,278,520,185,136,18,26,0,3326
"51031020900",2058,383,942,261,147,0,10,13,3814
"51033030100",2234,402,629,86,98,38,83,0,3570
"51033030201",1516,124,863,72,55,46,38,22,2736
"51033030202",1040,124,191,176,39,19,0,0,1589
"51033030300",1870,182,652,149,149,41,38,52,3133
"51033030400",987,286,271,69,51,45,29,0,1738
"51033030500",7246,826,2773,580,380,30,222,203,12260
"51033030600",1354,60,1071,236,94,10,37,4,2866
"51035080100",2965,729,0,0,0,0,137,0,3831
"51035080200",3746,727,1,7,12,0,0,0,4493
"51035080300",4037,671,0,47,0,36,255,0,5046
"51035080400",4354,837,64,39,92,0,198,0,5584
"51035080500",3766,655,0,14,100,28,124,36,4723
"51035080601",1730,315,0,0,24,0,5,0,2074
"51035080602",3600,912,82,0,102,0,108,0,4804
"51036600100",1273,145,948,277,205,4,59,0,2911
"51036600200",576,103,1063,164,421,40,28,3,2398
"51036600300",777,92,869,108,24,0,29,0,1899
"51037930100",2789,634,1237,555,91,5,7,12,5330
"51037930200",1670,244,647,256,12,30,1,43,2903
"51037930300",2489,340,582,514,32,11,16,5,3989
"51041100106",2465,75,23,3,224,0,121,47,2958
"51041100107",663,343,632,147,205,31,146,105,2272
"51041100205",2037,714,3554,246,1468,53,1805,597,10474
"51041100206",2551,207,1729,10,470,18,508,120,5613
"51041100208",2007,136,158,50,266,0,184,10,2811
"51041100209",3521,406,1915,0,198,127,187,221,6575
"51041100210",709,44,580,21,147,22,115,0,1638
"51041100300",1006,388,508,137,164,84,254,343,2884
"51041100403",3428,288,1026,12,820,61,482,0,6117
"51041100404",1144,561,301,94,298,63,965,393,3819
"51041100405",1232,289,331,194,353,145,789,419,3752
"51041100406",346,109,356,180,134,50,131,50,1356
"51041100407",1743,225,818,38,339,14,328,33,3538
"51041100409",4895,466,910,0,417,1,424,50,7163
"51041100410",986,60,677,188,86,20,29,0,2046
"51041100505",3383,289,1219,255,166,45,186,0,5543
"51041100506",4248,262,1434,417,586,79,1036,81,8143
"51041100507",4037,175,1685,68,301,66,292,0,6624
"51041100508",2565,172,1572,345,323,19,92,39,5127
"51041100509",4756,207,1595,0,370,0,334,0,7262
"51041100510",2478,79,696,48,401,13,327,0,4042
"51041100600",158,58,950,130,44,7,0,7,1354
"51041100701",2315,182,1918,294,115,5,330,5,5164
"51041100702",1103,66,575,151,72,5,56,34,2062
"51041100703",5691,476,1296,63,139,2,178,30,7875
"51041100804",1545,281,1740,97,721,5,102,55,4546
"51041100805",1951,318,2720,297,689,25,1034,131,7165
"51041100806",1111,100,1368,348,497,89,578,102,4193
"51041100807",926,67,391,29,92,0,207,21,1733
"51041100812",3537,577,986,109,310,271,170,497,6457
"51041100814",1741,460,893,18,582,49,659,43,4445
"51041100815",2503,72,788,183,307,111,70,0,4034
"51041100816",3324,91,1114,1,327,17,315,0,5189
"51041100817",1514,226,916,42,322,18,162,139,3339
"51041100818",1587,115,1835,96,298,90,279,0,4300
"51041100819",1525,896,3903,187,310,36,429,642,7928
"51041100820",821,10,1506,157,369,124,147,146,3280
"51041100821",3631,122,553,12,128,0,111,0,4557
"51041100822",3948,113,558,17,125,7,73,0,4841
"51041100823",3795,196,1214,270,207,24,233,0,5939
"51041100902",3467,140,74,66,127,0,39,0,3913
"51041100907",1930,268,184,6,152,72,388,122,3122
"51041100910",3387,248,1174,122,397,64,313,0,5705
"51041100912",5095,216,810,26,330,0,119,0,6596
"51041100915",2713,185,647,16,377,84,159,8,4189
"51041100919",4591,578,768,19,690,194,483,153,7476
"51041100920",725,79,107,28,195,0,150,0,1284
"51041100921",4352,272,1145,184,638,0,553,0,7144
"51041100922",2818,184,1373,20,681,3,460,21,5560
"51041100923",1367,61,578,265,69,10,180,0,2530
"51041100924",3838,159,165,27,297,0,116,20,4622
"51041100926",4945,116,348,0,604,0,208,0,6221
"51041100927",6209,48,611,0,1199,0,330,0,8397
"51041100928",4230,278,659,59,513,21,123,132,6015
"51041100929",5245,312,621,3,620,2,210,2,7015
"51041100930",2755,173,331,27,107,0,68,0,3461
"51041100931",4623,119,493,58,312,9,101,19,5734
"51041100932",2867,44,432,15,469,0,111,0,3938
"51041100933",1578,238,666,16,126,0,141,47,2812
"51041100934",4053,152,1825,481,1010,0,343,26,7890
"51041100935",3419,85,60,0,145,91,22,0,3822
"51041100936",3608,102,118,12,110,0,87,0,4037
"51041101003",4812,55,551,0,332,0,122,0,5872
"51041101004",4017,80,397,19,272,0,72,0,4857
"51041101007",5372,55,355,0,449,0,236,0,6467
"51041101008",3850,79,373,0,311,0,38,0,4651
"51041101009",4665,209,638,6,452,36,288,22,6316
"51041101010",6590,223,910,0,40,207,71,0,8041
"51041101011",2475,124,268,8,265,12,208,12,3372
"51041101012",3801,20,765,129,477,12,446,0,5650
"51041101013",2833,0,458,0,68,0,24,0,3383
"51043010100",6504,567,362,206,420,199,213,190,8661
"51043010200",2192,266,111,36,189,6,125,6,2931
"51043010300",2717,276,7,0,6,0,47,0,3053
"51045050100",4500,495,0,0,84,116,0,0,5195
"51047930101",3513,298,330,70,301,28,475,41,5056
"51047930102",6606,496,332,1,655,0,198,0,8288
"51047930201",5797,254,662,148,181,22,715,0,7779
"51047930202",5097,189,502,70,309,17,407,0,6591
"51047930300",3120,433,1376,218,748,287,671,245,7098
"51047930400",3633,380,430,187,281,122,380,84,5497
"51047930501",3004,216,682,31,108,30,286,10,4367
"51047930502",3156,454,771,301,784,68,697,12,6243
"51049930100",3528,554,1454,568,71,84,0,0,6259
"51049930200",1727,348,983,250,0,192,0,12,3512
"51051040100",3151,1109,23,2,21,4,5,6,4321
"51051040200",2035,364,41,4,54,11,62,5,2576
"51051040300",4128,919,12,7,11,0,31,0,5108
"51051040400",2358,805,0,0,0,0,4,0,3167
"51053840100",3654,387,802,701,68,0,10,0,5622
"51053840200",3400,409,471,104,102,4,357,0,4847
"51053840300",2637,555,2372,318,245,0,300,0,6427
"51053840400",374,152,155,157,17,26,34,0,915
"51053840500",1551,330,809,112,100,0,51,0,2953
"51053840600",3909,355,2609,372,61,79,0,20,7405
"51053980100",0,0,0,0,0,0,0,0,0
"51057950600",1588,67,1528,259,126,22,0,0,3590
"51057950700",1707,433,1263,524,73,24,0,7,4031
"51057950800",2238,120,879,84,114,0,37,15,3487
"51059415100",2822,301,125,0,388,58,419,197,4310
"51059415200",2543,90,103,7,156,128,118,11,3156
"51059415300",2397,49,279,0,918,4,959,16,4622
"51059415401",3025,147,1340,212,934,211,2102,178,8149
"51059415402",1990,19,547,56,383,0,274,24,3293
"51059415500",4085,182,907,302,394,34,652,0,6556
"51059415600",2584,11,34,0,146,1,115,1,2892
"51059415700",3463,16,81,0,250,0,243,0,4053
"51059415800",4440,40,0,0,524,0,319,0,5323
"51059415900",2340,37,162,0,562,100,469,63,3733
"51059416000",3358,165,921,295,901,85,1152,112,6989
"51059416100",2877,113,250,26,447,0,214,0,3927
"51059416200",2824,128,1131,47,1107,0,934,0,6171
"51059416300",1745,63,66,4,90,0,45,0,2013
"51059420100",1849,93,574,72,980,156,974,113,4811
"51059420201",1714,160,782,0,1267,27,461,79,4490
"51059420202",1293,99,419,6,251,0,147,0,2215
"51059420203",1770,68,256,53,379,65,196,1,2788
"51059420300",3672,107,495,0,1470,0,1076,32,6852
"51059420400",1637,62,641,17,953,38,705,17,4070
"51059420501",1124,124,351,23,112,11,99,13,1857
"51059420502",1012,35,253,6,539,47,415,47,2354
"51059420503",1553,140,732,110,469,23,649,29,3705
"51059420600",2115,97,775,18,1281,201,980,130,5597
"51059420700",2946,100,323,0,750,80,665,73,4937
"51059420800",2394,53,596,13,911,126,911,111,5115
"51059421001",1442,97,501,14,829,33,637,0,3553
"51059421002",2374,200,1084,13,1079,258,409,75,5492
"51059421101",3354,131,1269,15,1401,105,608,0,6883
"51059421102",2599,68,522,52,920,60,618,30,4869
"51059421103",3132,60,865,0,937,26,290,0,5310
"51059421200",1736,36,103,0,218,0,148,4,2245
"51059421300",2734,54,361,0,765,16,539,0,4469
"51059421400",2259,619,1087,263,3844,724,2409,661,11866
"51059421500",3058,185,998,487,1323,807,2012,764,9634
"51059421600",2443,394,1772,351,1406,106,2566,435,9473
"51059421701",1542,365,1462,60,1767,156,2027,398,7777
"51059421702",1734,144,842,53,1458,0,1374,107,5712
"51059421800",2812,135,1714,221,1242,268,1718,73,8183
"51059421900",1570,113,591,53,371,89,448,19,3254
"51059422000",1968,6,818,36,866,0,419,0,4113
"51059422101",2735,71,1680,290,2098,0,1393,0,8267
"51059422102",1895,144,2571,119,2330,18,879,80,8036
"51059422201",1589,4,445,0,1367,58,274,0,3737
"51059422202",1861,79,1534,18,2051,177,394,18,6132
"51059422301",1929,0,478,32,616,26,362,0,3443
"51059422302",3344,91,731,0,1185,43,331,30,5755
"51059422401",1392,24,447,0,489,0,150,0,2502
"51059422402",3085,0,1123,97,857,20,563,20,5765
"51059422403",2050,57,345,6,131,29,177,0,2795
"51059430101",3819,26,90,1,731,11,400,0,5078
"51059430102",1374,67,494,0,1078,0,360,12,3385
"51059430201",2959,134,124,0,949,35,312,49,4562
"51059430202",3235,645,129,41,1143,12,526,0,5731
"51059430203",1832,85,80,10,649,65,188,1,2910
"51059430400",4659,66,169,4,2081,148,1200,50,8377
"51059430500",1265,12,65,0,357,40,113,0,1852
"51059430600",3310,302,404,1,3204,185,3084,309,10799
"51059430700",1675,13,246,0,1045,72,858,0,3909
"51059430801",3514,42,180,0,827,0,642,20,5225
"51059430802",2918,40,449,6,583,11,800,0,4807
"51059430901",2386,9,478,137,1192,110,521,0,4833
"51059430902",2177,32,161,0,1256,19,478,0,4123
"51059431001",3043,124,320,1,1547,29,1147,23,6234
"51059431002",898,44,475,0,673,7,161,7,2265
"51059431300",3039,40,193,12,949,0,254,0,4487
"51059431400",2630,146,549,2,1343,32,315,109,5126
"51059431500",3925,96,407,9,773,76,484,15,5785
"51059431600",4252,368,771,18,1983,165,640,25,8222
"51059431801",3047,95,163,2,931,45,736,57,5076
"51059431802",2265,14,65,65,853,46,454,0,3762
"51059431900",2174,0,95,0,797,17,334,11,3428
"51059432000",2295,49,289,113,683,65,426,12,3932
"51059432100",2621,205,76,0,677,103,553,0,4235
"51059432201",1375,9,265,0,856,0,561,0,3066
"51059432202",2914,146,287,38,940,381,427,367,5500
"51059432300",3679,12,82,0,1412,47,807,0,6039
"51059432401",2771,69,146,0,722,12,309,25,4054
"51059432402",4035,67,235,58,736,51,595,0,5777
"51059432500",4153,192,298,61,794,0,306,0,5804
"51059432600",3390,53,365,0,858,0,570,0,5236
"51059432701",2249,29,608,18,405,0,399,0,3708
"51059432702",2275,132,849,60,1031,100,917,0,5364
"51059432800",1314,47,292,55,463,118,291,8,2588
"51059440100",5381,274,71,2,1658,114,647,0,8147
"51059440201",1185,103,292,0,978,54,569,86,3267
"51059440202",3293,199,635,75,1625,130,647,8,6612
"51059440300",2126,64,102,2,475,7,61,5,2842
"51059440501",3703,74,43,0,1199,171,569,24,5783
"51059440502",1380,88,500,0,489,25,131,7,2620
"51059440600",2119,105,105,17,787,15,719,83,3950
"51059440701",2316,19,90,0,690,0,390,0,3505
"51059440702",4213,145,76,1,1217,49,406,24,6131
"51059440800",4889,109,262,0,1171,170,819,25,7445
"51059450100",2888,142,164,35,1838,164,1173,129,6533
"51059450200",2127,248,67,293,1622,121,1594,324,6396
"51059450300",2672,150,191,5,1582,165,1447,106,6318
"51059450400",2073,41,30,0,709,0,639,16,3508
"51059450500",1974,29,136,0,1112,32,1379,7,4669
"51059450601",2596,33,27,1,1625,61,814,1,5158
"51059450602",1691,316,295,1,1904,223,1467,275,6172
"51059450701",1598,66,228,0,944,153,308,59,3356
"51059450702",1666,905,322,0,1226,425,1443,1025,7012
"51059450800",2097,97,201,0,1240,46,645,68,4394
"51059450900",1339,0,20,0,339,4,349,0,2051
"51059451000",1711,189,24,9,377,83,328,66,2787
"51059451100",1672,47,4,0,428,143,471,88,2853
"51059451200",1487,34,41,8,270,21,146,9,2016
"51059451300",1854,32,53,0,510,6,519,5,2979
"51059451400",1331,498,183,9,1154,363,1536,584,5658
"51059451501",2332,275,450,177,1612,417,1242,215,6720
"51059451502",2434,559,975,42,1421,37,1465,536,7469
"51059451601",1765,799,115,0,2597,1017,3414,1591,11298
"51059451602",1406,56,409,10,684,134,379,4,3082
"51059451800",2450,47,104,1,943,171,1103,124,4943
"51059451900",3232,86,512,0,1012,269,1258,269,6638
"51059452000",1560,34,230,33,754,177,399,31,3218
"51059452101",2390,94,509,18,2138,107,868,49,6173
"51059452102",1673,225,70,34,1343,204,918,126,4593
"51059452200",3514,301,572,41,2255,373,2326,471,9853
"51059452301",1449,297,280,0,1244,255,559,364,4448
"51059452302",2363,318,467,0,1557,288,2093,356,7442
"51059452400",2944,254,950,74,2678,139,1281,236,8556
"51059452501",2294,85,271,13,1175,84,991,15,4928
"51059452502",1559,502,1332,416,1318,301,1412,446,7286
"51059452600",3388,92,1176,113,2031,309,2135,262,9506
"51059452700",2006,217,1267,269,1331,283,1263,296,6932
"51059452801",2538,714,1284,216,1147,41,770,29,6739
"51059452802",1902,232,391,334,240,19,276,10,3404
"51059460100",3217,20,76,1,1257,43,223,0,4837
"51059460200",3647,44,45,0,528,0,104,29,4397
"51059460300",2534,42,7,0,349,6,120,0,3058
"51059460400",3094,140,102,0,1393,171,363,7,5270
"51059460501",1800,85,28,12,713,39,146,2,2825
"51059460502",3935,236,599,133,2852,3,942,1,8701
"51059460600",3043,51,161,0,786,11,292,1,4345
"51059460701",2456,69,49,93,764,85,641,69,4226
"51059460702",3534,108,156,0,715,1,271,7,4792
"51059460800",2621,68,6,0,583,0,326,0,3604
"51059460900",2000,10,10,0,537,0,116,0,2673
"51059461000",1740,43,202,21,418,45,87,6,2562
"51059461100",5719,180,36,26,1439,333,844,335,8912
"51059461201",3743,58,116,65,543,0,270,8,4803
"51059461202",2529,156,750,0,2158,143,401,0,6137
"51059461500",3915,149,700,0,1659,15,610,0,7048
"51059461601",3799,231,265,0,1926,428,322,0,6971
"51059461602",1861,76,204,0,2548,264,510,210,5673
"51059461700",3386,178,243,0,2849,199,556,30,7441
"51059461801",777,28,118,102,368,84,89,0,1566
"51059461802",3467,71,259,0,1704,15,645,0,6161
"51059461901",2019,75,513,195,1250,148,793,18,5011
"51059461902",719,185,202,87,511,235,563,176,2678
"51059470100",2338,21,63,9,475,7,252,11,3176
"51059470300",2640,4,17,2,543,92,261,0,3559
"51059470400",3940,64,32,5,466,17,311,1,4836
"51059470500",3908,110,108,0,1329,165,248,0,5868
"51059470600",1920,33,12,1,634,59,86,0,2745
"51059470700",4251,13,111,0,1291,50,596,3,6315
"51059470800",2158,51,174,0,683,26,165,0,3257
"51059470900",5458,139,167,9,993,23,458,0,7247
"51059471000",1615,16,10,0,452,9,73,0,2175
"51059471100",4363,194,77,0,2173,65,973,0,7845
"51059471201",1869,53,359,0,1044,61,245,18,3649
"51059471202",3392,213,99,77,1075,122,839,176,5993
"51059471301",2374,147,83,45,1646,265,1157,288,6005
"51059471303",2352,81,156,0,1378,294,647,81,4989
"51059471304",1570,53,56,0,233,0,88,0,2000
"51059471401",2385,30,233,40,1150,107,640,44,4629
"51059471402",1894,110,194,32,1180,9,1166,45,4630
"51059480100",3466,197,109,0,582,0,132,7,4493
"51059480201",3295,94,144,18,949,0,72,15,4587
"51059480202",2285,51,69,22,1317,149,145,0,4038
"51059480203",1107,86,50,27,911,100,151,0,2432
"51059480300",5503,50,44,0,1361,58,224,26,7266
"51059480401",2953,38,94,0,1165,19,187,29,4485
"51059480402",4310,79,91,7,1837,0,460,0,6784
"51059480501",2603,15,120,0,633,79,357,0,3807
"51059480502",4675,55,168,0,690,263,623,14,6488
"51059480503",2663,64,85,0,609,15,167,0,3603
"51059480504",1751,58,25,0,202,6,77,9,2128
"51059480505",2650,53,56,0,498,32,274,8,3571
"51059480801",3049,128,643,0,1592,278,1826,257,7773
"51059480802",1981,19,274,0,1270,0,605,0,4149
"51059480901",3451,170,692,245,2477,317,2823,360,10535
"51059480902",2118,224,219,44,871,58,1095,172,4801
"51059480903",2161,75,382,66,1231,278,1593,38,5824
"51059481000",2470,359,822,84,2489,83,2031,173,8511
"51059481101",688,28,195,0,1574,0,268,0,2753
"51059481102",1252,16,448,0,1828,54,138,9,3745
"51059481103",1342,9,469,49,1433,76,369,32,3779
"51059481104",886,46,276,0,1688,0,132,23,3051
"51059481105",2864,29,378,10,2068,6,548,0,5903
"51059481106",4125,63,178,0,1034,203,355,0,5958
"51059481201",919,12,58,0,212,32,76,0,1309
"51059481202",3216,554,1056,0,1560,61,1839,404,8690
"51059481400",4804,111,374,124,944,179,466,0,7002
"51059481500",1827,63,147,0,249,0,79,4,2369
"51059481600",3104,56,0,0,295,0,190,0,3645
"51059481701",5038,71,88,0,960,28,98,0,6283
"51059481702",3442,34,122,0,1099,127,643,22,5489
"51059481900",3688,401,626,104,1041,40,208,181,6289
"51059482001",3808,120,239,0,766,65,157,22,5177
"51059482002",2937,69,96,11,467,0,306,9,3895
"51059482100",2253,155,362,165,563,41,667,39,4245
"51059482201",1141,515,257,137,471,84,400,414,3419
"51059482202",2179,105,160,9,537,148,267,10,3415
"51059482203",2923,111,133,58,573,9,211,4,4022
"51059482301",4047,85,221,0,496,0,430,0,5279
"51059482302",2112,277,670,293,865,147,951,499,5814
"51059482303",2976,29,17,0,478,0,180,0,3680
"51059482400",1938,28,40,0,324,39,161,8,2538
"51059482501",2943,198,1930,53,3637,20,1437,64,10282
"51059482502",2134,56,59,0,990,0,192,19,3450
"51059482503",2896,121,336,32,1658,99,279,0,5421
"51059482504",3770,93,190,0,1478,0,513,0,6044
"51059482601",4595,140,211,0,2346,128,917,0,8337
"51059482602",3606,42,554,0,2892,20,228,0,7342
"51059490101",3598,73,267,32,1211,118,302,16,5617
"51059490103",4168,204,341,0,1162,0,1209,36,7120
"51059490501",1560,83,91,0,926,280,220,149,3309
"51059490502",3970,84,416,27,1734,0,215,0,6446
"51059491000",1512,19,52,0,426,0,73,0,2082
"51059491101",2916,36,83,0,757,0,177,0,3969
"51059491102",2362,64,208,0,729,0,226,64,3653
"51059491103",3166,297,370,67,2619,272,896,277,7964
"51059491201",3204,246,496,34,1886,16,776,0,6658
"51059491202",549,15,140,52,709,139,192,0,1796
"51059491301",3462,15,799,0,2289,210,1525,0,8300
"51059491302",1839,31,255,0,1553,192,629,57,4556
"51059491303",1589,43,500,143,1964,234,804,103,5380
"51059491401",2386,38,308,12,2204,148,728,8,5832
"51059491402",2492,135,270,0,1853,32,875,79,5736
"51059491403",2997,78,39,0,858,43,453,0,4468
"51059491404",2126,68,322,27,1233,48,90,0,3914
"51059491405",2256,74,65,2,482,0,94,59,3032
"51059491501",2222,102,300,48,4570,185,407,0,7834
"51059491502",4186,145,282,0,1881,1,295,142,6932
"51059491601",1958,366,410,181,1496,211,645,89,5356
"51059491602",2769,226,415,0,1929,609,1042,386,7376
"51059491701",2487,69,164,47,853,100,411,0,4131
"51059491702",3707,615,664,637,2421,46,825,371,9286
"51059491703",2156,106,772,0,1236,586,531,0,5387
"51059491704",2729,281,467,0,1622,187,487,0,5773
"51059491705",1299,17,212,20,1730,63,172,7,3520
"51059491801",909,39,544,0,828,32,149,0,2501
"51059491802",2231,47,199,0,447,0,579,9,3512
"51059491803",4130,166,335,148,1715,0,769,0,7263
"51059492000",4941,48,365,0,625,11,63,14,6067
"51059492100",5460,60,171,0,723,103,147,0,6664
"51059492201",2239,32,103,0,508,0,150,0,3032
"51059492202",5142,53,306,86,1261,0,349,0,7197
"51059492203",3278,36,194,0,620,23,106,0,4257
"51059492300",2098,48,228,0,853,15,518,0,3760
"51059492400",2759,86,533,0,1155,106,923,111,5673
"51059492500",3621,63,77,0,436,27,64,0,4288
"51059980100",0,0,0,0,0,0,0,0,0
"51059980200",0,0,0,0,0,0,0,0,0
"51059980300",0,0,0,0,0,0,0,0,0
"51061930100",4104,608,298,20,273,0,177,373,5853
"51061930203",2116,115,190,0,212,0,31,0,2664
"51061930204",2866,63,332,0,69,28,44,58,3460
"51061930205",1493,32,189,60,31,0,43,0,1848
"51061930206",1913,37,73,13,161,15,26,0,2238
"51061930207",1165,200,124,15,115,0,108,0,1727
"51061930302",5680,550,594,54,472,35,326,132,7843
"51061930303",3032,72,151,10,127,0,76,0,3468
"51061930304",2337,83,100,0,69,20,82,0,2691
"51061930401",4865,143,226,13,270,14,235,0,5766
"51061930402",5208,199,193,61,183,36,148,0,6028
"51061930403",5575,103,577,33,296,4,561,0,7149
"51061930703",2252,152,107,0,316,0,252,4,3083
"51061930704",3392,62,336,38,236,0,99,0,4163
"51061930705",3052,141,285,49,79,68,398,68,4140
"51061930706",4528,382,563,49,330,30,1008,99,6989
"51061930707",1923,132,148,3,53,20,298,49,2626
"51063920101",6036,323,46,5,61,0,29,19,6519
"51063920102",3091,292,94,180,73,6,28,10,3774
"51063920200",4391,693,0,52,92,0,282,32,5542
"51065020101",3904,165,421,317,321,96,352,96,5672
"51065020102",8288,40,405,0,430,85,211,25,9484
"51065020200",3422,286,1210,280,140,53,83,2,5476
"51065020300",3760,252,640,0,134,44,36,0,4866
"51067020101",4656,180,77,15,195,0,21,0,5144
"51067020102",2463,164,30,31,0,0,0,0,2688
"51067020200",3335,1605,179,167,203,67,57,562,6175
"51067020300",5840,398,126,83,16,30,57,0,6550
"51067020400",4452,744,121,16,33,0,0,0,5366
"51067020500",6700,540,243,27,195,0,31,0,7736
"51067020600",2507,322,0,0,32,0,0,0,2861
"51067020700",3884,812,248,0,60,28,49,126,5207
"51067020800",3511,515,1555,375,56,292,23,157,6484
"51067020900",4817,1610,957,102,64,0,152,175,7877
"51069050100",3657,321,211,6,97,0,208,0,4500
"51069050200",3730,178,30,0,42,0,69,0,4049
"51069050300",5377,333,342,17,167,73,58,90,6457
"51069050400",5843,450,0,0,144,9,129,0,6575
"51069050500",4774,182,81,2,189,4,305,0,5537
"51069050600",3939,152,219,4,171,20,352,0,4857
"51069050700",2539,183,118,27,115,0,157,39,3178
"51069050801",3274,341,170,27,241,0,418,180,4651
"51069050802",6298,366,245,0,261,0,606,0,7776
"51069050803",5711,461,695,0,291,0,192,46,7396
"51069050900",3289,327,424,0,163,90,355,165,4813
"51069051000",8592,540,276,11,647,38,631,78,10813
"51069051101",6847,306,239,14,394,21,706,21,8548
"51069051102",4664,675,142,57,309,12,840,170,6869
"51071930100",1741,218,0,0,119,46,50,0,2174
"51071930200",2880,414,118,74,31,9,31,65,3622
"51071930300",4650,587,0,1,53,15,58,0,5364
"51071930400",5105,463,62,0,53,64,0,0,5747
"51073100100",6585,295,515,44,389,0,110,0,7938
"51073100201",4856,121,282,0,253,0,130,0,5642
"51073100202",3098,79,388,10,77,31,44,31,3758
"51073100203",2998,63,346,163,187,3,35,0,3795
"51073100301",4142,249,283,58,227,0,99,0,5058
"51073100302",4257,821,485,79,87,16,232,52,6029
"51073100400",941,259,160,29,39,0,44,0,1472
"51073100500",3139,361,147,0,110,54,240,93,4144
"51075400100",5883,278,465,44,223,19,69,19,7000
"51075400200",3114,102,518,25,165,0,144,4,4072
"51075400300",128,3,49,0,16,0,0,0,196
"51075400400",3840,81,1122,248,0,0,21,0,5312
"51075400500",2998,138,505,212,235,13,230,0,4331
"51077060101",2141,562,9,30,73,0,21,22,2858
"51077060102",3325,773,0,69,19,149,103,72,4510
"51077060201",1957,898,72,52,15,11,57,139,3201
"51077060202",2506,264,60,37,56,0,14,4,2941
"51077060300",1668,383,0,8,14,8,11,8,2100
"51079030101",3039,123,167,206,119,7,19,7,3687
"51079030102",4693,593,124,76,81,1,63,105,5736
"51079030200",7505,630,626,34,550,183,537,180,10245
"51081880101",1503,193,1476,391,24,0,26,0,3613
"51081880102",0,0,0,0,0,0,0,0,0
"51081880200",1362,252,1667,651,31,3,0,152,4118
"51083930100",1046,306,965,99,0,1,17,3,2437
"51083930201",2615,675,1123,444,87,18,42,0,5004
"51083930202",800,137,1360,230,10,0,10,0,2547
"51083930301",1425,397,655,113,16,0,48,22,2676
"51083930302",2387,473,1246,285,162,75,31,5,4664
"51083930400",2467,450,461,145,200,10,143,40,3916
"51083930500",2638,225,884,115,80,0,69,0,4011
"51083930600",2382,181,1549,1151,210,0,223,0,5696
"51083930800",2275,187,1003,958,26,0,5,0,4454
"51085320100",4917,502,482,12,150,50,41,50,6204
"51085320200",5131,46,913,54,34,0,74,0,6252
"51085320300",3185,190,520,4,157,15,26,0,4097
"51085320400",3481,499,368,0,231,29,53,0,4661
"51085320500",2633,160,101,25,115,0,18,0,3052
"51085320601",1617,243,683,114,117,131,150,32,3087
"51085320602",2017,326,439,100,143,111,115,154,3405
"51085320701",2730,97,80,29,166,0,57,0,3159
"51085320702",2186,59,244,14,110,0,29,0,2642
"51085320801",2035,52,260,69,10,0,4,0,2430
"51085320803",4956,181,207,2,129,2,119,9,5605
"51085320804",4618,42,304,0,316,0,105,0,5385
"51085320805",2634,103,47,51,106,0,51,0,2992
"51085320900",6825,202,473,72,227,30,181,0,8010
"51085321001",2606,194,383,0,24,37,28,47,3319
"51085321002",6093,107,956,0,597,0,449,34,8236
"51085321100",4995,332,103,59,119,16,210,22,5856
"51085321201",4062,215,152,50,93,0,87,0,4659
"51085321202",2531,207,379,405,198,36,32,0,3788
"51085321300",4992,247,492,20,473,12,182,11,6429
"51085321401",1982,120,52,0,21,0,22,0,2197
"51085321402",2737,197,261,42,68,58,32,28,3423
"51085321403",2741,6,90,0,23,0,34,0,2894
"51087200104",3669,278,912,220,483,45,303,70,5980
"51087200105",3733,1289,361,116,1327,390,685,740,8641
"51087200106",3038,540,748,81,397,91,270,167,5332
"51087200107",5952,446,748,153,891,0,548,82,8820
"51087200108",2544,59,10,1,113,7,6,1,2741
"51087200109",3771,25,26,0,57,0,12,11,3902
"51087200112",3477,287,587,78,243,41,58,10,4781
"51087200116",4440,78,428,22,328,30,484,0,5810
"51087200119",5337,346,915,59,2492,0,331,11,9491
"51087200120",5964,75,274,11,1068,8,50,0,7450
"51087200121",6004,36,242,17,932,18,149,0,7398
"51087200122",3470,6,235,86,788,2,86,0,4673
"51087200123",1765,154,859,228,306,79,147,55,3593
"51087200124",3640,61,256,1,345,21,128,0,4452
"51087200125",1437,214,735,179,1415,55,179,18,4232
"51087200126",1606,40,537,9,1229,9,245,0,3675
"51087200127",4270,359,173,240,795,79,26,79,6021
"51087200128",3025,112,645,7,1260,58,77,7,5191
"51087200129",8673,108,1013,0,3782,37,327,0,13940
"51087200130",5946,59,65,0,924,0,376,0,7370
"51087200201",2269,68,118,0,212,14,69,6,2756
"51087200202",3658,254,0,0,64,10,28,17,4031
"51087200301",1006,52,28,0,56,7,53,0,1202
"51087200302",2579,77,220,0,240,4,222,11,3353
"51087200303",2100,374,395,41,324,135,191,52,3612
"51087200305",2497,191,349,68,885,131,157,26,4304
"51087200404",1699,443,651,16,318,263,282,347,4019
"51087200406",6437,72,1069,173,1288,0,326,21,9386
"51087200407",3413,360,638,61,880,89,265,76,5782
"51087200409",754,85,649,107,278,107,288,137,2405
"51087200410",2028,899,1360,190,325,294,847,433,6376
"51087200411",2601,246,1531,110,513,124,249,113,5487
"51087200412",670,194,753,78,97,120,93,163,2168
"51087200413",3829,47,341,35,872,17,65,0,5206
"51087200414",4098,111,573,0,1137,70,490,0,6479
"51087200501",1121,117,321,115,552,21,425,6,2678
"51087200502",1472,112,168,6,238,58,152,20,2226
"51087200503",2887,309,496,26,415,78,276,143,4630
"51087200600",3364,607,684,92,282,0,692,92,5813
"51087200700",2219,425,388,740,25,23,38,255,4113
"51087200801",1929,71,943,159,159,13,394,0,3668
"51087200802",1078,219,598,7,117,0,33,32,2084
"51087200804",357,154,3253,1209,490,67,286,20,5836
"51087200805",190,20,2437,1854,0,22,0,0,4523
"51087200903",4248,275,1552,140,761,0,360,0,7336
"51087200904",2407,134,3553,108,353,221,182,0,6958
"51087200905",1607,197,2200,506,387,29,202,48,5176
"51087200906",3275,153,700,185,362,0,65,0,4740
"51087201001",752,181,4740,580,501,52,331,0,7137
"51087201002",504,66,1629,279,355,49,61,32,2975
"51087201003",260,0,4024,536,114,0,11,0,4945
"51087201101",660,175,3546,1192,183,161,59,123,6099
"51087201102",1110,154,2391,428,192,61,29,89,4454
"51087201201",2121,470,3115,990,290,50,209,17,7262
"51087201202",852,433,3776,899,121,0,19,209,6309
"51087201401",1086,182,2554,682,181,0,129,57,4871
"51087201403",2181,365,2868,639,65,0,90,0,6208
"51087201404",3125,278,475,176,52,17,45,0,4168
"51087201501",1646,274,6766,1835,350,184,224,224,11503
"51087201502",2414,306,2179,153,270,0,107,0,5429
"51087201601",1956,87,690,47,65,11,0,0,2856
"51087201602",2543,256,1580,108,342,10,115,13,4967
"51087201701",2455,242,827,8,136,39,14,15,3736
"51087980100",0,0,0,0,0,0,0,0,0
"51089010100",2461,444,503,85,167,129,169,189,4147
"51089010200",3295,544,1287,195,95,0,0,0,5416
"51089010300",3225,331,1312,585,46,10,237,121,5867
"51089010400",1547,441,1057,57,370,0,428,151,4051
"51089010500",2193,598,680,118,203,96,194,94,4176
"51089010601",2060,256,237,60,90,0,0,0,2703
"51089010602",2708,451,467,122,177,71,133,94,4223
"51089010700",2207,275,548,291,24,31,24,0,3400
"51089010800",778,269,753,181,17,73,83,51,2205
"51089010900",1387,453,348,74,74,7,76,0,2419
"51089011000",2721,1002,1036,340,79,195,0,172,5545
"51089011100",2106,282,231,54,0,0,12,136,2821
"51089011200",2311,691,121,74,143,126,131,115,3712
"51089011300",2879,297,475,212,18,0,77,0,3958
"51091970100",1943,282,0,0,11,0,0,0,2236
"51093280101",2179,306,1061,147,28,142,5,32,3900
"51093280103",5095,234,1000,41,738,0,401,103,7612
"51093280104",3560,62,561,24,154,11,130,32,4534
"51093280105",1821,264,1467,464,98,9,42,0,4165
"51093280106",1730,340,469,236,24,1,71,1,2872
"51093280200",2508,327,991,134,58,48,63,0,4129
"51093280300",3389,444,729,162,333,207,0,0,5264
"51093280400",2977,253,270,266,64,15,19,0,3864
"51095080101",4556,110,480,0,572,0,116,0,5834
"51095080102",1486,467,908,405,340,68,420,95,4189
"51095080202",4153,181,576,219,304,0,176,0,5609
"51095080203",2620,332,233,53,248,8,67,0,3561
"51095080205",1760,469,754,137,344,31,135,215,3845
"51095080206",8623,390,828,11,506,94,162,271,10885
"51095080301",6188,472,1584,239,363,69,430,173,9518
"51095080303",6690,322,163,151,557,27,205,71,8186
"51095080304",5246,301,127,0,184,0,94,0,5952
"51095080401",5640,815,965,33,227,13,331,411,8435
"51095080402",5349,82,1259,109,330,40,240,40,7449
"51097950400",2245,267,983,307,298,7,186,0,4293
"51097950500",2120,258,495,101,16,9,40,9,3048
"51099040100",3508,175,1069,90,683,24,570,0,6119
"51099040200",3150,214,442,115,168,3,0,0,4092
"51099040300",6210,262,1189,128,217,0,308,0,8314
"51099040400",3178,82,845,32,189,0,74,0,4400
"51099040500",2026,224,479,17,44,0,92,0,2882
"51101950101",2580,291,619,361,50,123,96,0,4120
"51101950102",4687,256,1019,132,126,0,0,0,6220
"51101950200",1388,108,629,174,126,19,9,0,2453
"51101950300",2626,321,176,20,97,92,0,21,3353
"51103030100",2062,177,1089,162,89,10,118,0,3707
"51103030200",2243,223,974,383,34,16,13,8,3894
"51103030300",2797,207,432,59,82,9,22,7,3615
"51103990100",0,0,0,0,0,0,0,0,0
"51105950100",2199,952,0,0,0,0,0,13,3164
"51105950200",3254,805,8,0,160,0,10,0,4237
"51105950300",2244,1088,160,0,0,0,2,3,3497
"51105950400",2323,817,0,0,11,0,0,0,3151
"51105950500",4120,996,157,0,98,0,20,0,5391
"51105950600",2973,1356,0,13,0,0,2,0,4344
"51107610101",3717,209,41,0,282,6,205,6,4466
"51107610102",3315,42,84,0,119,0,184,0,3744
"51107610201",4087,287,1,42,295,36,211,0,4959
"51107610202",4301,36,62,2,369,7,347,9,5133
"51107610300",6320,329,221,0,570,16,434,156,8046
"51107610400",3931,41,156,0,537,61,601,61,5388
"51107610503",5046,0,663,83,1815,18,598,0,8223
"51107610504",5695,169,597,0,967,109,1281,85,8903
"51107610505",3776,423,278,0,1439,43,2812,367,9138
"51107610506",3238,111,535,156,1254,870,866,758,7788
"51107610507",5043,166,488,0,973,48,235,57,7010
"51107610601",6484,103,551,51,399,36,623,54,8301
"51107610602",1865,23,83,0,462,0,202,0,2635
"51107610603",2068,233,297,0,204,54,428,21,3305
"51107610604",5568,204,451,0,1236,20,683,83,8245
"51107610701",4855,168,68,0,140,56,400,134,5821
"51107610702",5330,273,272,9,407,17,520,85,6913
"51107610703",3947,55,136,0,374,2,296,7,4817
"51107610800",4504,121,253,14,118,27,224,27,5288
"51107610900",1722,74,307,45,123,0,104,0,2375
"51107611002",2270,179,442,12,1572,611,939,379,6404
"51107611004",5521,240,570,0,1744,0,714,78,8867
"51107611005",4081,101,579,47,843,23,375,0,6049
"51107611006",3467,238,425,0,1404,91,551,61,6237
"51107611009",3462,42,331,31,1206,0,529,0,5601
"51107611010",1237,11,143,0,71,0,9,0,1471
"51107611011",1836,60,657,92,957,93,307,64,4066
"51107611012",2986,33,339,0,1202,69,212,0,4841
"51107611013",2720,49,235,10,1128,43,444,10,4639
"51107611014",4107,159,566,10,875,10,1166,134,7027
"51107611015",1248,28,187,0,845,7,569,7,2891
"51107611016",2364,15,249,8,369,17,329,0,3351
"51107611017",1972,77,233,0,702,38,149,11,3182
"51107611018",1422,18,370,63,654,3,351,0,2881
"51107611019",4213,87,246,105,1498,0,467,0,6616
"51107611020",2967,196,770,129,1685,33,500,111,6391
"51107611021",3258,43,435,30,3556,0,651,17,7990
"51107611022",3586,19,569,0,2309,23,401,0,6907
"51107611023",4625,93,263,0,1130,21,480,54,6666
"51107611024",4962,93,231,33,1205,0,204,0,6728
"51107611025",5160,174,677,33,2717,25,477,57,9320
"51107611101",2853,88,374,0,882,13,517,7,4734
"51107611102",5011,88,338,21,817,0,676,0,6951
"51107611202",3393,199,462,2,623,6,286,0,4971
"51107611204",3465,207,608,0,1587,37,1769,118,7791
"51107611205",2773,361,476,125,2140,231,1023,304,7433
"51107611206",2785,97,180,0,1044,80,617,10,4813
"51107611207",2993,24,303,0,979,99,373,0,4771
"51107611208",2768,32,390,0,1351,69,333,43,4986
"51107611209",5115,112,102,48,1378,31,441,69,7296
"51107611300",2888,124,686,38,2055,143,2027,90,8051
"51107611400",3033,146,399,75,1539,143,1883,168,7386
"51107611501",1458,138,338,0,952,362,662,357,4267
"51107611502",3841,175,413,5,1761,56,1562,100,7913
"51107611601",2397,221,517,44,1085,18,656,170,5108
"51107611602",2035,148,340,22,1283,101,1820,227,5976
"51107611700",2684,431,606,14,2573,117,1708,382,8515
"51107611801",3781,59,627,2,2236,36,498,15,7254
"51107611802",4636,20,695,0,4882,135,819,0,11187
"51107611803",3883,172,385,0,2158,0,366,158,7122
"51107611804",3256,18,327,0,1947,160,218,0,5926
"51107611805",3273,78,298,21,924,98,179,10,4881
"51107611806",4770,56,859,1,3270,0,773,7,9736
"51107611900",3215,130,593,10,5053,0,302,0,9303
"51107980100",0,0,0,0,0,0,0,0,0
"51109950100",5319,185,1339,8,129,0,37,13,7030
"51109950201",3208,513,609,200,333,27,239,41,5170
"51109950202",2523,447,574,40,302,36,114,21,4057
"51109950300",7253,455,769,162,461,0,288,0,9388
"51109950400",1546,276,796,100,39,24,0,52,2833
"51109950500",4117,693,816,219,319,0,43,0,6207
"51111930100",2742,423,758,495,86,101,77,91,4773
"51111930200",2303,358,796,314,136,0,60,19,3986
"51111930300",1300,132,696,369,42,87,28,167,2821
"51113930100",5853,463,362,270,502,163,172,39,7824
"51113930200",4222,594,304,115,111,8,51,7,5412
"51115951300",4235,163,402,135,193,13,120,0,5261
"51115951400",2913,291,356,11,90,0,0,0,3661
"51115990100",0,0,0,0,0,0,0,0,0
"51117930101",1868,289,447,245,75,136,76,173,3309
"51117930102",2093,377,374,22,26,0,41,0,2933
"51117930200",3081,258,1637,758,172,117,91,13,6127
"51117930300",1127,142,782,148,198,35,174,0,2606
"51117930400",2208,404,1906,899,128,62,0,0,5607
"51117930500",1224,205,328,114,7,0,3,0,1881
"51117930600",1195,210,491,208,20,42,17,0,2183
"51117930700",1325,134,784,250,24,141,34,14,2706
"51117930800",2061,302,478,477,125,0,119,3,3565
"51119950900",1256,143,327,40,0,6,45,0,1817
"51119951000",2193,177,667,194,34,33,42,25,3365
"51119951100",2080,96,481,154,0,0,0,0,2811
"51119951200",2211,131,84,5,55,3,82,3,2574
"51119990100",0,0,0,0,0,0,0,0,0
"51121020100",0,0,0,0,0,0,0,0,0
"51121020201",2146,1773,23,162,839,669,97,77,5786
"51121020202",1260,434,14,24,42,22,10,0,1806
"51121020300",3358,1499,134,87,984,577,115,34,6788
"51121020400",1814,3887,17,397,540,840,132,194,7821
"51121020500",3846,1506,135,149,441,285,237,116,6715
"51121020600",3100,1631,34,89,635,257,45,52,5843
"51121020700",3150,1667,464,184,313,223,183,41,6225
"51121020800",5570,805,252,151,32,0,388,0,7198
"51121020900",4072,348,44,20,154,0,3,0,4641
"51121021000",4051,396,93,57,115,0,14,9,4735
"51121021100",6042,400,459,228,446,0,158,83,7816
"51121021200",5688,815,195,20,138,0,197,0,7053
"51121021300",3142,144,43,0,124,0,65,0,3518
"51121021400",3725,1318,130,29,29,0,55,46,5332
"51121021500",7768,562,16,0,58,52,74,12,8542
"51125950100",3420,874,940,117,99,0,200,38,5688
"51125950200",3986,450,327,0,154,0,94,0,5011
"51125950300",3135,455,314,263,137,0,169,0,4473
"51127700100",4572,221,393,27,237,14,0,0,5464
"51127700200",3571,196,560,27,225,0,59,0,4638
"51127700300",6474,674,1067,51,586,117,322,65,9356
"51131930100",2216,412,1243,487,64,25,192,58,4697
"51131930200",1810,359,805,299,113,7,196,198,3787
"51131930300",2155,339,728,802,14,0,257,4,4299
"51131990100",0,0,0,0,0,0,0,0,0
"51133020100",2630,118,518,256,0,0,32,0,3554
"51133020200",1577,138,1297,122,7,0,8,16,3165
"51133020300",3985,204,824,514,96,0,0,0,5623
"51133990100",0,0,0,0,0,0,0,0,0
"51135000100",2378,553,1678,582,213,71,319,117,5911
"51135000200",1708,396,483,179,5,74,0,72,2917
"51135000300",2763,635,1529,841,53,108,33,51,6013
"51135980100",4,5,10,0,0,0,0,0,19
"51137110102",6755,543,1015,342,196,72,365,0,9288
"51137110103",8251,746,943,9,665,30,388,39,11071
"51137110104",2313,156,412,15,209,0,75,5,3185
"51137110200",2899,988,512,280,142,39,458,32,5350
"51137110300",4806,650,467,225,201,10,10,0,6369
"51139030100",2422,405,0,0,28,0,13,13,2881
"51139030200",3126,478,126,96,140,47,58,13,4084
"51139030300",3838,913,28,0,30,5,52,61,4927
"51139030400",4999,1312,15,28,5,68,28,2,6457
"51139030500",4642,498,55,0,282,30,147,36,5690
"51141030100",3757,845,128,155,76,105,75,28,5169
"51141030200",4568,1462,289,36,0,33,0,310,6698
"51141030301",1887,313,365,54,22,0,16,39,2696
"51141030302",3015,815,80,0,17,0,0,23,3950
"51143010100",2561,454,1025,89,33,0,0,0,4162
"51143010200",3120,412,858,215,79,4,34,27,4749
"51143010300",2716,635,535,222,93,0,98,0,4299
"51143010400",2546,533,700,87,94,38,29,27,4054
"51143010500",2610,287,833,211,155,12,104,0,4212
"51143010600",1569,330,700,191,45,13,2,12,2862
"51143010700",968,54,551,200,111,51,266,54,2255
"51143010801",1175,196,951,202,4,8,0,2,2538
"51143010802",3761,1348,558,131,362,72,222,6,6460
"51143010900",2007,288,209,0,74,16,3,16,2613
"51143011001",3008,383,805,46,25,70,79,43,4459
"51143011002",3731,405,509,80,9,11,0,0,4745
"51143011100",1590,331,727,166,24,190,29,190,3247
"51143011200",1517,165,267,143,145,35,0,14,2286
"51143011300",4359,674,626,177,90,137,25,0,6088
"51143011400",2482,344,748,266,260,22,180,0,4302
"51145500101",5451,261,178,10,170,0,35,0,6105
"51145500102",4675,290,202,0,192,0,41,0,5400
"51145500200",7783,401,603,108,142,82,211,13,9343
"51145500300",329,4,47,6,12,0,51,2,451
"51145500400",4007,58,489,32,48,0,60,0,4694
"51147930100",2662,823,1859,1224,204,99,11,19,6901
"51147930201",1700,281,327,95,0,26,18,0,2447
"51147930202",1902,201,1075,251,15,13,9,0,3466
"51147930203",0,0,29,0,0,0,0,0,29
"51147930300",3271,264,1534,595,26,11,131,15,5847
"51149850100",308,30,39,41,46,11,37,11,523
"51149850200",1814,73,1597,246,551,89,666,117,5153
"51149850301",2994,138,2463,427,613,222,540,166,7563
"51149850302",3332,255,962,167,200,0,206,41,5163
"51149850400",4117,344,554,109,405,0,121,0,5650
"51149850501",4036,185,969,442,293,61,53,261,6300
"51149850502",2985,208,1760,315,157,7,74,0,5506
"51153900100",1960,168,431,0,761,22,382,0,3724
"51153900201",1423,39,261,157,258,10,920,6,3074
"51153900202",2367,565,406,236,789,50,1740,436,6589
"51153900203",1805,482,1823,276,564,101,1445,291,6787
"51153900300",3813,265,2103,176,2011,19,1546,111,10044
"51153900403",1918,68,1288,344,1358,28,1190,159,6353
"51153900404",3173,189,1141,225,940,45,2073,78,7864
"51153900407",2435,126,2397,395,1180,42,1456,51,8082
"51153900408",1657,149,1381,33,1236,161,808,113,5538
"51153900409",2265,179,1186,31,748,484,1347,578,6818
"51153900410",1495,537,1684,269,1198,0,768,529,6480
"51153900501",4541,403,800,40,1951,129,4174,371,12409
"51153900502",1242,9,922,7,831,0,470,0,3481
"51153900600",4055,930,1128,169,883,359,2910,1191,11625
"51153900701",1976,59,2494,205,1467,17,1290,18,7526
"51153900702",4236,80,2567,186,805,189,1578,169,9810
"51153900801",2381,25,2073,11,1429,0,732,0,6651
"51153900802",2095,296,3072,310,1381,142,1249,192,8737
"51153900901",1814,391,1939,615,512,244,973,484,6972
"51153900904",2064,144,2099,115,1034,39,979,75,6549
"51153900905",2458,212,1734,84,876,16,615,0,5995
"51153901001",3707,186,2126,178,651,93,1405,0,8346
"51153901005",3093,0,1161,11,944,7,648,0,5864
"51153901008",2390,152,3519,202,1816,223,1954,88,10344
"51153901009",5047,200,1038,16,666,0,419,0,7386
"51153901010",2852,0,938,0,464,0,316,0,4570
"51153901011",2988,8,1442,58,945,33,803,26,6303
"51153901012",2035,20,561,1,407,19,244,0,3287
"51153901100",3251,123,228,50,1218,118,972,15,5975
"51153901203",2447,47,987,179,710,325,1294,221,6210
"51153901208",2432,106,342,48,218,51,409,44,3650
"51153901209",3767,98,1319,34,917,215,1184,49,7583
"51153901211",2057,320,708,333,965,23,1401,221,6028
"51153901212",1797,117,2448,90,3970,91,3101,91,11705
"51153901219",4301,92,437,57,414,10,282,0,5593
"51153901221",2936,330,1248,96,688,0,659,245,6202
"51153901222",1925,23,379,19,361,14,459,0,3180
"51153901223",4318,61,744,199,855,130,1319,78,7704
"51153901224",3063,66,362,123,450,10,696,10,4780
"51153901225",2675,92,1245,11,539,0,892,40,5494
"51153901226",2617,0,1389,96,1620,139,1200,0,7061
"51153901227",3228,14,1248,139,801,59,1989,0,7478
"51153901228",3579,197,1887,25,632,22,866,75,7283
"51153901229",1897,89,801,206,1272,63,1182,76,5586
"51153901230",2614,26,1053,47,675,79,717,12,5223
"51153901231",4693,87,345,19,769,75,703,0,6691
"51153901232",2681,30,263,2,535,0,359,0,3870
"51153901233",5580,111,333,0,845,16,824,0,7709
"51153901234",2108,105,89,49,180,202,165,0,2898
"51153901235",1964,10,575,0,870,0,476,0,3895
"51153901236",3121,46,1029,22,769,78,512,0,5577
"51153901237",1671,48,1078,383,333,98,359,114,4084
"51153901303",3528,233,572,16,523,35,609,214,5730
"51153901304",1997,146,37,4,111,77,143,51,2566
"51153901305",2540,125,34,0,334,8,526,49,3616
"51153901306",4873,84,605,0,248,0,326,0,6136
"51153901403",3391,392,926,150,913,139,1613,271,7795
"51153901407",2460,408,708,0,255,11,1405,369,5616
"51153901408",3070,804,1232,160,1624,256,2360,488,9994
"51153901409",4626,146,839,33,893,0,1457,10,8004
"51153901410",5615,52,1192,25,1375,0,1047,21,9327
"51153901411",4290,128,334,0,992,84,286,0,6114
"51153901412",5153,81,889,8,1524,26,762,0,8443
"51153901413",3351,95,317,32,539,73,521,0,4928
"51153901414",3547,133,488,252,756,0,353,117,5646
"51153901415",3079,0,391,0,609,83,436,70,4668
"51153901416",3699,32,729,0,745,0,418,25,5648
"51153901417",2106,35,22,0,81,6,130,6,2386
"51153901503",4924,93,66,0,530,40,285,0,5938
"51153901504",2801,42,122,196,361,0,23,0,3545
"51153901505",5088,122,991,0,1144,103,264,114,7826
"51153901506",3275,98,728,9,1160,36,933,63,6302
"51153901507",1953,60,300,0,404,22,177,16,2932
"51153901508",3165,52,405,53,927,109,533,64,5308
"51153901509",4533,155,285,27,326,36,388,0,5750
"51153901510",3656,43,562,0,987,38,345,0,5631
"51153901511",2341,20,243,0,273,0,123,0,3000
"51153901601",2679,159,276,0,625,98,1222,29,5088
"51153901602",5553,253,1205,164,1052,211,2565,84,11087
"51153901701",3964,629,524,319,1888,351,3103,526,11304
"51153901702",2525,739,82,20,808,46,1959,760,6939
"51153901900",3706,619,624,92,1216,326,2160,420,9163
"51153980100",0,0,0,0,0,0,0,0,0
"51155210100",5581,790,471,21,83,25,43,0,7014
"51155210201",2796,652,68,61,77,57,42,16,3769
"51155210202",3271,175,80,0,103,10,36,0,3675
"51155210300",3579,489,190,17,43,8,46,0,4372
"51155210400",3530,808,293,243,51,0,63,0,4988
"51155210500",2428,329,102,0,33,0,78,0,2970
"51155210600",2972,226,222,24,29,45,78,0,3596
"51155210700",2757,443,68,39,102,44,78,0,3531
"51155980100",0,0,0,0,0,0,0,0,0
"51155980200",0,0,0,0,0,0,0,0,0
"51157950100",2290,325,161,6,38,0,103,45,2968
"51157950200",3848,390,129,12,214,0,103,0,4696
"51159040100",2958,255,868,212,46,0,134,36,4509
"51159040200",1736,254,473,27,263,0,200,16,2969
"51161030100",2998,427,0,45,29,0,23,0,3522
"51161030201",3611,166,500,112,267,0,252,12,4920
"51161030203",3140,385,176,0,48,0,46,155,3950
"51161030204",4925,409,285,67,204,165,185,14,6254
"51161030205",3127,87,336,13,237,8,130,8,3946
"51161030300",5264,318,290,14,329,0,226,0,6441
"51161030500",3024,327,120,0,83,0,11,0,3565
"51161030600",6633,746,85,23,269,196,184,126,8262
"51161030701",5722,301,51,10,545,3,18,3,6653
"51161030702",4536,476,513,299,306,72,53,27,6282
"51161030801",4149,395,466,13,562,114,189,1,5889
"51161030802",4345,89,21,8,237,15,193,0,4908
"51161030900",4420,334,370,47,444,4,105,15,5739
"51161031000",3307,275,204,0,8,26,12,0,3832
"51161031101",3356,445,210,136,181,25,0,129,4482
"51161031102",2921,242,134,150,8,129,0,60,3644
"51161031201",4548,241,84,79,87,8,8,0,5055
"51161031202",5781,163,90,0,206,0,191,0,6431
"51163930100",6253,1170,36,121,185,56,51,4,7876
"51163930200",3244,526,12,13,109,0,100,0,4004
"51163930300",5313,593,73,0,239,13,30,0,6261
"51163930400",3375,431,235,53,46,109,48,98,4395
"51165010100",2476,333,26,10,9,1,9,0,2864
"51165010200",2876,469,131,3,31,10,25,52,3597
"51165010300",3786,413,117,85,179,0,180,36,4796
"51165010400",2148,151,0,0,4,5,31,5,2344
"51165010500",1767,612,32,0,172,419,311,669,3982
"51165010600",3535,207,33,0,93,86,25,82,4061
"51165010700",3344,210,2,0,0,0,0,0,3556
"51165010800",4648,1049,239,10,127,0,177,178,6428
"51165010900",2056,452,16,56,98,0,109,0,2787
"51165011000",2588,356,0,0,15,0,22,0,2981
"51165011100",3048,215,20,0,59,0,19,0,3361
"51165011200",4692,248,0,1,38,0,216,0,5195
"51165011400",4520,538,16,10,329,0,517,224,6154
"51165011500",4201,207,88,39,167,0,227,22,4951
"51165011600",1814,215,9,1,45,0,30,0,2114
"51165011700",2633,466,91,48,99,21,441,201,4000
"51165011800",7236,255,33,0,477,13,394,4,8412
"51165011900",3075,413,48,0,106,2,89,0,3733
"51165012000",3824,713,27,28,275,101,121,83,5172
"51167030100",3288,1305,28,0,163,27,63,18,4892
"51167030200",4053,1083,29,10,0,2,58,0,5235
"51167030300",2687,817,22,0,73,0,0,0,3599
"51167030401",4852,1014,0,22,73,16,56,20,6053
"51167030402",2259,356,1,3,0,0,0,0,2619
"51167030500",1769,451,2,5,0,1,0,0,2228
"51167030600",2694,641,74,0,109,24,95,0,3637
"51169030100",2829,707,0,58,47,0,15,0,3656
"51169030200",2748,657,60,6,36,16,0,0,3523
"51169030300",2840,828,0,0,52,4,0,27,3751
"51169030400",2761,791,0,0,0,0,0,65,3617
"51169030500",3137,576,0,0,5,0,25,0,3743
"51169030600",2853,742,0,21,68,0,113,0,3797
"51171040100",7010,695,285,2,567,52,452,0,9063
"51171040201",2141,212,42,0,24,0,0,0,2419
"51171040202",2750,239,0,0,9,0,43,0,3041
"51171040300",3761,254,13,21,135,4,118,2,4308
"51171040400",2097,86,0,0,210,0,48,0,2441
"51171040500",6323,1528,221,179,86,100,481,182,9100
"51171040600",3346,320,28,0,88,29,92,106,4009
"51171040700",3424,643,112,17,363,64,694,134,5451
"51171040800",3877,655,9,24,158,14,419,113,5269
"51173030100",2815,400,0,0,0,0,0,0,3215
"51173030200",3244,962,15,0,46,114,25,26,4432
"51173030301",2039,510,105,0,0,0,48,0,2702
"51173030302",3260,504,74,94,31,0,15,73,4051
"51173030400",1830,364,0,0,60,0,20,68,2342
"51173030500",1651,407,28,6,28,7,16,3,2146
"51173030600",2131,695,101,31,49,112,72,0,3191
"51173030701",3687,795,29,42,72,18,83,63,4789
"51173030702",3982,754,0,0,27,0,0,63,4826
"51175200100",2858,294,738,241,59,0,18,2,4210
"51175200200",1252,196,993,190,66,0,13,54,2764
"51175200300",0,0,7,1,0,0,0,0,8
"51175200400",3573,253,1223,875,150,112,22,53,6261
"51175200500",1897,197,1264,273,123,17,19,0,3790
"51177020104",3753,332,494,90,275,21,238,20,5223
"51177020105",1979,89,82,0,76,0,21,0,2247
"51177020106",4391,52,386,47,259,0,155,0,5290
"51177020107",1566,80,116,0,126,0,46,0,1934
"51177020108",2185,278,711,469,336,19,438,28,4464
"51177020109",2477,167,235,258,195,6,45,0,3383
"51177020110",2676,171,463,45,413,283,425,283,4759
"51177020111",1505,15,508,5,206,0,193,0,2432
"51177020112",1717,177,543,6,316,27,370,17,3173
"51177020113",3435,158,466,49,161,23,295,33,4620
"51177020114",3742,101,1055,204,437,69,277,0,5885
"51177020201",3344,364,756,76,1200,279,706,222,6947
"51177020202",3348,263,607,227,460,62,525,10,5502
"51177020203",3101,156,1208,146,452,29,337,117,5546
"51177020204",3153,98,564,0,299,15,228,0,4357
"51177020205",3120,166,672,155,428,216,393,222,5372
"51177020304",2743,256,560,77,823,19,694,51,5223
"51177020305",2216,137,764,24,257,124,132,124,3778
"51177020306",3184,88,1632,89,1043,0,605,0,6641
"51177020307",2024,106,764,111,815,113,959,7,4899
"51177020308",3252,75,398,0,227,0,174,0,4126
"51177020309",4132,360,1048,107,465,205,332,143,6792
"51177020310",3215,107,611,13,415,8,230,0,4599
"51177020311",3726,271,658,402,474,22,489,128,6170
"51177020403",3098,403,423,27,87,23,200,0,4261
"51177020404",3060,481,289,35,66,9,28,26,3994
"51177020405",2533,453,604,0,44,54,90,0,3778
"51177020406",2940,257,316,13,14,0,84,0,3624
"51177020407",4233,210,499,0,212,36,159,20,5369
"51177020408",2242,149,144,18,156,21,182,43,2955
"51179010103",2650,57,438,163,409,84,419,35,4255
"51179010105",4428,76,1232,125,1146,28,973,27,8035
"51179010106",2503,158,220,9,98,0,106,0,3094
"51179010107",2687,51,408,0,161,11,302,0,3620
"51179010108",3529,52,1462,105,560,81,506,14,6309
"51179010201",20,16,14,0,0,0,0,0,50
"51179010202",5008,222,388,0,542,0,404,22,6586
"51179010204",5561,147,876,123,863,5,369,7,7951
"51179010205",5029,174,1212,11,487,31,357,0,7301
"51179010206",3179,178,1131,0,763,65,752,65,6133
"51179010207",3418,417,2003,300,2006,98,1892,20,10154
"51179010210",3663,168,2167,0,1486,197,1093,197,8971
"51179010211",2195,8,1033,0,787,359,679,305,5366
"51179010212",3027,133,708,23,588,38,719,20,5256
"51179010213",1837,19,405,0,232,18,204,0,2715
"51179010214",2891,113,659,51,274,52,425,40,4505
"51179010301",3292,44,504,8,285,0,196,0,4329
"51179010303",6532,323,1916,77,868,190,595,134,10635
"51179010304",3624,240,954,10,762,14,559,0,6163
"51179010305",3303,347,1403,34,872,243,415,287,6904
"51179010403",2362,96,400,36,226,2,133,5,3260
"51179010404",4524,248,851,14,555,12,604,0,6808
"51179010405",5239,164,524,22,502,117,475,0,7043
"51179010406",1982,254,360,42,331,26,186,10,3191
"51179010502",3609,153,334,0,255,26,238,39,4654
"51179010503",1851,161,5,3,126,0,74,0,2220
"51179010504",1365,74,86,0,54,2,40,0,1621
"51181860100",1462,280,1009,389,59,57,34,73,3363
"51181860200",1745,88,1610,67,57,0,4,0,3571
"51183870100",670,178,809,141,2,2,0,6,1808
"51183870201",942,49,492,21,0,0,0,0,1504
"51183870202",0,0,0,0,0,0,0,0,0
"51183870300",736,88,585,403,54,30,53,59,2008
"51183870400",639,202,327,247,11,1,5,3,1435
"51185020100",2003,259,4,10,18,16,0,0,2310
"51185020200",3902,354,297,81,38,54,34,8,4768
"51185020300",4717,1752,70,41,17,0,11,63,6671
"51185020400",3229,714,0,0,14,0,1,0,3958
"51185020500",2174,679,0,0,80,0,0,0,2933
"51185020600",3800,583,70,0,20,21,0,12,4506
"51185020700",2136,421,49,35,228,67,0,0,2936
"51185020800",1744,265,45,41,39,7,29,17,2187
"51185020900",1622,532,0,0,39,0,0,0,2193
"51185021000",3375,696,0,15,70,0,0,0,4156
"51185021100",4649,830,152,45,249,0,111,0,6036
"51187020100",7327,945,203,0,287,19,143,0,8924
"51187020200",2643,58,98,0,8,0,17,0,2824
"51187020300",5614,458,85,20,395,0,23,0,6595
"51187020400",3000,620,150,172,234,0,201,0,4377
"51187020500",2845,397,476,19,453,15,269,0,4474
"51187020601",4662,297,60,57,240,35,356,28,5735
"51187020602",2039,340,99,0,156,103,180,0,2917
"51187020700",2795,141,0,0,14,0,197,0,3147
"51191010100",6329,640,0,0,157,0,43,0,7169
"51191010200",5333,436,0,0,113,10,0,113,6005
"51191010300",5246,868,0,0,30,0,31,0,6175
"51191010401",1893,79,34,0,96,0,26,0,2128
"51191010402",2738,338,12,43,36,20,110,1,3298
"51191010501",3356,314,227,11,32,32,45,20,4037
"51191010502",2105,883,194,4,93,78,70,36,3463
"51191010601",3466,507,90,0,60,11,97,11,4242
"51191010602",1645,354,28,0,31,72,0,17,2147
"51191010700",3733,755,34,16,10,44,43,71,4706
"51191010800",2376,444,0,0,68,0,0,0,2888
"51191010900",3537,615,10,3,7,0,0,0,4172
"51191011000",3252,266,2,2,54,0,33,0,3609
"51193010100",1718,565,2121,363,61,0,64,0,4892
"51193010200",2064,285,1116,176,130,7,111,10,3899
"51193010300",2028,220,533,204,147,0,678,0,3810
"51193010400",4619,363,346,81,288,59,207,0,5963
"51195930700",2144,674,0,0,12,0,0,0,2830
"51195930800",1646,376,0,0,0,0,0,0,2022
"51195930900",3256,645,25,17,66,6,0,1,4016
"51195931000",2364,574,0,0,0,0,0,0,2938
"51195931100",1905,712,6,76,45,51,25,0,2820
"51195931200",3794,1393,197,28,99,9,6,84,5610
"51195931300",2890,601,0,133,43,0,0,0,3667
"51195931400",3410,600,0,14,88,0,17,0,4129
"51195931500",3501,1222,28,99,43,39,37,57,5026
"51195931600",1861,696,36,20,16,42,8,53,2732
"51195931700",1600,387,0,0,18,0,48,3,2056
"51197050100",4084,594,439,221,75,0,77,0,5490
"51197050200",5183,1201,227,68,167,40,93,0,6979
"51197050301",3684,568,66,0,22,16,67,0,4423
"51197050302",3000,424,0,0,7,5,0,0,3436
"51197050401",3268,473,11,0,61,6,22,23,3864
"51197050402",4218,740,16,0,7,0,0,28,5009
"51199050203",4675,76,804,0,1110,64,116,14,6859
"51199050204",3789,416,1075,47,791,23,696,10,6847
"51199050205",3721,71,258,7,582,0,281,0,4920
"51199050206",5353,94,557,37,510,0,212,20,6783
"51199050303",4720,188,303,0,524,162,149,26,6072
"51199050304",4882,231,159,0,280,32,130,21,5735
"51199050305",2009,93,269,0,618,0,76,66,3131
"51199050306",3670,221,489,58,257,27,209,54,4985
"51199050401",2759,81,326,0,152,0,14,0,3332
"51199050402",3167,111,107,0,54,0,51,0,3490
"51199050500",1266,44,1137,366,62,50,512,23,3460
"51199050900",833,180,558,152,82,50,88,8,1951
"51199051000",2223,363,420,172,113,8,21,129,3449
"51199051100",4747,377,1185,344,591,53,340,269,7906
"51199990100",0,0,0,0,0,0,0,0,0
"51510200102",1788,506,753,250,1001,75,1041,389,5803
"51510200103",2588,165,3183,392,1421,256,1800,125,9930
"51510200104",1652,269,1044,46,638,234,1065,254,5202
"51510200105",970,138,2149,623,377,0,231,0,4488
"51510200106",1994,148,402,88,781,0,570,59,4042
"51510200107",3648,227,1169,159,858,24,710,43,6838
"51510200201",2466,78,378,87,348,0,367,11,3735
"51510200202",1443,65,24,2,177,13,125,0,1849
"51510200301",1503,175,963,47,695,120,525,166,4194
"51510200302",2361,123,1333,15,917,96,690,0,5535
"51510200303",2529,310,1615,165,642,50,805,10,6126
"51510200403",721,25,266,0,217,33,119,0,1381
"51510200404",2777,8,511,0,360,10,208,10,3884
"51510200405",2655,282,2201,103,1467,127,1477,274,8586
"51510200406",1657,179,2003,265,1416,111,1165,111,6907
"51510200407",1966,43,1174,72,600,0,355,0,4210
"51510200500",1854,130,1083,273,557,46,596,0,4539
"51510200600",2587,163,836,226,1338,50,1231,111,6542
"51510200701",611,78,55,0,23,0,70,0,837
"51510200702",3728,53,299,22,484,0,550,0,5136
"51510200703",2068,27,455,235,232,16,150,0,3183
"51510200801",2280,35,244,17,170,11,228,8,2993
"51510200802",2285,0,353,310,367,15,608,0,3938
"51510200900",4297,101,219,48,253,0,176,0,5094
"51510201000",2336,43,70,0,244,18,192,8,2911
"51510201100",2645,64,110,9,506,0,251,11,3596
"51510201202",2400,142,214,2,281,29,473,32,3573
"51510201203",3586,1466,473,463,1120,117,2943,1319,11487
"51510201204",2272,154,702,107,376,0,1017,141,4769
"51510201300",2835,46,376,14,232,0,287,0,3790
"51510201400",3536,22,125,89,233,0,286,0,4291
"51510201500",3313,49,24,0,133,0,143,0,3662
"51510201600",3081,97,526,580,371,39,167,0,4861
"51510201801",4549,85,595,154,623,104,578,0,6688
"51510201802",1351,59,285,212,146,0,118,0,2171
"51510201900",1460,35,55,27,101,5,64,0,1747
"51510202001",1982,2,50,0,107,0,64,0,2205
"51510202002",1736,39,33,27,119,0,76,0,2030
"51520020100",3166,442,116,0,0,71,7,71,3873
"51520020200",2927,1172,339,191,0,224,0,86,4939
"51520020300",1578,861,127,99,106,73,0,0,2844
"51520020400",5091,277,36,0,190,86,127,0,5807
"51530930600",4027,1594,0,0,393,161,29,49,6253
"51540000201",1428,430,486,124,112,116,68,19,2783
"51540000202",774,2043,559,446,204,233,63,98,4420
"51540000302",1916,169,327,30,135,0,48,1,2626
"51540000401",1431,568,891,604,167,44,243,65,4013
"51540000402",2951,565,491,146,148,12,30,12,4355
"51540000501",960,156,1854,383,134,185,54,9,3735
"51540000502",3342,485,1039,24,501,44,42,23,5500
"51540000600",733,1451,100,116,300,526,96,90,3412
"51540000700",2334,562,35,31,148,109,71,55,3345
"51540000800",2961,477,298,55,143,213,783,70,5000
"51540000900",1796,127,60,61,57,0,99,0,2200
"51540001000",2448,268,106,132,176,60,74,0,3264
"51550020001",1195,61,60,0,86,0,60,12,1474
"51550020002",2333,294,1166,540,188,29,252,21,4823
"51550020003",3626,203,665,807,356,162,148,110,6077
"51550020100",406,165,2561,955,158,35,191,99,4570
"51550020200",289,8,2491,1600,97,0,0,6,4491
"51550020300",451,70,564,352,79,44,27,21,1608
"51550020400",1683,266,735,147,146,19,110,0,3106
"51550020500",556,52,326,147,278,0,237,37,1633
"51550020600",3038,280,705,63,127,0,235,0,4448
"51550020700",976,419,3208,606,455,20,311,187,6182
"51550020804",4954,334,1334,152,701,0,676,0,8151
"51550020805",2997,100,1571,116,701,16,103,34,5638
"51550020806",4356,273,1592,68,1115,0,342,50,7796
"51550020807",5076,117,1836,8,758,38,465,18,8316
"51550020808",556,0,2881,81,400,0,371,0,4289
"51550020809",2518,172,1273,142,463,0,298,0,4866
"51550020903",572,118,1725,157,111,0,143,0,2826
"51550020904",4998,130,2340,621,617,110,177,0,8993
"51550020905",2096,220,341,0,30,13,277,0,2977
"51550020906",3865,470,2114,234,577,205,421,0,7886
"51550021004",4614,403,415,31,442,0,491,205,6601
"51550021005",2997,99,767,11,463,34,442,0,4813
"51550021006",6492,249,463,96,611,0,132,102,8145
"51550021009",3620,52,178,22,376,0,141,11,4400
"51550021010",4358,260,504,44,245,73,172,22,5678
"51550021011",2830,70,220,45,190,0,91,0,3446
"51550021012",5353,430,117,0,304,0,293,0,6497
"51550021013",3723,90,336,0,403,17,91,41,4701
"51550021101",4654,165,174,5,170,0,325,0,5493
"51550021102",4739,342,479,19,541,0,70,1,6191
"51550021200",4294,190,280,32,483,50,32,27,5388
"51550021301",3495,299,1597,126,258,14,235,0,6024
"51550021302",5554,223,3088,389,733,121,626,185,10919
"51550021401",1136,67,452,44,101,85,46,78,2009
"51550021402",4115,849,1131,31,257,40,106,0,6529
"51550021403",2674,235,1021,270,314,146,251,172,5083
"51550021404",1569,690,4359,664,438,63,339,291,8413
"51550021501",4936,206,3565,1023,822,51,479,85,11167
"51550021502",5458,472,1404,34,871,0,130,0,8369
"51550021601",6001,131,806,190,860,0,217,0,8205
"51550021602",2386,31,2852,1127,313,45,126,0,6880
"51570830100",4080,379,147,0,223,34,133,0,4996
"51570830200",2022,282,436,145,109,49,152,6,3201
"51570830300",1765,107,385,39,473,9,178,9,2965
"51570830400",1415,195,329,265,115,69,143,0,2531
"51570830500",3279,256,430,101,151,44,232,20,4513
"51580060100",1514,787,642,75,39,32,0,9,3098
"51580060200",1802,522,29,21,170,0,58,0,2602
"51590000100",2498,115,2484,572,75,71,105,0,5920
"51590000200",1523,206,1280,579,61,26,81,47,3803
"51590000300",688,161,1654,510,14,25,0,7,3059
"51590000400",611,201,1231,1235,14,79,0,49,3420
"51590000500",201,88,681,480,26,36,0,0,1512
"51590000600",394,109,929,597,79,13,41,9,2171
"51590000700",2026,243,317,206,114,38,61,0,3005
"51590000800",1355,243,788,164,106,0,0,0,2656
"51590000900",2051,311,947,281,211,144,153,5,4103
"51590001000",590,254,1429,981,95,111,107,41,3608
"51590001100",396,70,462,291,26,21,10,33,1309
"51590001200",818,232,252,293,190,43,176,53,2057
"51590001301",627,33,449,72,164,0,139,0,1484
"51590001302",251,90,319,44,31,17,76,35,863
"51590001400",1878,285,467,52,230,7,76,0,2995
"51590980100",0,0,0,0,0,0,0,0,0
"51595890100",358,224,1009,769,183,50,162,0,2755
"51595890200",1199,332,714,530,87,2,9,0,2873
"51600300100",3344,208,313,70,1182,167,649,19,5952
"51600300200",3537,146,0,71,1164,79,1024,56,6077
"51600300300",3441,267,143,0,1623,0,859,0,6333
"51600300400",2155,90,130,19,935,202,825,13,4369
"51600300500",2371,232,312,0,535,42,342,11,3845
"51610500100",2999,43,37,1,205,19,109,14,3427
"51610500200",3868,57,150,11,1512,71,960,45,6674
"51610500300",3302,47,78,0,772,112,157,8,4476
"51620090100",2670,214,1563,205,158,0,51,37,4898
"51620090200",266,56,1858,1274,44,13,0,0,3511
"51630000100",2316,295,267,21,231,18,58,16,3222
"51630000200",3579,991,951,417,513,86,883,77,7497
"51630000301",32,11,0,0,0,0,0,0,43
"51630000302",3043,444,802,106,236,78,422,34,5165
"51630000400",1221,212,1077,354,271,126,53,139,3453
"51630000500",3453,422,1968,233,810,294,874,243,8297
"51640070101",2773,1188,160,36,69,76,419,403,5124
"51640070102",1627,368,122,46,69,52,257,79,2620
"51650010103",4360,402,1486,102,755,159,454,140,7858
"51650010104",2048,199,2167,929,571,43,379,0,6336
"51650010200",513,0,26,0,45,30,0,0,614
"51650010304",2694,70,3336,499,973,67,701,31,8371
"51650010306",2711,173,2382,405,885,31,560,205,7352
"51650010307",2116,41,2598,105,557,35,266,0,5718
"51650010309",1293,322,2157,299,222,0,123,12,4428
"51650010310",2378,175,1600,77,353,7,274,0,4864
"51650010311",1640,195,2045,483,189,5,199,0,4756
"51650010312",2156,159,699,119,260,20,23,104,3540
"51650010313",2175,323,2779,775,408,42,298,164,6964
"51650010314",605,182,801,6,106,5,41,0,1746
"51650010400",1066,55,3728,1692,176,35,19,0,6771
"51650010501",1527,73,3621,728,189,88,415,0,6641
"51650010502",288,64,1590,825,262,0,83,0,3112
"51650010601",328,13,667,722,0,0,10,0,1740
"51650010602",475,48,1475,926,50,20,64,74,3132
"51650010701",1337,207,938,916,62,10,106,0,3576
"51650010702",2405,268,1060,27,338,43,85,12,4238
"51650010703",2001,57,673,60,120,55,139,26,3131
"51650010800",2940,107,2087,254,587,0,366,0,6341
"51650010900",262,71,1320,582,62,13,182,0,2492
"51650011000",2434,448,1923,523,254,0,30,0,5612
"51650011100",372,11,6,0,40,0,8,0,437
"51650011200",1302,283,810,45,95,0,63,0,2598
"51650011300",660,77,738,315,65,0,28,0,1883
"51650011400",33,33,98,256,4,0,29,19,472
"51650011500",2802,292,525,168,206,0,398,23,4414
"51650011600",718,74,1450,657,112,18,103,0,3132
"51650011800",1275,98,2379,738,214,33,159,0,4896
"51650011900",145,161,1915,515,29,149,29,202,3145
"51650012000",522,122,1580,554,76,24,35,18,2931
"51650012100",4530,123,665,27,307,0,205,0,5857
"51650990100",0,0,0,0,0,0,0,0,0
"51660000101",2812,901,465,229,294,48,1101,217,6067
"51660000102",2957,634,420,64,261,166,810,141,5453
"51660000203",1163,409,71,0,92,66,33,86,1920
"51660000204",1960,1198,47,191,265,230,636,219,4746
"51660000205",3118,2218,140,113,368,297,951,56,7261
"51660000206",141,0,0,0,0,0,22,0,163
"51660000207",588,3203,75,264,90,235,132,225,4812
"51660000301",2857,354,52,1,187,26,683,51,4211
"51660000302",3044,1261,224,78,334,131,1140,272,6484
"51660000401",1907,210,179,12,351,130,130,35,2954
"51660000402",4868,1592,292,65,143,0,1193,614,8767
"51670820100",584,305,388,146,24,51,48,101,1647
"51670820300",833,271,583,440,516,25,343,9,3020
"51670820400",3380,237,1298,189,250,16,246,0,5616
"51670820500",3371,485,445,356,144,42,21,0,4864
"51670820600",1315,473,1916,531,662,172,534,153,5756
"51670820700",221,37,1677,389,107,0,61,0,2492
"51670980100",0,0,0,0,0,0,0,0,0
"51678930500",1920,477,617,52,134,149,152,36,3537
"51680000100",3176,151,289,126,134,0,83,0,3959
"51680000201",5418,460,204,144,428,0,31,0,6685
"51680000202",3251,467,1032,964,244,32,257,21,6268
"51680000203",60,65,20,51,10,0,0,0,206
"51680000300",1927,288,892,319,25,9,58,0,3518
"51680000400",963,168,1121,532,31,34,1,0,2850
"51680000500",233,83,84,22,25,18,0,0,465
"51680000600",541,55,1425,854,113,55,102,103,3248
"51680000700",761,389,1192,906,174,9,30,16,3477
"51680000801",1027,389,310,163,21,30,22,0,1962
"51680000802",1752,405,535,78,228,45,21,12,3076
"51680000900",3264,969,1420,868,358,38,529,74,7520
"51680001000",2079,220,459,201,60,0,48,31,3098
"51680001100",269,94,727,310,47,72,13,10,1542
"51680001400",130,168,26,9,0,0,0,0,333
"51680001600",3750,2322,982,794,664,689,369,43,9613
"51680001700",3339,613,507,13,328,66,184,0,5050
"51680001800",1581,210,195,51,46,9,22,9,2123
"51680001900",1094,542,1781,1179,68,27,0,38,4729
"51683910100",3121,242,328,189,412,7,969,202,5470
"51683910201",3652,255,225,0,317,50,948,121,5568
"51683910202",5269,223,1314,74,1204,93,2751,159,11087
"51683910301",3130,377,752,39,593,37,1233,298,6459
"51683910302",3460,336,739,106,1028,172,1456,72,7369
"51683910401",3998,1125,1177,25,649,317,2960,1268,11519
"51683910402",3664,231,790,47,949,0,946,19,6646
"51685920100",4994,231,349,0,1107,319,3048,435,10483
"51685920200",4625,373,1394,175,1844,134,1755,260,10560
"51690000100",1285,238,1013,380,93,10,228,0,3247
"51690000200",150,111,1320,723,19,25,0,36,2384
"51690000300",1042,344,723,162,59,34,38,16,2418
"51690000400",685,154,744,493,258,93,293,4,2724
"51690000500",2357,198,317,140,7,0,0,0,3019
"51700030100",167,112,1299,1595,163,19,93,243,3691
"51700030300",296,51,3752,1273,10,197,60,156,5795
"51700030400",74,10,1686,1642,44,19,15,22,3512
"51700030500",4,44,1196,458,52,32,10,0,1796
"51700030600",74,60,1614,705,38,0,58,0,2549
"51700030800",0,0,973,726,44,0,19,4,1766
"51700030900",481,95,947,464,116,0,107,37,2247
"51700031100",924,127,1321,142,135,1,12,15,2677
"51700031200",510,117,945,354,125,11,55,13,2130
"51700031300",1347,83,1806,446,141,21,80,0,3924
"51700031400",2979,290,1979,811,321,0,179,81,6640
"51700031500",4642,197,700,137,211,70,189,6,6152
"51700031601",3149,429,2688,150,594,265,399,237,7911
"51700031602",2731,217,1025,65,298,7,182,46,4571
"51700031701",1320,183,357,181,98,54,59,4,2256
"51700031702",2470,100,810,233,132,0,178,15,3938
"51700031800",3485,282,235,0,141,0,130,0,4273
"51700031901",3312,61,205,33,192,50,0,0,3853
"51700031902",2326,148,1156,162,270,40,145,0,4247
"51700032001",2252,47,547,0,235,8,74,0,3163
"51700032002",4319,118,1097,2,510,30,188,30,6294
"51700032005",2050,106,471,71,187,0,82,13,2980
"51700032006",689,270,1264,951,345,109,152,196,3976
"51700032007",2259,152,947,67,343,18,359,16,4161
"51700032113",1122,235,551,16,295,35,208,95,2557
"51700032114",1007,29,362,13,256,0,139,2,1808
"51700032117",2161,305,803,471,206,50,266,0,4262
"51700032123",2045,72,2383,603,596,100,665,38,6502
"51700032124",974,165,2072,158,430,43,186,27,4055
"51700032126",2183,553,609,189,257,96,841,409,5137
"51700032127",1642,321,1779,273,262,21,302,0,4600
"51700032128",1622,146,692,326,463,21,806,106,4182
"51700032129",1271,65,1121,339,276,49,158,15,3294
"51700032130",3236,137,1084,0,815,0,478,68,5818
"51700032131",2256,329,1361,34,418,103,243,90,4834
"51700032132",3240,332,1352,166,372,261,646,116,6485
"51700032211",4222,42,1054,0,608,122,263,0,6311
"51700032212",284,219,1928,663,496,294,531,237,4652
"51700032223",1146,91,1370,227,499,82,450,34,3899
"51700032224",2046,399,2978,954,544,69,312,231,7533
"51700032225",643,500,2183,461,166,4,241,106,4304
"51700032226",1164,309,1272,444,374,183,365,223,4334
"51700032300",1362,278,466,67,586,219,382,190,3550
"51700032400",1627,225,920,82,238,76,177,186,3531
"51710000100",1274,300,680,38,54,0,19,0,2365
"51710000201",1360,288,471,120,357,94,66,121,2877
"51710000202",2028,569,486,175,506,182,81,110,4137
"51710000300",1593,225,551,304,479,66,381,24,3623
"51710000400",1994,192,846,138,300,81,295,33,3879
"51710000500",1672,578,528,57,282,42,100,110,3369
"51710000600",2121,205,1383,308,321,94,284,94,4810
"51710000700",1870,146,434,40,71,0,78,52,2691
"51710000800",1129,103,363,125,310,119,241,28,2418
"51710000901",2217,327,779,109,352,180,364,150,4478
"51710000902",813,35,451,0,165,7,241,0,1712
"51710001100",1036,90,481,544,510,317,91,47,3116
"51710001200",2454,249,900,108,371,13,336,10,4441
"51710001300",1239,62,517,332,316,0,218,0,2684
"51710001400",1593,326,274,183,287,20,135,0,2818
"51710001500",1084,81,534,124,115,63,127,0,2128
"51710001600",145,47,1102,550,214,22,96,7,2183
"51710001700",1255,88,771,224,67,40,117,40,2602
"51710002000",1060,26,121,10,20,0,104,0,1341
"51710002100",1105,171,79,32,72,12,15,43,1529
"51710002200",1540,52,188,0,116,0,21,0,1917
"51710002300",1732,174,7,0,200,48,60,0,2221
"51710002400",3024,620,55,43,110,26,222,0,4100
"51710002500",274,749,744,333,146,78,63,71,2458
"51710002600",698,843,297,721,242,304,55,196,3356
"51710002700",254,62,1595,836,213,16,0,9,2985
"51710002800",2324,224,719,139,469,32,381,49,4337
"51710002900",334,126,2374,492,220,40,142,17,3745
"51710003000",948,127,452,265,66,50,89,12,2009
"51710003100",712,29,1112,503,311,84,102,96,2949
"51710003200",461,104,1715,398,203,52,170,18,3121
"51710003300",364,54,1844,370,83,0,118,4,2837
"51710003400",188,52,1364,733,27,34,78,7,2483
"51710003501",122,0,1607,974,131,84,0,61,2979
"51710003600",1184,68,99,39,138,12,85,5,1630
"51710003700",1353,318,137,79,189,71,47,6,2200
"51710003800",2355,234,81,31,132,0,57,0,2890
"51710004001",1034,30,46,0,76,19,30,6,1241
"51710004002",2302,370,68,93,315,122,167,12,3449
"51710004100",0,64,386,1470,0,43,0,99,2062
"51710004200",0,0,463,955,0,0,0,0,1418
"51710004300",48,0,1384,1165,164,48,53,25,2887
"51710004400",132,0,1061,246,58,0,31,28,1556
"51710004500",20,0,1306,241,122,17,70,4,1780
"51710004600",134,58,1083,573,94,5,0,0,1947
"51710004700",43,22,524,56,7,12,33,0,697
"51710004800",0,4,207,943,0,58,0,50,1262
"51710004900",2196,271,259,215,236,15,129,0,3321
"51710005000",73,0,2205,1138,48,46,55,12,3577
"51710005100",239,52,2245,2063,521,75,134,66,5395
"51710005500",1336,306,1151,363,340,328,550,427,4801
"51710005601",3246,211,262,340,296,80,104,21,4560
"51710005602",2103,225,638,248,119,90,125,23,3571
"51710005701",1071,393,2059,1097,626,20,769,20,6055
"51710005702",514,41,1528,282,48,22,66,10,2511
"51710005800",294,132,2827,998,201,67,124,68,4711
"51710005901",1119,67,2644,499,537,75,798,64,5803
"51710005902",1264,121,1144,481,661,7,173,0,3851
"51710005903",621,26,613,173,206,17,85,0,1741
"51710006000",1637,392,997,429,303,12,87,17,3874
"51710006100",2748,879,2940,681,461,133,677,134,8653
"51710006200",1506,86,865,81,255,15,135,37,2980
"51710006400",740,53,2110,766,208,56,184,0,4117
"51710006501",1260,509,626,588,249,39,176,65,3512
"51710006502",1846,184,287,391,181,84,112,0,3085
"51710006601",474,13,320,119,67,0,51,0,1044
"51710006602",2066,163,47,5,192,0,113,0,2586
"51710006603",1583,209,253,44,373,20,160,10,2652
"51710006604",1064,149,345,108,465,130,162,66,2489
"51710006605",1520,97,639,8,337,138,241,0,2980
"51710006606",2188,380,1072,171,307,25,362,164,4669
"51710006607",1357,119,825,13,496,58,114,15,2997
"51710006800",850,121,477,147,210,14,86,116,2021
"51710006901",696,279,1935,161,492,202,235,305,4305
"51710006902",1108,186,524,73,451,58,219,39,2658
"51710007001",386,87,954,53,134,7,25,20,1666
"51710007002",944,192,1758,217,277,242,178,109,3917
"51710980100",0,0,0,0,0,0,0,0,0
"51710980200",0,0,0,0,0,0,0,0,0
"51710980300",0,0,0,0,0,0,0,0,0
"51710990000",0,0,0,0,0,0,0,0,0
"51720960100",2604,847,135,0,261,102,97,0,4046
"51730810100",43,73,1176,1281,90,49,7,7,2726
"51730810300",414,3,1172,680,292,41,200,41,2843
"51730810400",41,47,759,338,78,21,14,21,1319
"51730810500",367,115,2287,1350,35,62,63,8,4287
"51730810600",15,19,873,566,72,59,0,19,1623
"51730810700",131,149,1352,703,11,14,91,30,2481
"51730810900",522,181,2202,479,99,32,82,65,3662
"51730811000",1386,57,1913,798,62,0,176,0,4392
"51730811100",554,84,1968,127,105,0,34,0,2872
"51730811200",661,179,2115,631,183,115,257,144,4285
"51730811300",429,108,1117,415,57,19,56,0,2201
"51735340100",3353,108,84,0,136,0,84,0,3765
"51735340200",4711,294,28,0,215,0,130,0,5378
"51735340300",2780,100,0,0,217,0,58,0,3155
"51735990100",0,0,0,0,0,0,0,0,0
"51740210200",1219,165,320,266,82,15,12,9,2088
"51740210300",1188,157,873,28,175,0,167,0,2588
"51740210400",1037,55,181,106,48,14,72,0,1513
"51740210500",102,25,894,1020,0,13,74,5,2133
"51740210600",1052,25,319,103,144,34,140,0,1817
"51740210900",1582,205,523,180,80,6,77,37,2690
"51740211100",13,66,1137,461,49,110,0,0,1836
"51740211400",22,4,1465,398,100,0,5,0,1994
"51740211500",528,172,798,281,54,62,15,53,1963
"51740211600",2875,400,582,117,204,3,306,18,4505
"51740211700",148,61,2152,248,5,133,22,27,2796
"51740211800",62,20,1374,2270,83,68,0,30,3907
"51740211900",59,0,1085,339,102,0,0,0,1585
"51740212000",0,4,1323,715,54,10,0,10,2116
"51740212100",20,15,660,597,13,0,15,0,1320
"51740212300",1944,308,1272,725,183,0,94,65,4591
"51740212400",1212,12,1397,652,273,43,93,43,3725
"51740212500",1281,101,429,80,200,142,106,105,2444
"51740212600",605,91,265,119,5,11,0,0,1096
"51740212701",31,0,3944,548,278,6,209,0,5016
"51740212702",84,21,2730,389,79,0,0,5,3308
"51740212801",1916,356,1314,348,119,67,68,0,4188
"51740212802",2006,162,438,6,95,0,48,15,2770
"51740212900",4077,450,489,0,263,32,119,0,5430
"51740213001",3572,83,1586,16,431,0,235,0,5923
"51740213002",3287,140,682,84,257,0,152,0,4602
"51740213101",872,105,2984,996,452,64,134,68,5675
"51740213103",2527,225,2569,254,723,13,375,91,6777
"51740213104",898,16,2146,1175,154,26,45,0,4460
"51740213200",539,30,775,109,82,24,44,28,1631
"51740980100",0,0,0,0,0,0,0,0,0
"51750010101",1991,1913,125,192,37,83,34,77,4452
"51750010102",853,1980,13,38,43,25,3,26,2981
"51750010200",4664,1190,508,76,373,0,136,0,6947
"51760010200",2924,170,648,193,187,11,26,0,4159
"51760010300",30,72,1083,367,8,0,20,0,1580
"51760010401",1996,103,609,420,51,2,17,16,3214
"51760010402",1684,178,826,258,83,6,40,0,3075
"51760010500",321,11,976,68,122,13,39,0,1550
"51760010600",329,46,1330,236,122,8,0,0,2071
"51760010700",156,8,1607,552,16,6,80,0,2425
"51760010800",179,126,2677,1036,69,12,0,0,4099
"51760010900",142,105,1969,976,113,15,30,15,3365
"51760011000",163,34,1117,571,100,62,0,0,2047
"51760011100",344,107,1122,650,70,5,11,0,2309
"51760020100",4,33,773,1072,0,0,0,0,1882
"51760020200",0,112,1465,2610,26,67,0,83,4363
"51760020300",107,31,1049,503,0,3,0,3,1696
"51760020400",0,90,1376,2381,40,32,0,78,3997
"51760020500",2121,542,640,184,332,248,67,48,4182
"51760020600",785,72,457,40,156,18,19,0,1547
"51760020700",148,87,548,408,14,43,0,12,1260
"51760020800",997,57,254,136,128,18,0,0,1590
"51760020900",334,178,2065,365,39,63,3,19,3066
"51760021000",273,69,732,496,12,0,15,0,1597
"51760021100",177,42,705,369,37,0,43,0,1373
"51760021200",188,57,1129,382,40,0,0,0,1796
"51760030100",0,22,713,1837,8,136,0,54,2770
"51760030200",721,543,363,247,124,43,11,16,2068
"51760030500",977,537,535,145,439,349,29,65,3076
"51760040200",1245,697,741,390,126,165,86,123,3573
"51760040300",205,283,32,63,54,151,25,73,886
"51760040400",1359,1069,190,337,27,56,16,20,3074
"51760040500",2271,420,141,102,36,51,88,4,3113
"51760040600",1089,280,85,77,63,35,13,0,1642
"51760040700",2201,299,192,79,125,54,151,35,3136
"51760040800",1234,204,85,19,79,3,40,4,1668
"51760040900",1897,302,262,70,201,14,55,2,2803
"51760041000",2389,260,30,38,159,0,35,6,2917
"51760041100",2415,777,361,434,78,61,77,15,4218
"51760041200",785,303,8,23,53,115,39,14,1340
"51760041300",449,230,1473,831,61,87,0,0,3131
"51760041400",742,80,884,70,60,14,30,0,1880
"51760041600",682,72,710,25,52,7,20,5,1573
"51760050100",2382,191,249,65,94,0,16,9,3006
"51760050200",2844,127,14,0,156,0,39,0,3180
"51760050300",1390,26,4,0,64,0,5,0,1489
"51760050400",2630,95,171,0,170,9,62,43,3180
"51760050500",2387,116,37,0,77,0,17,0,2634
"51760050600",2420,54,14,0,68,6,8,6,2576
"51760060200",168,159,1242,642,31,26,54,126,2448
"51760060400",578,158,2527,1659,107,330,75,0,5434
"51760060500",2896,197,1409,729,440,2,47,62,5782
"51760060600",2059,139,221,157,44,0,41,0,2661
"51760060700",223,99,2931,1730,248,60,133,53,5477
"51760060800",685,135,1396,817,225,18,514,124,3914
"51760060900",394,288,356,217,193,40,350,164,2002
"51760061000",1040,199,1796,854,225,44,143,6,4307
"51760070100",3725,201,944,40,354,0,168,0,5432
"51760070300",1975,282,756,135,149,54,323,275,3949
"51760070400",2821,171,767,35,86,25,62,4,3971
"51760070601",1566,1257,1578,801,689,529,1750,1556,9726
"51760070602",366,126,1203,445,313,16,504,82,3055
"51760070700",1152,275,2324,768,378,194,849,387,6327
"51760070801",910,393,4020,2088,255,75,394,132,8267
"51760070802",654,45,1334,419,123,32,177,0,2784
"51760070900",1294,404,3801,1056,297,621,754,688,8915
"51760071001",822,199,2234,825,700,73,297,79,5229
"51760071002",789,89,1979,436,179,170,177,83,3902
"51760071100",2472,183,1815,183,358,54,58,2,5125
"51770000100",862,107,2023,565,305,56,170,25,4113
"51770000300",2210,460,1047,134,607,89,179,325,5051
"51770000400",3726,546,285,24,122,13,88,134,4938
"51770000500",2488,743,1019,178,402,363,826,0,6019
"51770000601",3678,726,323,87,280,0,360,0,5454
"51770000602",2488,412,258,210,566,12,507,143,4596
"51770000900",1183,579,2233,1857,54,39,0,26,5971
"51770001000",536,252,744,405,292,88,303,34,2654
"51770001100",644,88,61,11,26,9,5,18,862
"51770001200",1977,456,213,89,125,78,183,0,3121
"51770001800",3209,437,278,110,173,63,9,36,4315
"51770001900",3279,462,263,171,320,423,206,209,5333
"51770002100",2517,352,84,26,67,33,13,0,3092
"51770002200",1488,88,850,33,228,10,78,10,2785
"51770002300",1927,309,2597,1160,808,325,116,265,7507
"51770002400",208,67,2029,920,42,189,11,1,3467
"51770002500",325,625,2818,1315,142,129,91,76,5521
"51770002600",981,815,182,461,115,67,23,50,2694
"51770002700",3156,1142,73,280,52,53,173,133,5062
"51770002800",4202,678,185,92,342,124,231,15,5869
"51770002900",5017,189,224,30,112,0,96,0,5668
"51770003000",2942,246,333,63,84,144,131,0,3943
"51770003100",3221,198,287,0,258,9,403,37,4413
"51775010100",4023,493,729,313,0,64,104,0,5726
"51775010200",4282,442,50,45,138,10,30,0,4997
"51775010300",2717,532,410,99,85,26,87,0,3956
"51775010501",3053,263,32,8,312,11,281,66,4026
"51775010502",4292,272,76,0,239,0,91,58,5028
"51790000100",776,156,35,0,57,18,5,9,1056
"51790000200",2048,863,545,81,113,34,116,12,3812
"51790000300",3793,760,408,274,225,61,206,0,5727
"51790000400",5245,631,439,322,330,0,86,22,7075
"51790000500",1660,368,45,0,13,11,21,0,2118
"51790000600",2746,262,308,205,106,6,65,10,3708
"51800065100",189,26,1088,715,85,75,35,0,2213
"51800065200",1418,106,403,78,156,40,132,18,2351
"51800065300",1266,76,1445,543,91,0,104,21,3546
"51800065400",254,7,2388,1057,88,162,40,9,4005
"51800065500",48,34,1919,716,165,0,12,0,2894
"51800075101",2397,80,3709,293,643,135,329,113,7699
"51800075102",3052,116,786,0,251,0,167,0,4372
"51800075201",3787,103,582,0,212,21,76,0,4781
"51800075202",764,0,440,0,71,0,0,0,1275
"51800075203",2113,0,1124,0,235,144,236,108,3960
"51800075204",1994,307,2219,143,367,32,282,13,5357
"51800075301",1660,69,248,18,143,11,72,11,2232
"51800075302",1469,93,259,220,63,20,19,11,2154
"51800075401",1080,78,367,86,104,0,171,32,1918
"51800075402",1989,45,1583,141,265,0,456,0,4479
"51800075403",1937,87,1722,112,347,48,147,0,4400
"51800075404",976,18,99,0,0,0,7,0,1100
"51800075405",1954,46,178,5,12,0,36,0,2231
"51800075501",1889,298,1606,959,216,30,56,0,5054
"51800075502",2071,107,1598,137,184,0,123,24,4244
"51800075601",365,14,2183,899,25,88,22,0,3596
"51800075602",1104,54,259,40,93,37,25,0,1612
"51800075701",734,46,566,261,19,0,4,0,1630
"51800075702",2772,257,435,13,81,0,71,6,3635
"51800075703",893,60,466,14,0,0,27,0,1460
"51800075801",2383,66,406,43,74,0,23,0,2995
"51800075802",856,95,651,37,23,18,0,0,1680
"51800075803",1010,19,131,137,35,0,37,0,1369
"51810040000",921,97,277,9,190,21,145,14,1674
"51810040200",1199,262,1911,496,225,155,480,127,4855
"51810040402",1913,262,3411,764,562,161,329,52,7454
"51810040403",2358,187,666,22,305,135,579,130,4382
"51810040404",4359,177,1363,16,783,131,266,0,7095
"51810040600",1699,325,2547,1119,541,166,443,118,6958
"51810040801",2961,67,903,71,379,31,345,14,4771
"51810040802",2310,258,1147,264,658,1,296,77,5011
"51810041002",1280,187,181,5,213,143,267,96,2372
"51810041003",2436,207,505,9,341,68,349,85,4000
"51810041004",2542,300,452,209,489,34,366,91,4483
"51810041200",5012,172,258,0,181,0,105,24,5752
"51810041400",4119,77,458,29,521,15,222,15,5456
"51810041600",2435,41,363,4,497,22,146,0,3508
"51810041801",3310,243,572,209,734,90,194,147,5499
"51810041802",4641,313,103,0,398,9,332,0,5796
"51810042000",3149,65,68,0,167,0,76,0,3525
"51810042201",3246,75,99,0,195,9,107,0,3731
"51810042202",4043,178,91,4,240,0,61,17,4634
"51810042400",3694,288,748,22,244,67,123,50,5236
"51810042600",1882,157,209,106,178,38,80,0,2650
"51810042801",4319,307,978,37,460,9,586,0,6696
"51810042802",2279,199,1250,161,621,34,460,0,5004
"51810043002",3655,51,76,0,402,8,253,30,4475
"51810043003",4098,132,238,0,162,0,0,0,4630
"51810043004",3609,208,36,0,98,12,85,0,4048
"51810043200",723,68,112,30,63,13,121,31,1161
"51810043400",1587,0,0,0,56,0,0,0,1643
"51810043600",1498,73,0,0,53,0,12,0,1636
"51810043800",3373,105,141,22,173,0,71,0,3885
"51810044001",4473,138,1191,115,256,0,328,9,6510
"51810044003",4406,360,124,0,216,0,76,13,5195
"51810044004",1508,193,297,193,150,27,130,6,2504
"51810044200",3144,770,1195,1033,697,193,407,306,7745
"51810044401",3181,32,0,0,266,0,185,0,3664
"51810044402",4255,333,262,139,419,78,118,0,5604
"51810044600",5215,121,15,0,221,0,304,0,5876
"51810044805",2060,168,656,145,332,13,435,28,3837
"51810044806",1095,403,1166,204,189,292,167,80,3596
"51810044807",3139,530,676,731,822,0,382,263,6543
"51810044808",2621,249,287,245,385,66,385,39,4277
"51810045000",62,0,24,0,0,0,0,0,86
"51810045200",1787,92,330,86,125,22,326,0,2768
"51810045405",2390,94,1024,358,877,75,522,49,5389
"51810045406",3574,344,2849,133,2529,305,1156,215,11105
"51810045407",3337,162,740,9,361,246,136,94,5085
"51810045408",4286,346,1180,0,812,41,500,121,7286
"51810045412",1339,61,36,5,238,0,27,0,1706
"51810045414",2693,290,1230,648,578,232,310,276,6257
"51810045415",1459,53,292,37,105,0,31,0,1977
"51810045417",6970,148,601,19,1393,48,354,0,9533
"51810045420",4333,239,186,0,414,0,120,0,5292
"51810045421",2342,73,572,0,353,0,293,0,3633
"51810045422",3352,52,733,34,728,0,480,0,5379
"51810045423",5395,202,945,8,793,11,189,11,7554
"51810045424",4252,59,288,0,493,0,166,0,5258
"51810045425",2255,216,150,2,219,5,182,28,3057
"51810045426",4715,682,642,0,662,0,489,107,7297
"51810045427",4503,379,905,186,377,235,200,249,7034
"51810045428",1164,92,37,17,50,0,38,0,1398
"51810045601",2240,24,281,27,290,0,97,0,2959
"51810045603",1153,68,393,8,155,9,175,9,1970
"51810045604",3583,372,1183,451,862,51,752,19,7273
"51810045801",2609,345,422,39,785,82,457,21,4760
"51810045803",1867,54,691,19,303,27,152,0,3113
"51810045805",851,138,160,0,193,5,121,22,1490
"51810045806",2290,197,800,207,522,120,584,142,4862
"51810045807",846,145,421,9,101,15,179,78,1794
"51810045808",1614,76,505,86,426,0,190,19,2916
"51810045809",3280,245,1371,280,1497,274,531,212,7690
"51810045810",653,131,555,742,89,58,147,35,2410
"51810046002",3711,139,551,1,336,76,321,22,5157
"51810046005",3720,392,1267,297,883,16,436,24,7035
"51810046006",3771,68,287,81,403,39,195,36,4880
"51810046009",3438,38,697,66,515,16,270,49,5089
"51810046010",1765,21,460,114,303,25,193,49,2930
"51810046011",846,32,187,74,210,4,81,0,1434
"51810046012",3975,459,2083,79,1045,68,838,63,8610
"51810046013",1728,292,1205,140,830,211,411,73,4890
"51810046014",2140,353,1392,24,662,0,281,131,4983
"51810046015",3061,113,1347,100,1164,5,580,0,6370
"51810046016",2297,0,551,22,804,35,184,0,3893
"51810046204",3916,51,380,0,343,17,213,0,4920
"51810046206",3165,116,799,58,1144,138,154,1,5575
"51810046207",3597,245,1424,182,715,43,550,0,6756
"51810046211",2096,214,444,7,450,6,299,6,3522
"51810046212",2786,182,349,4,691,0,86,14,4112
"51810046213",3019,353,1381,131,1086,263,600,39,6872
"51810046214",3005,184,1151,1,927,70,377,0,5715
"51810046216",3154,67,1487,88,1408,195,373,25,6797
"51810046217",2567,200,1001,71,1353,69,332,91,5684
"51810046219",1568,22,807,16,1517,83,356,105,4474
"51810046220",2131,269,1803,428,653,99,284,99,5766
"51810046221",1231,55,2254,256,326,66,523,0,4711
"51810046222",3410,100,832,37,813,89,242,0,5523
"51810046223",1920,12,324,16,410,13,97,0,2792
"51810046224",2113,153,1092,194,996,10,328,48,4934
"51810046225",2204,144,926,2,767,114,165,127,4449
"51810046400",4497,244,162,7,125,1,150,1,5187
"51810990100",0,0,0,0,0,0,0,0,0
"51820003100",584,477,59,86,64,0,91,212,1573
"51820003200",2965,910,750,393,226,33,183,1,5461
"51820003300",2627,708,736,204,170,221,116,204,4986
"51820003400",4139,434,253,35,398,72,504,0,5835
"51820003500",3768,223,157,0,88,0,110,0,4346
"51830370100",2799,812,143,53,48,80,99,46,4080
"51830370200",1739,321,545,407,107,55,335,84,3593
"51830370300",2138,524,616,115,197,34,65,52,3741
"51840000100",4349,1080,808,367,459,170,1699,455,9387
"51840000201",2731,235,114,93,210,119,276,35,3813
"51840000202",4318,409,400,0,361,53,228,12,5781
"51840000301",2570,501,405,49,448,58,308,194,4533
"51840000302",4044,1007,414,6,362,53,546,577,7009
"53001950100",1968,196,0,0,89,16,66,35,2370
"53001950200",1185,269,0,0,99,68,112,93,1826
"53001950300",2901,1188,27,0,2588,354,4168,1168,12394
"53001950400",1685,463,0,0,470,409,1316,804,5147
"53001950500",2307,501,0,0,1463,555,2949,993,8768
"53003960100",3400,359,0,0,356,93,60,21,4289
"53003960200",4206,369,10,0,200,21,166,0,4972
"53003960300",2452,607,8,10,144,23,34,23,3301
"53003960400",1826,294,29,0,19,69,0,107,2344
"53003960500",2882,656,0,0,71,185,49,200,4043
"53003960600",2714,595,0,0,113,20,94,27,3563
"53005010100",3741,258,0,0,463,2,176,2,4642
"53005010201",4182,305,185,0,351,34,315,44,5416
"53005010202",3889,1151,12,0,962,281,788,448,7531
"53005010300",4459,422,9,0,640,174,433,125,6262
"53005010400",2746,240,29,0,352,86,434,44,3931
"53005010500",2033,530,0,31,352,399,130,400,3875
"53005010600",2914,428,21,3,574,101,536,91,4668
"53005010701",1856,101,25,11,160,0,161,0,2314
"53005010703",2388,461,13,0,183,303,242,212,3802
"53005010705",4901,133,32,0,224,0,351,0,5641
"53005010707",2589,217,9,0,213,0,164,100,3292
"53005010708",1956,130,21,0,244,93,327,83,2854
"53005010803",6397,157,52,0,927,78,766,157,8534
"53005010805",4503,537,213,0,819,64,296,0,6432
"53005010807",881,120,0,0,150,0,100,7,1258
"53005010809",4809,646,25,0,694,0,582,178,6934
"53005010810",4726,211,0,0,269,28,217,0,5451
"53005010811",3254,29,10,0,332,13,57,0,3695
"53005010813",8990,345,252,0,1282,2,1116,7,11994
"53005010814",2763,71,0,0,101,11,176,5,3127
"53005010901",2919,1617,225,36,951,361,580,797,7486
"53005010902",2733,481,13,73,1502,328,1391,337,6858
"53005011001",2951,832,75,0,925,49,831,253,5916
"53005011002",2731,838,14,0,598,391,658,425,5655
"53005011100",5092,457,54,0,1705,604,1861,371,10144
"53005011200",2592,2207,132,122,1762,1351,2011,2061,12238
"53005011300",2692,651,97,159,1077,456,2011,551,7694
"53005011401",1765,418,0,154,539,431,689,515,4511
"53005011402",4474,184,6,0,866,125,603,119,6377
"53005011501",5013,492,63,0,931,12,1230,67,7808
"53005011503",7384,342,313,0,789,332,510,376,10046
"53005011504",2440,284,106,0,293,79,353,79,3634
"53005011600",592,17,0,0,343,24,410,24,1410
"53005011700",4433,439,0,0,1891,486,2599,556,10404
"53005011800",4126,1018,0,4,1272,723,2260,1160,10563
"53005011900",3277,904,18,0,972,326,1132,382,7011
"53005012000",22,0,0,0,0,0,0,0,22
"53007960100",1937,231,0,0,42,56,191,69,2526
"53007960200",5042,768,29,0,220,115,449,55,6678
"53007960300",4638,1059,0,0,581,570,1511,1033,9392
"53007960400",2740,415,37,12,124,0,1203,16,4547
"53007960500",5197,924,0,0,666,0,1476,75,8338
"53007960600",3351,490,12,0,289,27,934,293,5396
"53007960700",3366,119,16,4,52,80,240,83,3960
"53007960801",2443,277,9,0,39,0,97,171,3036
"53007960802",5398,1610,0,1,258,162,969,686,9084
"53007961000",4714,827,0,0,477,110,2144,433,8705
"53007961100",7558,1232,0,22,1144,205,4775,705,15641
"53007961200",3503,598,15,0,222,14,652,366,5370
"53007961301",901,39,131,0,275,4,225,2,1577
"53007961302",6420,466,5,0,1072,29,1030,169,9191
"53009000200",630,201,0,24,45,38,11,48,997
"53009000300",3097,918,79,0,378,185,424,432,5513
"53009000400",986,115,0,0,325,114,125,0,1665
"53009000600",2530,401,0,0,224,144,177,21,3497
"53009000700",2467,1058,39,0,143,86,195,53,4041
"53009000800",3257,590,0,12,164,118,157,33,4331
"53009000900",2218,306,0,13,114,114,200,53,3018
"53009001000",1849,359,0,0,173,35,41,35,2492
"53009001100",2315,262,0,263,115,274,37,20,3286
"53009001200",2631,527,13,0,234,44,115,14,3578
"53009001300",2972,345,0,14,111,0,117,0,3559
"53009001400",3882,365,0,0,427,130,115,54,4973
"53009001500",1362,228,0,0,547,203,115,10,2465
"53009001600",2889,263,0,0,84,24,65,0,3325
"53009001700",3741,487,0,0,289,13,110,29,4669
"53009001800",2231,216,0,0,164,73,23,65,2772
"53009001900",4865,231,0,0,245,12,132,0,5485
"53009002000",4396,383,89,0,377,0,182,0,5427
"53009002100",2517,488,0,42,329,101,617,43,4137
"53009002300",3535,541,41,1,155,34,66,25,4398
"53009940000",136,16,0,0,1066,271,89,10,1588
"53009990100",0,0,0,0,0,0,0,0,0
"53011040101",4340,685,14,0,101,50,71,0,5261
"53011040102",2981,292,18,0,36,25,59,10,3421
"53011040201",4553,336,51,0,430,20,238,8,5636
"53011040202",3326,243,124,5,265,55,71,3,4092
"53011040203",4955,289,0,0,410,0,120,35,5809
"53011040301",1322,94,0,0,57,22,80,0,1575
"53011040302",5866,487,0,0,561,0,374,1,7289
"53011040403",3436,155,71,0,116,31,213,34,4056
"53011040407",4198,1007,19,0,178,35,349,66,5852
"53011040408",2986,284,0,29,144,11,157,23,3634
"53011040409",1574,79,0,0,43,0,83,0,1779
"53011040411",1781,181,10,0,105,19,23,71,2190
"53011040412",3617,343,49,0,436,9,144,77,4675
"53011040413",2578,223,8,0,62,32,78,0,2981
"53011040414",4929,436,33,0,541,12,250,0,6201
"53011040415",3403,634,38,0,148,19,198,262,4702
"53011040416",3027,148,26,0,213,0,137,0,3551
"53011040504",4058,356,46,0,154,0,24,0,4638
"53011040505",5430,188,0,2,313,13,202,0,6148
"53011040507",1736,225,0,0,180,133,190,107,2571
"53011040508",5902,201,74,29,381,2,151,0,6740
"53011040509",2393,411,0,0,182,167,141,143,3437
"53011040510",4533,325,0,0,183,51,106,37,5235
"53011040511",1908,191,0,0,208,0,36,34,2377
"53011040603",3891,333,32,0,232,28,205,49,4770
"53011040604",4274,753,124,3,646,278,632,103,6813
"53011040605",4395,126,228,0,338,17,150,0,5254
"53011040608",3430,35,100,0,624,69,191,0,4449
"53011040609",4014,30,15,0,721,11,156,0,4947
"53011040610",3047,50,27,0,372,0,126,0,3622
"53011040703",5276,688,144,0,554,22,292,46,7022
"53011040706",2743,266,0,60,335,115,356,9,3884
"53011040707",2865,149,0,0,125,0,85,0,3224
"53011040709",3538,165,145,18,499,25,242,0,4632
"53011040710",4809,162,42,0,477,41,658,39,6228
"53011040711",2622,291,115,94,443,139,178,245,4127
"53011040712",4146,291,49,39,1236,103,240,109,6213
"53011040803",4353,216,13,0,751,135,351,233,6052
"53011040805",5062,475,93,0,537,23,360,84,6634
"53011040806",4281,258,0,24,411,93,198,9,5274
"53011040808",1486,197,17,0,57,32,63,77,1929
"53011040809",3956,551,98,0,1312,272,1002,317,7508
"53011040810",1971,162,17,0,556,17,414,0,3137
"53011040904",4606,957,70,0,348,502,442,413,7338
"53011040905",2701,127,45,0,45,7,81,9,3015
"53011040907",4267,241,156,0,434,0,107,0,5205
"53011040908",5865,277,53,0,364,39,569,0,7167
"53011040909",4616,185,14,0,272,27,427,0,5541
"53011040910",3785,257,0,0,321,90,15,13,4481
"53011041003",3178,364,18,2,269,44,92,44,4011
"53011041005",1128,489,88,30,412,244,341,268,3000
"53011041007",2504,256,35,52,94,277,58,278,3554
"53011041008",3305,165,20,1,514,20,262,0,4287
"53011041009",2940,359,80,10,247,62,350,21,4069
"53011041010",2858,483,34,129,370,113,420,113,4520
"53011041011",2559,139,33,0,285,8,105,0,3129
"53011041104",2745,940,62,87,454,153,105,130,4676
"53011041105",3855,388,252,0,682,31,209,97,5514
"53011041107",2155,65,1,0,355,4,158,0,2738
"53011041108",4859,483,88,0,751,102,294,56,6633
"53011041110",4475,564,107,38,821,74,450,6,6535
"53011041111",1747,645,112,27,778,138,457,322,4226
"53011041112",3870,725,84,154,931,169,573,155,6661
"53011041201",4189,730,334,0,1000,112,412,198,6975
"53011041203",3345,434,419,55,709,124,129,90,5305
"53011041205",3014,489,0,0,935,56,519,58,5071
"53011041206",3776,124,151,2,550,101,331,7,5042
"53011041309",3709,404,9,19,781,336,740,238,6236
"53011041310",3767,312,123,16,422,132,239,20,5031
"53011041312",2769,403,84,108,678,283,291,246,4862
"53011041313",1382,460,70,16,548,17,410,109,3012
"53011041317",2694,326,271,45,543,101,317,113,4410
"53011041318",3436,633,0,84,915,41,494,0,5603
"53011041319",3902,366,0,68,643,390,217,326,5912
"53011041320",4433,712,278,0,1379,28,349,20,7199
"53011041321",2347,98,9,0,407,88,238,0,3187
"53011041322",3073,619,121,17,827,97,844,134,5732
"53011041323",3880,532,40,135,540,128,620,102,5977
"53011041325",3730,126,102,0,1060,78,255,21,5372
"53011041326",1755,181,28,100,382,117,322,90,2975
"53011041327",5205,906,265,0,1804,420,298,260,9158
"53011041328",4642,232,44,0,1169,146,317,41,6591
"53011041329",3302,116,45,0,854,29,475,0,4821
"53011041330",3273,210,39,8,691,55,403,67,4746
"53011041331",1709,322,0,0,846,16,691,41,3625
"53011041332",2326,450,0,0,864,202,503,306,4651
"53011041333",2381,188,74,58,380,16,141,0,3238
"53011041400",4539,180,8,0,520,10,182,0,5439
"53011041500",2255,391,0,0,135,27,193,25,3026
"53011041600",1759,833,140,58,520,155,449,122,4036
"53011041700",2063,657,91,29,560,311,189,187,4087
"53011041800",2058,583,28,21,725,111,437,168,4131
"53011041900",1461,161,39,15,128,81,67,55,2007
"53011042000",1484,148,21,0,92,0,162,0,1907
"53011042100",2216,244,34,8,292,55,231,0,3080
"53011042300",2017,543,53,46,150,131,92,81,3113
"53011042400",942,284,0,32,63,30,38,12,1401
"53011042500",839,147,18,47,96,23,30,0,1200
"53011042600",3082,871,60,5,542,368,260,252,5440
"53011042700",2017,1055,54,6,938,586,792,486,5934
"53011042800",2232,434,145,27,273,9,338,78,3536
"53011042900",909,402,45,0,207,73,157,88,1881
"53011043000",1246,180,55,12,247,7,265,6,2018
"53011043100",3225,333,42,11,332,174,222,171,4510
"53013960200",3068,532,8,0,148,158,129,126,4169
"53015000300",222,209,38,0,18,114,101,145,847
"53015000400",2718,498,22,0,163,44,436,31,3912
"53015000501",2160,387,0,0,221,120,165,51,3104
"53015000502",2490,1644,10,35,297,304,596,358,5734
"53015000601",2093,1052,17,0,361,94,94,75,3786
"53015000602",2511,388,12,0,189,32,158,4,3294
"53015000702",2649,277,0,0,137,60,80,2,3205
"53015000703",992,249,0,0,156,32,70,54,1553
"53015000704",5027,1335,13,0,608,118,551,155,7807
"53015000800",5663,494,0,0,506,32,75,8,6778
"53015000900",5823,485,19,25,607,58,517,11,7545
"53015001000",611,510,0,4,55,127,168,255,1730
"53015001100",2909,2154,142,0,219,141,240,336,6141
"53015001200",3279,400,33,0,281,56,213,52,4314
"53015001300",2350,499,76,0,675,156,524,62,4342
"53015001501",2444,359,0,0,55,34,76,116,3084
"53015001502",5371,983,11,23,362,133,589,519,7991
"53015001600",5852,654,0,0,333,0,313,0,7152
"53015001700",4477,356,0,0,162,14,365,43,5417
"53015001800",1562,119,0,0,167,46,54,0,1948
"53015001900",4343,597,45,47,36,38,108,0,5214
"53015002001",3457,288,0,0,133,15,23,5,3921
"53015002002",5297,412,0,8,498,29,83,72,6399
"53015002100",1900,1058,0,13,354,250,217,242,4034
"53017950100",2751,402,0,32,2295,632,2606,824,9542
"53017950200",2165,441,0,14,223,100,62,17,3022
"53017950300",3742,404,0,0,1104,787,1371,940,8348
"53017950400",5699,159,40,1,664,512,953,541,8569
"53017950500",2079,280,0,0,542,144,566,89,3700
"53017950600",3407,124,16,0,765,36,671,24,5043
"53017950700",2905,550,0,0,1032,290,1234,356,6367
"53017950800",3211,551,15,14,882,362,1186,386,6607
"53019940000",295,120,0,0,815,370,46,9,1655
"53019970100",1860,443,4,2,119,146,97,30,2701
"53019970200",2526,512,7,0,256,66,91,32,3490
"53021020100",4744,740,0,0,4315,1238,7652,1958,20647
"53021020200",2644,1220,95,15,1389,808,2983,1767,10921
"53021020300",2359,1102,73,7,1522,478,2723,1379,9643
"53021020400",3314,1836,165,184,2004,1490,4067,2853,15913
"53021020501",4044,266,115,0,522,6,921,113,5987
"53021020502",6790,612,128,0,1720,2,2587,332,12171
"53021020601",6963,862,103,0,1244,204,2274,540,12190
"53021020603",2176,301,142,111,189,925,426,999,5269
"53021020605",6910,372,109,0,738,2,2767,25,10923
"53021020606",5144,187,46,96,1690,436,2424,326,10349
"53021020700",1200,51,4,0,295,0,396,0,1946
"53021020800",4275,779,68,0,1404,1076,2976,1546,12124
"53021980100",0,0,0,0,0,0,0,0,0
"53023970300",1892,251,0,0,56,1,26,49,2275
"53025010100",3151,543,0,12,352,72,116,9,4255
"53025010200",2312,263,4,0,151,22,294,86,3132
"53025010300",2699,638,20,1,439,298,405,268,4768
"53025010400",5553,820,0,0,1225,415,1235,369,9617
"53025010500",1849,131,16,8,810,647,919,666,5046
"53025010600",2739,1155,7,0,2733,552,4055,1526,12767
"53025010700",1580,112,0,1,833,341,799,348,4014
"53025010800",1836,889,61,38,904,641,844,748,5961
"53025010901",842,169,0,0,270,37,320,37,1675
"53025010902",6625,892,184,92,2028,408,2499,254,12982
"53025011000",8468,1088,42,0,1799,156,2432,483,14468
"53025011100",4577,888,109,0,861,324,1559,569,8887
"53025011200",4220,228,0,0,524,212,659,235,6078
"53025011300",1843,339,37,20,1276,366,1881,626,6388
"53025011401",1594,76,0,0,487,126,1119,126,3528
"53025011402",5417,979,0,5,4156,2291,7737,3148,23733
"53027000200",5910,514,46,1,757,111,223,0,7562
"53027000300",2712,279,0,1,239,51,129,53,3464
"53027000400",5615,236,0,0,448,17,440,47,6803
"53027000500",4751,1061,5,8,351,12,158,62,6408
"53027000600",2933,501,15,3,163,95,122,35,3867
"53027000700",3274,721,27,0,597,177,112,30,4938
"53027000800",3235,852,23,0,113,40,235,189,4687
"53027000900",4196,764,0,54,510,384,468,144,6520
"53027001000",2017,891,0,6,342,246,517,520,4539
"53027001100",3172,427,0,4,273,92,122,0,4090
"53027001200",3018,643,43,52,336,361,860,525,5838
"53027001300",2452,697,0,0,166,45,130,251,3741
"53027001400",1292,408,31,39,142,153,50,88,2203
"53027001500",2531,960,0,1,278,148,480,95,4493
"53027001600",2930,823,29,0,273,59,153,170,4437
"53027940000",171,50,0,13,503,357,77,22,1193
"53027990000",0,0,0,0,0,0,0,0,0
"53029970100",1908,154,99,0,452,23,174,0,2810
"53029970200",281,49,37,0,41,0,59,6,473
"53029970300",3735,213,71,0,344,27,0,0,4390
"53029970400",3393,835,274,74,1668,236,444,246,7170
"53029970500",4538,313,35,0,530,204,394,0,6014
"53029970601",1916,265,344,0,899,40,329,43,3836
"53029970602",2153,423,36,25,492,46,314,26,3515
"53029970700",1048,283,296,55,155,44,95,43,2019
"53029970800",2037,214,103,8,261,25,193,56,2897
"53029970900",3045,245,392,66,925,122,657,130,5582
"53029971000",3742,456,15,0,649,3,304,82,5251
"53029971100",2472,207,32,0,109,20,110,6,2956
"53029971300",3922,389,0,0,148,122,13,0,4594
"53029971400",3659,218,31,11,258,17,42,6,4242
"53029971500",2904,228,15,0,79,11,59,0,3296
"53029971600",3561,263,6,0,331,4,406,0,4571
"53029971700",3431,142,0,0,244,38,238,51,4144
"53029971800",2208,48,0,0,59,0,68,0,2383
"53029971900",3175,462,27,0,273,46,59,0,4042
"53029972000",3339,533,5,0,142,51,238,0,4308
"53029972100",3097,172,23,0,207,0,102,0,3601
"53029992201",0,0,0,0,0,0,0,0,0
"53031950202",1127,173,0,3,93,6,33,4,1439
"53031950300",5209,363,0,0,249,92,65,34,6012
"53031950400",3550,522,0,0,175,97,163,30,4537
"53031950500",5386,657,0,0,532,26,363,6,6970
"53031950601",5011,660,18,0,437,8,149,0,6283
"53031950602",2429,354,2,131,216,25,31,26,3214
"53031950702",991,226,0,0,274,165,32,21,1709
"53031990000",0,0,0,0,0,0,0,0,0
"53033000100",3581,593,680,168,1319,543,572,288,7744
"53033000200",4478,361,418,217,2121,351,438,0,8384
"53033000300",1709,268,78,41,478,56,136,24,2790
"53033000401",3004,517,494,365,836,530,359,140,6245
"53033000402",3534,148,307,93,474,96,178,19,4849
"53033000500",2546,112,32,0,312,38,47,0,3087
"53033000600",4538,482,371,151,1948,159,845,65,8559
"53033000700",2847,365,376,58,940,297,392,151,5426
"53033000800",1957,99,22,0,265,78,46,0,2467
"53033000900",1554,78,10,7,253,54,67,0,2023
"53033001000",1114,58,268,216,283,155,44,68,2206
"53033001100",1778,156,88,30,468,149,155,0,2824
"53033001200",2979,1089,213,155,1703,397,512,148,7196
"53033001300",2605,297,167,62,1044,214,314,68,4771
"53033001400",4400,327,0,0,698,80,312,74,5891
"53033001500",2182,79,0,0,104,33,94,0,2492
"53033001600",3341,136,15,10,484,117,177,24,4304
"53033001701",2548,318,99,39,975,76,306,36,4397
"53033001702",3144,272,33,29,658,139,247,55,4577
"53033001800",3581,333,9,0,963,331,290,285,5792
"53033001900",2899,457,95,59,884,292,239,13,4938
"53033002000",2806,266,3,3,433,89,61,43,3704
"53033002100",3012,145,86,0,820,66,156,0,4285
"53033002200",4442,130,0,5,968,17,262,0,5824
"53033002400",2333,121,17,0,493,30,112,0,3106
"53033002500",2487,136,26,0,332,0,71,8,3060
"53033002600",3686,429,76,30,620,148,113,9,5111
"53033002700",4392,361,113,0,994,151,171,109,6291
"53033002800",3837,346,150,5,292,97,176,0,4903
"53033002900",3770,148,0,0,356,29,82,0,4385
"53033003000",4819,199,35,0,510,146,220,69,5998
"53033003100",5510,320,42,0,335,0,400,15,6622
"53033003200",6672,633,0,13,776,139,295,200,8728
"53033003300",5444,254,78,0,634,122,271,18,6821
"53033003400",2980,156,25,0,416,10,88,0,3675
"53033003500",2979,282,16,3,594,35,211,28,4148
"53033003600",4258,471,48,29,879,386,290,48,6409
"53033003800",1602,162,46,4,301,22,114,0,2251
"53033003900",2459,161,0,0,452,8,88,8,3176
"53033004000",2032,291,45,180,400,93,57,29,3127
"53033004100",6166,387,0,0,1134,159,131,0,7977
"53033004200",6496,349,147,2,995,185,311,0,8485
"53033004301",2154,346,19,27,633,364,46,19,3608
"53033004302",850,855,29,47,359,697,11,72,2920
"53033004400",3374,1788,214,17,483,489,226,157,6748
"53033004500",1983,452,15,31,412,134,114,0,3141
"53033004600",2837,207,18,0,376,26,146,15,3625
"53033004700",6568,443,186,0,1051,140,345,111,8844
"53033004800",4088,262,48,0,334,40,118,0,4890
"53033004900",5508,267,26,37,898,82,214,80,7112
"53033005000",3102,174,49,0,352,18,86,0,3781
"53033005100",3031,158,12,0,469,56,242,12,3980
"53033005200",2976,1078,43,61,828,1628,190,106,6910
"53033005301",890,1402,43,26,839,1775,77,240,5292
"53033005302",47,35,0,0,26,35,0,0,143
"53033005400",3867,363,19,52,680,41,221,46,5289
"53033005600",5568,120,44,0,612,80,146,0,6570
"53033005700",5282,308,0,16,974,53,297,49,6979
"53033005801",3682,357,430,105,498,39,337,0,5448
"53033005802",3719,190,311,0,684,131,190,47,5272
"53033005900",4720,769,48,58,542,91,162,17,6407
"53033006000",4240,454,36,0,623,21,324,0,5698
"53033006100",4182,168,97,1,693,63,181,43,5428
"53033006200",3380,118,38,10,416,43,161,9,4175
"53033006300",4165,143,67,0,532,46,127,0,5080
"53033006400",2871,113,25,23,306,3,95,3,3439
"53033006500",3866,206,19,1,341,16,107,18,4574
"53033006600",2627,134,79,4,637,102,126,50,3759
"53033006700",5111,187,291,41,1745,225,119,25,7744
"53033006800",2612,165,31,0,377,21,71,19,3296
"53033006900",4040,122,33,0,496,20,51,0,4762
"53033007000",5736,247,167,29,1266,18,439,0,7902
"53033007100",2560,319,85,58,627,124,197,80,4050
"53033007200",3747,339,261,34,1580,602,354,55,6972
"53033007300",3298,652,129,196,1010,245,328,80,5938
"53033007401",3499,457,145,0,874,44,259,46,5324
"53033007402",3076,519,163,150,1144,158,88,94,5392
"53033007500",5203,566,226,217,1291,280,743,22,8548
"53033007600",2699,252,294,54,455,48,168,5,3975
"53033007700",3461,231,422,299,634,50,139,0,5236
"53033007800",3678,158,429,38,1178,160,145,109,5895
"53033007900",4027,599,622,232,505,184,281,7,6457
"53033008001",3501,422,325,239,1341,139,169,0,6136
"53033008002",1779,650,119,85,529,84,114,99,3459
"53033008100",2282,525,125,196,610,350,117,81,4286
"53033008200",2330,346,177,115,639,211,248,23,4089
"53033008300",2019,195,62,23,365,104,142,26,2936
"53033008400",2623,437,236,0,637,157,160,0,4250
"53033008500",1393,266,110,236,387,365,199,8,2964
"53033008600",1416,664,155,128,613,380,245,95,3696
"53033008700",2098,340,707,169,980,91,489,42,4916
"53033008800",2354,216,438,87,536,196,382,26,4235
"53033008900",2176,62,833,219,1217,46,317,0,4870
"53033009000",1143,222,468,298,891,328,93,0,3443
"53033009100",454,48,120,354,1363,346,84,0,2769
"53033009200",1052,298,141,155,520,468,148,44,2826
"53033009300",1120,256,96,169,892,151,288,32,3004
"53033009400",1784,196,373,271,2293,816,590,35,6358
"53033009500",3600,459,1107,145,574,411,181,85,6562
"53033009600",4208,128,38,173,618,74,203,13,5455
"53033009701",4792,196,99,0,615,15,238,0,5955
"53033009702",4848,95,30,2,456,155,166,0,5752
"53033009800",5756,234,13,67,709,123,336,16,7254
"53033009900",3413,217,346,1,955,122,525,52,5631
"53033010001",1192,63,981,301,1402,193,114,0,4246
"53033010002",2287,231,172,28,1867,178,1040,128,5931
"53033010100",2731,177,1522,518,1164,499,215,133,6959
"53033010200",2752,194,471,66,1026,34,131,22,4696
"53033010300",2459,293,1061,421,1580,436,436,106,6792
"53033010401",561,172,467,96,2647,748,32,113,4836
"53033010402",1223,185,604,0,2928,260,510,96,5806
"53033010500",4662,530,89,14,962,127,319,52,6755
"53033010600",6068,405,224,91,1154,107,526,31,8606
"53033010701",1478,322,511,613,558,151,218,10,3861
"53033010702",1334,161,800,1114,540,443,280,41,4713
"53033010800",2163,211,214,247,1534,272,151,99,4891
"53033010900",697,148,15,6,174,15,103,14,1172
"53033011001",535,254,804,921,1511,884,129,146,5184
"53033011002",292,82,245,850,2980,273,107,41,4870
"53033011101",1100,185,785,248,2340,411,358,56,5483
"53033011102",1833,323,201,314,1477,421,285,547,5401
"53033011200",1463,1026,57,15,995,463,608,1093,5720
"53033011300",3468,373,294,31,2676,119,604,27,7592
"53033011401",1957,356,451,133,891,253,509,270,4820
"53033011402",2313,166,291,356,1002,277,739,21,5165
"53033011500",3071,160,112,84,748,69,317,51,4612
"53033011600",5530,177,31,19,684,71,213,0,6725
"53033011700",889,46,1087,261,2799,374,373,53,5882
"53033011800",1984,767,1245,1443,1784,787,984,728,9722
"53033011900",1619,243,1416,123,3121,874,551,0,7947
"53033012000",2725,174,97,0,467,11,82,0,3556
"53033012100",2207,20,47,1,513,53,210,12,3063
"53033020100",2457,155,49,4,420,15,97,0,3197
"53033020200",3880,369,45,31,973,84,279,42,5703
"53033020300",4028,597,257,60,1750,123,767,54,7636
"53033020401",2282,272,212,0,703,39,234,0,3742
"53033020402",4189,227,28,0,1070,65,628,0,6207
"53033020500",3959,246,108,118,1405,209,426,100,6571
"53033020600",2070,181,338,0,823,191,200,48,3851
"53033020700",2148,403,138,103,725,174,402,194,4287
"53033020800",3349,181,53,0,602,30,75,35,4325
"53033020900",2517,309,160,25,516,67,191,0,3785
"53033021000",3208,493,468,12,1276,229,421,0,6107
"53033021100",2125,266,276,230,1380,137,557,11,4982
"53033021300",2718,239,184,21,712,55,227,13,4169
"53033021400",3204,303,87,31,389,70,116,0,4200
"53033021500",3750,86,67,62,464,55,95,0,4579
"53033021600",3542,343,161,23,774,58,149,87,5137
"53033021700",5902,444,189,11,1779,278,954,315,9872
"53033021802",3731,454,74,0,1132,104,264,0,5759
"53033021803",3323,369,95,113,635,150,238,78,5001
"53033021804",3386,167,117,15,630,217,385,218,5135
"53033021903",4103,316,138,52,1029,75,469,0,6182
"53033021904",2973,136,10,0,1560,277,315,10,5281
"53033021905",3978,295,52,0,1144,13,604,43,6129
"53033021906",2983,212,29,0,821,71,175,41,4332
"53033022001",3851,124,28,0,989,9,270,46,5317
"53033022003",3837,294,34,21,819,22,469,31,5527
"53033022005",2854,217,80,0,1649,54,432,104,5390
"53033022006",2699,144,15,32,550,160,380,0,3980
"53033022101",3622,358,8,21,539,90,130,77,4845
"53033022102",4496,217,0,10,1585,23,402,62,6795
"53033022201",3470,323,32,0,574,60,242,8,4709
"53033022202",5966,252,134,31,1279,71,749,100,8582
"53033022203",3839,281,11,0,843,16,90,0,5080
"53033022300",2057,64,23,0,420,1,112,1,2678
"53033022400",7036,244,84,1,1146,178,274,23,8986
"53033022500",6039,270,0,0,945,36,244,46,7580
"53033022603",3611,161,63,0,1668,29,322,69,5923
"53033022604",3366,75,138,0,851,77,238,0,4745
"53033022605",3441,489,111,0,1884,210,1366,156,7657
"53033022606",4415,131,127,0,1171,119,846,15,6824
"53033022701",1967,98,13,0,382,46,112,6,2624
"53033022702",2611,317,27,0,521,73,102,0,3651
"53033022703",1667,156,51,0,383,0,66,43,2366
"53033022801",3266,193,362,31,4274,248,468,41,8883
"53033022802",2904,226,83,1,1459,93,239,0,5005
"53033022803",2116,307,71,0,2738,130,115,25,5502
"53033022901",1846,72,90,0,818,0,55,44,2925
"53033022902",4113,116,124,0,1848,205,177,13,6596
"53033023000",3660,136,95,0,1026,75,230,8,5230
"53033023100",2545,62,141,17,1161,70,272,0,4268
"53033023201",2015,305,30,0,3949,137,435,29,6900
"53033023202",1706,670,377,116,1534,290,424,438,5555
"53033023300",4562,186,2,0,1331,152,298,86,6617
"53033023401",1659,229,18,43,1396,205,150,32,3732
"53033023403",2772,157,74,16,1046,98,160,48,4371
"53033023404",2607,29,22,8,635,7,14,7,3329
"53033023500",2217,166,25,47,1161,56,138,33,3843
"53033023601",2054,206,65,68,1294,167,186,89,4129
"53033023603",2655,167,119,128,2691,518,574,188,7040
"53033023604",2824,179,235,97,2236,660,653,370,7254
"53033023700",2805,133,38,1,1197,28,177,1,4380
"53033023801",1249,99,50,0,744,90,86,9,2327
"53033023803",2719,132,51,0,1424,661,262,20,5269
"53033023804",3268,255,193,1,2159,285,100,2,6263
"53033023900",4723,702,60,0,1364,134,151,167,7301
"53033024000",4719,188,28,2,2833,49,221,0,8040
"53033024100",3807,69,2,0,895,52,87,0,4912
"53033024200",2203,120,15,0,714,57,36,0,3145
"53033024300",5240,550,222,0,1871,169,109,37,8198
"53033024400",1920,75,31,34,528,16,135,16,2755
"53033024500",3676,149,121,0,1056,1,154,0,5157
"53033024601",3597,60,0,0,921,2,128,1,4709
"53033024602",3118,13,31,0,570,22,170,0,3924
"53033024701",2327,82,164,17,1132,144,230,39,4135
"53033024702",4966,286,190,64,2030,236,322,140,8234
"53033024800",2785,239,151,0,2258,203,1177,63,6876
"53033024901",2382,106,56,1,2410,91,75,1,5122
"53033024902",2324,112,36,0,1237,60,293,9,4071
"53033024903",3677,79,0,1,3085,138,78,0,7058
"53033025001",3163,87,79,0,1414,35,158,0,4936
"53033025003",4438,223,18,0,2247,53,474,41,7494
"53033025005",2582,104,117,26,1757,96,213,31,4926
"53033025006",3834,80,54,339,1536,157,304,331,6635
"53033025101",3269,349,269,72,1277,348,392,356,6332
"53033025102",3946,95,197,143,3006,331,503,0,8221
"53033025200",4860,388,405,86,2003,299,855,62,8958
"53033025301",3830,183,197,22,1232,197,106,113,5880
"53033025302",2225,459,515,522,1038,417,601,176,5953
"53033025400",2779,606,400,302,2721,437,1188,177,8610
"53033025500",2587,472,251,36,1575,99,914,366,6300
"53033025601",2194,281,167,48,1826,562,590,246,5914
"53033025602",3459,124,82,0,2576,215,387,60,6903
"53033025701",2947,367,859,44,1008,162,395,49,5831
"53033025702",1833,131,366,31,1032,123,126,0,3642
"53033025803",2510,185,515,292,1421,98,1318,76,6415
"53033025804",1993,227,296,105,1166,53,404,5,4249
"53033025805",1970,276,417,118,2185,282,1034,342,6624
"53033025806",1570,99,639,117,2154,226,97,0,4902
"53033026001",1857,171,1323,129,2211,64,317,47,6119
"53033026002",2684,155,1815,1054,2567,611,664,123,9673
"53033026100",1632,148,1469,539,2523,212,406,85,7014
"53033026200",2396,306,1045,106,1438,354,578,197,6420
"53033026300",466,48,147,6,850,70,115,9,1711
"53033026400",2636,294,734,363,1260,398,1112,452,7249
"53033026500",1361,275,480,514,980,618,577,428,5233
"53033026600",1281,172,383,33,916,23,464,125,3397
"53033026700",2906,370,166,131,1286,167,384,174,5584
"53033026801",1812,362,246,260,2399,436,1325,551,7391
"53033026802",2238,479,77,250,1629,211,1255,330,6469
"53033027000",1818,159,223,42,822,476,524,287,4351
"53033027100",1660,427,171,64,470,400,676,235,4103
"53033027200",755,200,203,178,738,461,208,234,2977
"53033027300",2657,410,665,100,1411,956,1127,405,7731
"53033027400",2653,557,310,7,1311,177,656,257,5928
"53033027500",2512,329,73,117,1292,386,1059,31,5799
"53033027600",3096,386,308,52,515,547,1519,526,6949
"53033027701",4827,238,0,1,219,193,68,25,5571
"53033027702",4165,152,51,0,213,0,125,0,4706
"53033027800",2855,113,32,0,212,1,146,10,3369
"53033027900",5421,351,147,147,879,300,876,349,8470
"53033028000",1687,623,197,427,840,249,844,468,5335
"53033028100",718,141,337,286,678,222,308,45,2735
"53033028200",1232,572,708,753,1599,122,456,408,5850
"53033028300",2632,158,363,98,1737,22,504,30,5544
"53033028402",1569,126,1104,400,1320,256,432,20,5227
"53033028403",1787,142,1431,316,1077,471,325,90,5639
"53033028500",2232,246,290,77,809,231,600,128,4613
"53033028600",5413,144,0,0,785,237,545,0,7124
"53033028700",3563,312,170,3,928,110,413,71,5570
"53033028801",1295,169,55,0,439,127,408,128,2621
"53033028802",2357,811,955,1039,1311,534,940,477,8424
"53033028901",2658,115,10,46,578,51,390,0,3848
"53033028902",2366,547,391,336,1933,856,1707,296,8432
"53033029001",3009,333,74,10,816,118,348,132,4840
"53033029003",2872,496,728,181,1339,295,1191,117,7219
"53033029004",1422,393,405,291,640,528,921,551,5151
"53033029101",1419,81,413,13,911,102,174,0,3113
"53033029102",1901,253,548,39,1114,127,435,110,4527
"53033029203",1174,317,378,102,505,451,538,227,3692
"53033029204",3537,322,708,46,2482,52,1000,22,8169
"53033029205",2559,327,299,18,1814,59,1673,57,6806
"53033029206",1655,487,209,84,1357,436,1027,328,5583
"53033029303",2985,408,832,37,2784,338,226,293,7903
"53033029304",3110,334,178,24,1541,92,217,190,5686
"53033029305",2243,133,94,162,1078,156,247,26,4139
"53033029306",1646,57,245,38,1351,31,33,0,3401
"53033029307",2614,79,172,1,1390,2,247,15,4520
"53033029403",2320,136,438,61,2341,363,610,145,6414
"53033029405",2908,256,368,104,1990,155,314,74,6169
"53033029406",2218,133,420,204,2092,97,245,0,5409
"53033029407",1791,509,381,101,1191,521,597,406,5497
"53033029408",1851,493,347,56,1427,72,1004,87,5337
"53033029502",3901,364,448,215,1650,317,258,249,7402
"53033029503",2531,2003,332,651,2165,1036,1262,1536,11516
"53033029504",2903,587,618,790,1510,124,395,340,7267
"53033029601",2751,565,555,196,2080,380,626,141,7294
"53033029602",3470,445,122,8,1546,1,313,1,5906
"53033029700",4753,985,707,187,1305,147,972,426,9482
"53033029801",4354,431,640,0,2604,753,1413,347,10542
"53033029802",4932,757,238,78,1908,207,728,398,9246
"53033029901",3436,191,359,19,917,25,476,72,5495
"53033029902",2763,154,383,0,887,9,147,11,4354
"53033030003",3031,359,686,52,2056,201,1143,212,7740
"53033030004",3823,588,724,368,1778,825,1738,636,10480
"53033030005",2475,722,510,14,1449,96,1150,393,6809
"53033030006",1357,345,408,197,889,688,677,593,5154
"53033030100",5211,633,492,0,1281,131,699,2,8449
"53033030201",2950,194,258,57,1477,178,768,27,5909
"53033030202",2719,387,814,91,1456,617,436,0,6520
"53033030304",2064,116,128,42,711,80,276,60,3477
"53033030305",2968,310,564,484,896,124,172,188,5706
"53033030306",3759,194,342,191,1059,242,575,200,6562
"53033030308",3678,382,474,380,1557,269,1208,211,8159
"53033030309",3201,292,908,29,1265,304,656,358,7013
"53033030310",3100,303,206,0,1737,173,583,177,6279
"53033030311",2819,820,410,16,1173,393,1269,871,7771
"53033030312",2811,218,295,131,1241,135,474,0,5305
"53033030313",1783,385,275,310,690,346,510,223,4522
"53033030314",2204,293,488,196,977,153,605,19,4935
"53033030401",5335,302,467,0,2379,532,489,52,9556
"53033030403",2736,226,233,0,1251,23,572,0,5041
"53033030404",3917,294,0,3,535,71,294,132,5246
"53033030501",876,291,53,56,136,231,38,39,1720
"53033030503",2621,440,251,10,1657,608,791,426,6804
"53033030504",2512,637,192,44,544,350,335,444,5058
"53033030600",3562,756,155,0,780,227,398,599,6477
"53033030700",2412,556,140,0,387,298,370,186,4349
"53033030801",2664,1646,58,402,1723,699,1819,1389,10400
"53033030802",2155,631,46,1,914,87,525,290,4649
"53033030901",2361,317,71,17,776,60,578,82,4262
"53033030902",3204,437,225,9,1774,353,617,177,6796
"53033031000",3081,30,98,0,577,19,32,0,3837
"53033031100",3687,778,313,68,1702,256,621,172,7597
"53033031202",4289,313,43,16,792,584,222,138,6397
"53033031204",4938,216,49,0,577,0,165,0,5945
"53033031205",4013,478,159,88,1381,407,322,83,6931
"53033031206",3103,269,118,56,1261,318,852,120,6097
"53033031301",2228,326,4,8,151,22,167,229,3135
"53033031302",3303,288,0,0,385,18,246,21,4261
"53033031400",4133,824,121,0,467,252,315,611,6723
"53033031501",3686,260,14,0,325,0,186,43,4514
"53033031502",3679,232,0,0,270,106,128,0,4415
"53033031601",4588,110,46,0,470,131,225,89,5659
"53033031603",4662,339,24,13,766,74,432,41,6351
"53033031604",4178,214,155,0,831,60,215,0,5653
"53033031605",3126,192,98,6,258,23,420,0,4123
"53033031703",4570,551,218,13,1367,0,425,315,7459
"53033031704",3330,152,300,112,1367,92,427,10,5790
"53033031705",3215,45,127,0,811,0,482,10,4690
"53033031706",4120,460,648,144,1137,170,302,31,7012
"53033031800",3538,91,111,19,819,46,251,2,4877
"53033031903",4956,77,237,0,1272,100,600,95,7337
"53033031904",2921,143,31,0,373,18,301,56,3843
"53033031906",2593,60,117,4,951,53,150,0,3928
"53033031907",4103,165,370,0,2989,108,512,108,8355
"53033031908",2430,222,626,100,1123,94,440,84,5119
"53033031909",1930,65,343,4,758,74,60,27,3261
"53033032002",2943,104,20,1,282,23,169,11,3553
"53033032003",4516,353,24,4,212,0,148,7,5264
"53033032005",5390,588,177,236,649,108,575,155,7878
"53033032006",3801,178,32,0,540,16,120,0,4687
"53033032007",3012,133,155,0,264,47,234,26,3871
"53033032008",3602,104,52,0,457,0,373,0,4588
"53033032010",4357,276,70,0,727,56,286,0,5772
"53033032011",3717,113,157,0,431,9,196,9,4632
"53033032102",4785,121,0,0,110,39,81,3,5139
"53033032103",3278,391,12,0,627,39,243,0,4590
"53033032104",4580,248,168,140,584,93,228,0,6041
"53033032203",5196,148,62,4,1947,158,226,0,7741
"53033032207",2734,64,10,0,483,9,119,0,3419
"53033032208",6211,323,185,0,1825,85,335,38,9002
"53033032210",8156,178,218,127,3589,23,647,0,12938
"53033032211",3109,134,91,0,1596,0,22,52,5004
"53033032212",5337,138,103,0,2890,140,410,76,9094
"53033032213",3591,73,1,0,910,0,112,0,4687
"53033032214",3728,54,43,2,2465,36,202,0,6530
"53033032215",3255,20,20,0,1931,50,139,0,5415
"53033032307",5873,77,54,37,646,40,215,17,6959
"53033032309",3398,289,99,0,2247,445,422,32,6932
"53033032311",5174,230,85,0,397,12,303,0,6201
"53033032313",3036,223,85,0,3076,284,1162,199,8065
"53033032315",4457,216,11,14,574,19,190,0,5481
"53033032316",4316,119,28,0,1241,65,185,14,5968
"53033032317",5142,307,19,0,784,51,332,133,6768
"53033032318",3758,90,74,0,1781,94,426,10,6233
"53033032319",3988,387,107,0,510,19,171,19,5201
"53033032320",4186,66,1,0,404,4,213,0,4874
"53033032321",3146,131,42,8,1877,38,131,8,5381
"53033032322",2951,76,24,0,569,1,51,1,3673
"53033032323",4131,108,69,0,1347,11,352,0,6018
"53033032324",3510,266,44,0,1195,302,510,171,5998
"53033032325",2883,207,40,134,1735,105,229,45,5378
"53033032326",3297,287,20,0,657,11,404,88,4764
"53033032327",3483,115,0,0,397,0,53,0,4048
"53033032328",2913,59,13,30,339,0,132,48,3534
"53033032329",4544,109,44,17,3968,15,287,15,8999
"53033032401",4837,618,0,2,229,0,26,152,5864
"53033032402",5690,146,255,0,230,56,326,24,6727
"53033032500",4583,225,67,1,475,40,266,37,5694
"53033032601",2479,145,0,0,0,0,25,0,2649
"53033032602",10116,142,53,0,1938,103,202,57,12611
"53033032702",5999,198,110,102,318,37,206,181,7151
"53033032703",2106,43,8,0,99,6,150,0,2412
"53033032704",5246,703,113,5,187,260,62,403,6979
"53033032800",2184,92,0,5,53,7,63,1,2405
"53033990100",0,0,0,0,0,0,0,0,0
"53035080101",1864,287,104,34,685,70,148,10,3202
"53035080102",2784,512,263,54,1239,479,547,429,6307
"53035080200",2210,252,10,158,450,456,267,193,3996
"53035080300",2397,265,33,64,459,171,343,31,3763
"53035080400",2464,269,66,33,325,186,72,127,3542
"53035080500",1080,719,50,198,369,108,146,84,2754
"53035080600",2672,1117,109,0,877,116,471,2,5364
"53035080700",2517,333,31,9,310,31,110,12,3353
"53035080800",970,196,126,0,378,125,262,11,2068
"53035080900",3229,563,25,14,626,257,389,0,5103
"53035081000",2686,772,109,25,502,76,708,42,4920
"53035081100",1511,385,157,5,528,107,88,9,2790
"53035081200",2126,627,60,84,274,86,190,13,3460
"53035081400",119,0,0,0,0,0,23,0,142
"53035090101",4586,358,20,0,1089,178,254,12,6497
"53035090102",5174,84,0,0,709,45,193,12,6217
"53035090201",3996,99,37,19,135,0,225,0,4511
"53035090202",4533,128,10,2,587,7,271,11,5549
"53035090300",3068,279,82,0,732,55,845,116,5177
"53035090400",3895,461,30,0,431,80,83,59,5039
"53035090501",2835,268,39,0,296,5,144,20,3607
"53035090502",3516,392,76,0,992,148,815,137,6076
"53035090700",4338,204,24,0,403,46,322,0,5337
"53035090800",3734,138,0,0,140,8,66,0,4086
"53035090900",6141,402,14,49,444,81,312,0,7443
"53035091000",5880,259,183,55,603,0,454,0,7434
"53035091100",3791,300,10,0,401,55,158,0,4715
"53035091201",2669,382,54,21,651,65,163,29,4034
"53035091203",4468,232,457,21,1933,139,715,36,8001
"53035091204",2617,162,95,0,618,65,113,18,3688
"53035091301",3688,107,93,0,411,8,118,8,4433
"53035091302",4310,173,51,6,767,78,391,0,5776
"53035091400",2491,95,48,0,702,39,128,39,3542
"53035091500",2752,192,289,35,783,46,253,44,4394
"53035091600",4305,465,221,0,1292,120,463,115,6981
"53035091700",5149,371,222,132,2068,163,557,0,8662
"53035091800",1955,98,144,0,390,0,260,0,2847
"53035091900",2827,185,123,290,988,134,165,0,4712
"53035092000",4974,225,46,0,728,17,92,0,6082
"53035092100",6087,542,60,0,888,68,249,73,7967
"53035092200",3847,895,48,47,577,210,364,298,6286
"53035092300",3939,814,77,0,1121,170,808,34,6963
"53035092400",4467,556,160,0,627,52,307,131,6300
"53035092500",3891,542,225,19,425,36,77,0,5215
"53035092600",4020,702,14,22,644,181,138,65,5786
"53035092701",3487,275,9,0,293,101,209,0,4374
"53035092704",2752,204,11,0,194,17,70,37,3285
"53035092801",3625,236,205,13,447,61,427,43,5057
"53035092802",3297,371,0,0,287,9,185,0,4149
"53035092803",2054,370,9,0,121,18,41,12,2625
"53035092901",3965,610,38,0,494,35,269,0,5411
"53035092902",4401,523,44,0,542,108,249,6,5873
"53035940000",2708,320,5,3,354,67,117,30,3604
"53035940100",4520,448,35,0,1031,190,262,25,6511
"53035990100",0,0,0,0,0,0,0,0,0
"53037975100",5311,753,48,0,380,43,216,45,6796
"53037975200",4262,390,0,0,372,12,124,12,5172
"53037975300",3816,544,0,0,180,0,110,29,4679
"53037975401",2614,2283,230,44,311,559,537,302,6880
"53037975402",3840,1000,0,0,208,234,352,0,5634
"53037975500",3306,1396,0,0,403,342,366,175,5988
"53037975600",1243,681,9,0,53,11,219,62,2278
"53037975700",3724,496,0,4,627,12,664,55,5582
"53039950100",6451,1190,1,88,562,171,453,66,8982
"53039950200",3576,769,12,5,140,49,91,288,4930
"53039950300",6041,816,0,30,769,32,1386,204,9278
"53041970100",2959,365,4,0,118,0,34,0,3480
"53041970200",2155,815,0,0,192,13,91,224,3490
"53041970300",2773,733,51,94,161,520,99,372,4803
"53041970400",4715,851,0,2,397,52,1209,270,7496
"53041970500",1571,162,0,0,191,32,157,26,2139
"53041970600",1442,441,2,2,89,91,291,99,2457
"53041970700",2981,920,18,2,138,219,595,366,5239
"53041970800",3382,542,53,0,130,30,507,47,4691
"53041970900",1055,288,143,6,20,80,110,20,1722
"53041971000",1995,511,0,2,103,96,294,87,3088
"53041971100",3028,432,29,0,273,59,138,24,3983
"53041971200",2224,268,0,0,104,27,131,20,2774
"53041971300",4912,860,1,0,218,6,210,0,6207
"53041971400",2006,164,34,0,486,134,121,12,2957
"53041971500",5808,779,2,0,444,145,374,78,7630
"53041971600",2822,553,62,0,139,44,213,30,3863
"53041971700",3881,488,0,0,291,69,339,78,5146
"53041971800",3896,360,0,0,90,0,87,0,4433
"53041971900",2129,616,0,0,103,9,89,0,2946
"53041972000",2242,220,4,0,147,24,102,0,2739
"53043960100",1235,288,0,0,21,4,27,0,1575
"53043960200",2428,432,7,0,120,22,25,51,3085
"53043960300",2078,323,11,4,195,0,84,18,2713
"53043960400",2378,466,2,0,190,23,58,20,3137
"53045940000",122,34,21,5,389,185,33,21,810
"53045960100",600,41,0,0,18,19,3,0,681
"53045960200",3629,1201,0,0,500,408,17,223,5978
"53045960300",4420,492,0,170,320,18,56,188,5664
"53045960400",6678,1050,69,236,421,95,266,466,9281
"53045960500",4754,209,0,97,93,87,61,0,5301
"53045960600",2496,346,5,0,829,175,596,50,4497
"53045960700",1022,115,0,0,243,211,185,216,1992
"53045960800",2249,619,0,9,304,176,358,279,3994
"53045960900",2907,860,29,0,419,792,466,699,6172
"53045961000",4058,474,113,0,559,75,259,44,5582
"53045961100",4482,721,40,65,276,32,29,118,5763
"53045961200",3573,201,0,0,285,12,11,12,4094
"53045961300",2343,625,11,4,672,307,202,297,4461
"53047940100",734,193,21,4,1207,477,31,84,2751
"53047940200",976,368,6,0,1010,572,318,168,3418
"53047970300",5184,1013,0,0,846,552,617,371,8583
"53047970400",2513,572,0,11,334,250,406,230,4316
"53047970500",1810,353,0,0,178,18,84,130,2573
"53047970600",4186,469,31,22,1082,560,564,382,7296
"53047970700",2694,612,9,65,427,355,458,468,5088
"53047970800",3059,597,37,3,1041,570,2098,813,8218
"53047970900",1687,222,0,0,54,20,32,5,2020
"53047971000",2673,700,5,12,261,56,282,145,4134
"53049950200",3050,689,14,0,292,342,379,114,4880
"53049950300",2120,697,0,0,497,263,254,257,4088
"53049950400",3072,407,0,15,153,70,148,110,3975
"53049950500",2287,299,5,4,62,48,162,90,2957
"53049950600",794,324,3,3,85,4,159,26,1398
"53049950700",2134,345,0,0,116,1,34,0,2630
"53049950800",1697,371,0,0,117,36,24,6,2251
"53049990100",0,0,0,0,0,0,0,0,0
"53051970100",1698,290,0,0,121,22,60,53,2244
"53051970200",2018,314,0,0,280,82,72,0,2766
"53051970300",2178,872,0,6,183,18,100,14,3371
"53051970400",1792,558,14,0,117,26,51,0,2558
"53051970500",1514,537,0,0,156,28,88,14,2337
"53053060200",607,281,10,0,101,21,50,222,1292
"53053060300",3408,268,110,37,253,2,66,0,4144
"53053060400",3223,281,7,0,265,102,206,20,4104
"53053060500",3437,279,50,0,321,8,142,16,4253
"53053060600",4169,591,107,15,362,85,125,4,5458
"53053060700",3724,883,186,54,302,117,233,54,5553
"53053060800",4620,215,0,10,211,0,170,0,5226
"53053060903",2374,475,207,0,394,0,203,181,3834
"53053060904",3488,776,58,20,462,317,176,0,5297
"53053060905",4233,949,597,109,654,51,292,142,7027
"53053060906",1633,68,93,26,310,29,118,25,2302
"53053061001",2892,188,50,24,504,27,251,9,3945
"53053061002",2496,166,570,305,471,234,257,0,4499
"53053061100",4997,484,244,22,755,108,280,0,6890
"53053061200",3502,409,699,22,586,83,627,117,6045
"53053061300",2522,707,785,206,571,345,349,161,5646
"53053061400",829,686,178,254,472,165,133,85,2802
"53053061500",3134,855,249,122,390,172,316,216,5454
"53053061601",706,491,129,92,224,248,29,108,2027
"53053061602",455,118,33,31,123,56,54,7,877
"53053061700",1775,435,835,190,753,523,451,56,5018
"53053061800",906,259,163,72,714,563,164,150,2991
"53053061900",775,231,55,111,242,269,119,224,2026
"53053062000",1881,413,289,230,1243,413,648,213,5330
"53053062300",1666,513,468,120,1819,678,759,434,6457
"53053062400",3472,361,230,296,594,549,147,87,5736
"53053062500",3933,624,708,360,1984,187,760,0,8556
"53053062600",1395,334,599,73,532,187,151,84,3355
"53053062801",2623,1076,1289,241,860,199,507,587,7382
"53053062802",2215,318,586,43,813,173,307,64,4519
"53053062900",3489,1027,896,139,1588,248,710,527,8624
"53053063000",1406,246,465,25,657,238,307,68,3412
"53053063100",1897,438,445,18,1212,350,627,223,5210
"53053063200",3008,520,253,102,1165,420,532,133,6133
"53053063300",2776,377,741,287,3245,934,2161,899,11420
"53053063400",3417,854,512,398,1740,354,421,456,8152
"53053063501",1561,325,566,102,1530,278,900,114,5376
"53053063502",1768,182,473,26,1887,535,405,10,5286
"53053070100",2986,484,126,0,154,48,203,32,4033
"53053070203",4666,116,37,152,680,0,329,12,5992
"53053070204",2913,494,0,0,177,85,176,132,3977
"53053070205",2740,201,0,0,257,0,240,0,3438
"53053070206",3693,193,22,6,70,24,108,0,4116
"53053070207",4019,682,12,10,410,40,74,0,5247
"53053070307",4831,229,0,0,217,0,163,33,5473
"53053070308",3103,283,48,0,109,11,19,1,3574
"53053070309",4375,338,54,49,407,40,186,12,5461
"53053070310",4395,255,54,0,464,148,44,87,5447
"53053070311",3843,360,64,0,331,416,303,396,5713
"53053070312",4551,374,65,1,639,17,310,16,5973
"53053070313",4866,261,0,0,445,30,112,49,5763
"53053070314",2799,176,0,0,295,0,49,0,3319
"53053070315",4209,271,20,0,1085,0,188,16,5789
"53053070316",3708,38,468,0,1542,0,177,0,5933
"53053070401",1853,150,4,0,136,148,117,148,2556
"53053070403",3189,183,0,0,311,9,322,32,4046
"53053070404",3485,829,44,0,459,6,228,58,5109
"53053070703",5108,282,121,47,533,79,332,0,6502
"53053071100",1766,108,0,0,237,189,113,0,2413
"53053071205",3615,351,64,16,728,81,212,15,5082
"53053071206",4985,646,215,2,621,70,319,98,6956
"53053071207",4269,565,62,39,1341,27,735,100,7138
"53053071208",5434,436,245,1,1264,312,576,81,8349
"53053071209",3164,329,7,75,463,12,141,0,4191
"53053071210",3748,131,4,4,494,113,139,113,4746
"53053071304",3771,531,480,31,1280,156,623,0,6872
"53053071305",2769,284,19,33,427,197,274,120,4123
"53053071306",4499,128,325,62,1260,63,106,43,6486
"53053071307",3427,337,306,27,373,192,308,19,4989
"53053071309",2507,386,216,41,1015,288,305,0,4758
"53053071310",3758,157,197,3,804,21,480,10,5430
"53053071403",2782,213,312,8,666,67,154,78,4280
"53053071406",3927,654,658,0,1611,120,669,83,7722
"53053071407",4834,622,891,0,516,0,970,52,7885
"53053071408",2069,243,365,37,891,305,209,147,4266
"53053071409",2090,720,319,0,1020,213,331,220,4913
"53053071410",4259,879,856,0,664,137,830,443,8068
"53053071411",3106,510,566,98,928,36,688,21,5953
"53053071503",3369,290,435,42,972,107,748,3,5966
"53053071504",1845,991,305,319,741,218,231,114,4764
"53053071505",3222,286,467,60,930,79,364,45,5453
"53053071506",2941,317,458,78,1241,58,393,14,5500
"53053071601",1933,306,560,62,1245,707,1042,502,6357
"53053071602",3101,575,917,0,1672,357,343,237,7202
"53053071703",1042,691,506,117,785,258,314,276,3989
"53053071704",1792,599,459,144,1284,671,1673,460,7082
"53053071705",1868,536,124,53,940,300,328,354,4503
"53053071706",874,204,271,47,440,36,220,30,2122
"53053071707",1725,439,266,35,303,70,135,274,3247
"53053071803",2838,765,773,186,732,225,848,290,6657
"53053071805",806,495,292,146,1985,632,532,484,5372
"53053071806",1078,698,407,338,743,889,616,883,5652
"53053071807",1529,278,443,98,1034,177,339,151,4049
"53053071808",1510,951,278,122,1036,283,731,665,5576
"53053071901",2690,408,406,96,932,357,280,449,5618
"53053071902",3664,436,158,31,586,66,291,53,5285
"53053072000",1700,1046,259,30,605,629,364,1082,5715
"53053072105",2950,284,310,33,1139,146,247,25,5134
"53053072106",3361,611,705,139,1033,239,615,234,6937
"53053072107",2873,136,252,20,777,122,382,8,4570
"53053072108",3341,589,599,10,1036,35,400,19,6029
"53053072109",2537,84,195,0,472,107,245,15,3655
"53053072111",1682,214,82,10,562,84,128,14,2776
"53053072112",2387,201,387,90,1160,128,719,1,5073
"53053072305",4388,179,297,0,917,162,200,7,6150
"53053072307",2869,214,456,166,733,8,333,11,4790
"53053072308",4752,259,367,0,1582,479,554,256,8249
"53053072309",3839,684,188,0,1056,105,301,0,6173
"53053072310",2732,253,140,37,435,73,188,88,3946
"53053072311",2126,288,668,36,987,277,480,87,4949
"53053072312",2684,751,161,67,1418,54,241,108,5484
"53053072313",2416,204,187,55,647,80,107,26,3722
"53053072405",3745,82,0,0,286,0,161,0,4274
"53053072406",5715,66,24,0,242,1,283,1,6332
"53053072407",3213,362,125,3,867,46,444,64,5124
"53053072408",5178,241,104,0,298,65,148,45,6079
"53053072409",2348,72,20,0,119,13,116,0,2688
"53053072410",3147,171,6,20,387,0,37,0,3768
"53053072503",3567,255,7,4,416,198,85,3,4535
"53053072504",3402,162,89,0,233,174,34,63,4157
"53053072505",6281,75,59,9,517,122,335,65,7463
"53053072506",2521,242,58,0,233,61,29,32,3176
"53053072507",2139,165,13,0,349,9,132,17,2824
"53053072601",4264,424,63,6,591,86,421,1,5856
"53053072602",3628,392,0,0,146,9,86,10,4271
"53053072603",3674,555,13,49,185,27,40,7,4550
"53053072800",6343,389,737,105,1542,76,786,0,9978
"53053072901",1930,119,467,10,296,23,786,44,3675
"53053072903",1170,54,333,24,318,53,229,20,2201
"53053072905",3762,433,725,0,775,91,1038,66,6890
"53053072906",44,0,0,0,19,0,19,0,82
"53053072907",3171,802,686,0,669,24,888,169,6409
"53053073001",4752,826,2,0,427,63,295,0,6365
"53053073005",4100,773,46,0,422,159,28,111,5639
"53053073006",3392,177,0,0,140,34,235,7,3985
"53053073108",4886,661,552,0,1871,56,887,498,9411
"53053073110",3134,55,38,0,274,76,285,26,3888
"53053073111",3373,490,65,0,412,0,260,89,4689
"53053073113",5168,362,233,0,999,0,436,7,7205
"53053073114",4276,319,444,7,333,115,284,18,5796
"53053073115",3159,267,38,0,534,111,239,85,4433
"53053073116",2764,268,64,0,384,55,95,54,3684
"53053073117",3170,335,77,0,95,93,77,0,3847
"53053073118",3843,109,13,0,281,0,239,9,4494
"53053073119",2641,138,19,0,113,11,10,3,2935
"53053073120",2631,368,197,199,667,76,231,0,4369
"53053073121",3831,99,120,0,718,22,607,77,5474
"53053073122",3050,262,229,0,805,92,483,15,4936
"53053073123",3509,189,212,0,1189,0,438,0,5537
"53053073124",3170,119,0,0,439,4,217,1,3950
"53053073125",7015,619,528,165,830,384,706,228,10475
"53053073126",2196,354,485,0,1105,18,371,246,4775
"53053073200",4938,673,5,1,230,0,164,67,6078
"53053073301",4156,622,75,0,624,207,626,0,6310
"53053073302",3148,209,21,0,358,49,190,22,3997
"53053073404",4421,516,89,4,374,98,367,0,5869
"53053073405",2237,358,97,62,571,82,363,36,3806
"53053073406",3840,414,117,15,722,263,475,0,5846
"53053073407",3001,284,29,0,439,43,236,0,4032
"53053073408",3259,353,33,0,286,112,243,129,4415
"53053073500",5860,517,8,0,806,16,695,0,7902
"53053940001",2063,80,85,0,431,23,109,0,2791
"53053940002",2253,290,231,40,644,278,272,80,4088
"53053940003",3677,509,658,120,1967,310,907,286,8434
"53053940004",5157,442,283,7,660,42,324,7,6922
"53053940005",3715,236,447,42,1312,274,673,145,6844
"53053940006",416,176,307,656,654,692,80,158,3139
"53053940007",973,292,226,71,1240,449,439,135,3825
"53053940008",3642,392,362,21,1522,64,385,140,6528
"53053940009",2473,80,65,2,246,12,286,9,3173
"53053940010",3139,495,89,2,369,33,462,144,4733
"53053940011",3085,95,104,20,1009,20,163,12,4508
"53055960100",4412,615,32,12,294,81,158,118,5722
"53055960300",4073,305,23,12,144,12,105,19,4693
"53055960400",2196,249,7,0,266,37,280,60,3095
"53055960500",2317,425,17,1,151,74,68,113,3166
"53055990100",0,0,0,0,0,0,0,0,0
"53057940200",1964,117,0,0,131,12,58,0,2282
"53057940300",4212,287,20,1,222,15,159,10,4926
"53057940400",6091,414,24,0,385,40,286,11,7251
"53057940500",1708,515,9,18,212,41,246,95,2844
"53057940600",1237,219,1,12,19,5,77,13,1583
"53057940700",1281,141,7,0,89,15,54,2,1589
"53057940800",1970,160,9,8,561,177,135,7,3027
"53057950100",598,133,2,0,30,7,2,4,776
"53057950800",5007,590,0,0,136,35,123,437,6328
"53057950900",3301,468,7,139,269,145,272,112,4713
"53057951000",2201,367,0,0,126,24,70,24,2812
"53057951100",3517,955,8,2,266,149,240,71,5208
"53057951200",2755,92,1,0,182,35,208,0,3273
"53057951300",1467,210,0,0,94,0,92,17,1880
"53057951400",2658,790,54,0,306,191,292,458,4749
"53057951500",7147,1405,45,0,742,104,1016,64,10523
"53057951600",3281,573,0,11,142,368,492,600,5467
"53057951700",2853,312,0,0,363,136,400,197,4261
"53057951800",2078,937,21,40,1379,374,1262,600,6691
"53057951900",3141,98,9,1,323,13,132,0,3717
"53057952100",2869,409,0,1,62,10,332,115,3798
"53057952200",2008,1349,155,26,802,216,886,997,6439
"53057952301",1954,993,72,100,833,855,1370,1535,7712
"53057952302",6514,680,30,0,1220,768,1476,1175,11863
"53057952401",1944,463,0,0,436,46,729,77,3695
"53057952402",4979,735,13,1,1473,257,1681,531,9670
"53057952500",1743,469,0,14,363,40,467,83,3179
"53057952600",3110,206,45,1,290,38,340,96,4126
"53057952700",2783,195,0,8,374,34,300,8,3702
"53057990100",0,0,0,0,0,0,0,0,0
"53059950100",182,0,0,0,2,0,0,0,184
"53059950200",4138,494,26,22,153,36,17,0,4886
"53059950300",1252,329,0,29,84,14,67,3,1778
"53059950400",1820,198,18,0,44,43,283,18,2424
"53059950500",1721,337,0,0,212,24,241,4,2539
"53061040100",3112,244,171,0,194,24,103,0,3848
"53061040200",2528,914,238,82,1038,679,246,130,5855
"53061040300",2030,451,11,0,334,52,249,73,3200
"53061040400",2716,453,117,21,261,115,267,85,4035
"53061040500",1516,286,34,15,308,170,80,118,2527
"53061040700",2124,956,71,98,278,120,106,187,3940
"53061040800",1635,312,20,33,294,149,186,0,2629
"53061040900",2501,115,24,0,226,22,124,15,3027
"53061041000",3733,1249,132,0,543,73,474,145,6349
"53061041100",2909,408,65,0,956,275,626,85,5324
"53061041201",2122,366,42,0,647,136,149,37,3499
"53061041202",3595,1512,172,63,1002,69,509,610,7532
"53061041301",4406,183,0,0,779,0,119,0,5487
"53061041303",3250,206,90,0,689,58,645,28,4966
"53061041304",2332,8,58,0,444,15,132,0,2989
"53061041400",3927,452,41,0,833,165,744,148,6310
"53061041500",1049,200,16,11,60,24,68,7,1435
"53061041601",3961,238,160,20,1219,160,701,65,6524
"53061041605",4949,449,187,1,946,1,556,180,7269
"53061041606",3585,312,117,40,1258,172,294,14,5792
"53061041607",3119,151,59,0,621,12,126,67,4155
"53061041608",4939,62,178,0,1213,15,286,0,6693
"53061041701",3109,283,197,300,1369,225,661,268,6412
"53061041703",3651,279,149,292,1408,0,420,202,6401
"53061041704",3745,194,67,0,1190,288,256,207,5947
"53061041805",3112,362,241,65,1642,24,517,117,6080
"53061041806",4979,754,252,60,1794,752,1550,704,10845
"53061041808",2481,378,136,107,693,91,805,98,4789
"53061041809",2653,685,615,22,1328,143,1008,438,6892
"53061041810",2157,698,187,135,967,379,730,628,5881
"53061041811",4018,896,419,0,1525,281,649,489,8277
"53061041812",2683,791,308,0,1691,466,1124,421,7484
"53061041901",2526,380,93,5,1285,54,451,283,5077
"53061041903",4113,1140,336,305,1399,331,1012,615,9251
"53061041904",2957,1067,247,0,964,376,1384,647,7642
"53061041905",3282,863,428,35,1143,352,1296,0,7399
"53061042001",4674,145,29,13,775,68,82,1,5787
"53061042003",2901,30,16,0,358,1,198,0,3504
"53061042004",2981,211,139,0,874,159,99,42,4505
"53061042005",3304,69,14,0,1464,297,133,0,5281
"53061042006",3062,139,46,0,1500,174,246,13,5180
"53061050101",2144,40,49,72,340,34,83,0,2762
"53061050102",3490,504,74,71,1560,267,439,0,6405
"53061050200",3617,43,0,2,493,12,115,0,4282
"53061050300",4306,263,0,0,687,124,21,0,5401
"53061050401",5708,209,17,0,986,75,529,26,7550
"53061050402",4004,195,110,56,754,27,86,0,5232
"53061050500",5683,537,0,0,595,249,337,146,7547
"53061050600",931,15,68,0,231,18,46,5,1314
"53061050700",4160,216,299,134,809,637,165,212,6632
"53061050800",4578,201,140,0,1150,141,167,42,6419
"53061050900",2107,297,145,38,599,17,192,66,3461
"53061051000",3456,135,158,0,870,133,498,57,5307
"53061051100",2859,149,44,0,998,28,581,0,4659
"53061051200",2866,249,93,18,1013,232,556,175,5202
"53061051300",4351,439,300,3,1599,0,403,32,7127
"53061051400",3407,632,834,171,1255,827,877,376,8379
"53061051500",3277,716,212,0,973,431,765,196,6570
"53061051601",2712,557,261,70,856,148,556,163,5323
"53061051602",2821,307,197,0,780,145,153,37,4440
"53061051701",2837,442,579,5,1775,489,573,150,6850
"53061051702",2354,308,255,21,1112,142,288,101,4581
"53061051802",2994,236,386,16,1777,217,621,112,6359
"53061051803",2549,745,418,44,1965,500,700,447,7368
"53061051804",2631,210,352,1,1596,34,332,0,5156
"53061051905",4490,866,537,210,2023,236,532,36,8930
"53061051912",1951,101,0,0,281,0,51,0,2384
"53061051913",3612,102,43,3,726,67,280,0,4833
"53061051914",3514,246,9,47,513,0,264,0,4593
"53061051915",5348,299,290,5,1882,92,258,82,8256
"53061051916",2842,142,37,0,449,91,255,31,3847
"53061051917",3385,136,0,1,582,9,264,1,4378
"53061051918",3897,59,2,0,941,103,280,63,5345
"53061051921",3555,366,68,0,859,61,855,63,5827
"53061051922",3173,194,294,48,1131,130,395,36,5401
"53061051923",3784,222,46,0,1346,117,361,17,5893
"53061051924",4351,283,39,24,1331,20,637,27,6712
"53061051925",4225,203,291,1,2705,359,217,184,8185
"53061051926",3382,174,110,8,1263,29,200,0,5166
"53061051927",3449,103,28,0,1210,67,79,7,4943
"53061051928",2981,208,40,101,1578,102,569,5,5584
"53061052003",5020,455,190,0,3146,95,311,0,9217
"53061052004",3886,531,143,0,1699,0,193,12,6464
"53061052005",4391,237,91,0,986,0,244,0,5949
"53061052006",2891,227,61,0,1102,68,305,6,4660
"53061052007",3299,246,8,0,1541,60,501,0,5655
"53061052104",2924,257,74,2,656,1,355,15,4284
"53061052105",1390,81,14,0,84,105,18,120,1812
"53061052107",3460,282,0,0,981,183,181,148,5235
"53061052108",5469,579,42,0,251,36,119,0,6496
"53061052112",2232,161,0,0,213,9,89,0,2704
"53061052113",2803,97,23,0,220,0,130,0,3273
"53061052114",4116,55,34,1,703,1,271,0,5181
"53061052115",5789,202,124,0,730,59,660,95,7659
"53061052118",5659,348,26,0,970,75,292,114,7484
"53061052203",4492,93,0,14,524,66,335,57,5581
"53061052204",4719,117,63,0,535,8,812,0,6254
"53061052206",3791,170,0,0,227,0,199,0,4387
"53061052207",5152,456,0,0,208,39,278,142,6275
"53061052208",2332,441,60,0,626,127,690,363,4639
"53061052209",1807,698,8,0,219,133,597,335,3797
"53061052301",3940,148,19,0,168,9,308,3,4595
"53061052302",3528,131,15,0,337,22,66,64,4163
"53061052401",3085,230,12,13,358,201,189,189,4277
"53061052402",2964,614,9,9,266,41,90,0,3993
"53061052502",4342,244,0,0,132,19,81,2,4820
"53061052503",5593,407,0,0,781,18,403,0,7202
"53061052504",1928,187,85,0,84,34,87,12,2417
"53061052603",2070,138,11,5,183,0,205,0,2612
"53061052604",3462,534,5,0,187,279,316,203,4986
"53061052605",5078,414,0,0,413,49,269,2,6225
"53061052606",4315,473,10,17,434,108,593,11,5961
"53061052607",5155,139,35,0,713,33,494,14,6583
"53061052701",1534,41,0,0,51,0,111,0,1737
"53061052705",5888,308,108,0,1170,224,578,227,8503
"53061052706",4756,255,37,0,834,36,708,19,6645
"53061052707",3339,100,34,0,541,9,230,30,4283
"53061052708",4178,82,46,0,849,14,281,0,5450
"53061052709",2991,326,27,0,203,23,189,0,3759
"53061052803",4261,433,163,1,528,6,557,101,6050
"53061052804",5741,268,30,0,1504,214,1109,0,8866
"53061052805",3043,370,16,65,372,258,50,35,4209
"53061052806",5269,438,30,64,1039,48,999,41,7928
"53061052903",2601,910,21,0,544,115,390,230,4811
"53061052904",4178,436,62,56,533,309,325,358,6257
"53061052905",2858,498,1,0,592,180,606,192,4927
"53061052906",3847,562,20,14,494,23,292,16,5268
"53061053101",3110,363,0,1,397,82,221,63,4237
"53061053102",4280,309,0,0,208,27,121,19,4964
"53061053201",3183,236,184,0,251,0,43,11,3908
"53061053202",3902,82,8,0,318,92,118,27,4547
"53061053301",4944,819,0,19,231,198,328,109,6648
"53061053302",4910,260,76,0,309,0,342,0,5897
"53061053400",4746,534,62,71,230,19,29,37,5728
"53061053504",5206,620,0,0,128,343,318,254,6869
"53061053505",4587,153,0,0,430,22,469,17,5678
"53061053506",4819,390,0,2,342,62,39,2,5656
"53061053507",4116,288,99,13,437,5,316,0,5274
"53061053508",2744,385,0,1,316,9,294,60,3809
"53061053509",2988,490,0,0,308,83,292,0,4161
"53061053602",4938,422,43,0,352,46,401,0,6202
"53061053603",3462,188,0,0,184,13,39,10,3896
"53061053604",3955,257,65,0,140,26,254,0,4697
"53061053700",2417,471,9,0,185,36,10,8,3136
"53061053801",2778,364,9,0,225,34,241,17,3668
"53061053802",4398,478,0,0,505,8,532,11,5932
"53061053803",4591,585,34,0,235,54,302,117,5918
"53061940001",4324,450,47,11,1327,360,469,100,7088
"53061940002",1887,220,45,7,988,291,169,4,3611
"53061990002",0,0,0,0,0,0,0,0,0
"53061990100",0,0,0,0,0,0,0,0,0
"53063000200",2934,1297,124,6,218,74,135,68,4856
"53063000300",3009,1294,29,61,479,232,341,86,5531
"53063000400",2500,932,150,68,670,44,394,56,4814
"53063000500",2466,452,10,0,273,38,129,30,3398
"53063000600",2669,174,31,0,233,150,135,1,3393
"53063000700",3357,801,23,0,207,127,163,18,4696
"53063000800",3968,443,45,0,210,52,100,10,4828
"53063000900",5180,608,15,3,477,10,274,117,6684
"53063001000",4570,601,18,0,334,30,279,7,5839
"53063001100",2791,302,43,0,213,44,109,62,3564
"53063001200",1681,290,34,12,54,83,28,5,2187
"53063001300",2271,539,140,105,169,93,145,58,3520
"53063001400",3896,1040,104,133,710,231,345,124,6583
"53063001500",3558,878,4,0,445,136,321,39,5381
"53063001600",2171,768,15,154,387,158,114,177,3944
"53063001800",1762,590,71,17,156,76,51,22,2745
"53063001900",2405,384,87,0,261,181,73,31,3422
"53063002000",2346,957,19,0,306,389,75,58,4150
"53063002100",1533,503,32,23,144,108,95,12,2450
"53063002300",3129,1876,105,49,163,239,119,530,6210
"53063002400",865,735,9,18,88,342,57,192,2306
"53063002500",2221,2137,59,196,175,472,381,439,6080
"53063002600",2728,1368,83,151,821,280,245,109,5785
"53063002900",2162,210,37,12,538,98,150,94,3301
"53063003000",1223,573,174,26,275,336,273,230,3110
"53063003100",3246,895,77,7,134,257,94,78,4788
"53063003200",1474,426,33,5,274,49,134,23,2418
"53063003500",1051,899,22,11,36,85,30,83,2217
"53063003600",2497,1268,149,85,174,121,75,68,4437
"53063003800",1122,368,4,0,144,2,101,2,1743
"53063003900",1706,282,0,0,73,2,61,2,2126
"53063004000",2926,1045,110,17,493,120,164,101,4976
"53063004100",1915,200,0,0,156,47,95,0,2413
"53063004200",4289,202,0,0,155,54,159,21,4880
"53063004300",3095,152,37,9,81,17,106,10,3507
"53063004400",3527,325,302,0,293,90,243,0,4780
"53063004500",2834,262,37,0,204,92,47,0,3476
"53063004601",2500,447,16,0,405,181,109,39,3697
"53063004602",2386,285,17,4,340,45,204,76,3357
"53063004700",4912,569,229,19,314,298,349,38,6728
"53063004800",3224,327,116,26,244,0,93,0,4030
"53063004900",4821,378,13,38,486,182,0,0,5918
"53063005000",3034,378,34,0,128,100,104,10,3788
"53063010100",4777,1043,24,0,158,0,144,98,6244
"53063010201",3256,429,0,0,67,7,35,0,3794
"53063010202",6448,406,0,0,200,0,220,0,7274
"53063010301",3524,617,0,0,135,69,235,39,4619
"53063010303",2755,361,0,0,159,75,48,71,3469
"53063010304",4198,719,0,0,141,0,77,18,5153
"53063010305",5397,162,0,0,251,17,132,4,5963
"53063010401",2026,556,30,60,645,289,324,219,4149
"53063010402",6429,488,0,0,370,16,153,4,7460
"53063010501",6877,853,65,39,378,0,360,241,8813
"53063010503",6778,250,30,0,412,1,237,0,7708
"53063010504",3029,288,0,0,73,0,61,0,3451
"53063010601",3244,155,72,16,150,10,133,0,3780
"53063010602",6685,283,44,0,555,15,217,0,7799
"53063010700",5621,125,22,0,638,17,447,0,6870
"53063010800",1430,418,0,2,120,47,43,15,2075
"53063010900",2912,453,28,3,252,65,65,10,3788
"53063011000",3128,236,69,0,129,169,77,22,3830
"53063011101",2800,1196,373,65,444,547,335,141,5901
"53063011102",2810,659,37,13,484,136,107,60,4306
"53063011201",6110,901,75,38,515,115,290,0,8044
"53063011202",3454,342,6,8,201,30,99,14,4154
"53063011300",6177,616,25,16,642,17,107,31,7631
"53063011400",5023,197,75,0,480,60,173,0,6008
"53063011500",1223,198,0,2,66,25,21,0,1535
"53063011600",1351,170,21,52,92,0,23,13,1722
"53063011701",1779,292,19,0,37,58,0,0,2185
"53063011702",3769,1399,184,25,354,176,122,216,6245
"53063011800",2713,891,0,0,328,14,152,43,4141
"53063011900",2975,774,220,0,277,149,328,70,4793
"53063012000",3519,405,0,0,91,114,63,200,4392
"53063012100",1994,364,35,0,85,229,43,89,2839
"53063012200",1711,316,59,0,170,13,151,0,2420
"53063012300",3560,1175,144,0,491,83,96,6,5555
"53063012401",3616,229,9,0,272,6,30,14,4176
"53063012402",5281,345,0,0,309,41,265,0,6241
"53063012500",2691,462,22,0,231,60,91,0,3557
"53063012600",3061,476,34,0,647,147,256,109,4730
"53063012701",3045,506,33,10,96,20,20,0,3730
"53063012702",1985,82,0,0,23,0,68,0,2158
"53063012801",3308,270,26,24,296,76,174,0,4174
"53063012802",3089,129,0,0,238,30,175,12,3673
"53063012901",2394,595,0,0,196,0,295,131,3611
"53063012902",5150,804,29,0,609,83,454,29,7158
"53063013000",6013,1030,98,0,510,159,430,0,8240
"53063013100",8513,1781,0,42,470,76,167,77,11126
"53063013201",6426,820,0,0,368,49,122,28,7813
"53063013202",8013,358,19,70,815,49,422,67,9813
"53063013300",2855,160,33,1,109,0,50,0,3208
"53063013401",4035,129,82,0,542,1,153,0,4942
"53063013500",7448,204,178,1,464,174,366,60,8895
"53063013600",3467,380,97,13,692,66,315,12,5042
"53063013700",2247,319,146,1,436,94,156,29,3428
"53063013800",1905,81,174,0,190,55,270,0,2675
"53063013900",4289,491,35,102,192,154,110,2,5375
"53063014001",1800,1172,93,108,310,368,167,205,4223
"53063014002",3012,1616,48,142,227,54,213,237,5549
"53063014100",4674,414,43,168,451,98,119,0,5967
"53063014200",2460,645,0,0,82,98,21,24,3330
"53063014300",2304,341,0,0,149,8,74,17,2893
"53063014400",3464,487,36,102,546,83,188,86,4992
"53063014500",778,757,30,17,105,58,71,72,1888
"53065941000",209,110,0,9,1311,553,61,26,2279
"53065950100",5789,1157,13,4,235,93,159,39,7489
"53065950200",2623,588,0,0,126,35,82,46,3500
"53065950300",1863,524,0,1,124,123,50,104,2789
"53065950500",1750,341,0,19,26,3,28,24,2191
"53065950600",1893,375,1,0,112,17,12,9,2419
"53065950700",1795,465,0,65,131,65,12,2,2535
"53065950800",2502,454,0,0,147,71,56,0,3230
"53065950900",1232,212,0,0,104,20,24,2,1594
"53065951100",2588,708,51,0,160,239,69,143,3958
"53065951300",3280,497,12,0,85,22,133,52,4081
"53065951400",6695,803,37,0,476,180,28,127,8346
"53067010100",2246,522,51,47,175,62,97,37,3237
"53067010200",3980,804,21,26,427,206,328,60,5852
"53067010300",3366,844,72,50,307,198,211,248,5296
"53067010400",3037,198,7,19,285,0,104,0,3650
"53067010510",896,301,9,17,145,58,35,14,1475
"53067010520",3412,1029,12,24,480,145,339,105,5546
"53067010600",3857,1395,73,0,349,404,196,368,6642
"53067010700",4644,426,166,0,1037,0,466,0,6739
"53067010800",5318,557,31,0,469,122,175,161,6833
"53067010910",5062,675,338,99,1278,257,408,25,8142
"53067010920",2895,538,87,88,208,141,133,161,4251
"53067011000",3861,655,0,0,320,55,371,12,5274
"53067011100",2508,484,43,3,809,61,264,35,4207
"53067011200",3055,774,213,0,517,240,471,107,5377
"53067011300",3533,248,39,7,429,96,414,63,4829
"53067011410",3651,472,61,0,790,210,203,320,5707
"53067011420",5382,340,65,0,813,302,964,83,7949
"53067011500",4162,903,130,29,694,151,497,149,6715
"53067011610",4642,425,373,21,1061,178,186,149,7035
"53067011621",4172,566,547,152,1459,266,789,94,8045
"53067011622",3247,185,113,23,939,79,319,11,4916
"53067011623",4056,282,242,40,1255,23,523,78,6499
"53067011624",2906,343,147,0,485,54,98,6,4039
"53067011710",6431,273,169,0,874,40,202,2,7991
"53067011720",3908,183,35,0,475,86,117,27,4831
"53067011810",3119,173,28,0,171,57,70,32,3650
"53067011821",3298,294,53,0,162,112,180,33,4132
"53067011822",3460,301,0,0,373,151,135,40,4460
"53067011900",6150,638,0,0,510,15,65,15,7393
"53067012000",5259,318,0,0,778,167,248,45,6815
"53067012100",3692,150,57,0,132,0,86,0,4117
"53067012211",1878,217,67,6,289,73,121,84,2735
"53067012212",4577,848,193,20,1534,21,345,65,7603
"53067012221",3950,131,355,5,904,125,319,7,5796
"53067012222",5979,255,184,251,1269,107,456,0,8501
"53067012310",6228,451,1173,56,2629,76,1325,59,11997
"53067012320",1589,280,110,0,692,552,367,22,3612
"53067012330",2529,405,343,33,1296,136,713,257,5712
"53067012411",4980,1551,167,15,542,271,561,353,8440
"53067012412",3460,578,34,0,478,488,206,191,5435
"53067012420",3331,283,7,0,387,13,325,0,4346
"53067012510",2514,307,58,11,254,28,329,9,3510
"53067012520",5420,629,109,0,625,71,489,120,7463
"53067012530",3446,200,83,65,319,90,229,59,4491
"53067012610",5242,319,91,0,447,71,332,30,6532
"53067012620",3145,1140,0,3,188,34,161,255,4926
"53067012710",1860,265,0,0,175,25,139,32,2496
"53067012720",4790,1315,0,0,991,80,800,798,8774
"53067012730",5194,275,0,0,255,49,184,1,5958
"53067990100",0,0,0,0,0,0,0,0,0
"53069950100",3044,637,0,0,228,37,146,25,4117
"53071920000",3886,630,3,9,369,193,1133,477,6700
"53071920100",3742,454,49,0,229,60,457,69,5060
"53071920200",3032,459,0,4,656,45,994,244,5434
"53071920300",5539,1216,84,22,973,77,1066,366,9343
"53071920400",8,0,0,0,5,0,0,0,13
"53071920500",1230,932,10,16,662,62,1210,483,4605
"53071920600",3473,1217,20,26,301,199,1497,383,7116
"53071920701",2650,730,3,0,373,78,516,142,4492
"53071920702",3738,420,0,0,208,131,515,129,5141
"53071920801",3372,1020,21,0,445,77,740,79,5754
"53071920802",1500,646,0,0,222,138,158,234,2898
"53071920900",7442,616,55,0,482,58,643,17,9313
"53073000100",6982,1085,150,0,1393,157,384,169,10320
"53073000200",7116,1603,112,0,751,340,807,612,11341
"53073000300",5064,1138,50,117,1307,795,565,704,9740
"53073000400",5322,319,0,0,432,135,315,142,6665
"53073000501",3358,1190,23,1,204,106,98,118,5098
"53073000502",1595,429,15,8,380,45,166,7,2645
"53073000600",646,366,4,0,141,53,51,53,1314
"53073000700",3924,1020,95,0,981,750,996,347,8113
"53073000803",4382,724,24,2,770,243,308,35,6488
"53073000804",5682,373,55,0,645,82,292,68,7197
"53073000805",3930,608,0,1,504,26,93,135,5297
"53073000806",7162,833,27,41,488,102,372,240,9265
"53073000901",4160,1427,10,15,704,118,296,154,6884
"53073000902",4395,543,67,0,804,0,227,49,6085
"53073001000",1558,1086,26,26,211,233,115,69,3324
"53073001100",5381,747,11,33,349,228,101,141,6991
"53073001201",3034,3171,0,82,190,627,71,271,7446
"53073001202",3076,373,11,0,137,36,61,8,3702
"53073010100",6002,1535,1,0,534,166,595,42,8875
"53073010200",6808,864,3,15,1026,162,1163,326,10367
"53073010301",6024,315,13,0,440,67,1131,0,7990
"53073010302",4080,427,27,2,257,0,709,40,5542
"53073010303",4314,345,11,0,856,129,446,0,6101
"53073010401",6263,531,37,0,1072,87,433,46,8469
"53073010403",4011,427,16,43,152,28,12,0,4689
"53073010404",4790,1074,98,0,569,1,166,0,6698
"53073010501",5805,531,130,0,708,264,408,185,8031
"53073010502",5100,1005,177,0,883,350,826,285,8626
"53073010600",5236,319,33,0,916,57,720,52,7333
"53073010701",5200,220,75,1,252,14,428,27,6217
"53073010702",2874,201,0,2,844,240,631,79,4871
"53073010900",844,49,6,0,48,18,5,0,970
"53073011000",1062,101,18,0,72,17,6,12,1288
"53073940000",1699,336,35,0,1996,948,201,35,5250
"53075000100",570,2328,0,31,177,419,18,106,3649
"53075000200",4442,1117,67,0,752,374,342,109,7203
"53075000300",3479,833,89,6,527,68,193,58,5253
"53075000400",2920,700,106,62,191,51,68,70,4168
"53075000500",162,447,14,15,99,285,16,31,1069
"53075000600",1535,3179,94,135,1140,875,139,182,7279
"53075000700",3087,369,22,2,84,13,92,22,3691
"53075000800",2743,481,36,0,61,75,61,27,3484
"53075000900",3064,457,18,8,193,29,154,27,3950
"53075001000",1985,213,0,0,25,8,9,40,2280
"53077000100",1001,546,32,9,215,330,765,619,3517
"53077000200",2168,1664,60,17,1276,768,2654,1607,10214
"53077000300",2181,713,0,0,718,469,1000,798,5879
"53077000400",5914,345,36,4,994,18,1243,2,8556
"53077000500",3684,361,0,16,591,198,1194,79,6123
"53077000600",2494,1845,35,12,2167,1190,3833,2449,14025
"53077000700",3761,1233,122,0,1870,282,3145,951,11364
"53077000800",3473,246,41,0,520,75,742,22,5119
"53077000901",5912,310,211,0,1015,16,897,115,8476
"53077000902",2508,413,0,0,1115,80,1112,0,5228
"53077001000",4135,753,0,0,498,130,1093,199,6808
"53077001100",4750,717,15,102,943,301,1588,343,8759
"53077001201",1377,933,55,0,735,579,1091,1013,5783
"53077001202",3536,1171,54,13,775,795,2485,1498,10327
"53077001300",1470,295,0,0,478,130,974,273,3620
"53077001400",1649,686,27,41,738,349,1173,646,5309
"53077001501",2615,2505,8,117,1266,647,3436,2236,12830
"53077001502",1218,626,45,0,718,339,1541,833,5320
"53077001601",1690,252,0,0,273,47,302,38,2602
"53077001602",5400,495,50,18,888,33,923,72,7879
"53077001701",2186,128,29,10,189,188,343,225,3298
"53077001702",4591,449,7,29,960,203,2152,437,8828
"53077001800",5621,746,0,0,855,112,3641,655,11630
"53077001901",2099,1295,65,0,511,236,1861,1404,7471
"53077001902",4543,833,30,0,775,267,4040,1013,11501
"53077002001",5095,1837,11,0,831,515,5050,2296,15635
"53077002002",5597,2294,0,0,970,13,4914,2206,15994
"53077002101",1447,334,0,0,240,7,819,311,3158
"53077002102",5436,1949,13,0,726,153,4352,1865,14494
"53077002200",5764,1213,0,0,918,762,2462,1748,12867
"53077002701",1823,689,0,0,451,32,1929,653,5577
"53077002801",4466,199,0,0,322,12,525,66,5590
"53077002802",6617,472,19,0,1005,71,1660,137,9981
"53077002900",4402,318,91,0,1226,524,2016,730,9307
"53077003001",3554,651,0,2,257,22,173,0,4659
"53077003002",2332,356,0,39,254,243,307,134,3665
"53077003100",4315,512,9,94,360,127,536,271,6224
"53077003200",5215,447,44,0,548,247,890,268,7659
"53077003400",3639,430,152,0,307,47,479,10,5064
"53077940001",2951,738,5,60,1770,821,1942,474,8761
"53077940002",1817,530,27,12,1506,409,1353,415,6069
"53077940003",1300,150,3,0,1157,626,436,69,3741
"53077940004",3032,1555,0,46,1322,969,3401,1840,12165
"53077940005",2192,1549,0,50,706,216,2078,1493,8284
"53077940006",1933,1352,7,0,1221,270,2579,1536,8898
"54001965500",3887,299,21,0,0,0,27,0,4234
"54001965600",2035,998,48,0,53,79,0,5,3218
"54001965700",3607,1275,0,0,94,19,68,0,5063
"54001965800",2938,716,0,0,45,96,11,6,3812
"54003971101",4513,631,310,0,354,112,119,0,6039
"54003971102",6867,1050,495,0,197,31,304,73,9017
"54003971201",8173,870,507,27,230,17,235,0,10059
"54003971202",4390,380,0,0,40,0,30,95,4935
"54003971300",6543,1065,461,435,466,89,356,57,9472
"54003971400",7915,697,613,49,614,0,371,14,10273
"54003971500",2328,535,209,231,355,267,34,173,4132
"54003971600",2662,963,166,341,51,131,62,52,4428
"54003971700",3557,1357,236,271,172,163,204,258,6218
"54003971800",7283,555,0,0,94,0,320,0,8252
"54003971900",7214,1558,785,12,549,8,325,23,10474
"54003972000",8368,1292,1347,258,381,340,503,5,12494
"54003972101",4398,504,441,17,126,0,0,0,5486
"54003972102",7838,805,515,117,353,57,417,29,10131
"54005958200",2995,1324,0,0,0,20,0,0,4339
"54005958300",2957,814,0,0,35,0,2,0,3808
"54005958400",1733,482,51,0,25,0,9,0,2300
"54005958501",2134,483,0,0,1,0,24,0,2642
"54005958502",2580,759,64,0,3,17,0,17,3440
"54005958600",1752,424,0,0,21,0,16,0,2213
"54005958700",1705,435,0,0,20,0,11,0,2171
"54005958800",2013,760,24,11,101,0,31,7,2947
"54007967900",3693,1155,0,0,67,0,14,10,4939
"54007968000",3437,903,0,0,15,0,6,0,4361
"54007968100",3820,795,9,24,17,64,43,10,4782
"54009031101",3974,557,187,0,30,81,23,9,4861
"54009031102",4152,329,16,0,0,5,22,4,4528
"54009031200",2615,551,5,47,5,29,5,5,3262
"54009031400",3216,666,38,0,5,0,0,0,3925
"54009031600",2885,389,0,0,104,1,19,0,3398
"54009031700",2328,283,41,1,24,21,10,25,2733
"54011000101",1191,518,25,45,54,17,125,0,1975
"54011000102",1605,385,40,92,33,8,25,8,2196
"54011000200",1813,920,0,37,33,85,39,0,2927
"54011000300",1898,320,0,0,28,22,26,0,2294
"54011000400",1150,1430,31,81,102,34,8,19,2855
"54011000500",235,338,4,193,0,107,0,11,888
"54011000600",336,575,53,46,12,128,3,0,1153
"54011000900",679,738,0,114,2,66,24,1,1624
"54011001000",1202,687,0,0,84,127,18,33,2151
"54011001100",1173,361,25,14,46,3,7,6,1635
"54011001200",2274,285,365,24,65,0,56,0,3069
"54011001300",1979,666,151,12,80,8,72,0,2968
"54011001400",1108,518,406,419,18,20,50,73,2612
"54011001500",604,421,359,259,175,164,0,0,1982
"54011001600",503,372,85,50,39,48,0,0,1097
"54011001800",1818,1334,134,363,194,91,18,0,3952
"54011001900",1780,263,1,0,46,100,13,59,2262
"54011002000",2810,138,128,15,212,66,54,27,3450
"54011002100",2783,386,7,0,54,0,22,0,3252
"54011010102",4900,1030,63,0,57,0,60,21,6131
"54011010201",4367,509,144,0,332,53,29,0,5434
"54011010202",3164,368,11,20,78,40,0,40,3721
"54011010300",2610,207,0,0,61,8,0,0,2886
"54011010400",5275,448,100,73,141,94,122,0,6253
"54011010500",4766,707,0,0,129,0,37,0,5639
"54011010600",3156,525,32,0,29,66,0,0,3808
"54011010700",6949,550,0,5,138,16,49,0,7707
"54011010800",5302,983,11,11,70,0,0,0,6377
"54011010900",674,719,97,91,60,74,38,0,1753
"54013962600",2643,771,1,1,50,43,72,7,3588
"54013962700",3399,492,5,0,24,7,0,0,3927
"54015957900",2599,966,0,0,123,0,0,0,3688
"54015958000",2191,1024,0,0,25,0,0,0,3240
"54015958100",1472,536,0,0,25,4,13,0,2050
"54017965000",3138,405,1,0,69,31,0,0,3644
"54017965100",3132,754,0,0,47,0,35,0,3968
"54019020100",4347,853,0,0,89,0,31,0,5320
"54019020201",3157,971,431,55,20,0,0,0,4634
"54019020202",3339,616,120,5,20,0,53,0,4153
"54019020300",2169,724,21,50,18,7,15,36,3040
"54019020400",2917,955,398,212,93,52,48,0,4675
"54019020500",1079,802,121,168,29,11,12,0,2222
"54019020600",1574,308,0,5,13,0,19,12,1931
"54019020700",2764,685,236,29,74,45,26,10,3869
"54019020800",3515,526,131,81,104,9,47,0,4413
"54019020900",3593,677,20,0,0,0,39,18,4347
"54019021000",2184,300,0,0,8,9,0,0,2501
"54019021100",2437,528,0,0,0,0,14,9,2988
"54021967700",3429,886,0,0,58,104,0,0,4477
"54021967800",1141,742,8,39,177,10,0,0,2117
"54023969400",2561,358,0,1,33,0,13,0,2966
"54023969500",3604,576,46,0,0,0,26,0,4252
"54023969600",3495,761,21,95,112,0,28,7,4519
"54025950100",3962,1039,218,86,53,56,16,16,5446
"54025950200",2975,689,40,0,35,60,3,40,3842
"54025950300",2868,654,20,0,43,52,26,11,3674
"54025950400",5995,1253,83,0,397,60,261,0,8049
"54025950500",2563,603,26,24,66,6,0,12,3300
"54025950600",4263,539,150,33,101,56,66,0,5208
"54025950700",4415,1094,41,39,56,187,19,11,5862
"54027968200",4193,758,54,0,8,0,48,32,5093
"54027968300",4144,1331,31,0,171,53,58,0,5788
"54027968400",3317,1038,60,0,26,35,70,6,4552
"54027968500",2188,596,0,24,14,0,48,0,2870
"54027968600",3876,844,45,42,0,0,21,0,4828
"54029020600",3634,310,88,14,70,0,79,0,4195
"54029020700",3417,508,71,2,58,79,56,0,4191
"54029020900",2273,502,53,0,152,0,20,14,3014
"54029021100",3087,354,132,0,18,3,48,3,3645
"54029021200",3010,664,0,0,31,1,3,0,3709
"54029021300",2151,874,83,50,3,102,0,117,3380
"54029021400",2758,688,137,17,71,6,16,4,3697
"54029021500",3633,661,0,0,24,0,0,0,4318
"54031970100",4146,493,41,3,10,4,48,50,4795
"54031970200",3975,675,270,49,66,22,187,66,5310
"54031970300",3236,581,233,11,6,25,66,97,4255
"54033030100",1762,788,110,52,64,0,31,0,2807
"54033030200",1941,838,0,0,47,22,23,25,2896
"54033030300",2042,781,89,11,25,18,64,25,3055
"54033030400",2388,181,223,56,96,0,60,0,3004
"54033030500",3627,598,43,2,106,20,19,0,4415
"54033030601",2198,234,58,0,49,18,0,18,2575
"54033030602",5328,995,54,0,32,50,125,0,6584
"54033030700",2026,322,25,0,36,126,12,0,2547
"54033030800",3320,854,0,11,34,14,32,38,4303
"54033031000",2647,825,58,18,69,12,34,7,3670
"54033031100",1718,344,4,7,115,10,37,93,2328
"54033031200",2049,104,14,0,39,4,80,9,2299
"54033031300",2524,330,16,0,32,0,34,0,2936
"54033031400",2193,371,0,0,146,35,7,0,2752
"54033031500",1332,197,0,0,0,0,0,0,1529
"54033031600",1589,391,63,7,32,7,25,10,2124
"54033031700",1306,486,0,0,0,0,6,0,1798
"54033031800",1770,396,0,0,43,15,12,0,2236
"54033031900",2090,391,0,0,46,38,9,0,2574
"54033032000",1785,374,0,2,0,0,46,8,2215
"54033032101",3349,526,13,87,0,0,9,0,3984
"54033032102",5673,87,143,17,259,0,96,0,6275
"54035963200",3632,1008,73,0,68,81,13,0,4875
"54035963300",3058,899,0,0,187,62,0,0,4206
"54035963400",3911,372,0,0,0,0,0,0,4283
"54035963500",2846,253,25,0,18,0,0,0,3142
"54035963600",3934,885,0,0,22,21,0,0,4862
"54035963700",6398,1008,0,96,35,58,0,0,7595
"54037972201",3351,142,156,111,113,77,62,22,4034
"54037972203",2020,210,13,3,71,0,92,2,2411
"54037972204",1716,246,14,0,58,0,44,0,2078
"54037972300",3608,509,405,0,300,20,164,40,5046
"54037972401",1398,405,407,0,133,108,160,107,2718
"54037972402",3492,354,438,246,158,56,286,78,5108
"54037972501",4232,160,396,38,224,27,483,5,5565
"54037972503",2207,323,426,6,16,227,165,14,3384
"54037972505",1635,354,235,142,36,26,85,41,2554
"54037972506",2211,309,332,28,184,0,334,105,3503
"54037972601",1806,213,67,0,54,27,19,0,2186
"54037972602",3992,124,53,0,129,0,125,0,4423
"54037972701",2564,136,0,0,25,0,11,0,2736
"54037972702",3367,337,29,13,181,5,131,17,4080
"54037972800",4986,1142,86,53,170,45,100,45,6627
"54039000100",606,265,99,156,73,110,3,45,1357
"54039000200",1228,445,287,98,159,76,6,0,2299
"54039000300",2357,311,109,28,38,77,7,0,2927
"54039000500",1735,260,28,34,71,58,70,0,2256
"54039000600",2695,503,345,183,385,23,44,10,4188
"54039000700",577,403,550,285,188,178,19,0,2200
"54039000800",611,306,94,157,201,69,8,0,1446
"54039000900",362,211,109,57,56,15,21,15,846
"54039001100",2956,1029,295,311,383,48,0,28,5050
"54039001200",667,359,180,106,114,168,0,53,1647
"54039001300",1453,289,142,34,277,109,63,41,2408
"54039001500",3430,167,139,38,211,7,15,0,4007
"54039001700",1294,308,19,45,28,19,0,0,1713
"54039001800",1695,315,86,11,209,70,49,0,2435
"54039001901",3526,69,61,0,363,24,76,0,4119
"54039001902",3092,504,10,0,239,0,26,0,3871
"54039002000",3075,94,53,0,38,0,16,0,3276
"54039002100",3658,1023,163,102,406,14,75,0,5441
"54039010100",2868,394,172,19,156,72,44,83,3808
"54039010200",1677,201,99,39,30,0,0,0,2046
"54039010300",1854,343,221,28,19,0,18,0,2483
"54039010400",377,91,367,163,92,24,6,0,1120
"54039010500",4165,545,214,28,166,132,214,0,5464
"54039010600",4461,439,38,0,109,43,0,0,5090
"54039010701",4299,269,87,113,63,248,42,0,5121
"54039010702",4207,573,113,0,31,62,0,0,4986
"54039010801",5356,797,0,0,274,159,0,0,6586
"54039010802",2907,408,0,0,181,31,0,0,3527
"54039010900",2590,219,0,0,69,71,173,47,3169
"54039011000",4285,284,27,0,225,0,0,0,4821
"54039011100",3901,526,5,0,344,111,0,0,4887
"54039011200",3516,359,4,0,227,16,48,0,4170
"54039011301",2121,561,0,0,231,24,60,17,3014
"54039011302",4586,578,0,0,545,29,0,0,5738
"54039011401",1621,424,0,0,212,76,7,8,2348
"54039011402",3285,432,39,0,51,39,10,0,3856
"54039011500",2568,570,340,26,159,151,0,18,3832
"54039011800",3330,824,62,0,508,145,0,1,4870
"54039012100",2649,433,77,87,461,48,67,0,3822
"54039012200",3619,810,71,29,291,184,51,0,5055
"54039012300",5669,1069,10,0,188,0,29,5,6970
"54039012800",3485,210,196,43,210,26,28,0,4198
"54039012900",1001,134,57,0,37,60,28,0,1317
"54039013000",3227,787,44,62,474,112,0,1,4707
"54039013100",2870,583,137,172,112,53,36,42,4005
"54039013200",2735,557,27,13,86,0,0,0,3418
"54039013300",2561,95,22,0,51,0,0,0,2729
"54039013400",1409,461,90,52,87,175,59,14,2347
"54039013500",2269,177,29,29,147,34,0,0,2685
"54039013600",3366,976,120,28,83,23,23,11,4630
"54039013701",1920,156,10,0,82,0,0,0,2168
"54039013702",5055,1112,13,0,22,0,0,0,6202
"54039013800",1915,604,34,0,22,52,0,22,2649
"54041967200",2675,811,0,0,109,14,0,0,3609
"54041967300",3128,556,0,0,41,0,0,142,3867
"54041967400",2129,470,0,0,19,11,24,0,2653
"54041967500",1803,966,50,26,11,0,10,0,2866
"54041967600",2950,485,0,0,36,18,0,0,3489
"54043955400",5013,1635,38,34,55,0,0,0,6775
"54043955500",2653,819,0,0,0,6,0,0,3478
"54043955600",2616,1456,0,0,30,44,24,0,4170
"54043955700",2777,554,31,0,0,72,0,0,3434
"54043955800",2375,1241,0,0,42,9,0,0,3667
"54045956101",5950,1138,0,0,71,0,64,0,7223
"54045956102",2543,680,14,0,27,0,27,0,3291
"54045956200",2364,485,199,35,105,22,10,2,3222
"54045956400",2888,644,93,0,28,47,0,0,3700
"54045956500",1436,633,13,0,0,0,11,0,2093
"54045956600",4368,632,0,0,45,0,99,0,5144
"54045956700",3165,678,0,251,18,0,62,0,4174
"54045956800",3235,936,0,0,0,0,0,0,4171
"54045956900",1458,608,43,106,117,7,6,35,2380
"54047953600",439,223,254,104,0,0,0,0,1020
"54047953800",2378,855,108,11,18,0,0,0,3370
"54047953900",1030,830,0,0,0,0,0,0,1860
"54047954000",1129,659,0,0,0,2,0,0,1790
"54047954200",1139,1243,20,0,0,0,2,0,2404
"54047954501",984,406,242,32,20,0,0,0,1684
"54047954503",1643,609,354,229,28,25,5,2,2895
"54047954504",2744,1700,76,0,21,15,0,0,4556
"54049020100",424,617,82,193,18,146,0,0,1480
"54049020200",1117,597,33,226,37,34,0,34,2078
"54049020300",3384,363,1,0,149,1,0,0,3898
"54049020400",1155,151,33,63,17,18,37,3,1477
"54049020500",774,559,462,186,136,26,0,12,2155
"54049020600",1275,187,45,0,16,0,6,0,1529
"54049020700",2957,845,0,0,7,0,7,0,3816
"54049020800",2075,642,30,9,7,9,39,0,2811
"54049020900",3364,506,0,0,58,0,0,0,3928
"54049021000",4775,267,53,0,0,0,168,0,5263
"54049021100",2432,237,115,2,29,0,8,0,2823
"54049021200",5422,439,62,3,432,7,225,3,6593
"54049021300",2795,694,18,1,23,15,17,1,3564
"54049021400",1633,155,47,28,40,0,3,0,1906
"54049021500",2861,380,58,83,27,0,48,0,3457
"54049021600",3898,568,0,0,21,1,16,0,4504
"54049021700",1778,174,0,0,17,25,4,0,1998
"54049021800",2314,511,36,0,8,12,21,0,2902
"54051020200",1447,449,0,0,27,19,26,26,1994
"54051020500",672,209,11,58,9,2,0,8,969
"54051020601",1755,288,0,0,26,0,0,4,2073
"54051020702",1057,241,2,26,4,9,5,0,1344
"54051020800",4073,577,0,0,5,25,69,22,4771
"54051020900",4363,494,36,0,26,0,0,0,4919
"54051021000",5290,899,27,49,47,20,60,14,6406
"54051021100",4390,403,0,41,80,15,19,15,4963
"54051021300",4039,304,10,0,149,0,0,40,4542
"54053954801",2029,476,23,0,4,65,0,0,2597
"54053954802",3402,796,5,0,56,0,0,0,4259
"54053954900",5250,1282,0,0,163,0,0,0,6695
"54053955000",4076,665,161,0,36,2,36,67,5043
"54053955101",2325,532,0,0,0,0,147,0,3004
"54053955102",3772,1257,0,0,42,0,17,0,5088
"54055000900",2209,751,0,43,12,25,0,22,3062
"54055001000",3908,1283,0,0,52,0,30,7,5280
"54055001100",4848,532,4,49,161,41,28,16,5679
"54055001200",2677,355,6,0,27,134,8,7,3214
"54055001300",2642,1333,18,76,54,138,49,60,4370
"54055001400",1327,259,81,73,53,130,22,67,2012
"54055001500",4337,812,50,25,105,88,0,0,5417
"54055001600",929,299,11,0,16,0,0,0,1255
"54055001700",3388,1327,0,59,85,8,31,0,4898
"54055001800",4373,1185,26,96,42,35,0,13,5770
"54055001900",568,237,509,213,2,7,0,7,1543
"54055002000",1365,422,506,452,56,11,20,10,2842
"54055002100",2329,262,342,137,22,43,21,15,3171
"54055002200",3015,707,437,88,68,35,0,0,4350
"54055002300",4114,822,91,27,247,61,84,0,5446
"54055002400",2169,513,15,43,30,0,10,0,2780
"54057010100",1798,372,0,0,18,0,0,3,2191
"54057010200",3104,448,6,0,6,0,0,0,3564
"54057010300",3836,785,0,37,63,0,37,0,4758
"54057010400",4021,612,0,0,21,0,0,0,4654
"54057010500",3816,601,79,59,20,0,0,0,4575
"54057010600",3731,900,174,173,190,158,159,17,5502
"54057010700",1343,338,161,69,29,10,17,5,1972
"54059957100",3332,805,0,0,0,2,12,0,4151
"54059957200",2592,776,0,0,0,7,0,0,3375
"54059957300",3280,600,0,44,51,30,35,6,4046
"54059957400",2357,876,53,115,132,293,0,0,3826
"54059957500",2171,1061,18,57,78,16,38,12,3451
"54059957600",2188,1006,10,65,10,18,0,0,3297
"54059957700",2819,883,0,0,10,0,0,0,3712
"54061010101",152,318,3,21,10,10,7,6,527
"54061010102",1140,1703,26,7,109,159,27,46,3217
"54061010201",1623,2238,55,53,346,154,88,20,4577
"54061010202",1763,1599,27,20,162,118,11,21,3721
"54061010400",3129,395,156,99,139,119,6,27,4070
"54061010600",2720,1888,338,167,355,241,194,7,5910
"54061010700",2070,1051,175,332,167,13,28,27,3863
"54061010800",3332,647,96,156,87,78,0,0,4396
"54061010901",2136,695,12,183,130,48,28,0,3232
"54061010902",3073,213,134,30,181,41,71,0,3743
"54061011000",2408,971,28,34,39,168,58,70,3776
"54061011100",1981,541,51,12,6,0,0,10,2601
"54061011200",3122,681,39,37,87,95,6,0,4067
"54061011300",3456,550,13,0,90,0,85,0,4194
"54061011400",3335,494,0,0,68,0,0,0,3897
"54061011500",4465,369,0,0,195,0,38,0,5067
"54061011600",4084,1156,80,0,547,194,156,201,6418
"54061011700",3293,233,213,110,348,0,6,0,4203
"54061011803",3195,308,12,12,8,0,47,0,3582
"54061011804",3273,181,0,0,11,5,44,0,3514
"54061011805",4291,365,2,0,105,125,45,125,5058
"54061011806",4282,471,18,0,154,16,68,65,5074
"54061011900",3962,279,38,0,112,0,0,0,4391
"54061012000",2275,553,96,6,330,161,48,0,3469
"54063950100",2947,586,0,2,83,10,0,0,3628
"54063950200",3117,771,46,45,47,48,15,0,4089
"54063950300",4905,771,0,0,3,19,125,0,5823
"54065970700",5289,396,22,0,27,62,26,0,5822
"54065970800",3043,882,0,2,94,0,14,9,4044
"54065970900",2166,422,21,20,75,21,66,0,2791
"54065971000",4215,385,30,28,40,0,45,33,4776
"54067950100",2551,534,0,0,12,0,0,0,3097
"54067950200",5130,1370,0,3,10,18,0,0,6531
"54067950300",1023,213,0,0,0,0,0,0,1236
"54067950400",3836,875,0,0,0,0,0,0,4711
"54067950500",950,376,4,0,22,0,7,0,1359
"54067950600",4618,702,0,0,85,10,0,0,5415
"54067950700",2792,535,0,0,7,0,0,0,3334
"54069000200",2486,422,73,35,49,0,45,7,3117
"54069000300",1397,237,60,33,46,19,25,0,1817
"54069000400",608,423,20,36,10,3,4,0,1104
"54069000500",1064,257,44,17,95,36,27,0,1540
"54069000600",806,247,56,147,31,14,0,0,1301
"54069000700",484,139,131,182,7,21,2,2,968
"54069001300",1198,239,0,3,29,0,0,0,1469
"54069001400",2260,215,25,28,146,0,21,0,2695
"54069001500",2072,178,53,2,69,0,105,13,2492
"54069001600",1796,232,0,0,38,0,25,0,2091
"54069001700",1443,54,0,29,100,16,16,0,1658
"54069001800",4337,842,107,223,62,39,27,21,5658
"54069001901",2234,237,0,0,57,16,4,0,2548
"54069002000",4453,306,22,5,71,0,2,9,4868
"54069002100",2582,522,4,10,38,0,21,0,3177
"54069002200",2048,240,4,0,39,0,0,0,2331
"54069002600",1404,525,40,8,20,4,0,0,2001
"54069002700",320,278,66,135,0,4,0,6,809
"54071970400",1293,463,0,0,27,7,10,14,1814
"54071970500",2695,676,138,9,11,0,57,0,3586
"54071970600",1544,337,36,8,42,0,0,0,1967
"54073962100",2268,522,0,0,35,0,58,0,2883
"54073962200",3357,722,10,0,59,16,0,24,4188
"54075960101",1069,250,0,0,0,0,10,0,1329
"54075960102",976,247,56,2,16,0,0,7,1304
"54075960200",2736,586,15,36,67,70,5,12,3527
"54075960300",2065,191,0,0,0,0,25,0,2281
"54077963800",3728,605,0,0,60,18,32,18,4461
"54077963900",3141,431,0,0,53,0,0,0,3625
"54077964000",3014,671,105,0,10,78,19,0,3897
"54077964100",3840,757,24,0,48,0,21,0,4690
"54077964200",3446,605,0,0,43,0,9,0,4103
"54077964300",3982,477,0,0,6,5,29,0,4499
"54077964400",2484,569,0,0,63,0,9,0,3125
"54077964500",2564,355,3,3,39,0,0,0,2964
"54079020100",4881,731,0,0,0,0,16,0,5628
"54079020200",4489,546,0,0,51,0,72,0,5158
"54079020300",4210,248,20,0,78,0,38,0,4594
"54079020400",6050,534,3,0,31,173,10,0,6801
"54079020500",4883,1077,5,0,9,0,63,0,6037
"54079020601",5288,150,182,0,115,0,137,0,5872
"54079020603",6223,828,358,0,166,0,143,22,7740
"54079020604",2150,203,120,141,45,0,0,0,2659
"54079020605",6772,556,0,0,328,0,52,0,7708
"54079020700",4158,295,8,12,65,0,10,0,4548
"54081000200",1351,387,978,498,206,60,22,0,3502
"54081000300",2646,425,918,271,171,56,13,0,4500
"54081000400",1692,539,544,336,33,4,0,0,3148
"54081000500",3333,319,223,16,139,0,111,56,4197
"54081000600",2570,574,324,586,351,133,12,0,4550
"54081000700",2504,436,155,63,6,28,26,0,3218
"54081000802",3575,283,37,18,60,0,53,0,4026
"54081000803",4094,387,0,0,226,75,15,60,4857
"54081000804",5037,349,17,0,42,2,0,0,5447
"54081000900",4104,1131,0,62,23,40,72,0,5432
"54081001001",4091,804,0,0,4,0,27,0,4926
"54081001002",2635,827,32,0,0,112,0,72,3678
"54081001100",4577,965,15,22,146,0,9,0,5734
"54081001200",3689,895,0,0,7,0,0,0,4591
"54081001300",3620,1073,84,0,52,32,65,0,4926
"54081001400",3729,650,1,27,119,103,102,56,4787
"54081001500",3121,714,156,7,167,13,42,0,4220
"54083965900",3107,463,0,0,0,35,0,34,3639
"54083966000",3244,647,0,3,73,3,23,20,4013
"54083966100",2415,730,112,50,114,10,19,78,3528
"54083966200",3276,481,179,0,15,0,14,19,3984
"54083966300",2321,429,0,0,6,0,0,0,2756
"54083966400",4761,932,4,5,34,22,7,0,5765
"54083966500",2855,800,3,0,0,0,0,0,3658
"54085962300",3215,890,16,0,30,9,0,0,4160
"54085962400",2182,363,0,0,48,0,0,29,2622
"54085962500",2394,799,30,0,18,10,3,7,3261
"54087962800",2026,369,0,0,34,2,6,0,2437
"54087962900",3171,775,0,0,53,8,24,0,4031
"54087963000",2558,848,1,2,57,12,23,80,3581
"54087963100",3205,1091,0,0,69,58,0,0,4423
"54089000500",1721,621,86,152,9,45,58,0,2692
"54089000600",3951,598,75,18,92,20,56,0,4810
"54089000700",1044,352,66,15,16,0,0,0,1493
"54089000800",3168,362,0,1,22,0,48,0,3601
"54091964600",3871,938,0,16,158,11,61,0,5055
"54091964700",4251,359,44,0,11,6,43,0,4714
"54091964800",3336,1024,23,25,95,20,22,0,4545
"54091964900",1850,332,35,0,3,0,32,0,2252
"54093965200",1453,209,0,0,47,8,7,0,1724
"54093965300",1787,253,0,0,4,23,15,12,2094
"54093965400",2453,514,10,0,24,6,0,0,3007
"54095961800",2743,724,0,8,48,20,44,2,3589
"54095961900",2651,619,7,0,11,4,4,5,3301
"54095962000",1695,390,0,0,9,0,1,0,2095
"54097966600",3791,848,0,0,51,19,81,0,4790
"54097966700",1635,542,8,22,26,0,8,69,2310
"54097966800",2657,717,60,0,0,0,24,38,3496
"54097966900",3034,510,10,0,31,0,17,0,3602
"54097967000",3846,702,42,31,54,40,15,0,4730
"54097967100",3702,685,0,0,29,73,7,0,4496
"54099005100",1623,320,11,0,7,6,0,0,1967
"54099005200",1719,104,0,6,40,0,0,0,1869
"54099020100",2070,372,0,0,90,17,11,10,2570
"54099020300",3657,568,19,0,0,151,12,76,4483
"54099020400",5380,650,0,40,27,0,73,0,6170
"54099020500",3333,1268,0,0,20,2,0,1,4624
"54099020600",4119,1364,67,0,170,0,29,0,5749
"54099020700",3222,309,0,0,0,0,0,0,3531
"54099020800",2892,1086,5,0,36,0,10,32,4061
"54099020900",2160,1235,0,0,22,0,0,0,3417
"54099021000",1885,958,0,0,108,12,0,0,2963
"54101970100",2877,1193,0,0,33,0,0,0,4103
"54101970200",1816,632,0,0,52,70,23,0,2593
"54101970300",1738,412,7,0,14,0,0,0,2171
"54103004900",2736,784,0,0,61,0,18,11,3610
"54103030400",2227,675,0,0,36,0,18,6,2962
"54103030500",3036,851,0,0,24,29,0,0,3940
"54103030700",3394,673,10,0,3,4,41,0,4125
"54103030800",1284,114,9,0,22,39,11,0,1479
"54105030101",2553,533,20,0,61,18,0,0,3185
"54105030102",2340,233,0,0,15,8,9,0,2605
"54107000100",2735,694,16,0,107,0,9,0,3561
"54107000300",2100,361,27,28,81,18,0,0,2615
"54107000400",2002,133,27,0,25,42,21,0,2250
"54107000500",2347,1223,128,2,291,51,0,20,4062
"54107000701",1439,1003,60,49,8,55,31,24,2669
"54107000702",950,427,0,0,84,13,9,25,1508
"54107000801",998,552,0,1,0,13,0,0,1564
"54107000802",2653,672,54,101,5,40,0,0,3525
"54107000901",1097,338,0,0,6,11,67,0,1519
"54107000902",1051,277,15,4,50,23,0,0,1420
"54107000903",3248,943,3,3,22,38,0,0,4257
"54107010101",1670,226,0,0,19,0,7,0,1922
"54107010102",1640,220,23,0,61,0,16,0,1960
"54107010200",2778,274,15,0,12,0,30,0,3109
"54107010300",3955,165,28,0,257,33,113,33,4584
"54107010400",1451,183,11,21,40,1,0,0,1707
"54107010501",1126,373,0,0,35,37,22,37,1630
"54107010502",3238,602,39,22,149,6,0,0,4056
"54107010601",3722,575,0,0,96,75,68,44,4580
"54107010602",4084,536,0,0,29,0,29,0,4678
"54107010701",4411,1015,122,0,18,75,88,33,5762
"54107010702",6807,1237,39,0,86,0,0,50,8219
"54107010800",2385,590,0,0,11,0,29,0,3015
"54107010901",4238,291,6,0,121,20,0,0,4676
"54107010902",3247,583,12,0,53,14,0,0,3909
"54107011000",2700,486,0,15,55,35,0,23,3314
"54109002800",2197,495,0,0,107,0,0,0,2799
"54109002901",3567,711,0,0,43,29,0,29,4379
"54109002902",2623,643,0,0,0,26,27,0,3319
"54109003000",1639,585,0,0,0,0,0,0,2224
"54109003100",3538,1400,0,35,0,5,0,0,4978
"54109003200",3766,998,134,0,121,7,10,10,5046
"55001950100",2719,224,0,0,49,0,7,0,2999
"55001950201",1130,143,0,0,16,0,26,2,1317
"55001950202",2223,376,5,0,30,10,72,11,2727
"55001950400",3416,807,3,10,129,76,133,6,4580
"55001950501",1137,336,22,1,15,0,39,5,1555
"55001950502",2274,334,2,3,88,9,35,17,2762
"55001950700",3092,329,4,4,108,42,67,64,3710
"55003940000",617,168,8,0,583,445,85,19,1925
"55003950300",1865,186,0,12,158,136,79,40,2476
"55003950400",1697,284,0,30,88,22,22,14,2157
"55003950500",1976,197,1,0,84,8,9,3,2278
"55003950600",1142,201,7,4,30,11,6,22,1423
"55003950700",1758,327,0,0,36,14,22,6,2163
"55003950800",2288,292,0,0,577,61,18,0,3236
"55003990000",0,0,0,0,0,0,0,0,0
"55005000100",3538,265,0,0,61,37,38,30,3969
"55005000200",3065,528,0,0,168,88,122,47,4018
"55005000300",3391,442,43,28,221,33,193,19,4370
"55005000400",3956,487,445,0,80,0,93,0,5061
"55005000500",3931,557,0,0,110,30,41,0,4669
"55005000600",4382,1141,0,8,16,46,126,39,5758
"55005000800",4752,537,5,0,165,13,21,5,5498
"55005000900",4264,455,17,1,153,6,93,1,4990
"55005001001",1608,195,0,0,59,3,0,25,1890
"55005001002",4785,720,0,0,20,20,130,0,5675
"55007960100",1290,115,43,17,930,357,28,5,2785
"55007960200",1481,159,5,0,38,9,25,0,1717
"55007960300",2860,391,0,0,242,45,34,8,3580
"55007960400",4138,401,15,0,190,24,101,0,4869
"55007960600",1901,155,13,0,9,46,3,5,2132
"55007990000",0,0,0,0,0,0,0,0,0
"55009000100",1409,434,45,106,485,302,163,285,3229
"55009000200",4717,810,57,214,287,308,371,308,7072
"55009000302",3243,422,0,0,650,106,303,125,4849
"55009000303",1441,335,93,119,426,167,250,75,2906
"55009000401",2867,506,424,29,458,244,197,59,4784
"55009000402",1963,210,0,0,71,20,0,106,2370
"55009000500",2265,349,54,214,288,66,100,51,3387
"55009000600",3141,182,164,97,403,58,439,19,4503
"55009000700",3547,436,65,10,443,345,110,159,5115
"55009000800",702,501,64,50,347,112,158,73,2007
"55009000900",2514,768,27,0,455,310,1299,401,5774
"55009001000",591,255,39,11,108,18,11,0,1033
"55009001100",1111,579,19,34,132,139,361,286,2661
"55009001200",845,509,147,86,339,97,350,160,2533
"55009001300",1749,592,96,102,158,175,201,92,3165
"55009001400",2735,257,16,44,510,248,803,44,4657
"55009001600",2730,534,89,230,2361,126,1772,31,7873
"55009001701",1740,490,17,101,926,321,1109,292,4996
"55009001702",1974,707,48,11,674,131,852,301,4698
"55009001801",3415,422,58,0,419,43,428,16,4801
"55009001802",3776,391,23,8,42,111,14,14,4379
"55009002001",6055,810,52,83,669,695,393,734,9491
"55009002002",3860,365,50,61,524,281,409,175,5725
"55009002003",2901,251,28,195,83,0,84,0,3542
"55009010100",5145,335,140,0,337,9,354,0,6320
"55009010201",2397,270,0,4,167,98,234,15,3185
"55009010202",4336,257,132,48,151,14,47,30,5015
"55009010300",5677,211,224,30,297,137,298,0,6874
"55009020100",5108,349,0,0,110,4,59,5,5635
"55009020203",5973,318,12,0,90,1,20,12,6426
"55009020204",5068,147,14,0,54,11,8,0,5302
"55009020502",4099,482,42,192,628,133,358,77,6011
"55009020503",7166,324,0,0,539,48,474,0,8551
"55009020504",4664,148,26,0,116,0,57,0,5011
"55009020600",4655,308,7,0,71,44,63,5,5153
"55009020702",5688,544,112,0,251,168,23,29,6815
"55009020703",6330,253,0,0,125,294,120,211,7333
"55009020704",5447,1164,50,0,1175,187,621,384,9028
"55009020800",1850,112,37,0,342,25,82,0,2448
"55009020900",2159,39,24,0,384,64,245,0,2915
"55009021000",2412,118,3,25,82,0,41,0,2681
"55009021100",0,0,0,0,0,0,0,0,0
"55009021200",4486,184,45,14,183,7,195,0,5114
"55009021301",2855,138,54,0,211,28,242,0,3528
"55009021302",5179,394,28,0,282,89,20,0,5992
"55009021303",2552,594,120,14,283,93,96,0,3752
"55009021304",1807,169,63,0,155,81,8,0,2283
"55009021400",6923,308,14,13,396,154,451,160,8419
"55009021500",2793,95,12,6,75,6,57,17,3061
"55009021600",5621,288,15,0,53,0,33,0,6010
"55009940001",14238,750,0,0,1609,144,127,0,16868
"55009940002",3627,290,57,0,775,102,202,9,5062
"55009940003",2657,227,46,5,352,249,74,33,3643
"55009940004",1937,111,0,34,345,124,98,25,2674
"55011960100",2216,306,19,0,21,0,21,5,2588
"55011960200",2218,457,0,0,54,33,0,0,2762
"55011960300",1827,158,10,0,54,27,74,27,2177
"55011960400",2223,214,0,12,44,0,48,1,2542
"55011960500",2963,293,16,0,30,0,68,0,3370
"55013970400",3167,342,23,11,176,132,31,24,3906
"55013970600",1456,141,4,0,253,94,45,2,1995
"55013970700",1886,187,0,0,149,58,9,4,2293
"55013970800",1731,502,0,8,17,77,10,8,2353
"55013970900",2161,499,0,1,117,97,65,3,2943
"55013971000",1618,215,8,0,27,7,9,4,1888
"55015020100",4425,210,26,0,58,0,70,0,4789
"55015020200",3529,219,0,5,82,14,147,18,4014
"55015020303",2792,181,60,192,790,0,255,0,4270
"55015020304",2922,408,0,6,236,16,249,0,3837
"55015020306",5732,84,8,0,518,0,144,0,6486
"55015020308",3577,200,27,0,17,13,13,27,3874
"55015020400",3257,166,0,0,16,14,71,0,3524
"55015020500",4301,580,3,0,6,0,104,184,5178
"55015020600",4444,505,29,0,41,30,50,0,5099
"55015020700",4117,19,0,0,61,0,110,0,4307
"55015020800",4715,389,31,0,151,183,118,350,5937
"55017010100",2437,201,0,0,211,153,0,0,3002
"55017010200",5858,352,90,8,282,65,3,31,6689
"55017010300",4917,850,44,0,29,0,136,0,5976
"55017010400",4224,274,0,0,256,7,90,0,4851
"55017010500",3636,880,0,5,84,73,0,0,4678
"55017010700",7178,234,0,0,54,0,0,0,7466
"55017010800",4613,870,38,0,183,4,36,4,5748
"55017010900",4022,642,0,2,84,1,168,17,4936
"55017011000",6122,703,19,0,103,100,71,70,7188
"55017011100",3655,387,0,0,27,6,1,6,4082
"55017011200",6159,264,16,0,82,0,131,0,6652
"55019950100",3906,526,0,0,150,40,510,132,5264
"55019950200",3591,589,3,0,110,28,221,93,4635
"55019950300",3623,628,14,3,44,20,65,13,4410
"55019950400",3085,743,0,0,14,2,8,20,3872
"55019950500",4241,912,15,0,97,8,75,66,5414
"55019950600",3680,999,23,29,64,22,65,2,4884
"55019950700",2942,444,27,0,106,22,8,25,3574
"55019950800",2584,477,0,0,89,12,84,7,3253
"55021970100",3572,472,20,11,100,31,133,118,4457
"55021970200",5148,563,4,0,142,22,118,29,6026
"55021970300",3089,407,2,0,128,3,182,6,3817
"55021970400",4744,608,0,72,92,46,21,8,5591
"55021970500",3213,626,84,18,136,56,239,120,4492
"55021970600",4369,162,0,2,129,0,52,0,4714
"55021970700",3662,291,0,61,144,6,25,47,4236
"55021970800",5215,178,25,0,82,27,54,18,5599
"55021970900",4489,157,0,0,69,0,49,0,4764
"55021971000",3580,301,3,14,67,16,31,14,4026
"55021971100",3133,272,41,0,48,8,68,24,3594
"55021971200",4468,414,40,0,149,0,73,0,5144
"55023960100",2331,437,5,12,62,0,16,0,2863
"55023960200",1904,194,3,0,34,33,10,9,2187
"55023960300",2160,234,7,1,37,4,12,2,2457
"55023960400",2856,268,8,14,66,11,30,11,3264
"55023960500",1692,238,0,0,0,0,50,0,1980
"55023960600",2579,577,0,0,0,0,0,0,3156
"55025000100",2222,114,15,0,125,56,93,0,2625
"55025000201",1702,75,0,0,276,32,57,8,2150
"55025000202",2431,152,68,0,429,40,147,0,3267
"55025000204",3394,81,227,603,861,178,68,0,5412
"55025000205",4119,202,193,0,406,24,39,0,4983
"55025000300",3143,297,47,26,1309,287,152,36,5297
"55025000401",3067,70,17,11,244,2,162,8,3581
"55025000402",2194,61,40,53,97,50,17,44,2556
"55025000405",4463,559,435,63,855,47,547,362,7331
"55025000406",2213,183,53,1,387,70,93,0,3000
"55025000407",2930,294,579,714,719,246,343,120,5945
"55025000408",1321,161,43,12,136,0,15,46,1734
"55025000501",3254,475,383,127,109,10,202,139,4699
"55025000503",4905,451,365,324,1010,110,770,331,8266
"55025000504",5457,246,250,18,748,132,54,16,6921
"55025000600",2437,364,254,964,1711,721,2240,616,9307
"55025000700",2811,84,74,0,150,44,187,0,3350
"55025000800",2943,349,42,96,190,77,58,12,3767
"55025000901",1999,43,39,0,130,7,41,0,2259
"55025000902",2954,2140,118,63,126,434,54,30,5919
"55025001000",1786,50,39,0,57,4,44,0,1980
"55025001101",565,3347,100,183,170,599,12,146,5122
"55025001102",42,204,0,22,22,114,6,58,468
"55025001200",3711,1724,169,69,504,633,457,155,7422
"55025001300",1690,181,119,38,291,47,105,8,2479
"55025001401",1835,1014,907,179,1815,1138,1160,740,8788
"55025001402",2687,505,878,540,715,236,779,187,6527
"55025001403",4691,417,328,637,1356,468,858,548,9303
"55025001501",1350,400,89,40,144,87,97,232,2439
"55025001502",2264,1017,395,425,1198,215,862,733,7109
"55025001603",309,2080,0,42,137,706,33,140,3447
"55025001604",884,2445,0,72,186,538,104,73,4302
"55025001605",1628,1178,22,12,232,72,69,7,3220
"55025001606",616,1250,13,82,86,134,57,80,2318
"55025001704",1758,536,25,0,194,46,106,10,2675
"55025001705",3058,775,72,20,273,190,71,37,4496
"55025001802",2352,463,95,92,143,8,72,8,3233
"55025001804",2227,479,204,35,333,156,234,62,3730
"55025001900",5029,886,189,37,303,34,196,89,6763
"55025002000",4477,376,268,396,335,31,162,18,6063
"55025002100",3134,651,148,150,213,147,123,41,4607
"55025002200",2737,219,233,212,565,60,333,0,4359
"55025002301",1663,418,324,184,403,7,307,224,3530
"55025002302",1114,154,56,43,134,0,19,9,1529
"55025002401",2733,78,133,127,298,9,208,22,3608
"55025002402",1964,279,285,148,48,811,159,61,3755
"55025002500",1035,298,71,71,168,177,182,146,2148
"55025002601",1213,236,143,53,226,48,129,39,2087
"55025002602",4029,399,518,0,1017,99,738,282,7082
"55025002603",3158,434,723,206,855,0,219,0,5595
"55025002700",2881,258,18,9,90,15,144,6,3421
"55025002800",1847,135,54,3,45,3,59,3,2149
"55025002900",2539,297,140,111,180,6,300,0,3573
"55025003001",4205,269,179,49,167,95,189,248,5401
"55025003002",2365,433,299,217,386,165,445,211,4521
"55025003100",5270,371,294,0,329,0,148,251,6663
"55025003200",862,232,19,14,1402,212,213,43,2997
"55025010100",1538,51,78,1,119,0,56,0,1843
"55025010200",1398,21,0,0,25,0,59,5,1508
"55025010300",3208,151,0,1,118,0,124,32,3634
"55025010400",2854,205,113,11,100,35,135,30,3483
"55025010501",2271,95,83,63,247,348,31,0,3138
"55025010502",7128,181,19,0,229,34,116,0,7707
"55025010600",4742,321,36,1,18,0,71,0,5189
"55025010701",5246,102,149,0,541,97,217,88,6440
"55025010702",5440,127,154,14,552,0,311,11,6609
"55025010800",9510,244,192,434,564,15,224,4,11187
"55025010901",4599,67,173,1,938,148,158,89,6173
"55025010903",2520,117,182,0,353,9,81,0,3262
"55025010904",7885,108,6,0,482,0,330,0,8811
"55025011000",3560,179,221,139,275,46,94,0,4514
"55025011101",3530,317,135,361,336,39,310,121,5149
"55025011102",7294,307,194,0,705,78,481,0,9059
"55025011200",8464,238,54,1,590,12,269,11,9639
"55025011301",5767,201,45,0,299,0,228,73,6613
"55025011302",2695,136,52,0,75,0,80,0,3038
"55025011401",5857,428,368,19,439,0,197,47,7355
"55025011402",7368,261,59,0,1340,45,534,0,9607
"55025011503",7879,301,182,95,509,0,74,0,9040
"55025011504",2872,132,309,156,230,10,73,10,3792
"55025011505",3125,388,196,323,293,118,434,60,4937
"55025011506",3725,263,324,120,405,12,130,0,4979
"55025011600",5624,611,64,0,339,17,130,16,6801
"55025011700",3666,453,31,2,213,67,255,298,4985
"55025011800",4627,726,14,219,207,6,275,287,6361
"55025011900",6110,344,90,13,94,46,60,51,6808
"55025012001",7026,244,41,0,679,397,356,407,9150
"55025012002",4767,171,31,6,183,23,26,5,5212
"55025012100",2348,139,0,0,24,9,110,14,2644
"55025012201",1770,83,2,6,77,1,55,0,1994
"55025012202",5823,447,209,1,170,80,82,0,6812
"55025012300",4772,312,73,189,171,10,164,0,5691
"55025012400",4673,146,0,0,119,0,74,0,5012
"55025012501",6288,322,120,0,172,54,60,65,7081
"55025012502",3849,106,145,0,261,0,49,0,4410
"55025012600",4304,151,32,2,110,0,73,0,4672
"55025012700",3703,216,12,0,101,9,38,0,4079
"55025012800",7374,353,17,0,50,22,34,0,7850
"55025012900",3776,126,10,0,60,0,62,0,4034
"55025013000",4114,142,0,13,96,7,59,0,4431
"55025013100",4084,383,12,11,102,5,75,40,4712
"55025013200",7926,331,34,18,499,104,127,33,9072
"55025013301",4255,216,74,15,321,38,68,0,4987
"55025013302",5368,256,11,0,142,0,254,38,6069
"55025013700",5042,255,161,39,206,14,15,0,5732
"55025991702",0,0,0,0,0,0,0,0,0
"55025991703",0,0,0,0,0,0,0,0,0
"55027960100",5231,403,123,0,150,4,269,36,6216
"55027960200",2691,210,7,0,42,0,24,0,2974
"55027960300",5234,673,0,1,104,0,299,2,6313
"55027960400",4109,272,0,0,47,0,150,0,4578
"55027960500",2327,253,17,16,32,14,43,25,2727
"55027960600",3383,335,0,1,86,1,187,3,3996
"55027960700",3915,340,15,2,220,69,32,0,4593
"55027960800",2909,260,0,28,200,64,323,5,3789
"55027960900",3262,737,0,0,257,0,166,166,4588
"55027961000",3724,529,0,16,116,24,345,65,4819
"55027961100",3273,391,0,0,129,103,160,85,4141
"55027961200",2967,240,81,0,16,7,122,0,3433
"55027961300",4416,443,30,0,246,0,169,0,5304
"55027961400",3647,216,0,0,84,0,62,6,4015
"55027961500",4635,423,11,26,81,7,79,0,5262
"55027961600",4097,402,0,0,95,23,60,43,4720
"55027961700",2495,212,80,1,112,51,45,7,3003
"55027961800",3738,349,3,0,72,26,92,9,4289
"55027961900",5161,245,31,5,356,0,284,0,6082
"55027962000",1756,213,29,0,154,23,69,0,2244
"55029100100",1905,291,3,14,33,50,16,0,2312
"55029100300",1903,187,0,0,73,50,34,56,2303
"55029100400",2568,156,0,0,95,31,234,3,3087
"55029100500",3150,166,3,10,9,0,27,0,3365
"55029100600",2786,241,25,4,58,52,55,18,3239
"55029100700",3746,482,17,20,86,31,0,55,4437
"55029100800",4649,607,0,0,74,36,89,30,5485
"55029100900",1325,160,0,0,25,0,15,20,1545
"55029101000",1973,172,9,6,36,0,69,0,2265
"55029990000",0,0,0,0,0,0,0,0,0
"55031020300",1511,830,0,47,235,74,29,62,2788
"55031020400",2587,190,44,5,147,86,68,0,3127
"55031020500",1897,260,75,31,66,23,8,21,2381
"55031020600",3139,1257,14,1,78,52,0,0,4541
"55031020700",3380,418,41,0,79,69,12,77,4076
"55031020800",2344,430,0,39,237,94,5,9,3158
"55031020900",1892,235,51,1,107,4,0,0,2290
"55031021000",1327,289,34,0,88,11,0,0,1749
"55031021100",1296,862,0,24,112,56,30,0,2380
"55031030100",5439,406,7,0,223,50,53,3,6181
"55031030200",4483,388,7,0,212,33,98,9,5230
"55031030300",4246,408,12,2,253,38,38,11,5008
"55031990000",0,0,0,0,0,0,0,0,0
"55033970100",3390,314,0,0,60,19,38,3,3824
"55033970200",4187,489,0,0,35,47,14,13,4785
"55033970300",5192,545,4,0,56,6,20,22,5845
"55033970400",5464,470,7,0,235,29,77,58,6340
"55033970500",4536,528,131,0,302,1,91,0,5589
"55033970600",3650,310,0,0,61,132,9,0,4162
"55033970700",4071,1374,12,0,475,57,59,195,6243
"55033970800",2341,1674,8,61,236,84,8,1,4413
"55035000100",3804,923,30,0,113,31,73,83,5057
"55035000200",4395,256,15,0,60,11,34,5,4776
"55035000301",3386,328,0,0,24,5,0,0,3743
"55035000302",6552,487,0,0,360,24,252,0,7675
"55035000400",6496,424,21,5,468,73,19,24,7530
"55035000501",3991,397,10,0,185,63,0,0,4646
"55035000502",4115,181,34,0,176,28,0,0,4534
"55035000600",3340,931,19,0,496,278,22,0,5086
"55035000700",4258,486,25,1,479,156,486,79,5970
"55035000801",3319,120,13,0,247,0,0,0,3699
"55035000802",3453,364,0,0,227,20,85,96,4245
"55035000803",4175,928,96,11,333,245,0,356,6144
"55035000900",3702,770,0,25,427,183,82,0,5189
"55035001101",817,779,4,39,48,60,24,44,1815
"55035001200",2089,2614,0,124,28,194,69,25,5143
"55035001300",4201,628,0,0,191,163,0,0,5183
"55035001400",5625,1204,0,58,180,37,52,40,7196
"55035001500",3009,229,77,1,131,0,28,0,3475
"55035001600",5045,201,43,6,220,35,50,0,5600
"55035001700",1469,684,6,1,131,51,60,30,2432
"55037190100",2462,263,0,0,50,0,22,0,2797
"55037190200",1478,146,4,0,10,0,18,5,1661
"55039040100",3820,156,0,23,218,140,213,126,4696
"55039040200",2306,343,12,0,79,36,37,32,2845
"55039040300",3300,1030,98,47,1100,270,603,418,6866
"55039040400",2520,183,0,10,46,23,81,13,2876
"55039040500",2150,823,38,67,178,129,111,18,3514
"55039040700",3584,325,41,118,235,13,201,0,4517
"55039040800",3961,649,65,0,189,26,476,167,5533
"55039040900",2949,170,24,0,91,23,156,17,3430
"55039041000",2652,371,0,21,85,26,172,18,3345
"55039041100",7919,389,32,29,263,86,237,0,8955
"55039041300",5591,475,196,0,258,70,267,129,6986
"55039041400",5461,103,11,0,62,73,74,55,5839
"55039041500",2681,211,0,0,81,0,131,0,3104
"55039041600",4416,531,30,18,129,73,28,70,5295
"55039041700",3635,221,23,3,98,10,125,20,4135
"55039041800",4365,185,0,0,284,0,165,0,4999
"55039041900",6405,495,17,3,122,8,184,34,7268
"55039042000",7465,319,0,0,293,4,200,4,8285
"55039042100",4429,272,0,0,60,4,27,0,4792
"55039042200",5452,457,0,0,128,10,75,8,6130
"55041950100",1087,155,0,4,34,24,0,9,1313
"55041950200",1795,323,9,13,253,55,28,6,2482
"55041950300",1715,243,4,0,402,142,46,60,2612
"55041950400",1731,269,0,0,348,277,10,9,2644
"55043960100",3230,429,16,3,93,3,69,19,3862
"55043960200",3451,400,3,1,31,23,23,3,3935
"55043960300",3567,539,0,0,20,0,26,0,4152
"55043960400",2970,517,1,0,49,3,44,36,3620
"55043960500",3051,504,0,0,69,5,7,0,3636
"55043960600",3113,405,18,2,78,5,12,32,3665
"55043960700",3432,415,13,0,7,0,36,0,3903
"55043960800",2674,303,0,0,40,10,15,2,3044
"55043960900",2747,1532,34,77,28,0,25,45,4488
"55043961000",3565,1360,58,0,210,35,73,46,5347
"55043961100",3979,351,8,6,38,16,61,0,4459
"55043961200",3467,358,15,0,84,16,60,0,4000
"55045960100",6168,234,21,0,77,16,145,4,6665
"55045960200",5352,329,7,6,41,12,57,53,5857
"55045960300",4344,339,3,4,147,20,50,9,4916
"55045960400",3070,775,0,0,180,0,90,72,4187
"55045960500",3260,503,17,13,17,161,231,36,4238
"55045960600",3120,217,0,0,0,0,103,0,3440
"55045960700",3638,255,0,5,25,16,40,61,4040
"55045960800",3709,327,0,0,161,21,92,8,4318
"55047100100",2401,708,5,0,180,0,171,122,3587
"55047100200",2286,283,0,0,181,0,143,21,2914
"55047100300",2665,234,13,0,28,13,6,13,2972
"55047100400",2310,185,27,28,76,3,66,0,2695
"55047100500",2569,379,6,0,26,0,18,0,2998
"55047100600",3572,387,3,4,62,50,195,98,4371
"55049950100",3416,325,15,0,84,0,13,4,3857
"55049950200",2505,404,4,20,54,35,27,2,3051
"55049950300",2745,247,0,0,183,5,107,11,3298
"55049950400",4592,588,0,0,83,0,34,0,5297
"55049950500",4206,312,33,4,133,7,122,5,4822
"55049950600",2926,501,6,0,29,0,27,20,3509
"55051180100",1965,245,0,16,39,29,14,12,2320
"55051180200",1270,157,0,0,31,2,8,2,1470
"55051180300",1765,204,0,0,31,0,12,0,2012
"55051990000",0,0,0,0,0,0,0,0,0
"55053960100",1947,328,8,4,608,194,87,40,3216
"55053960200",2682,349,2,0,294,17,116,18,3478
"55053960300",3367,675,0,1,52,107,46,59,4307
"55053960400",3371,606,2,0,142,64,106,30,4321
"55053960500",3592,425,1,28,351,12,32,42,4483
"55055100100",4765,757,0,0,277,0,162,0,5961
"55055100200",2614,546,13,13,229,14,288,47,3764
"55055100300",4875,762,11,20,127,156,230,157,6338
"55055100400",5254,315,12,0,157,0,347,115,6200
"55055100500",5612,542,54,11,242,4,215,54,6734
"55055100601",1331,86,11,0,10,0,6,0,1444
"55055100602",2956,297,0,1,73,0,9,13,3349
"55055100700",4080,314,38,7,104,10,84,30,4667
"55055100800",3895,296,5,6,49,14,32,12,4309
"55055100900",3438,176,0,0,21,31,107,0,3773
"55055101000",3239,419,0,0,195,55,303,174,4385
"55055101100",3639,358,53,9,142,16,512,27,4756
"55055101201",1965,150,12,4,10,5,7,0,2153
"55055101202",1539,91,0,0,24,6,18,0,1678
"55055101300",4615,481,12,60,305,107,327,16,5923
"55055101400",2468,467,6,0,182,181,256,351,3911
"55055101500",3131,598,0,0,337,45,360,274,4745
"55055101600",3992,660,44,41,283,91,698,32,5841
"55055101701",1342,110,0,0,9,0,24,5,1490
"55055101702",4368,265,26,0,115,0,161,0,4935
"55057100100",2345,395,31,0,55,0,119,7,2952
"55057100200",3031,375,10,8,89,29,25,6,3573
"55057100300",2517,657,17,0,60,3,47,0,3301
"55057100400",3360,405,8,4,108,30,75,47,4037
"55057100500",3320,604,38,36,25,10,115,18,4166
"55057100600",2842,420,10,46,39,16,33,47,3453
"55057100700",3274,454,5,4,175,71,54,9,4046
"55059000100",4030,828,170,135,357,2,417,0,5939
"55059000300",2437,670,170,100,36,156,283,325,4177
"55059000400",2801,381,66,61,70,42,297,83,3801
"55059000500",3984,739,257,34,89,17,511,48,5679
"55059000601",4233,261,231,142,223,0,279,64,5433
"55059000602",5531,819,509,105,290,0,500,262,8016
"55059000700",3320,663,485,630,188,50,903,351,6590
"55059000800",2022,741,412,184,75,103,1068,580,5185
"55059000900",2073,737,505,170,116,149,868,392,5010
"55059001000",1241,275,61,162,80,10,204,8,2041
"55059001100",868,857,512,514,155,101,223,552,3782
"55059001200",2822,513,140,282,204,63,982,274,5280
"55059001300",2892,520,170,504,397,75,775,146,5479
"55059001400",5341,816,114,38,310,10,494,52,7175
"55059001500",2511,342,365,251,147,35,395,70,4116
"55059001600",1779,704,281,264,200,271,885,466,4850
"55059001700",1650,295,313,540,85,67,405,93,3448
"55059001800",1632,265,226,172,50,39,281,118,2783
"55059001900",2172,178,64,41,174,35,119,0,2783
"55059002000",4835,296,0,0,405,25,121,8,5690
"55059002100",3083,1423,90,319,132,161,458,969,6635
"55059002200",2950,444,74,67,130,41,196,152,4054
"55059002300",4584,563,27,234,170,13,276,0,5867
"55059002400",3876,618,159,0,101,0,149,280,5183
"55059002500",3155,184,41,0,112,18,178,18,3706
"55059002601",7527,302,652,35,845,0,1466,0,10827
"55059002602",7126,299,456,0,601,175,733,39,9429
"55059002700",5155,279,81,0,143,0,363,0,6021
"55059002800",5745,515,25,54,68,129,238,0,6774
"55059002903",2766,176,0,24,94,48,58,8,3174
"55059002904",5127,668,0,0,19,0,432,0,6246
"55059002905",3230,383,4,0,69,0,109,0,3795
"55059002906",4370,184,36,14,137,0,109,7,4857
"55059003001",3671,485,5,1,52,0,69,0,4283
"55059003002",4419,474,28,0,114,14,141,0,5190
"55059990000",0,0,0,0,0,0,0,0,0
"55061960100",2604,350,0,46,0,45,34,37,3116
"55061960200",2383,260,0,9,18,9,48,0,2727
"55061960400",7745,526,7,0,167,91,121,109,8766
"55061960500",5411,444,0,0,175,20,113,20,6183
"55061990000",0,0,0,0,0,0,0,0,0
"55063000100",3630,313,0,0,577,223,171,88,5002
"55063000200",2976,971,123,33,576,349,63,74,5165
"55063000300",1230,421,127,116,179,12,0,13,2098
"55063000400",1645,3195,0,55,179,97,22,35,5228
"55063000500",589,1379,0,22,45,97,0,8,2140
"55063000600",1705,392,0,0,96,22,14,17,2246
"55063000700",4148,141,10,0,101,9,12,0,4421
"55063000800",2275,798,30,0,80,35,43,40,3301
"55063000900",2019,561,306,38,385,116,41,11,3477
"55063001000",2591,619,32,92,276,23,72,1,3706
"55063001101",1903,167,0,0,33,0,8,0,2111
"55063001102",2838,400,9,0,232,285,58,138,3960
"55063001200",3461,366,83,0,233,23,22,0,4188
"55063010101",5169,550,19,0,29,20,48,20,5855
"55063010102",3998,394,8,10,102,31,19,57,4619
"55063010201",8109,783,1,5,691,79,73,0,9741
"55063010202",6305,337,12,0,352,0,27,0,7033
"55063010203",1667,128,7,6,64,26,7,0,1905
"55063010300",4038,475,0,0,74,44,35,44,4710
"55063010401",4768,215,17,0,354,0,73,0,5427
"55063010402",7339,590,116,76,959,254,100,16,9450
"55063010500",4912,384,107,0,430,71,48,0,5952
"55063010600",2969,201,27,15,68,0,58,9,3347
"55063010700",4982,222,0,0,29,8,73,0,5314
"55063010800",2803,322,0,0,63,0,85,26,3299
"55065970100",2752,277,2,1,35,12,53,8,3140
"55065970200",3110,517,4,0,171,0,165,109,4076
"55065970300",2985,296,6,15,164,2,159,39,3666
"55065970400",2756,344,20,0,13,0,6,14,3153
"55065970500",2759,329,2,4,45,3,7,4,3153
"55067960100",2311,311,2,1,32,22,5,4,2688
"55067960300",2303,233,0,0,69,57,2,38,2702
"55067960400",3311,361,0,0,85,15,36,44,3852
"55067960500",1471,263,0,6,13,19,13,6,1791
"55067960600",3313,1028,13,96,97,44,125,0,4716
"55067960700",2977,602,0,0,112,5,75,0,3771
"55069960100",2060,204,0,2,28,5,15,16,2330
"55069960200",2036,298,0,0,36,22,46,0,2438
"55069960300",1730,69,0,0,18,0,21,0,1838
"55069960400",1686,86,3,0,19,0,8,0,1802
"55069960500",1614,171,0,0,37,6,22,23,1873
"55069960600",3815,372,1,2,114,10,17,0,4331
"55069960700",3488,131,0,7,10,0,65,4,3705
"55069960800",2778,426,0,0,41,79,38,0,3362
"55069960900",2251,362,13,8,96,4,27,4,2765
"55069961000",2767,475,0,15,37,46,38,12,3390
"55071000100",3981,734,25,0,165,24,0,0,4929
"55071000200",1902,350,0,0,145,0,85,95,2577
"55071000300",4998,274,0,0,250,0,33,32,5587
"55071000400",3465,395,37,0,306,107,285,156,4751
"55071000500",2289,195,8,0,122,0,497,8,3119
"55071000600",3891,566,0,0,764,0,106,0,5327
"55071000700",4002,905,0,0,148,407,48,47,5557
"55071000800",2887,431,0,0,194,234,213,68,4027
"55071005100",2096,176,0,53,45,8,34,0,2412
"55071005200",4087,330,27,1,52,1,67,0,4565
"55071005300",1626,309,0,9,153,12,46,36,2191
"55071005400",2402,263,0,100,129,0,102,0,2996
"55071010100",4291,225,18,0,93,0,64,0,4691
"55071010200",5369,255,4,0,77,0,5,71,5781
"55071010300",3872,381,0,0,71,0,32,38,4394
"55071010400",5556,402,0,0,124,21,214,45,6362
"55071010500",3024,300,0,5,77,17,8,0,3431
"55071010600",4803,270,40,0,115,0,185,12,5425
"55071010700",3772,189,0,8,38,0,108,0,4115
"55071990000",0,0,0,0,0,0,0,0,0
"55073000100",1145,739,22,43,575,131,74,126,2855
"55073000200",1993,229,0,0,353,237,36,8,2856
"55073000300",4101,298,1,2,337,114,0,6,4859
"55073000400",4722,690,116,0,681,105,193,127,6634
"55073000500",1897,271,2,31,642,319,17,181,3360
"55073000601",1393,102,0,0,350,202,14,0,2061
"55073000602",2060,561,22,0,852,123,154,61,3833
"55073000700",3314,782,0,243,830,103,80,12,5364
"55073000800",2741,173,56,3,128,170,29,0,3300
"55073000900",1961,160,0,0,54,70,51,9,2305
"55073001000",2980,162,19,0,64,0,0,0,3225
"55073001102",7621,307,5,0,278,158,257,4,8630
"55073001103",4003,302,32,0,154,835,20,0,5346
"55073001104",4444,998,0,24,244,0,328,102,6140
"55073001201",7885,476,14,0,330,16,17,0,8738
"55073001202",4558,345,16,11,164,16,6,22,5138
"55073001300",6357,228,35,0,242,0,0,0,6862
"55073001400",5752,756,88,0,269,19,48,254,7186
"55073001500",3925,205,1,0,52,0,0,0,4183
"55073001600",5603,247,2,0,195,2,85,9,6143
"55073001700",3191,268,0,0,43,35,51,2,3590
"55073001800",5002,210,7,7,34,35,20,6,5321
"55073001900",5246,567,0,0,83,25,48,21,5990
"55073002000",3638,275,20,5,47,7,58,6,4056
"55073002100",6171,553,51,1,211,10,67,8,7072
"55073002200",2835,395,5,3,98,17,333,110,3796
"55073002300",6684,622,0,0,117,52,210,41,7726
"55075960100",2496,369,0,0,35,8,11,0,2919
"55075960200",3353,474,3,2,61,42,11,4,3950
"55075960600",1972,342,3,0,41,39,0,0,2397
"55075960700",2591,229,0,0,14,0,0,2,2836
"55075960800",2159,311,0,0,36,2,6,15,2529
"55075960900",2381,151,11,0,7,0,19,0,2569
"55075961000",3526,410,0,0,139,26,112,28,4241
"55075961100",4531,581,6,0,192,3,89,0,5402
"55075961200",2369,169,0,0,8,0,18,0,2564
"55075961300",2143,486,8,0,181,62,126,0,3006
"55075961400",3420,668,18,9,87,27,47,0,4276
"55075961500",3028,685,20,35,108,38,60,56,4030
"55075990000",0,0,0,0,0,0,0,0,0
"55077960100",2220,347,23,0,74,10,8,0,2682
"55077960200",2014,419,2,3,11,0,4,0,2453
"55077960300",2962,568,0,0,65,16,55,4,3670
"55077960400",2151,181,4,0,64,14,66,23,2503
"55077960500",3053,505,0,0,144,6,148,93,3949
"55078940101",26,3,0,0,724,755,42,66,1616
"55078940102",386,59,0,3,1685,715,51,83,2982
"55079000101",931,179,1521,1528,428,83,344,0,5014
"55079000102",864,138,1531,774,202,127,85,66,3787
"55079000201",1359,356,1336,1375,422,380,505,482,6215
"55079000202",2930,108,1637,946,394,195,136,82,6428
"55079000301",1181,39,188,2,93,0,0,0,1503
"55079000302",483,59,1535,840,171,105,87,48,3328
"55079000303",661,76,862,73,66,90,27,0,1855
"55079000304",1367,14,1219,51,356,150,63,0,3220
"55079000400",714,127,1054,256,287,34,144,0,2616
"55079000501",1446,205,1102,534,325,96,144,71,3923
"55079000502",617,90,1937,1457,414,38,241,13,4807
"55079000600",1144,66,2315,1358,1198,368,81,0,6530
"55079000700",1096,41,1546,465,112,16,35,16,3327
"55079000800",1095,159,2429,553,486,7,134,77,4940
"55079000900",678,18,1855,1157,142,65,111,0,4026
"55079001000",383,50,1913,911,238,51,64,27,3637
"55079001100",232,107,1355,449,50,21,15,13,2242
"55079001200",167,14,946,817,810,452,130,96,3432
"55079001300",276,14,2293,782,856,128,206,0,4555
"55079001400",260,24,812,560,463,193,62,24,2398
"55079001500",550,150,972,695,706,173,0,0,3246
"55079001600",475,46,1293,946,130,18,18,23,2949
"55079001700",1091,85,2266,934,247,248,120,201,5192
"55079001800",518,151,1248,910,129,63,135,32,3186
"55079001900",305,105,1397,954,124,0,6,8,2899
"55079002000",216,43,1356,664,111,35,38,0,2463
"55079002100",90,27,1139,787,39,9,29,9,2129
"55079002200",711,54,560,272,29,7,223,7,1863
"55079002300",146,61,2616,1066,74,92,45,94,4194
"55079002400",92,0,1111,726,0,118,8,0,2055
"55079002500",226,42,838,777,113,101,140,51,2288
"55079002600",196,9,1838,848,14,15,19,16,2955
"55079002700",157,73,1221,603,66,0,0,0,2120
"55079002800",212,25,1244,728,115,16,91,5,2436
"55079002900",237,24,825,803,286,16,88,14,2293
"55079003000",605,103,1963,1043,330,81,24,47,4196
"55079003100",346,39,2472,345,634,61,91,52,4040
"55079003200",487,33,1457,385,507,77,90,53,3089
"55079003300",795,164,2379,937,581,111,166,68,5201
"55079003400",1927,68,2001,1108,389,292,141,129,6055
"55079003500",562,43,2785,434,273,43,35,0,4175
"55079003600",208,51,1257,713,70,0,23,15,2337
"55079003700",253,71,1085,473,105,0,6,0,1993
"55079003800",92,37,1581,641,152,18,107,11,2639
"55079003900",20,10,1984,594,127,21,69,34,2859
"55079004000",123,6,1575,860,35,8,0,2,2609
"55079004100",135,35,1454,602,40,149,33,10,2458
"55079004200",53,13,1510,1656,8,0,13,0,3253
"55079004300",242,4,2918,1186,10,44,134,0,4538
"55079004400",809,155,1285,970,133,91,197,24,3664
"55079004500",12,42,1092,955,42,96,33,109,2381
"55079004600",34,9,1892,1104,28,8,13,0,3088
"55079004700",30,0,2779,1102,5,12,36,0,3964
"55079004800",120,151,2126,1454,104,52,10,60,4077
"55079004900",965,17,2303,713,234,9,65,9,4315
"55079005000",1001,139,2531,946,468,113,143,64,5405
"55079005100",471,103,2161,779,151,23,79,30,3797
"55079005200",956,46,420,110,124,15,75,0,1746
"55079005300",1235,49,317,135,241,17,203,0,2197
"55079005400",2848,232,442,159,174,0,73,12,3940
"55079005500",2575,56,438,8,141,0,218,0,3436
"55079005600",1818,62,56,21,128,1,119,0,2205
"55079005700",1839,85,306,101,27,0,46,0,2404
"55079005800",2226,128,492,317,108,0,259,0,3530
"55079005900",770,137,1657,439,404,51,472,51,3981
"55079006000",88,51,1338,1110,63,14,44,8,2716
"55079006100",305,30,1149,520,127,76,11,71,2289
"55079006200",28,31,1456,798,55,14,0,18,2400
"55079006300",16,15,1342,937,4,59,47,29,2449
"55079006400",0,0,839,1466,16,53,0,26,2400
"55079006500",97,27,782,1095,74,13,63,5,2156
"55079006600",89,130,1065,1495,124,44,74,145,3166
"55079006700",19,16,661,563,4,12,21,22,1318
"55079006800",0,21,1334,998,92,0,126,0,2571
"55079006900",172,91,783,1816,94,194,242,208,3600
"55079007000",193,146,1270,880,47,124,162,141,2963
"55079007100",1063,406,201,184,166,46,193,25,2284
"55079007200",1791,257,435,261,227,49,150,37,3207
"55079007300",1254,795,245,199,53,73,154,22,2795
"55079007400",902,415,51,0,103,8,22,24,1525
"55079007500",1806,564,27,29,74,28,33,33,2594
"55079007600",2345,589,83,46,142,148,138,24,3515
"55079007700",2211,1125,171,22,198,90,51,89,3957
"55079007800",1615,1588,31,41,239,136,105,79,3834
"55079007900",1136,221,187,44,178,63,89,50,1968
"55079008000",880,336,137,368,185,47,188,4,2145
"55079008100",192,121,378,476,61,62,99,125,1514
"55079008400",12,36,618,580,79,13,45,36,1419
"55079008500",8,14,467,939,0,41,0,16,1485
"55079008600",5,9,656,340,21,0,0,4,1035
"55079008700",21,0,815,647,0,20,0,86,1589
"55079008800",5,11,1013,912,10,15,5,12,1983
"55079008900",97,70,427,510,0,12,89,0,1205
"55079009000",50,60,996,1306,22,91,11,0,2536
"55079009100",190,41,884,738,224,97,89,15,2278
"55079009200",402,83,697,459,162,46,53,4,1906
"55079009300",1383,37,459,380,170,9,153,0,2591
"55079009400",1809,44,521,33,389,15,372,27,3210
"55079009500",1409,102,375,55,154,40,95,8,2238
"55079009600",137,134,728,904,133,154,83,215,2488
"55079009700",80,34,727,264,438,202,19,29,1793
"55079009800",35,5,531,721,88,99,0,15,1494
"55079009900",16,8,869,271,5,5,0,8,1182
"55079010600",351,80,298,155,89,121,138,114,1346
"55079010700",1393,290,189,102,241,127,284,68,2694
"55079010800",1633,378,114,33,48,0,57,5,2268
"55079011000",2131,518,287,74,228,26,28,0,3292
"55079011100",1083,303,57,8,109,36,63,17,1676
"55079011200",1540,321,150,140,62,56,113,38,2420
"55079011300",925,183,113,54,37,56,32,64,1464
"55079011400",1035,80,192,36,29,6,35,6,1419
"55079012200",178,143,543,690,494,595,34,49,2726
"55079012300",135,9,409,339,96,10,73,4,1075
"55079012400",1075,117,558,346,478,66,120,0,2760
"55079012500",1841,76,142,2,91,18,54,0,2224
"55079012600",1840,287,70,0,177,42,250,8,2674
"55079012700",1002,126,21,0,43,0,142,12,1346
"55079012800",1815,228,72,9,240,92,550,0,3006
"55079012900",2019,497,155,43,269,38,474,20,3515
"55079013000",1260,320,101,37,177,45,290,218,2448
"55079013300",337,131,212,125,214,49,141,0,1209
"55079013400",387,237,503,699,302,229,225,162,2744
"55079013500",349,179,434,797,80,47,142,83,2111
"55079013600",151,135,1030,743,62,325,113,332,2891
"55079013700",199,97,492,641,111,106,108,51,1805
"55079014100",154,150,589,693,6,4,74,25,1695
"55079014300",1810,301,64,34,265,5,244,0,2723
"55079014400",1649,247,69,40,346,0,142,0,2493
"55079014600",320,520,94,511,148,203,11,18,1825
"55079014700",259,1096,147,700,56,256,39,210,2763
"55079014800",326,233,310,385,196,122,130,76,1778
"55079014900",174,563,272,405,34,93,65,222,1828
"55079015700",620,555,89,220,734,755,1133,1080,5186
"55079015800",634,387,112,151,912,677,1230,737,4840
"55079015900",1176,837,248,275,749,584,1464,1034,6367
"55079016000",919,688,138,155,593,813,1043,954,5303
"55079016100",1943,550,0,66,759,289,1979,678,6264
"55079016200",1296,478,9,279,608,401,1460,680,5211
"55079016300",1065,642,199,273,1634,1076,2129,1436,8454
"55079016400",736,404,43,262,1495,1230,1899,1506,7575
"55079016500",555,261,62,66,743,561,1129,723,4100
"55079016600",505,259,66,449,321,405,501,509,3015
"55079016700",594,377,214,170,1167,735,1594,996,5847
"55079016800",617,478,277,286,905,757,1283,969,5572
"55079016900",1025,844,29,202,1136,642,1908,1089,6875
"55079017000",2033,882,19,188,1641,866,2819,1297,9745
"55079017100",1429,393,83,69,753,222,1640,361,4950
"55079017200",1389,506,105,1,491,78,1413,554,4537
"55079017300",1920,767,79,246,564,497,1947,1211,7231
"55079017400",1115,657,60,211,434,568,1238,1035,5318
"55079017500",1522,746,145,617,621,371,1773,837,6632
"55079017600",1007,621,50,176,661,533,1279,924,5251
"55079017900",2290,475,28,30,191,39,261,143,3457
"55079018000",2236,488,24,14,134,56,440,65,3457
"55079018100",1422,53,7,90,131,0,71,6,1780
"55079018200",1641,52,0,0,48,0,90,0,1831
"55079018300",1932,366,24,0,54,78,169,147,2770
"55079018400",1248,101,0,0,38,0,35,16,1438
"55079018500",1583,158,0,0,127,35,489,104,2496
"55079018600",1341,570,143,131,399,295,1250,610,4739
"55079018700",1679,891,44,166,467,306,1279,1114,5946
"55079018800",1126,630,5,151,261,138,1127,715,4153
"55079018900",1317,416,23,11,189,0,855,363,3174
"55079019000",3397,737,259,122,261,55,638,332,5801
"55079019100",2262,443,213,17,448,21,887,82,4373
"55079019200",2485,189,16,78,337,107,572,81,3865
"55079019300",2269,76,56,3,211,8,409,0,3032
"55079019400",3108,466,66,50,173,62,466,70,4461
"55079019500",3023,304,0,0,191,41,246,146,3951
"55079019600",2789,283,173,30,229,0,277,53,3834
"55079019700",4237,646,44,119,467,113,416,560,6602
"55079019800",3702,696,95,178,482,96,566,536,6351
"55079019900",2879,278,187,144,379,55,779,120,4821
"55079020000",1890,468,256,294,379,172,834,155,4448
"55079020100",2500,386,224,60,276,102,1346,344,5238
"55079020200",2043,475,21,141,362,83,768,324,4217
"55079020300",2859,483,211,28,441,39,1350,466,5877
"55079020400",2270,396,76,40,399,340,1713,613,5847
"55079020500",2102,669,15,5,354,108,1538,590,5381
"55079020600",2949,323,47,0,245,0,556,22,4142
"55079020700",3580,328,22,2,158,82,240,66,4478
"55079020800",2518,172,39,1,301,23,185,0,3239
"55079020900",2163,212,53,0,82,61,335,103,3009
"55079021000",1930,171,22,35,113,49,310,60,2690
"55079021100",1131,89,6,0,146,0,161,52,1585
"55079021200",1608,404,35,34,100,56,304,152,2693
"55079021300",1153,138,136,122,107,40,368,118,2182
"55079021400",1903,736,117,72,313,460,762,531,4894
"55079021500",2024,228,112,1,340,170,260,216,3351
"55079021600",3055,716,9,151,528,121,557,203,5340
"55079021700",5534,598,85,6,329,306,1313,183,8354
"55079021800",1591,320,26,34,299,98,317,159,2844
"55079030100",3889,78,112,1,327,42,87,34,4570
"55079035100",2154,75,4,0,62,0,10,4,2309
"55079035200",3639,126,195,0,297,0,93,0,4350
"55079040100",1199,17,81,0,167,6,31,12,1513
"55079050101",3914,129,1262,45,577,102,438,0,6467
"55079050102",2804,168,2036,531,489,38,260,22,6348
"55079060101",2685,288,349,86,308,47,106,10,3879
"55079060102",2372,30,379,40,372,12,340,0,3545
"55079060200",4067,499,611,92,182,110,145,175,5881
"55079070100",4183,168,0,0,222,0,131,0,4704
"55079070200",4441,156,0,124,202,0,57,0,4980
"55079070300",3773,82,76,0,624,70,150,0,4775
"55079080100",2182,98,54,24,193,12,17,0,2580
"55079080200",3053,233,79,8,198,12,103,18,3704
"55079080300",3359,125,65,31,205,56,131,14,3986
"55079080400",2254,553,40,56,250,144,122,0,3419
"55079090100",3522,341,357,48,109,1,107,0,4485
"55079090200",1582,31,143,12,129,38,35,0,1970
"55079090300",2363,102,179,38,565,37,224,0,3508
"55079090600",4078,227,88,0,122,219,141,17,4892
"55079090700",3083,61,0,0,54,0,75,0,3273
"55079090800",2280,72,30,0,26,0,13,0,2421
"55079090900",3085,108,256,0,209,52,34,0,3744
"55079091000",3731,237,321,3,344,0,191,60,4887
"55079091100",3871,106,141,7,113,0,84,0,4322
"55079091200",3503,544,198,0,392,40,127,60,4864
"55079091300",3033,285,3,47,110,6,44,0,3528
"55079091400",1909,60,95,0,226,10,141,0,2441
"55079100100",2416,577,213,346,179,32,200,73,4036
"55079100200",2872,423,147,35,295,91,674,86,4623
"55079100300",2103,362,26,0,277,140,221,34,3163
"55079100400",2013,371,83,29,117,0,254,72,2939
"55079100500",2571,504,73,194,294,35,360,63,4094
"55079100600",1705,389,59,28,99,11,132,121,2544
"55079100700",2294,232,104,1,62,1,188,0,2882
"55079100800",2524,138,10,0,187,24,133,24,3040
"55079100900",2527,456,127,40,523,71,192,137,4073
"55079101000",4105,452,17,15,119,70,328,122,5228
"55079101100",1499,179,75,10,73,0,115,52,2003
"55079101200",2604,172,7,0,66,20,124,17,3010
"55079101300",2564,197,34,34,184,0,234,6,3253
"55079101400",2926,231,114,7,191,121,497,47,4134
"55079101500",3576,996,53,144,143,38,474,455,5879
"55079101600",3600,385,166,41,374,104,549,213,5432
"55079101700",2545,310,59,125,170,59,267,172,3707
"55079101800",2030,273,80,32,95,42,51,28,2631
"55079110100",2411,661,289,253,491,106,1037,310,5558
"55079120101",3359,216,59,0,266,27,118,41,4086
"55079120102",3210,320,29,0,137,0,118,44,3858
"55079120201",2900,231,0,29,327,7,74,0,3568
"55079120202",2608,239,147,0,107,122,505,72,3800
"55079120203",2731,315,126,41,250,10,254,180,3907
"55079120300",1572,161,53,24,135,95,299,106,2445
"55079120400",5254,513,324,0,365,63,849,91,7459
"55079120501",3242,468,119,0,618,0,342,170,4959
"55079120502",3868,396,9,141,618,129,350,0,5511
"55079130100",4281,289,0,0,291,0,277,0,5138
"55079130200",2575,139,20,0,52,28,109,0,2923
"55079140100",2766,130,14,0,108,11,50,9,3088
"55079140201",4362,272,0,0,460,36,338,10,5478
"55079140202",4897,635,120,0,338,0,103,0,6093
"55079150100",7076,590,98,13,1061,119,492,0,9449
"55079150301",5352,229,13,0,541,0,129,0,6264
"55079150303",4264,195,56,0,347,0,129,10,5001
"55079150304",3000,474,174,0,253,70,66,0,4037
"55079160100",5313,747,85,19,348,63,213,237,7025
"55079160202",5951,530,104,0,778,0,708,0,8071
"55079160203",4564,388,222,0,781,0,405,79,6439
"55079160204",3617,243,154,48,963,32,367,0,5424
"55079160300",8519,306,172,0,889,5,543,134,10568
"55079170100",2236,239,20,0,85,97,152,14,2843
"55079170200",3226,339,44,14,163,18,279,53,4136
"55079170300",2248,262,37,0,83,28,102,19,2779
"55079170400",2854,160,32,41,132,0,101,0,3320
"55079170500",1738,259,23,35,43,23,156,0,2277
"55079170600",2447,765,20,19,221,153,494,80,4199
"55079170700",2455,168,32,69,125,19,426,42,3336
"55079180100",2530,407,21,0,62,0,170,81,3271
"55079180200",2843,1002,33,30,429,468,563,446,5814
"55079180300",2266,544,200,32,237,0,464,171,3914
"55079180400",2261,208,110,0,131,20,231,13,2974
"55079180500",3873,234,84,24,243,0,208,44,4710
"55079185100",3569,396,57,94,137,249,478,136,5116
"55079185200",3967,361,47,1,497,17,486,50,5426
"55079185300",3035,236,50,27,182,0,22,0,3552
"55079185400",10,9,798,657,127,166,5,0,1772
"55079185500",0,15,954,810,5,5,0,11,1800
"55079185600",400,42,748,465,45,0,0,0,1700
"55079185700",69,35,846,1202,0,134,46,1,2333
"55079185800",35,13,958,380,57,90,60,0,1593
"55079185900",69,25,531,349,167,67,0,0,1208
"55079186000",75,65,728,585,56,10,0,4,1523
"55079186100",108,23,564,1014,201,148,22,66,2146
"55079186200",116,35,446,687,52,41,89,31,1497
"55079186300",913,247,222,11,57,30,40,18,1538
"55079186400",150,160,42,36,9,27,14,24,462
"55079186500",725,141,153,27,238,415,408,408,2515
"55079186600",939,664,39,168,284,94,671,593,3452
"55079186800",131,314,157,297,192,213,181,342,1827
"55079186900",1632,90,158,0,293,8,96,8,2285
"55079187000",2518,448,51,66,352,47,195,0,3677
"55079187200",2950,102,77,0,262,0,170,0,3561
"55079187300",5471,175,23,0,800,95,191,16,6771
"55079187400",2412,101,45,35,152,11,139,11,2906
"55079980000",0,0,0,0,0,0,0,0,0
"55079990000",0,0,0,0,0,0,0,0,0
"55081950100",3954,347,52,5,314,125,49,33,4879
"55081950200",4099,314,0,0,97,74,79,2,4665
"55081950300",4910,986,0,2,212,196,397,341,7044
"55081950400",3347,725,0,0,62,54,122,13,4323
"55081950500",5362,467,104,2,297,3,100,0,6335
"55081950600",2820,874,81,26,84,53,25,0,3963
"55081950700",3600,794,0,26,76,46,13,4,4559
"55081950800",3246,919,0,0,318,87,334,128,5032
"55081950900",4303,537,77,8,85,6,61,20,5097
"55083100300",2490,193,0,0,36,33,2,0,2754
"55083100500",1907,269,6,12,48,56,61,34,2393
"55083100600",1966,384,0,0,125,62,20,38,2595
"55083100700",2283,268,7,0,153,58,66,49,2884
"55083100800",2106,250,0,0,48,34,22,8,2468
"55083100900",2395,387,26,0,71,40,17,6,2942
"55083101000",3590,264,0,3,67,9,46,27,4006
"55083101100",4393,307,5,6,67,6,50,1,4835
"55083101200",3454,328,0,0,138,48,79,0,4047
"55083101300",8074,449,7,0,138,0,80,0,8748
"55083990000",0,0,0,0,0,0,0,0,0
"55085970101",1381,111,0,0,20,1,9,0,1522
"55085970102",3137,284,0,0,93,13,19,7,3553
"55085970400",2345,220,0,1,54,9,0,0,2629
"55085970500",1682,184,0,3,47,5,8,3,1932
"55085970601",1764,98,0,0,4,3,22,3,1894
"55085970602",3066,380,26,11,109,10,63,9,3674
"55085970800",1850,253,0,8,32,40,39,20,2242
"55085970900",2005,147,0,0,5,5,15,3,2180
"55085971001",1210,106,0,0,21,0,24,0,1361
"55085971002",2129,127,29,0,110,11,74,0,2480
"55085971100",1940,182,0,1,50,0,5,0,2178
"55085971300",1509,196,0,0,54,0,6,0,1765
"55085971400",2821,303,0,43,174,12,49,7,3409
"55085971500",3571,796,10,50,107,19,9,45,4607
"55087010100",1528,487,0,69,31,50,51,4,2220
"55087010200",3090,220,0,15,593,161,374,123,4576
"55087010300",1344,437,7,5,428,71,115,0,2407
"55087010500",2454,453,43,56,234,24,104,4,3372
"55087010601",2270,346,55,27,683,451,120,285,4237
"55087010602",3169,237,0,1,467,11,133,0,4018
"55087010700",3083,486,257,86,395,93,269,43,4712
"55087010800",1281,54,21,0,84,0,0,0,1440
"55087010900",1814,67,5,6,99,102,71,34,2198
"55087011000",4130,488,26,2,616,446,457,291,6456
"55087011101",3818,465,107,0,590,42,353,0,5375
"55087011102",5791,565,32,21,572,82,422,39,7524
"55087011200",1936,177,0,79,436,79,262,20,2989
"55087011300",2421,203,20,11,69,124,85,33,2966
"55087011400",4267,613,0,0,401,62,88,192,5623
"55087011501",2598,168,14,1,280,38,56,0,3155
"55087011502",3280,533,0,90,394,0,161,28,4486
"55087011600",6167,301,40,16,311,3,136,10,6984
"55087011700",2344,198,61,19,42,0,39,22,2725
"55087011800",1622,128,10,0,100,24,114,0,1998
"55087011900",7242,476,0,1,249,74,120,83,8245
"55087012000",5753,402,39,0,281,0,125,0,6600
"55087012100",7034,364,0,18,57,62,68,0,7603
"55087012200",1491,371,0,0,123,6,93,21,2105
"55087012300",1450,90,0,4,31,0,25,0,1600
"55087012400",2581,190,29,0,86,69,173,31,3159
"55087012503",3598,46,0,0,63,0,41,0,3748
"55087012504",3171,101,7,24,52,0,51,0,3406
"55087012505",3409,204,11,0,451,81,83,0,4239
"55087012506",3087,236,44,17,574,0,106,0,4064
"55087012601",8190,390,306,0,172,0,25,0,9083
"55087012602",4580,60,0,0,36,0,15,0,4691
"55087012700",5544,484,0,0,197,31,287,102,6645
"55087012800",6652,543,32,0,181,37,130,12,7587
"55087012901",5885,197,0,0,78,0,28,0,6188
"55087012902",3387,128,0,0,0,0,0,0,3515
"55087013100",4831,520,0,0,246,93,163,0,5853
"55087013200",3207,422,0,0,105,110,126,136,4106
"55087013300",6728,264,13,0,198,27,107,71,7408
"55087940000",2260,72,10,0,1638,516,102,105,4703
"55089610101",4006,155,15,0,116,4,155,0,4451
"55089610102",3337,119,3,0,228,10,248,29,3974
"55089620100",5317,411,30,10,247,0,165,29,6209
"55089630100",2533,229,14,0,48,9,101,41,2975
"55089630201",4343,167,10,0,56,8,112,0,4696
"55089630202",4693,172,33,0,78,8,101,3,5088
"55089640100",4876,854,30,41,91,0,151,0,6043
"55089640200",7063,294,202,0,515,0,164,0,8238
"55089650101",5818,166,0,0,366,0,121,47,6518
"55089650102",2415,251,0,3,59,0,28,0,2756
"55089650200",4365,313,38,0,205,10,120,24,5075
"55089650300",5037,123,75,0,97,0,110,0,5442
"55089660100",2714,238,38,7,187,9,9,0,3202
"55089660201",3345,74,178,61,255,0,40,0,3953
"55089660202",4370,167,109,0,220,17,101,0,4984
"55089660301",5634,376,110,0,157,0,217,0,6494
"55089660303",4594,108,40,0,280,0,65,0,5087
"55089660304",2984,53,57,0,179,0,59,0,3332
"55089990000",0,0,0,0,0,0,0,0,0
"55091950100",3309,589,5,4,19,12,24,46,4008
"55091950200",2880,334,2,7,64,1,24,0,3312
"55093960100",2515,306,4,6,27,18,20,15,2911
"55093960200",5335,394,30,2,116,83,136,8,6104
"55093960300",2321,748,39,0,56,29,0,0,3193
"55093960400",3759,1397,22,0,95,133,0,0,5406
"55093960500",7102,436,2,0,209,0,188,0,7937
"55093960600",4434,193,7,18,93,29,73,14,4861
"55093960700",4040,446,0,21,44,44,32,47,4674
"55093960800",3206,276,1,0,72,36,80,93,3764
"55095960100",2830,522,0,0,97,59,96,40,3644
"55095960200",2970,453,7,10,87,0,57,3,3587
"55095960300",4582,589,0,0,262,87,42,33,5595
"55095960500",2507,290,14,0,93,13,1,0,2918
"55095960600",1718,227,0,0,17,2,4,0,1968
"55095960700",4972,558,32,25,143,40,80,7,5857
"55095960800",5714,443,13,2,222,26,117,30,6567
"55095960900",4595,316,0,0,88,23,80,23,5125
"55095961000",4131,322,56,1,92,16,29,9,4656
"55095961100",3269,370,0,0,31,13,61,0,3744
"55097960100",4093,330,0,0,24,42,77,0,4566
"55097960200",4233,268,7,0,90,3,37,13,4651
"55097960300",2415,1183,16,0,177,81,0,43,3915
"55097960400",2319,1580,0,2,168,142,38,48,4297
"55097960500",6242,273,78,0,210,26,124,26,6979
"55097960600",4711,460,58,2,196,8,47,25,5507
"55097960701",4726,523,0,12,107,0,53,226,5647
"55097960702",2724,269,0,0,115,17,0,0,3125
"55097960800",4148,387,25,62,501,260,303,76,5762
"55097960900",2375,598,16,0,51,85,11,63,3199
"55097961000",1660,1020,54,0,46,101,51,34,2966
"55097961100",5195,624,0,0,339,126,95,0,6379
"55097961200",4940,951,27,0,312,28,65,72,6395
"55097961300",4376,486,0,0,59,146,189,271,5527
"55099970100",2341,238,0,0,67,8,14,2,2670
"55099970200",1982,441,0,0,24,18,7,0,2472
"55099970400",1658,110,0,0,50,8,9,2,1837
"55099970500",1704,287,0,0,52,7,17,0,2067
"55099970600",1860,238,0,3,49,47,8,0,2205
"55099970700",1842,444,39,0,51,11,45,91,2523
"55101000100",440,158,115,113,39,9,46,17,937
"55101000200",2364,260,1193,396,426,108,733,91,5571
"55101000300",765,652,929,605,398,68,702,608,4727
"55101000400",925,601,609,625,351,522,816,923,5372
"55101000500",1281,963,1439,1015,604,460,1531,1281,8574
"55101000600",3606,652,441,441,309,284,980,506,7219
"55101000700",3815,250,902,112,556,162,896,190,6883
"55101000800",2819,432,642,48,253,60,998,172,5424
"55101000901",2503,211,440,72,289,159,565,51,4290
"55101000903",3229,114,441,70,172,30,269,9,4334
"55101000904",3420,550,489,19,231,133,60,198,5100
"55101001001",1102,176,206,417,219,140,269,109,2638
"55101001002",1927,110,149,12,225,44,369,11,2847
"55101001003",2570,386,263,251,365,9,716,59,4619
"55101001100",4842,190,470,118,448,69,360,38,6535
"55101001201",2173,455,263,205,259,159,275,283,4072
"55101001202",3398,452,588,188,810,443,1226,290,7395
"55101001301",2595,393,279,0,388,113,512,135,4415
"55101001302",1773,942,798,342,357,159,549,340,5260
"55101001400",4847,374,799,60,362,0,490,0,6932
"55101001501",3085,171,75,0,160,1,158,0,3650
"55101001502",5643,376,293,23,316,17,267,31,6966
"55101001504",2072,173,116,62,478,17,156,56,3130
"55101001505",3531,285,125,344,118,167,419,117,5106
"55101001601",5507,307,124,73,79,106,250,0,6446
"55101001602",2788,108,118,0,169,0,95,0,3278
"55101001701",2280,197,583,110,282,13,153,9,3627
"55101001702",4422,192,84,1,217,72,403,38,5429
"55101001703",3702,232,50,0,399,0,380,83,4846
"55101001705",4738,183,192,49,277,0,404,51,5894
"55101001706",3098,116,159,100,210,78,150,29,3940
"55101001801",4234,433,14,0,311,8,210,0,5210
"55101001802",2787,80,0,2,46,0,97,14,3026
"55101001900",3634,193,16,2,45,0,143,17,4050
"55101002001",2619,146,0,0,52,0,0,0,2817
"55101002002",4782,282,6,4,113,0,131,34,5352
"55101002100",3191,99,0,8,38,0,50,0,3386
"55101002401",4756,398,64,3,498,0,452,0,6171
"55101002402",3810,826,45,65,73,197,405,216,5637
"55101002600",5647,209,15,0,18,16,30,16,5951
"55101002701",3563,103,120,0,183,0,118,24,4111
"55101002702",5400,298,0,0,84,0,303,0,6085
"55101002800",5317,165,86,0,221,66,211,43,6109
"55101980000",51,22,0,9,2,0,0,0,84
"55101990000",0,0,0,0,0,0,0,0,0
"55103970100",2444,359,6,0,50,35,38,4,2936
"55103970200",3858,656,0,8,46,20,19,8,4615
"55103970300",2034,290,27,2,12,0,54,64,2483
"55103970400",2796,557,8,0,55,46,6,7,3475
"55103970500",3354,461,37,15,59,160,26,130,4242
"55105000100",705,261,27,14,46,30,42,52,1177
"55105000200",2307,230,0,1,103,35,58,35,2769
"55105000300",1043,838,10,108,336,219,121,211,2886
"55105000400",2410,747,13,68,333,183,107,41,3902
"55105000500",3489,577,28,2,65,45,288,57,4551
"55105000600",2527,490,46,73,55,68,122,57,3438
"55105000700",3060,541,106,3,60,127,324,84,4305
"55105000800",3237,339,30,4,147,30,224,23,4034
"55105000900",2731,121,33,0,33,20,139,11,3088
"55105001000",1957,1093,17,30,196,150,249,348,4040
"55105001100",3826,539,33,36,178,138,32,8,4790
"55105001201",4671,236,3,0,180,22,0,0,5112
"55105001202",4859,142,0,0,156,19,216,0,5392
"55105001302",6249,383,44,12,139,11,72,0,6910
"55105001303",4091,219,23,0,117,3,95,2,4550
"55105001304",6766,917,78,17,307,103,276,166,8630
"55105001400",5075,507,23,64,301,317,640,33,6960
"55105001500",548,216,60,100,32,120,35,108,1219
"55105001600",2340,948,290,393,306,278,926,244,5725
"55105001700",2821,968,285,331,662,453,710,697,6927
"55105001800",1617,1124,537,395,251,128,836,710,5598
"55105001900",1862,406,28,52,98,144,247,186,3023
"55105002000",2489,562,92,106,232,122,218,153,3974
"55105002100",2811,407,303,67,299,38,377,29,4331
"55105002200",1907,176,15,30,157,0,34,60,2379
"55105002300",1137,328,161,101,106,57,208,95,2193
"55105002400",3005,519,17,68,206,0,10,0,3825
"55105002500",1707,482,266,38,144,26,254,254,3171
"55105002601",3838,489,316,10,298,152,299,175,5577
"55105002602",3345,337,98,49,219,26,154,156,4384
"55105002700",2311,133,0,0,75,4,26,0,2549
"55105002800",4336,575,20,0,142,10,50,26,5159
"55105002900",7575,422,12,16,161,14,278,21,8499
"55105003001",3981,689,0,0,140,32,200,0,5042
"55105003002",5019,194,0,29,80,4,117,0,5443
"55105003100",6856,400,25,33,152,48,129,22,7665
"55105003200",2295,238,0,3,72,12,205,97,2922
"55105003300",2934,238,23,0,206,26,255,44,3726
"55107960100",3070,456,13,11,35,22,36,1,3644
"55107960200",1724,261,0,12,16,11,16,7,2047
"55107960300",1829,396,0,0,11,30,46,8,2320
"55107960400",2245,413,38,0,57,5,19,2,2779
"55107960500",2708,567,25,32,82,36,54,14,3518
"55109120100",2030,127,23,0,123,0,68,0,2371
"55109120201",5113,393,107,0,258,2,69,0,5942
"55109120202",5346,35,22,0,169,6,93,0,5671
"55109120300",5017,248,5,0,114,115,132,40,5671
"55109120400",9283,799,44,29,272,198,147,347,11119
"55109120501",4397,455,4,31,59,164,31,0,5141
"55109120502",4954,159,17,0,51,24,98,0,5303
"55109120600",7506,450,23,25,159,37,42,16,8258
"55109120700",4131,319,1,4,78,28,51,2,4614
"55109120800",7281,500,2,7,222,0,216,2,8230
"55109120901",3803,183,15,0,40,17,158,13,4229
"55109120903",7885,671,163,12,291,0,188,0,9210
"55109120904",3942,95,0,0,25,0,10,0,4072
"55109121000",6579,317,24,14,160,38,95,23,7250
"55111000100",5011,882,41,0,432,226,349,186,7127
"55111000200",4101,415,4,2,170,35,143,40,4910
"55111000300",5135,1250,49,37,308,53,250,63,7145
"55111000401",4581,434,0,15,140,41,355,22,5588
"55111000402",2772,507,0,1,57,128,50,123,3638
"55111000500",2613,398,10,17,172,54,178,110,3552
"55111000600",5897,297,22,0,138,2,201,46,6603
"55111000700",2559,287,0,0,101,0,147,0,3094
"55111000800",3340,302,0,4,107,56,45,0,3854
"55111000900",4360,485,47,0,86,4,101,83,5166
"55111001001",5939,622,0,0,105,43,60,68,6837
"55111001002",2395,590,0,2,0,70,218,0,3275
"55111001100",3683,389,1,0,36,8,49,19,4185
"55113100300",3200,626,11,32,360,26,16,22,4293
"55113100400",1960,238,5,0,114,52,74,1,2444
"55113100500",2951,216,0,0,104,0,15,0,3286
"55113100700",1100,248,9,1,81,100,6,5,1550
"55113100800",1132,215,0,0,81,9,30,23,1490
"55113940000",691,49,8,14,1562,847,51,40,3262
"55115100100",2766,87,0,0,86,31,124,0,3094
"55115100200",1636,93,0,0,72,4,0,0,1805
"55115100300",2968,246,0,15,258,24,62,11,3584
"55115100400",3186,499,12,0,555,105,10,99,4466
"55115100500",3595,371,0,0,494,146,62,40,4708
"55115100600",2216,284,11,6,1360,352,72,43,4344
"55115100700",2826,505,7,0,78,73,97,75,3661
"55115100800",3839,564,15,20,221,49,70,87,4865
"55115100900",3159,294,0,0,88,40,83,2,3666
"55115101000",3146,414,0,0,59,0,28,53,3700
"55115101100",3472,219,0,0,37,10,4,0,3742
"55117000100",2805,462,0,0,530,0,201,3,4001
"55117000201",1781,296,6,32,285,363,303,116,3182
"55117000202",2824,351,67,99,472,5,166,43,4027
"55117000300",5230,332,43,0,1023,159,294,27,7108
"55117000400",3185,373,13,0,436,15,449,44,4515
"55117000500",2063,911,80,13,556,247,249,335,4454
"55117000800",3249,763,105,116,825,649,682,571,6960
"55117000900",3839,306,29,1,392,60,311,16,4954
"55117001000",5870,525,175,0,828,200,886,151,8635
"55117001100",3049,282,20,0,278,16,53,0,3698
"55117010100",1356,57,0,3,26,4,8,18,1472
"55117010200",3887,174,0,0,75,0,82,7,4225
"55117010300",2806,151,0,2,20,1,7,1,2988
"55117010400",2322,72,0,5,41,0,10,0,2450
"55117010501",6452,654,176,0,135,0,157,0,7574
"55117010502",3132,375,54,0,182,8,20,7,3778
"55117010601",4884,198,0,0,234,9,47,0,5372
"55117010602",3868,203,0,0,39,0,355,41,4506
"55117010700",8029,159,4,0,320,25,120,47,8704
"55117010800",3229,40,0,0,195,0,181,0,3645
"55117010900",2817,236,0,0,103,25,19,0,3200
"55117011000",2258,186,12,0,101,0,29,10,2596
"55117011100",2760,103,0,0,91,4,41,3,3002
"55117011200",3039,257,0,0,63,0,34,34,3427
"55117011300",6864,422,23,1,36,10,96,14,7466
"55117011400",1687,234,0,81,151,73,158,65,2449
"55117990000",0,0,0,0,0,0,0,0,0
"55119960100",3591,539,26,5,66,50,68,68,4413
"55119960200",2070,173,6,0,15,0,12,3,2279
"55119960300",2339,557,8,0,13,14,10,16,2957
"55119960400",4268,354,38,0,63,6,25,0,4754
"55119960500",2419,263,0,0,0,0,32,0,2714
"55119960600",2711,554,0,0,83,12,84,20,3464
"55121100100",2757,217,0,3,77,35,63,0,3152
"55121100200",2884,222,2,27,98,25,104,20,3382
"55121100300",2103,201,0,0,174,146,248,151,3023
"55121100400",3144,486,0,0,153,7,132,3,3925
"55121100500",2622,383,0,0,37,4,38,7,3091
"55121100600",2737,314,63,0,602,253,740,308,5017
"55121100700",4933,350,18,0,38,43,28,0,5410
"55121100800",3298,336,2,0,50,26,64,5,3781
"55123960100",3245,1017,5,8,60,11,62,4,4412
"55123960200",3173,1199,2,22,34,109,40,108,4687
"55123960300",3995,325,65,0,14,34,23,5,4461
"55123960400",4024,498,0,0,92,0,7,0,4621
"55123960500",2651,676,3,0,69,13,21,36,3469
"55123960600",3970,413,3,6,68,7,73,8,4548
"55123960700",3456,396,8,3,89,20,47,12,4031
"55125940000",1335,132,8,0,1013,941,25,24,3478
"55125950200",3429,464,4,0,133,19,68,0,4117
"55125950500",4717,856,21,0,153,19,163,29,5958
"55125950600",3495,270,0,0,17,11,13,1,3807
"55125950700",3316,335,27,0,419,0,37,5,4139
"55127000101",4396,912,116,2,161,15,201,0,5803
"55127000102",2420,267,23,0,28,0,31,0,2769
"55127000200",5938,382,31,0,115,17,217,64,6764
"55127000301",2764,217,0,7,49,7,139,0,3183
"55127000302",6058,330,12,3,67,0,438,16,6924
"55127000400",2578,885,7,29,352,109,348,88,4396
"55127000501",664,1142,0,176,18,16,49,23,2088
"55127000502",2445,1319,88,0,124,77,182,109,4344
"55127000600",4751,635,37,31,383,42,883,126,6888
"55127000701",3290,221,13,4,44,279,844,299,4994
"55127000702",3401,848,6,0,329,137,995,492,6208
"55127000800",4047,177,22,0,380,32,462,0,5120
"55127000901",5361,369,24,1,128,27,551,57,6518
"55127000902",2667,225,27,0,151,44,274,92,3480
"55127001000",4218,480,36,0,103,1,156,10,5004
"55127001501",2558,288,0,0,232,28,351,28,3485
"55127001502",4166,595,0,2,282,92,677,145,5959
"55127001602",4737,964,0,6,263,124,628,315,7037
"55127001603",2234,192,0,10,183,6,248,6,2879
"55127001604",4037,590,21,0,232,15,415,170,5480
"55127001701",4940,457,78,24,405,64,363,96,6427
"55127001702",4116,514,1,5,222,58,362,97,5375
"55129950100",1520,238,1,0,48,4,11,7,1829
"55129950200",1568,123,0,0,36,9,10,5,1751
"55129950300",2184,363,1,0,99,28,19,10,2704
"55129950500",4050,644,24,19,155,90,35,57,5074
"55129950600",3639,481,19,6,102,17,54,2,4320
"55131400102",3575,142,26,0,0,0,49,0,3792
"55131400103",3601,225,0,0,127,0,43,0,3996
"55131400104",5399,357,0,0,328,0,123,5,6212
"55131410100",4491,367,139,17,46,0,205,0,5265
"55131420103",5374,185,0,1,384,0,62,0,6006
"55131420104",4452,155,7,0,37,17,45,0,4713
"55131420105",3972,404,0,10,239,34,243,156,5058
"55131420106",3056,332,2,0,40,91,75,84,3680
"55131420200",5376,207,37,0,110,0,122,0,5852
"55131420300",4510,545,155,10,119,97,175,0,5611
"55131420401",1768,244,14,8,20,8,22,8,2092
"55131420402",1925,175,9,0,12,0,0,0,2121
"55131430100",5488,117,15,0,51,0,35,0,5706
"55131440103",4298,268,0,10,165,20,115,0,4876
"55131440104",5022,333,46,0,186,9,341,55,5992
"55131440105",3134,224,26,0,153,0,36,49,3622
"55131440106",3552,96,0,8,112,0,107,8,3883
"55131440200",3343,357,0,52,155,0,140,46,4093
"55131450103",4645,413,0,0,17,0,69,117,5261
"55131450104",5813,64,100,0,236,17,0,34,6264
"55131450105",2603,137,0,0,5,2,25,0,2772
"55131450106",5491,354,16,0,59,0,293,0,6213
"55131460101",5810,185,58,0,143,0,100,0,6296
"55131460102",4963,139,61,0,51,0,65,26,5305
"55131470100",4502,93,43,0,187,0,259,21,5105
"55131470202",5580,226,42,57,268,16,172,0,6361
"55131470203",3759,310,74,16,171,108,145,16,4599
"55131470204",3971,51,151,0,270,62,23,62,4590
"55133200101",4089,173,68,139,230,1,238,0,4938
"55133200102",4759,133,13,0,180,0,179,0,5264
"55133200103",2710,129,19,0,221,34,56,24,3193
"55133200201",3166,184,69,0,84,0,48,0,3551
"55133200202",3694,143,41,0,299,0,22,0,4199
"55133200300",3700,93,22,0,242,41,80,41,4219
"55133200400",5536,63,153,0,670,0,130,0,6552
"55133200500",4695,202,166,0,475,56,93,0,5687
"55133200600",1457,160,23,12,95,6,55,0,1808
"55133200700",3393,80,43,0,171,0,131,9,3827
"55133200801",4321,79,16,0,280,0,101,0,4797
"55133200803",4008,211,9,0,152,0,139,0,4519
"55133200804",3193,141,31,0,305,9,13,16,3708
"55133200901",3455,121,153,0,85,27,26,0,3867
"55133200902",3600,63,0,0,205,5,68,0,3941
"55133201000",5709,132,0,0,271,0,46,0,6158
"55133201101",4327,121,108,0,492,30,86,8,5172
"55133201102",2465,345,51,0,131,16,88,197,3293
"55133201201",1782,70,1,0,98,0,80,0,2031
"55133201202",4769,159,166,0,645,11,228,0,5978
"55133201203",2526,42,0,0,560,0,126,0,3254
"55133201300",4646,230,0,0,204,45,34,44,5203
"55133201402",3753,263,0,0,378,29,130,0,4553
"55133201403",3554,274,203,0,193,37,159,16,4436
"55133201404",3599,168,57,2,40,4,26,0,3896
"55133201503",5961,52,27,0,650,2,205,0,6897
"55133201504",5458,140,0,0,619,0,194,0,6411
"55133201505",2668,48,0,0,171,0,35,0,2922
"55133201506",4366,148,21,0,111,0,144,0,4790
"55133201600",4669,185,0,0,308,22,155,0,5339
"55133201701",4147,291,0,0,35,0,48,0,4521
"55133201703",5621,194,0,0,41,0,67,0,5923
"55133201704",5059,72,0,0,168,10,227,10,5546
"55133201800",1475,16,0,0,38,0,28,0,1557
"55133201900",5073,201,0,0,239,0,173,0,5686
"55133202001",4652,183,50,0,192,0,46,0,5123
"55133202002",3725,138,0,0,88,0,37,0,3988
"55133202101",3711,115,10,0,387,54,168,0,4445
"55133202102",4511,90,38,0,261,0,239,0,5139
"55133202103",3305,96,257,0,94,0,155,0,3907
"55133202201",3882,40,0,0,183,1,94,1,4201
"55133202202",3986,591,23,370,636,70,834,101,6611
"55133202301",3686,264,72,0,166,24,271,95,4578
"55133202302",4739,1037,458,438,257,135,1056,566,8686
"55133202400",3689,246,0,0,308,161,497,0,4901
"55133202500",3344,362,0,8,231,91,518,173,4727
"55133202600",1759,181,0,0,31,268,262,209,2710
"55133202700",1088,250,29,25,162,0,172,0,1726
"55133202800",2951,494,43,42,296,105,959,374,5264
"55133202901",3377,207,0,207,556,132,297,149,4925
"55133202902",3017,251,88,34,291,0,78,0,3759
"55133203000",1529,173,20,0,137,105,201,80,2245
"55133203101",5358,307,48,49,754,184,388,33,7121
"55133203102",5878,311,0,0,486,0,550,112,7337
"55133203103",3749,510,49,0,155,16,537,93,5109
"55133203200",3944,144,0,0,165,11,238,0,4502
"55133203303",3631,110,15,50,71,0,13,0,3890
"55133203304",4228,101,35,0,254,0,65,8,4691
"55133203305",3668,261,41,21,160,0,122,0,4273
"55133203306",5403,335,164,0,357,0,171,9,6439
"55133203402",3374,94,87,0,244,0,56,0,3855
"55133203403",5284,33,40,0,115,0,87,0,5559
"55133203404",2595,312,21,55,71,10,73,10,3147
"55133203405",4270,62,51,0,103,0,55,0,4541
"55133203406",6073,183,19,0,346,0,141,0,6762
"55133203500",6370,63,13,0,118,0,141,0,6705
"55133203601",3446,283,39,0,208,19,47,12,4054
"55133203602",5059,301,49,0,207,0,149,0,5765
"55133203702",4445,166,0,0,229,0,237,0,5077
"55133203703",2990,172,12,0,241,7,0,3,3425
"55133203704",4456,234,24,0,257,28,85,0,5084
"55133203802",5907,152,56,0,224,0,58,0,6397
"55133203803",3887,52,60,1,159,0,160,0,4319
"55133203804",6367,194,49,0,164,0,188,15,6977
"55133203901",4486,209,40,0,78,0,217,0,5030
"55133203902",3488,289,0,0,108,93,54,26,4058
"55133204002",4925,300,132,0,77,0,73,0,5507
"55133204003",3706,134,3,4,97,0,133,0,4077
"55133204004",3837,116,0,1,253,0,17,4,4228
"55133204100",4768,117,28,0,84,26,189,16,5228
"55133204200",6175,351,0,0,635,16,578,11,7766
"55133204301",4670,255,0,21,195,9,75,0,5225
"55133204302",3357,248,90,0,74,0,192,13,3974
"55133204400",1900,139,4,0,31,0,42,20,2136
"55133204501",2409,58,0,0,34,0,46,0,2547
"55133204502",5568,564,61,0,28,0,48,23,6292
"55135100100",3155,525,0,0,66,33,59,11,3849
"55135100200",2434,373,6,0,66,35,26,32,2972
"55135100300",3286,354,0,0,51,7,23,16,3737
"55135100400",4024,441,0,0,84,2,70,0,4621
"55135100500",2316,230,44,14,44,0,88,17,2753
"55135100600",4510,374,0,0,66,12,28,11,5001
"55135100700",2617,404,20,0,45,76,253,96,3511
"55135100800",4232,254,51,24,68,0,45,5,4679
"55135100900",4950,762,0,0,142,70,146,84,6154
"55135101000",4669,487,0,0,148,129,130,0,5563
"55135101100",4547,370,0,0,30,0,268,0,5215
"55135101200",3314,250,26,1,117,5,41,3,3757
"55137960100",2649,214,25,4,33,0,48,4,2977
"55137960200",3522,284,26,15,48,31,42,14,3982
"55137960300",2797,275,9,7,123,122,328,92,3753
"55137960400",2860,363,5,9,104,8,159,40,3548
"55137960600",1885,73,0,1,12,0,0,0,1971
"55137960700",2730,430,26,14,118,24,83,23,3448
"55137960800",3627,484,4,0,71,27,493,57,4763
"55139000100",2380,586,0,19,71,0,84,0,3140
"55139000200",1900,463,135,9,24,52,33,157,2773
"55139000300",3300,523,20,28,182,104,18,147,4322
"55139000400",2133,609,0,0,231,0,20,8,3001
"55139000500",3551,2252,113,22,236,12,64,14,6264
"55139000700",558,1428,3,5,44,37,0,27,2102
"55139000800",2526,390,82,0,80,0,100,0,3178
"55139000900",2664,382,17,140,118,0,21,20,3362
"55139001000",2247,326,17,2,47,63,116,0,2818
"55139001100",3326,401,103,0,81,7,110,41,4069
"55139001200",1762,267,29,1,131,9,104,34,2337
"55139001300",1996,178,0,7,132,61,8,0,2382
"55139001400",3534,377,26,0,255,19,69,35,4315
"55139001500",2502,352,19,76,20,290,19,0,3278
"55139001600",2136,267,54,4,210,81,102,14,2868
"55139001700",2548,142,10,12,73,72,30,0,2887
"55139001801",4913,173,70,0,199,0,119,0,5474
"55139001803",5397,332,7,0,408,0,262,0,6406
"55139001804",3633,292,0,18,93,0,21,0,4057
"55139001900",4615,180,10,0,66,11,85,11,4978
"55139002000",6191,857,0,0,311,27,620,147,8153
"55139002100",3539,177,0,9,41,0,160,0,3926
"55139002201",4384,199,0,0,18,6,6,7,4620
"55139002202",2612,219,0,0,44,5,22,5,2907
"55139002300",5034,100,29,0,276,16,65,0,5520
"55139002400",9070,429,74,60,398,111,163,190,10495
"55139002500",3541,523,144,63,364,33,296,103,5067
"55139002601",3073,357,8,35,271,84,57,96,3981
"55139002602",3893,270,26,25,435,143,144,0,4936
"55139002700",1939,177,5,0,49,0,40,16,2226
"55139002800",3775,523,202,0,304,0,111,46,4961
"55139002900",1444,398,12,11,164,203,107,153,2492
"55139003000",1274,241,29,0,51,0,29,33,1657
"55139003100",1656,88,0,0,217,0,143,0,2104
"55139003200",2035,167,12,0,115,43,52,0,2424
"55139003300",1904,359,8,7,220,58,19,0,2575
"55139003400",3505,302,0,0,167,23,97,18,4112
"55139003500",2033,273,56,21,263,11,310,11,2978
"55139003600",3587,182,0,0,139,0,49,0,3957
"55139003701",2897,426,23,132,197,123,219,210,4227
"55139003702",7769,575,35,0,273,37,147,188,9024
"55141010100",4007,541,0,0,89,8,75,10,4730
"55141010200",4384,352,0,0,84,0,40,0,4860
"55141010300",2498,475,21,4,178,2,323,66,3567
"55141010400",2697,413,0,0,160,0,174,20,3464
"55141010500",2685,246,0,0,128,15,33,48,3155
"55141010600",3829,620,5,3,104,11,61,0,4633
"55141010700",4680,235,4,0,122,18,87,4,5150
"55141010800",2456,241,0,0,27,14,39,0,2777
"55141010900",3477,229,12,5,252,51,185,0,4211
"55141011000",4121,609,64,0,315,119,199,105,5532
"55141011100",3052,435,0,37,120,11,42,0,3697
"55141011200",3060,720,75,26,204,99,119,0,4303
"55141011300",3578,566,0,0,164,0,22,0,4330
"55141011400",4303,437,0,0,353,18,71,51,5233
"55141011500",5309,199,0,0,286,0,37,0,5831
"55141011600",4500,538,0,0,20,0,31,0,5089
"55141011700",3366,581,71,5,105,113,67,37,4345
"56001962700",2810,354,0,3,129,155,145,186,3782
"56001962800",2500,636,0,0,184,209,222,130,3881
"56001962900",1270,317,0,0,205,110,468,130,2500
"56001963000",1412,597,39,88,138,69,132,30,2505
"56001963100",4524,1742,163,0,506,52,378,281,7646
"56001963400",1927,1330,0,0,267,275,195,8,4002
"56001963500",86,408,7,23,121,67,0,18,730
"56001963600",3282,948,0,0,128,0,79,85,4522
"56001963700",3941,1716,42,76,318,160,448,204,6905
"56001963900",1664,175,4,0,152,0,90,0,2085
"56003962600",2128,206,0,0,127,5,91,6,2563
"56003962700",3009,396,0,0,163,14,335,92,4009
"56003962800",4586,737,0,0,191,50,342,142,6048
"56005000100",8424,671,165,6,595,6,496,260,10623
"56005000200",6628,292,0,17,162,0,368,0,7467
"56005000300",4565,659,1,0,534,49,563,94,6465
"56005000400",3288,574,12,6,401,19,579,233,5112
"56005000500",6243,46,0,0,192,225,225,195,7126
"56005000600",4840,292,14,1,126,24,442,15,5754
"56005000700",7444,476,132,20,301,29,338,85,8825
"56007967600",1183,223,20,0,44,1,126,39,1636
"56007967700",3431,745,0,73,173,104,665,325,5516
"56007967800",3225,354,65,25,353,16,1173,136,5347
"56007968000",2870,443,0,0,174,9,27,33,3556
"56007968100",1072,231,0,16,38,40,75,11,1483
"56009956400",4185,420,1,0,252,1,469,53,5381
"56009956500",2774,259,0,0,37,36,111,16,3233
"56009956600",2941,298,0,0,71,13,181,13,3517
"56009956700",2215,217,19,0,184,64,192,0,2891
"56011950200",4239,228,14,0,37,18,117,9,4662
"56011950300",2520,116,0,0,8,0,53,0,2697
"56013000100",2751,662,10,0,186,349,131,174,4263
"56013000200",3141,219,0,0,116,13,71,21,3581
"56013000300",3673,214,15,0,388,18,210,7,4525
"56013000400",1555,48,23,0,64,7,50,0,1747
"56013940100",523,65,4,5,2560,696,166,29,4048
"56013940201",3368,283,0,0,363,28,79,22,4143
"56013940202",1581,114,4,4,2512,691,247,36,5189
"56013940300",3498,812,0,48,656,154,422,42,5632
"56013940400",4107,690,0,0,684,233,430,100,6244
"56013940500",1898,215,51,11,368,58,291,57,2949
"56015957700",1587,188,0,0,21,9,39,0,1844
"56015957800",1909,760,8,0,314,14,298,165,3468
"56015957900",4109,576,8,0,191,127,360,111,5482
"56015958000",2025,511,18,0,201,76,274,83,3188
"56017967800",2331,339,0,0,30,26,49,35,2810
"56017967900",1733,129,12,0,86,6,88,0,2054
"56019955100",2225,101,1,0,67,1,49,0,2444
"56019955200",5547,429,0,3,151,0,302,23,6455
"56021000200",2406,939,266,34,386,313,1182,269,5795
"56021000300",2612,203,193,13,515,145,840,141,4662
"56021000401",3460,598,56,0,533,64,856,104,5671
"56021000402",4089,886,112,0,386,382,1008,834,7697
"56021000501",6918,548,144,0,604,128,803,208,9353
"56021000600",4687,563,245,0,415,4,731,92,6737
"56021000700",2821,620,29,13,428,101,427,53,4492
"56021000800",1519,140,20,0,138,49,175,26,2067
"56021000900",2188,103,6,0,321,13,379,13,3023
"56021001000",2127,496,177,0,244,229,365,112,3750
"56021001100",1464,35,134,0,388,9,228,0,2258
"56021001200",4429,53,54,0,149,1,385,0,5071
"56021001300",6919,272,278,0,322,46,985,46,8868
"56021001401",3468,218,81,69,375,62,289,0,4562
"56021001402",1972,103,12,73,118,8,153,10,2449
"56021001501",3542,303,415,0,661,1,455,4,5381
"56021001502",3609,679,0,118,371,139,545,122,5583
"56021001901",4854,165,0,0,238,16,436,0,5709
"56021001902",4008,158,9,0,62,0,157,0,4394
"56021002000",7660,238,70,0,113,19,639,10,8749
"56021980801",0,0,0,0,0,0,0,0,0
"56023978000",6076,509,9,2,244,3,221,39,7103
"56023978100",5201,627,11,0,140,18,213,42,6252
"56023978200",1750,111,0,0,69,0,73,27,2030
"56023978400",3137,130,5,0,94,35,177,9,3587
"56025000200",2734,577,409,24,683,137,625,43,5232
"56025000300",3570,429,0,0,248,105,652,48,5052
"56025000400",3604,421,27,0,154,135,158,129,4628
"56025000501",4417,659,92,0,325,0,464,33,5990
"56025000502",2254,550,21,0,369,43,341,146,3724
"56025000600",6186,738,0,0,254,0,305,13,7496
"56025000700",2345,259,0,20,83,0,234,1,2942
"56025000800",3612,439,0,0,167,151,326,39,4734
"56025000901",3914,348,59,0,248,222,258,240,5289
"56025000902",3262,38,0,0,23,0,160,28,3511
"56025001000",4109,349,18,0,152,43,129,38,4838
"56025001100",2088,514,0,38,16,30,192,26,2904
"56025001200",1333,221,6,0,79,67,111,51,1868
"56025001401",5015,777,7,0,187,35,346,137,6504
"56025001602",5861,339,80,0,171,79,334,79,6943
"56025001603",3353,132,0,0,191,8,140,53,3877
"56025001700",4239,237,16,0,364,0,314,0,5170
"56025001800",3482,243,11,0,59,0,17,0,3812
"56027957200",1782,310,4,0,92,18,29,0,2235
"56029965100",4870,161,4,0,112,0,276,0,5423
"56029965200",4642,611,0,0,235,216,214,323,6241
"56029965300",6650,203,22,1,162,0,75,0,7113
"56029965400",5195,258,87,0,285,61,501,96,6483
"56029965500",3849,394,0,106,129,13,90,44,4625
"56031959100",1687,444,0,0,101,8,126,89,2455
"56031959400",5205,802,0,0,241,137,173,263,6821
"56033000100",3862,287,0,0,163,109,63,80,4564
"56033000200",2842,181,141,0,96,23,86,0,3369
"56033000300",3377,286,9,0,113,24,63,0,3872
"56033000400",4359,754,22,0,468,1,564,28,6196
"56033000500",6416,311,3,0,181,2,91,2,7006
"56033000600",4053,274,7,7,233,122,195,0,4891
"56035000101",3591,357,0,0,217,0,317,0,4482
"56035000102",5243,455,0,0,213,0,413,33,6357
"56037970500",2164,384,64,0,128,0,220,41,3001
"56037970601",3903,474,0,0,128,68,1024,132,5729
"56037970602",3301,112,0,0,278,10,475,34,4210
"56037970700",2906,395,7,0,181,169,263,227,4148
"56037970800",3657,779,129,0,601,4,777,245,6192
"56037970901",6360,540,23,0,351,58,372,249,7953
"56037970902",3629,419,0,0,429,28,433,188,5126
"56037970903",2037,577,16,0,135,49,436,405,3655
"56037971000",1841,151,0,0,31,76,138,97,2334
"56037971100",2655,291,0,0,194,36,797,46,4019
"56037971200",2153,229,11,91,20,5,146,0,2655
"56037971600",1626,94,0,17,58,2,182,14,1993
"56039967600",4449,266,22,5,31,41,176,74,5064
"56039967701",2024,113,0,1,121,92,425,92,2868
"56039967702",5904,528,0,0,371,258,1040,421,8522
"56039967800",7074,334,38,0,530,0,1020,124,9120
"56041975200",5704,717,16,0,133,0,172,76,6818
"56041975300",6305,358,18,0,362,81,432,13,7569
"56041975400",4999,1447,0,0,318,242,646,498,8150
"56043000200",2579,256,57,0,93,192,110,241,3528
"56043000301",2117,315,0,0,78,31,228,61,2830
"56043000302",1930,342,0,0,219,1,405,72,2969
"56045951100",2784,272,0,0,95,0,26,11,3188
"56045951300",2937,465,0,0,4,221,74,68,3769
"72001956300",1499,2366,0,0,67,283,1566,2643,8424
"72001956400",953,1691,0,0,0,65,953,1735,5397
"72001956500",903,1894,0,65,0,91,903,2039,5895
"72001956600",683,1246,27,0,49,83,759,1329,4176
"72001956700",794,995,0,6,65,32,859,1031,3782
"72001956800",2107,2655,0,0,81,173,2188,2828,10032
"72003430100",1928,1565,77,164,927,552,2856,2156,10225
"72003430200",1201,1976,30,0,653,1393,1799,3200,10252
"72003430300",329,802,44,38,383,758,704,1479,4537
"72003430401",1138,1767,0,23,1090,1242,2080,2777,10117
"72003430402",1019,1822,72,81,654,1153,1731,3023,9555
"72003430501",1459,1341,43,0,1345,1312,2536,2323,10359
"72003430502",1007,1674,23,1,1356,877,2180,2401,9519
"72003430601",919,1625,58,0,586,613,1442,2137,7380
"72003430602",1065,643,20,19,1135,541,2025,1115,6563
"72003990000",0,0,0,0,0,0,0,0,0
"72005400100",1941,1304,162,13,500,742,2428,1987,9077
"72005400300",1550,737,124,42,362,175,1673,941,5604
"72005400400",1359,1485,8,40,625,329,1982,1802,7630
"72005400501",1647,1332,155,37,229,316,1996,1685,7397
"72005400502",2586,2131,50,64,835,941,3409,3091,13107
"72005400600",689,1283,32,23,84,518,805,1770,5204
"72005400700",1503,826,78,34,141,113,1618,973,5286
"72005400800",267,861,0,35,116,123,365,992,2759
"72005400900",390,1002,28,84,113,477,531,1544,4169
"72005401000",267,676,17,24,156,177,440,864,2621
"72005401100",392,647,112,35,22,304,526,986,3024
"72005401200",866,1061,82,69,702,829,1552,1803,6964
"72005401301",1173,1892,71,89,652,867,1733,2735,9212
"72005401302",2172,1666,80,123,1857,802,3933,2525,13158
"72005401401",1481,919,0,57,682,538,1960,1360,6997
"72005401402",1268,950,261,90,826,860,2323,1854,8432
"72005990000",0,0,0,0,0,0,0,0,0
"72007230100",1870,2424,61,70,69,89,2000,2534,9117
"72007230200",2909,2441,77,136,185,280,3048,2857,11933
"72007230300",998,1579,61,118,183,54,1232,1751,5976
"72007230400",1535,2831,144,162,269,302,1948,3294,10485
"72007230501",1517,1429,61,223,467,361,2045,2013,8116
"72007230502",2012,2168,152,72,238,50,2402,2262,9356
"72009250100",2159,1988,411,77,510,0,3080,2065,10290
"72009250200",2591,1871,90,161,184,220,2865,2252,10234
"72009250300",1201,1584,301,103,66,36,1553,1723,6567
"72009250400",1041,988,28,51,41,259,1110,1285,4803
"72009250500",2233,1749,87,251,152,431,2472,2431,9806
"72009250600",1639,1662,118,115,254,167,1988,1935,7878
"72011810100",1062,1177,17,28,409,538,1488,1743,6462
"72011810200",2732,2004,17,308,1169,1291,3878,3550,14949
"72011810300",877,753,48,91,301,461,1215,1262,5008
"72011810400",244,366,26,17,221,105,491,487,1957
"72011810500",1543,1655,57,0,1520,660,3088,2315,10838
"72011810600",1759,1130,39,26,587,702,2331,1847,8421
"72011810700",1137,1500,62,204,660,981,1832,2628,9004
"72011990000",0,0,0,0,0,0,0,0,0
"72013300101",2277,1724,226,121,339,236,2825,2081,9829
"72013300102",2386,1979,61,84,190,209,2637,2260,9806
"72013300200",1597,1198,110,143,517,292,2224,1633,7714
"72013300301",1520,1661,48,33,178,47,1746,1741,6974
"72013300302",3143,1157,207,96,319,439,3637,1692,10690
"72013300400",312,734,176,88,171,257,659,1056,3453
"72013300500",280,719,43,46,75,111,398,876,2548
"72013300700",519,593,16,34,59,76,594,703,2594
"72013300800",1959,2242,54,100,176,530,2174,2837,10072
"72013301000",3321,1476,97,61,279,154,3697,1691,10776
"72013301100",4002,2263,288,137,418,474,4671,2874,15127
"72013301200",1827,1650,55,93,262,134,2129,1852,8002
"72013301300",423,2612,9,95,35,378,467,3085,7104
"72013301400",504,474,56,72,31,120,591,666,2514
"72013301500",2261,1901,296,183,426,464,2963,2548,11042
"72013301600",1560,1424,0,132,238,319,1798,1864,7335
"72013301700",2145,2247,91,9,51,118,2287,2374,9322
"72013301800",648,922,6,0,23,27,657,923,3206
"72013301900",1208,2728,0,27,0,71,1208,2805,8047
"72013302000",1567,1105,32,40,0,71,1580,1216,5611
"72013302100",1978,3173,49,39,29,51,2056,3260,10635
"72013302201",940,1730,0,0,111,0,1032,1723,5536
"72013302202",2171,1925,44,0,218,31,2403,1902,8694
"72013302300",1219,1285,55,31,34,0,1308,1316,5248
"72013992900",0,0,0,0,0,0,0,0,0
"72015280101",324,1053,329,379,187,167,840,1599,4878
"72015280102",2369,2003,651,603,411,835,3431,3441,13744
"72015280201",1194,1276,676,620,335,442,2205,2319,9067
"72015280202",1119,1163,540,921,852,558,2500,2642,10295
"72015991500",0,0,0,0,0,0,0,0,0
"72017590100",3240,3439,55,32,0,95,3295,3566,13722
"72017590200",1046,2359,114,21,31,252,1178,2602,7603
"72017590300",2977,4507,152,114,238,230,3342,4851,16411
"72017590400",3063,2602,0,51,0,126,3063,2699,11604
"72017990000",0,0,0,0,0,0,0,0,0
"72019952201",1357,1532,15,38,825,777,2197,2347,9088
"72019952202",1131,2187,205,90,548,1422,1884,3699,11166
"72019952301",1181,1348,0,8,541,907,1722,2263,7970
"72019952302",1139,2935,32,55,1063,1168,2204,4158,12754
"72019952400",463,853,0,42,181,535,644,1430,4148
"72019952500",1378,2308,151,163,1240,1664,2769,4135,13808
"72021030101",872,400,85,0,553,416,1445,804,4575
"72021030103",1130,1003,107,73,910,865,2147,1923,8158
"72021030104",2899,206,48,35,849,76,3741,317,8171
"72021030105",1062,304,150,10,513,221,1518,535,4313
"72021030200",1869,563,88,15,605,201,2542,750,6633
"72021030300",1009,885,165,12,1335,576,2509,1473,7964
"72021030700",226,408,41,85,142,334,409,822,2467
"72021030800",635,168,10,46,144,246,784,460,2493
"72021030901",968,257,41,69,416,124,1387,450,3712
"72021030902",1283,223,57,27,480,295,1820,545,4730
"72021030903",747,400,83,12,350,183,1159,595,3529
"72021030904",826,616,61,22,397,328,1284,960,4494
"72021031004",1158,246,182,28,754,231,2023,487,5109
"72021031005",951,761,95,56,419,692,1429,1509,5912
"72021031011",2185,257,345,18,884,300,3342,575,7906
"72021031013",2654,1233,390,109,2376,1214,5405,2556,15937
"72021031021",1352,549,173,86,531,684,2029,1302,6706
"72021031023",1299,286,84,11,737,489,2120,786,5812
"72021031031",1749,476,126,143,746,789,2574,1408,8011
"72021031032",980,68,109,35,760,146,1814,249,4161
"72021031033",1404,383,182,18,1247,1007,2808,1379,8428
"72021031101",1235,470,136,66,462,382,1800,878,5429
"72021031113",2011,844,170,179,666,727,2809,1696,9102
"72021031114",945,870,182,92,388,338,1515,1300,5630
"72021031121",1389,982,253,113,167,347,1769,1427,6447
"72021031122",1356,477,121,58,526,273,2003,808,5622
"72021031123",908,672,112,93,600,367,1620,1132,5504
"72021031124",450,318,36,41,373,711,859,1070,3858
"72021031125",870,362,88,26,451,519,1409,907,4632
"72021031201",412,940,72,72,564,1208,1048,2220,6536
"72021031202",756,544,112,36,387,239,1255,819,4148
"72021031203",801,348,100,25,358,132,1259,505,3528
"72021031301",2391,806,138,209,1022,493,3551,1508,10118
"72021031304",517,293,19,0,936,760,1461,1053,5039
"72021031305",2028,576,248,154,963,580,3239,1310,9098
"72021031306",1270,270,193,104,1252,485,2715,859,7148
"72021031307",1012,211,99,39,574,366,1685,616,4602
"72021031401",1593,762,93,132,553,232,2218,1126,6709
"72021031402",823,551,119,417,510,326,1452,1261,5459
"72021031403",1168,664,145,123,258,297,1563,1084,5302
"72021031501",1076,527,229,74,452,300,1731,901,5290
"72021031502",754,460,134,84,246,270,1134,814,3896
"72021031503",790,517,135,75,263,270,1161,862,4073
"72021031611",1193,548,129,157,246,186,1568,854,4881
"72021031612",1753,1795,214,471,405,815,2363,3081,10897
"72021031621",1221,401,202,47,228,264,1651,694,4708
"72021031622",1433,501,248,45,446,467,2119,1013,6272
"72021031631",1163,520,117,64,430,247,1694,831,5066
"72021031632",1038,526,135,229,327,158,1495,913,4821
"72021031641",935,635,169,143,250,137,1354,915,4538
"72021031651",1258,662,139,32,476,263,1849,948,5627
"72021031701",1961,660,171,169,358,422,2472,1251,7464
"72021031702",1543,1371,170,88,394,552,2107,2007,8232
"72021031703",2011,750,169,20,477,198,2657,968,7250
"72021031704",2626,1183,522,136,500,183,3648,1502,10300
"72021031800",2623,1019,304,168,1055,858,3959,2041,12027
"72021031900",2873,1570,77,44,855,385,3805,1916,11525
"72021032000",429,283,20,8,218,339,667,630,2594
"72021032100",608,516,0,36,368,758,976,1310,4572
"72021032200",659,887,17,231,252,390,928,1508,4872
"72021032301",1529,445,121,20,820,242,2470,707,6354
"72021032302",574,499,186,30,493,162,1253,691,3888
"72023830101",1745,1983,50,14,575,747,2351,2744,10209
"72023830102",1848,1678,345,33,606,550,2799,2261,10120
"72023830200",2810,1609,512,48,1080,732,4402,2389,13582
"72023830300",2673,1625,84,15,690,142,3405,1782,10416
"72023830400",1695,2722,26,105,126,371,1847,3198,10090
"72023830502",1318,1845,8,0,298,663,1596,2508,8236
"72023830503",2378,2193,27,130,601,306,3006,2629,11270
"72023830504",880,1817,93,16,273,660,1246,2493,7478
"72023830603",1648,2175,0,98,512,877,2118,3139,10567
"72023830604",1244,1711,0,0,634,638,1878,2349,8454
"72023980000",0,0,0,0,0,0,0,0,0
"72023990000",0,0,0,0,0,0,0,0,0
"72025200100",4039,1471,534,56,734,571,5307,2065,14777
"72025200200",1677,1456,270,56,1128,250,3033,1745,9615
"72025200302",4203,469,254,23,652,344,5055,836,11836
"72025200303",5387,1225,573,49,1696,533,7583,1807,18853
"72025200304",2927,1577,343,75,698,151,3909,1803,11483
"72025200400",1546,594,236,156,451,75,2215,825,6098
"72025200500",2354,1953,290,201,349,262,2979,2414,10802
"72025200600",1421,1312,324,140,388,308,2133,1760,7786
"72025200700",2062,728,135,127,374,72,2554,919,6971
"72025200800",1607,798,317,149,181,74,2105,1021,6252
"72025200900",375,847,77,259,97,39,549,1125,3368
"72025201000",528,1053,104,231,129,276,761,1542,4624
"72025201200",1171,1384,123,93,160,330,1454,1807,6522
"72025201300",1672,916,65,9,99,14,1836,939,5550
"72025201400",906,1172,53,187,117,138,1076,1497,5146
"72025201500",1207,1069,63,163,93,178,1363,1410,5546
"72025201600",541,1626,150,241,77,436,744,2303,6118
"72025201700",714,824,72,233,78,136,859,1179,4095
"72025201800",1125,1147,43,205,181,342,1324,1648,6015
"72025201900",617,623,35,62,36,206,688,891,3158
"72025202000",1731,2056,71,70,150,108,1920,2234,8340
"72025202100",1621,781,135,83,142,53,1898,917,5630
"72025202200",842,514,76,136,84,104,1002,754,3512
"72025202300",1615,737,231,62,88,35,1934,815,5517
"72025202402",3951,1812,405,212,912,316,5022,2302,14932
"72025202403",1854,1302,106,16,364,103,2324,1421,7490
"72025202404",2680,1040,300,115,427,163,3407,1318,9450
"72025202500",1959,1400,119,73,255,240,2333,1713,8092
"72025202601",3269,2245,387,193,547,125,4136,2525,13427
"72025202602",3862,1978,544,346,420,215,4826,2539,14730
"72025202701",2011,1128,338,189,684,456,2999,1757,9562
"72025202702",1912,1754,149,94,961,218,3022,2058,10168
"72025202800",1391,1422,178,226,688,553,2257,2201,8916
"72027320100",717,1370,28,65,108,343,853,1721,5205
"72027320200",2205,2958,0,20,333,765,2520,3743,12544
"72027320300",3580,2623,3,27,662,898,4245,3548,15586
"72027320401",2758,1049,0,16,292,202,3050,1267,8634
"72027320402",1820,1394,36,16,412,305,2214,1681,7878
"72027320500",1644,2014,241,9,121,202,1978,2225,8434
"72027320600",2252,1633,33,43,181,546,2452,2222,9362
"72027990000",0,0,0,0,0,0,0,0,0
"72029100101",451,748,523,245,492,923,1466,1916,6764
"72029100103",641,390,476,166,584,805,1672,1361,6095
"72029100104",361,1331,291,582,632,2389,1284,4291,11161
"72029100200",646,646,244,186,294,319,1184,1151,4670
"72029100400",1472,1965,406,177,2047,1166,3914,3308,14455
"72029100502",1185,775,456,109,502,395,2134,1279,6835
"72029100503",3186,831,486,99,1183,387,4855,1317,12344
"72029100504",2305,308,470,77,637,128,3412,513,7850
"72029100601",935,656,131,27,788,407,1854,1090,5888
"72029100602",709,903,111,203,637,637,1457,1743,6400
"72029100700",1415,1083,163,66,1009,886,2587,2035,9244
"72029100800",438,375,30,0,194,277,662,652,2628
"72031050103",3263,513,313,17,274,153,3548,643,8724
"72031050105",1465,321,505,371,138,50,2083,725,5658
"72031050106",901,134,72,11,243,22,947,134,2464
"72031050107",1340,152,92,0,138,0,1479,124,3325
"72031050110",1632,417,481,268,420,314,2374,968,6874
"72031050111",938,68,83,0,55,0,1008,68,2220
"72031050211",1877,639,517,205,274,81,2659,925,7177
"72031050212",3051,1166,583,363,848,346,4466,1859,12682
"72031050221",2127,662,1121,306,477,517,3700,1471,10381
"72031050222",1111,974,892,833,372,421,2270,2228,9101
"72031050231",1015,529,675,252,366,278,1999,1041,6155
"72031050232",2175,644,737,71,1355,346,4244,1061,10633
"72031050241",1886,812,1160,227,707,243,3718,1282,10035
"72031050242",1842,921,675,304,920,141,3384,1345,9532
"72031050302",1213,255,814,497,451,163,2462,915,6770
"72031050311",1070,620,254,94,280,182,1604,896,5000
"72031050321",1713,712,553,372,371,457,2637,1541,8356
"72031050331",819,400,245,58,234,215,1298,673,3942
"72031050341",1215,860,649,823,202,453,2066,2136,8404
"72031050401",1584,414,395,99,355,129,2317,642,5935
"72031050402",3618,1935,999,1418,1802,995,6361,4348,21476
"72031050501",3646,816,1171,133,1024,127,5809,1076,13802
"72031050503",1893,661,1173,454,626,307,3692,1422,10228
"72031050504",3028,1367,1656,386,468,262,5136,2015,14318
"72031050600",1697,1076,804,653,485,364,2933,2093,10105
"72031050700",232,146,171,139,238,232,641,501,2300
"72031050803",1526,655,773,254,498,310,2797,1219,8032
"72031050811",1878,502,600,226,708,249,3169,977,8309
"72031050812",1914,920,524,367,303,163,2712,1450,8353
"72031050821",1727,612,702,220,526,364,2900,1145,8196
"72031050822",1399,581,593,362,438,93,2430,1036,6932
"72031050831",1505,980,644,431,715,336,2864,1740,9215
"72031050841",583,507,495,414,257,340,1335,1261,5192
"72031050901",2041,638,901,445,1111,553,4053,1603,11345
"72031050902",2289,694,411,413,909,388,3609,1459,10172
"72031051001",2023,950,356,181,715,351,3050,1482,9108
"72031051002",1042,827,280,395,576,403,1898,1605,7026
"72031051102",725,695,551,448,868,921,2125,2064,8397
"72031051103",2498,509,554,138,839,142,3822,789,9291
"72031051104",2160,394,618,233,346,15,3112,631,7509
"72031980003",0,0,0,0,0,0,0,0,0
"72031990000",0,0,0,0,0,0,0,0,0
"72033020200",840,950,209,275,655,992,1690,2204,7815
"72033020302",290,855,47,66,320,405,657,1326,3966
"72033020403",1879,1111,383,131,512,383,2774,1625,8798
"72033020422",680,928,68,205,260,639,1008,1772,5560
"72033020423",2169,764,214,43,651,213,2981,1020,8055
"72033020425",713,812,141,90,117,611,971,1513,4968
"72033020426",61,1209,10,211,6,627,72,2043,4239
"72033020427",192,442,0,43,81,222,273,674,1927
"72033020500",2719,543,127,27,251,93,3053,651,7464
"72033980001",0,0,0,0,0,0,0,0,0
"72033980002",0,0,0,0,0,0,0,0,0
"72033980003",14,126,0,0,0,33,14,159,346
"72033980004",0,0,0,0,0,0,0,0,0
"72033980005",0,0,0,0,0,0,0,0,0
"72033980006",0,0,0,0,0,0,0,0,0
"72033980007",0,0,0,0,0,0,0,0,0
"72033980008",0,0,0,0,0,0,0,0,0
"72033990201",0,0,0,0,0,0,0,0,0
"72035260100",4270,2231,249,47,1699,604,6169,2841,18110
"72035260201",2031,611,233,47,247,80,2511,738,6498
"72035260202",2224,1181,91,97,673,182,2949,1460,8857
"72035260300",1439,1354,34,35,340,217,1813,1606,6838
"72035260400",1768,1620,14,48,437,647,2219,2315,9068
"72035260500",1712,1541,36,152,367,762,2090,2455,9115
"72035260600",928,1696,0,96,139,348,1067,2140,6414
"72035260700",791,1226,68,19,145,382,1004,1618,5253
"72035260800",1497,950,159,73,277,179,1933,1202,6270
"72035260901",2472,691,103,0,471,82,2954,773,7546
"72035260902",1799,1582,69,81,479,463,2327,2126,8926
"72037160100",0,0,0,0,0,0,0,0,0
"72037160201",1793,1081,244,162,948,621,2976,1864,9689
"72037160202",1135,1223,127,52,713,489,1949,1764,7452
"72037160300",1443,1076,246,96,609,736,2279,1898,8383
"72037990000",0,0,0,0,0,0,0,0,0
"72039955600",2294,2680,41,0,63,76,2398,2756,10308
"72039955700",938,1979,0,0,87,9,1025,1988,6026
"72039955800",1996,2525,59,0,206,0,2234,2525,9545
"72039955900",1400,3276,0,52,146,45,1516,3345,9780
"72041240101",2540,996,161,166,671,182,3328,1344,9388
"72041240102",2440,1466,108,33,535,194,3063,1674,9513
"72041240201",1632,1579,128,61,792,369,2535,2007,9103
"72041240202",1547,1327,73,109,301,389,1921,1825,7492
"72041240300",1240,654,41,26,99,98,1367,778,4303
"72041240401",2399,908,192,18,613,401,3182,1327,9040
"72041240402",1753,1114,76,90,340,239,2169,1408,7189
"72041240500",1826,1896,115,48,336,285,2277,2229,9012
"72041240601",1884,1464,129,160,625,570,2638,2194,9664
"72041240602",2467,1247,26,172,502,263,2976,1682,9335
"72043953900",1000,1157,102,298,287,324,1389,1779,6336
"72043954000",1216,1331,94,247,287,528,1573,2106,7382
"72043954100",372,1000,52,255,217,310,636,1565,4407
"72043954200",2663,1775,78,449,558,579,3299,2803,12204
"72043954300",489,857,97,176,53,168,639,1201,3680
"72043954400",789,918,72,75,225,134,1083,1127,4423
"72043954500",2372,3097,533,262,991,1111,3896,4470,16732
"72043954600",1861,1124,305,352,845,808,3004,2284,10583
"72043954700",3533,1660,375,119,874,728,4782,2451,14522
"72045951700",1404,1859,46,279,202,708,1652,2846,8996
"72045951800",1362,1631,178,104,830,1763,2370,3483,11721
"72045951900",639,1433,0,0,100,966,739,2399,6276
"72045952000",573,830,19,77,447,430,1039,1337,4752
"72045952100",1550,1124,131,128,609,813,2266,2065,8686
"72047530100",1029,726,79,51,532,732,1640,1503,6292
"72047530200",2162,1240,54,47,1298,1658,3498,2945,12902
"72047530300",1141,1490,21,73,354,915,1516,2478,7988
"72047530400",1999,1570,57,91,1230,1751,3286,3412,13396
"72047530500",2350,3145,102,196,741,2234,3193,5536,17497
"72047530600",1229,2804,28,113,1112,1401,2369,4318,13374
"72049950500",471,321,28,54,350,333,822,668,3047
"72049990501",0,0,0,0,0,0,0,0,0
"72051540100",1189,979,168,207,203,185,1560,1371,5862
"72051540200",2363,936,407,74,156,187,2808,1074,8005
"72051540300",937,621,273,281,115,161,1325,1063,4776
"72051540400",5902,1311,408,204,599,224,6686,1723,17057
"72051540500",4063,1833,972,591,520,358,5335,2782,16454
"72051540600",2284,1348,288,593,159,328,2682,2256,9938
"72051540700",2806,2422,257,450,414,247,3459,3093,13148
"72051990021",0,0,0,0,0,0,0,0,0
"72053150102",1048,516,179,97,373,188,1600,796,4797
"72053150104",1547,1062,169,220,632,465,2193,1747,8035
"72053150200",1791,1626,339,185,604,192,2734,1970,9441
"72053150301",845,1174,187,242,525,1087,1549,2487,8096
"72053150302",678,599,158,62,279,198,1115,859,3948
"72053150400",1194,838,202,180,664,514,2020,1532,7144
"72053150500",1334,1260,176,276,630,1328,2140,2864,10008
"72053150601",938,895,56,148,582,585,1576,1628,6408
"72053150602",2109,1019,322,23,1259,681,3671,1723,10807
"72053990103",0,0,0,0,0,0,0,0,0
"72054580100",2472,3098,0,0,48,18,2520,3097,11253
"72054580200",3146,3345,0,37,40,191,3186,3562,13507
"72055960900",1518,2041,9,97,113,633,1640,2748,8799
"72055961000",671,1129,26,49,24,588,721,1766,4974
"72055961100",692,1800,109,7,247,133,1048,1919,5955
"72055961200",509,1051,46,17,34,102,589,1170,3518
"72055961300",804,1135,26,87,76,246,885,1457,4716
"72055961400",777,523,24,0,9,32,810,555,2730
"72055961500",1168,1241,0,62,199,116,1367,1412,5565
"72055990000",0,0,0,0,0,0,0,0,0
"72057270100",1602,1870,153,222,324,524,2065,2616,9376
"72057270201",1703,1342,316,371,912,1052,2931,2681,11308
"72057270202",716,1258,207,152,57,243,980,1653,5266
"72057270300",2384,2078,504,425,408,184,3296,2664,11943
"72057270400",615,1894,78,290,40,72,723,2256,5968
"72057270500",2295,1329,520,196,351,267,3166,1792,9916
"72057270600",760,1481,125,253,137,398,1022,2132,6308
"72057270700",898,758,259,421,238,266,1395,1445,5680
"72057270800",2531,3470,561,414,925,853,4017,4737,17508
"72057992600",0,0,0,0,0,0,0,0,0
"72059740101",1265,1689,14,24,89,104,1345,1798,6328
"72059740102",1243,1447,14,51,186,122,1443,1604,6110
"72059740200",2151,2536,113,56,257,342,2471,2934,10860
"72059740300",1368,1731,85,39,149,179,1602,1949,7102
"72059740400",1641,2827,130,94,262,161,2033,3082,10230
"72059990001",0,0,0,0,0,0,0,0,0
"72061040101",715,706,124,25,387,228,1225,959,4369
"72061040102",597,589,137,146,246,248,971,949,3883
"72061040103",650,665,205,111,120,635,975,1409,4770
"72061040200",2976,474,92,109,182,304,3170,868,8175
"72061040301",1378,99,26,0,89,8,1456,107,3163
"72061040302",1770,249,53,0,139,1,1881,249,4342
"72061040303",1407,148,40,10,149,73,1583,231,3641
"72061040304",3970,453,117,24,322,141,4325,605,9957
"72061040403",3964,1028,251,233,463,378,4663,1639,12619
"72061040411",3225,820,37,79,243,500,3412,1399,9715
"72061040412",1524,72,68,0,153,0,1701,72,3590
"72061040421",6329,894,584,68,769,487,7576,1449,18156
"72061040422",1637,476,165,63,141,202,1915,724,5323
"72061040432",1617,616,70,0,342,92,2014,708,5459
"72061040442",2542,202,71,28,645,188,3249,339,7264
"72061040500",2145,1068,66,26,378,349,2589,1430,8051
"72061040601",2230,1102,121,67,615,575,2966,1744,9420
"72061040602",7647,698,386,61,1040,169,8718,928,19647
"72061040700",3305,2439,411,175,1209,1207,4900,3821,17467
"72061040800",1413,1157,62,215,394,199,1869,1571,6880
"72061040900",1759,981,73,170,342,471,2159,1622,7577
"72061041000",1112,479,72,111,436,220,1578,810,4818
"72061041100",1761,1121,13,17,681,214,2418,1336,7561
"72063210100",1744,1265,380,69,313,421,2400,1755,8347
"72063210201",1181,1169,218,117,601,497,2000,1783,7566
"72063210202",3847,1863,829,713,1538,815,6214,3324,19143
"72063210300",370,697,201,232,319,279,880,1208,4186
"72063210400",1218,1413,262,302,621,253,2059,1925,8053
"72063210502",8147,1156,632,194,2157,705,10790,2000,25781
"72063210503",1179,339,223,54,322,397,1712,790,5016
"72063210504",2745,1337,732,716,856,845,4261,2869,14361
"72065310100",4107,3494,163,0,0,282,4270,3752,16068
"72065310200",2234,2479,0,50,179,73,2303,2602,9920
"72065310300",3961,2770,0,50,37,0,3998,2772,13588
"72065310400",4769,3430,1,34,187,147,4908,3611,17087
"72065310500",4739,2695,31,24,0,27,4730,2746,14992
"72065310600",2548,2968,0,0,37,29,2585,2997,11164
"72065990016",0,0,0,0,0,0,0,0,0
"72067820100",1048,702,42,14,3612,2433,4669,3125,15645
"72067820300",1317,530,150,56,1486,938,2931,1524,8932
"72067820400",403,545,0,27,467,449,870,1021,3782
"72067820500",982,278,39,18,914,256,1931,552,4970
"72069180100",1174,1197,790,429,1102,770,3056,2385,10903
"72069180201",872,548,95,220,292,87,1250,855,4219
"72069180202",1796,1194,492,118,1245,1059,3282,2358,11544
"72069180301",1025,699,398,215,684,367,2107,1260,6755
"72069180302",1291,1222,316,61,583,616,2152,1899,8140
"72069180400",1713,1469,416,282,573,680,2702,2431,10266
"72069180500",2706,1156,143,105,1134,376,3983,1637,11240
"72069180600",995,1636,137,429,401,1298,1515,3363,9774
"72069180700",1604,1273,190,114,765,1032,2559,2419,9956
"72069180800",1986,2135,158,170,979,882,3045,3173,12528
"72069180901",720,885,53,231,465,993,1225,2109,6681
"72069180902",2404,540,181,64,895,491,3392,1086,9053
"72069991800",0,0,0,0,0,0,0,0,0
"72071410100",2610,1973,75,37,661,864,3304,2833,12357
"72071410200",713,1180,125,105,218,441,1056,1718,5556
"72071410300",966,945,42,119,70,430,1004,1476,5052
"72071410401",1090,1432,149,13,447,541,1671,1986,7329
"72071410402",2210,3018,187,23,786,1106,3172,4127,14629
"72071410500",2879,2047,209,189,699,626,3753,2829,13231
"72071410600",951,2204,0,152,431,998,1349,3326,9411
"72071410701",1002,949,55,244,337,475,1394,1643,6099
"72071410702",1456,2616,167,528,893,1418,2473,4507,14058
"72071990000",0,0,0,0,0,0,0,0,0
"72073956000",1948,3349,0,0,393,154,2341,3487,11672
"72073956100",986,1381,18,108,179,178,1183,1658,5691
"72073956200",2826,3446,0,100,269,367,3095,3913,14016
"72075710102",1583,1801,210,170,960,1089,2736,3060,11609
"72075710200",1155,1294,218,304,1348,1011,2708,2609,10647
"72075710301",1576,974,281,117,725,377,2505,1468,8023
"72075710302",1572,955,98,164,1067,514,2718,1633,8721
"72075710400",445,1125,34,141,487,365,966,1631,5194
"72075710500",271,436,79,104,135,255,485,795,2560
"72075710600",894,497,108,76,150,293,1146,866,4030
"72075710700",536,517,26,67,212,413,774,997,3542
"72075710800",1981,1771,278,403,934,951,3193,3082,12593
"72075710901",1419,1390,409,415,588,1121,2416,2926,10684
"72075710902",1512,1604,336,556,709,1106,2557,3266,11646
"72075711002",594,1275,227,295,622,1033,1443,2603,8092
"72075990001",0,0,0,0,0,0,0,0,0
"72077500100",2522,2866,159,85,755,1276,3436,4102,15201
"72077500200",3030,2051,199,49,575,344,3804,2406,12458
"72077500301",3717,2115,332,44,778,1070,4827,3229,16112
"72077500302",2192,2506,149,69,806,1251,3147,3826,13946
"72077500401",2003,2164,218,69,762,832,2971,3044,12063
"72077500402",2174,1532,74,53,621,607,2869,2192,10122
"72079850101",771,1413,39,0,109,443,919,1856,5550
"72079850102",2332,2604,19,12,598,812,2949,3428,12754
"72079850200",1765,1705,84,65,575,429,2424,2199,9246
"72079850300",1172,3197,107,27,695,934,1974,4137,12243
"72079850400",994,2313,222,0,552,678,1768,2991,9518
"72079991100",0,0,0,0,0,0,0,0,0
"72081957700",1658,2469,48,9,180,257,1886,2706,9213
"72081957800",2505,3316,56,0,402,179,2935,3473,12866
"72081957900",1871,2504,0,0,88,243,1959,2747,9412
"72081958000",1123,1890,34,0,77,35,1234,1925,6318
"72081958100",881,1011,0,0,74,84,955,1095,4100
"72081958200",1312,1588,6,68,229,135,1541,1791,6670
"72081958300",460,1562,0,0,88,34,548,1596,4288
"72081958400",591,1050,20,6,110,89,713,1145,3724
"72083959700",812,1757,28,0,155,286,947,2028,6013
"72083959800",424,540,0,1,62,272,486,812,2597
"72083959900",2208,1915,0,34,191,552,2399,2467,9766
"72085190101",2339,3092,431,1040,470,689,3224,4774,16059
"72085190102",4660,2456,539,613,885,274,6067,3343,18837
"72085190201",1101,1717,339,289,124,238,1552,2244,7604
"72085190202",1227,1375,252,297,178,33,1657,1696,6715
"72085190301",2939,2682,740,718,558,616,4237,3969,16459
"72085190302",2040,2091,420,511,330,245,2790,2847,11274
"72087110101",213,160,346,840,475,718,1034,1713,5499
"72087110102",159,154,396,453,527,596,1082,1203,4570
"72087110200",92,89,199,511,194,735,485,1335,3640
"72087110301",332,391,925,569,795,1368,2052,2328,8760
"72087110302",289,258,1192,249,1376,1006,2857,1513,8740
"72087110303",1091,398,357,225,826,209,2274,832,6212
"72087110304",1263,595,542,300,799,311,2604,1192,7606
"72087110400",107,251,337,586,143,724,587,1561,4296
"72087110500",53,124,354,346,126,314,533,784,2634
"72087110600",197,111,911,640,235,312,1343,1063,4812
"72087990000",0,0,0,0,0,0,0,0,0
"72089140101",1334,772,259,193,573,685,2113,1636,7565
"72089140102",1137,878,165,32,495,691,1768,1601,6767
"72089140201",468,851,52,255,78,519,466,1556,4245
"72089140202",2400,1019,323,76,600,661,3295,1756,10130
"72089140300",1253,839,223,265,1137,1132,2513,2207,9569
"72089990001",0,0,0,0,0,0,0,0,0
"72091570100",3303,2326,179,82,502,270,3935,2649,13246
"72091570201",3235,1825,123,9,366,176,3708,2000,11442
"72091570202",1476,1019,93,13,304,156,1847,1159,6067
"72091570300",1071,1971,91,133,34,268,1187,2355,7110
"72091570400",1313,1880,26,184,20,142,1349,2169,7083
"72091570500",2680,1480,308,60,299,232,3232,1756,10047
"72091570600",1171,1542,28,87,169,87,1357,1672,6113
"72091570700",1520,2163,67,14,94,199,1681,2349,8087
"72091570800",3552,2417,169,167,242,363,3890,2842,13642
"72091990025",0,0,0,0,0,0,0,0,0
"72093960100",1196,1525,14,36,196,1111,1406,2664,8148
"72093960200",664,998,31,70,160,314,855,1382,4474
"72095951400",1925,1862,1122,1438,222,444,3269,3744,14026
"72095951500",306,742,680,995,63,278,1049,2015,6128
"72095951600",389,417,291,317,153,40,828,763,3198
"72095990000",0,0,0,0,0,0,0,0,0
"72097080100",89,244,17,51,340,312,446,607,2106
"72097080200",268,378,11,14,183,668,462,1060,3044
"72097080300",307,354,53,5,333,1240,693,1599,4584
"72097080400",175,140,45,25,153,565,363,730,2196
"72097080500",184,252,67,15,168,560,402,827,2475
"72097080600",120,154,0,17,214,1332,334,1495,3666
"72097080800",693,346,201,43,409,516,1295,905,4408
"72097080900",262,246,49,94,148,633,454,965,2851
"72097081000",121,306,0,44,131,480,252,830,2164
"72097081100",256,206,10,31,192,236,458,473,1862
"72097081200",109,1089,0,269,297,3829,406,5175,11174
"72097081300",924,352,51,9,616,366,1591,727,4636
"72097081501",707,441,9,0,853,2194,1560,2529,8293
"72097081512",1409,2126,324,393,475,754,2208,3227,10916
"72097081522",1442,233,92,23,1742,775,3134,1031,8472
"72097081601",1005,370,0,0,2801,1333,3733,1701,10943
"72097081602",465,384,18,0,1183,1808,1646,2176,7680
"72097081700",494,390,199,9,1122,1406,1788,1784,7192
"72097081800",1118,536,32,0,673,375,1785,911,5430
"72097081900",2574,1286,32,41,594,586,3184,1913,10210
"72097082001",2177,1712,253,25,1327,574,3757,2285,12110
"72097082012",1512,1046,153,32,843,359,2508,1437,7890
"72097082022",1815,1037,57,0,719,329,2496,1366,7819
"72097082102",1143,963,51,142,305,665,1499,1736,6504
"72097082103",1481,1587,98,75,295,684,1840,2321,8381
"72097082104",818,1477,25,56,560,408,1395,1916,6655
"72097990000",0,0,0,0,0,0,0,0,0
"72099420100",1519,3493,270,243,1076,701,2846,4337,14485
"72099420200",2524,2908,41,94,643,587,3180,3589,13566
"72099420301",1627,1964,98,178,250,841,1975,2968,9901
"72099420302",1786,1760,15,11,314,502,2086,2252,8726
"72099420401",1177,1502,9,0,262,312,1437,1813,6512
"72099420402",1988,2263,17,0,438,800,2443,3063,11012
"72099420500",2792,2046,24,73,770,669,3586,2694,12654
"72101955201",1686,2761,7,1,50,214,1743,2976,9438
"72101955202",1909,3493,70,0,361,227,2340,3720,12120
"72101955300",2888,3840,29,189,570,542,3487,4571,16116
"72101955401",3832,2247,37,0,265,764,4134,2953,14232
"72101955402",1788,1336,0,20,104,178,1892,1534,6852
"72101955500",789,1719,33,17,9,197,831,1933,5528
"72103170100",1687,1823,167,87,995,1147,2828,3057,11791
"72103170200",2942,2253,0,90,799,1279,3741,3622,14726
"72103170300",1358,1477,135,201,790,1389,2283,3036,10669
"72103170400",2379,3144,204,188,1231,973,3798,4305,16222
"72103990013",0,0,0,0,0,0,0,0,0
"72105520100",1908,1811,257,138,874,807,3039,2756,11590
"72105520200",1586,1988,77,9,761,835,2424,2808,10488
"72105520300",498,943,15,206,371,650,870,1794,5347
"72105520400",2145,2386,286,413,1533,1393,3944,4192,16292
"72105520500",2895,1623,175,230,1600,1184,4622,3037,15366
"72107954801",1330,1996,24,107,234,370,1570,2473,8104
"72107954802",755,858,0,0,37,266,792,1124,3832
"72107954901",1257,1535,0,92,197,490,1454,2114,7139
"72107954902",783,1023,5,0,85,315,873,1338,4422
"72107955001",1864,2256,14,89,199,417,2077,2762,9678
"72107955002",929,1039,0,110,83,297,1012,1446,4916
"72107955100",1069,1630,29,30,204,433,1302,2093,6790
"72109290100",866,1222,455,649,37,297,1358,2168,7052
"72109290200",1521,2377,785,562,660,536,2966,3475,12882
"72109290300",1020,1472,864,959,119,619,2003,3038,10094
"72109290400",819,1477,223,436,172,294,1206,2196,6823
"72109990000",0,0,0,0,0,0,0,0,0
"72111730100",1689,2704,9,68,299,486,1980,3222,10457
"72111730200",1168,921,14,8,84,88,1257,1006,4546
"72111730300",2331,3849,168,145,186,597,2685,4535,14496
"72111730400",717,1140,91,59,116,106,924,1276,4429
"72111730700",1214,2139,8,205,81,319,1303,2663,7932
"72111730800",655,678,11,23,173,85,839,786,3250
"72111990000",0,0,0,0,0,0,0,0,0
"72113070100",2291,1864,93,118,378,274,2732,2256,10006
"72113070201",754,1321,22,67,535,453,1291,1805,6248
"72113070202",399,919,10,94,158,168,543,1181,3472
"72113070300",714,1622,64,136,198,427,976,2169,6306
"72113070400",277,1202,18,300,32,560,327,2062,4778
"72113070502",1915,1430,38,19,330,403,2276,1852,8263
"72113070503",2825,1037,30,45,173,187,3002,1269,8568
"72113070513",618,1130,55,309,213,324,886,1756,5291
"72113070514",1123,1134,137,27,171,205,1431,1366,5594
"72113070522",1526,907,102,45,281,313,1892,1265,6331
"72113070800",389,936,55,106,50,176,494,1218,3424
"72113070900",335,1130,7,186,167,473,509,1789,4596
"72113071000",443,744,26,42,117,199,581,985,3137
"72113071200",567,1036,108,214,105,434,762,1684,4910
"72113071300",358,1941,83,270,130,727,553,2938,7000
"72113071401",1270,771,29,37,215,115,1504,909,4850
"72113071402",2085,1327,85,59,153,151,2323,1537,7720
"72113071500",1448,1648,60,119,252,311,1760,2068,7666
"72113071601",1453,821,95,141,97,136,1630,1098,5471
"72113071602",277,1981,27,286,151,1176,455,3401,7754
"72113071700",556,722,66,8,230,126,777,856,3341
"72113071800",365,640,89,51,45,460,499,1132,3281
"72113071900",683,2978,149,184,352,921,1184,3986,10437
"72113072000",1129,460,52,43,143,112,1313,615,3867
"72113072101",340,826,13,79,186,215,539,1120,3318
"72113072102",2403,1680,196,14,276,103,2844,1797,9313
"72113072201",1130,1104,152,190,400,559,1674,1853,7062
"72113072202",2959,869,228,110,605,243,3772,1222,10008
"72113072300",200,360,157,89,148,361,505,810,2630
"72113072400",2926,1506,104,295,928,696,3905,2464,12824
"72113072500",3984,1834,170,97,1158,457,5258,2343,15301
"72113072600",843,1712,0,0,127,614,970,2326,6592
"72113072701",1650,975,118,83,181,180,1949,1238,6374
"72113072703",2633,1736,48,62,230,311,2828,2109,9957
"72113072704",866,1428,17,85,214,475,1097,1988,6170
"72113072900",4183,1685,298,61,391,140,4828,1886,13472
"72113073001",990,1423,9,9,214,251,1199,1683,5778
"72113073002",1530,2819,13,14,396,295,1897,3111,10075
"72113073003",574,1274,15,49,99,85,688,1408,4192
"72113073004",1831,1660,46,53,311,310,2188,1998,8397
"72113073005",1865,894,138,64,122,0,2125,958,6166
"72113073006",985,1652,18,30,194,349,1197,2024,6449
"72113073008",0,0,0,0,10,0,10,0,20
"72113073009",1065,2875,42,143,235,829,1342,3847,10378
"72113073010",2160,1422,138,45,302,143,2600,1610,8420
"72113993000",0,0,0,0,0,0,0,0,0
"72115330100",2821,3034,38,192,1031,1037,3862,4263,16278
"72115330200",1400,2353,158,264,432,813,1958,3414,10792
"72115330300",1860,2313,130,124,451,741,2348,3155,11122
"72115330400",2218,2040,164,139,487,878,2869,3057,11852
"72115990000",0,0,0,0,0,0,0,0,0
"72117959400",1460,1282,64,29,920,1067,2116,2185,9123
"72117959500",1012,714,15,33,582,852,1410,1488,6106
"72117959600",2231,1620,81,0,1229,1631,3167,3114,13073
"72117990400",0,0,0,0,0,0,0,0,0
"72119130101",1916,1123,352,482,521,797,2789,2374,10354
"72119130102",2765,781,556,233,1209,80,4448,958,11030
"72119130200",721,650,152,160,244,557,1117,1367,4968
"72119130300",1344,873,359,182,612,214,2295,1234,7113
"72119130401",1415,397,295,158,1111,467,2821,1022,7686
"72119130402",1580,932,599,619,681,1060,2860,2611,10942
"72119130500",1933,1326,555,681,1157,901,3645,2908,13106
"72119130601",1107,540,90,85,727,588,1911,1197,6245
"72119130602",1025,487,200,66,650,404,1847,935,5614
"72119130701",2646,1728,474,33,1460,1448,4580,3209,15578
"72119130702",1515,1190,454,253,1287,846,3256,2289,11090
"72119992700",0,0,0,0,0,0,0,0,0
"72121960300",2978,1853,18,114,322,298,3318,2202,11103
"72121960400",2814,1803,102,88,568,194,3430,2041,11040
"72121960500",385,929,21,44,54,97,460,1053,3043
"72121960600",1428,1282,38,58,303,136,1769,1476,6490
"72121960700",1946,2105,71,106,295,378,2295,2542,9738
"72121960800",1240,1669,48,31,166,219,1454,1919,6746
"72123952600",945,1406,43,35,211,450,1199,1874,6163
"72123952700",398,804,81,283,206,447,685,1529,4433
"72123952800",1348,1864,448,695,1116,1449,2889,4008,13817
"72123952900",2815,2215,550,419,1017,1325,4382,3959,16682
"72123953000",649,597,152,307,260,583,1014,1452,5014
"72123953100",528,696,99,284,199,437,826,1398,4467
"72123953200",1282,1243,313,387,405,820,1989,2435,8874
"72123992800",0,0,0,0,0,0,0,0,0
"72125840100",1587,1926,0,26,145,424,1732,2376,8216
"72125840200",2256,2593,0,34,311,1032,2567,3659,12452
"72125840300",2414,1660,38,204,345,125,2788,1989,9563
"72125840400",2109,2623,248,78,222,739,2563,3440,12022
"72125840500",2182,1375,38,29,363,220,2534,1617,8358
"72125840600",1726,1560,39,30,332,129,2064,1719,7599
"72125840700",1862,1801,0,41,216,425,2067,2267,8679
"72127000400",475,466,33,164,85,136,587,715,2661
"72127000506",759,331,14,9,74,104,758,430,2479
"72127000600",499,486,68,111,103,59,640,640,2606
"72127000700",600,526,45,122,101,103,702,739,2938
"72127000900",1851,337,88,10,97,66,1881,391,4721
"72127001000",3203,731,96,16,221,94,3314,761,8436
"72127001100",1109,246,0,12,165,72,1168,281,3053
"72127001200",1397,190,23,29,151,48,1454,242,3534
"72127001301",157,796,171,535,27,506,355,1837,4384
"72127001302",176,2256,139,631,194,1292,496,4158,9342
"72127001400",295,380,248,100,84,183,627,633,2550
"72127001500",786,327,212,65,315,364,1283,738,4090
"72127001600",1138,223,178,55,195,27,1476,305,3597
"72127001800",1347,284,80,114,212,252,1608,629,4526
"72127001900",2880,490,103,97,183,22,3113,609,7497
"72127002002",367,252,142,166,169,195,672,587,2550
"72127002100",401,350,109,249,294,193,767,736,3099
"72127002200",432,305,120,64,237,366,783,735,3042
"72127002300",153,247,129,129,162,274,439,639,2172
"72127002400",708,418,55,91,203,304,918,795,3492
"72127002500",506,429,194,141,174,178,860,736,3218
"72127002600",461,279,217,290,213,716,891,1285,4352
"72127002800",512,468,268,142,525,635,1285,1235,5070
"72127002900",237,411,91,158,208,384,530,953,2972
"72127003000",436,260,166,215,301,346,890,821,3435
"72127003100",459,431,394,550,419,436,1272,1417,5378
"72127003200",295,498,268,249,183,348,709,1095,3645
"72127003300",379,200,138,99,321,221,838,520,2716
"72127003400",359,1014,69,213,58,423,486,1629,4251
"72127003501",497,2411,61,360,151,1234,699,3977,9390
"72127003502",469,497,35,95,228,279,732,871,3206
"72127003600",156,217,44,70,115,228,315,515,1660
"72127003700",493,1504,267,457,528,970,1288,2875,8382
"72127003800",494,194,395,447,276,545,1105,1171,4627
"72127003902",951,1264,377,159,673,497,1993,1892,7806
"72127004200",646,717,326,509,69,140,1007,1329,4743
"72127004306",170,1599,8,137,22,330,200,2066,4532
"72127004400",387,616,223,316,108,340,718,1254,3962
"72127004500",547,878,235,179,133,258,910,1315,4455
"72127004600",1386,1556,126,354,152,237,1635,2139,7585
"72127004700",1620,1563,241,200,211,388,2054,2151,8428
"72127004800",178,2026,57,191,0,641,235,2840,6168
"72127004900",551,1749,333,670,35,215,883,2634,7070
"72127005000",1527,1629,523,337,279,858,2298,2780,10231
"72127005101",832,403,217,118,95,121,1138,642,3566
"72127005102",696,558,120,172,207,321,998,1018,4090
"72127005103",505,1807,265,190,253,498,964,2479,6961
"72127005201",1289,544,460,125,350,40,2063,700,5571
"72127005202",1476,856,227,282,176,154,1850,1254,6275
"72127005204",1086,358,198,32,185,75,1457,465,3856
"72127005214",1398,994,357,317,309,366,2038,1677,7456
"72127005215",755,937,226,171,221,499,1167,1534,5510
"72127005300",1097,771,371,155,297,349,1701,1203,5944
"72127005401",3404,1066,324,119,687,757,4372,1912,12641
"72127005402",165,1022,11,173,99,395,275,1590,3730
"72127005403",2305,1702,490,678,425,548,3169,2913,12230
"72127005500",1331,884,411,430,445,667,2166,1902,8236
"72127005601",1497,652,471,143,366,161,2246,956,6492
"72127005602",1367,1345,498,475,306,284,2138,1994,8407
"72127005800",1112,634,319,63,32,158,1345,855,4518
"72127005900",444,588,104,44,92,140,640,772,2824
"72127006000",444,678,88,180,105,385,623,1237,3740
"72127006101",639,2044,180,292,101,358,896,2679,7189
"72127006102",629,423,84,51,127,170,831,644,2959
"72127006200",762,753,60,80,131,128,953,950,3817
"72127006300",2260,1158,370,54,163,156,2777,1335,8273
"72127006500",1239,337,30,21,121,5,1319,351,3423
"72127006600",527,614,85,33,87,136,691,724,2897
"72127006700",2481,732,166,35,232,53,2803,820,7322
"72127006800",2717,1007,70,102,50,190,2837,1271,8244
"72127006900",1246,598,439,537,132,98,1808,1224,6082
"72127007004",1046,649,125,58,95,107,1250,814,4144
"72127007100",906,365,666,350,236,117,1791,800,5231
"72127007300",2101,673,268,135,275,83,2620,891,7046
"72127007400",788,479,260,159,31,93,1070,712,3592
"72127007500",612,636,345,522,109,100,1066,1258,4648
"72127007600",732,424,332,385,150,90,1178,884,4175
"72127007700",929,638,684,517,102,290,1715,1445,6320
"72127007800",1782,1751,503,1242,84,236,2310,3229,11137
"72127007900",1831,512,97,68,181,11,2036,569,5305
"72127008001",1938,1016,242,487,104,139,2242,1638,7806
"72127008002",1122,1762,742,1003,45,414,1909,3148,10145
"72127008100",2445,328,63,22,97,117,2471,467,6010
"72127008201",124,1793,116,738,131,107,371,2560,5940
"72127008202",814,1192,156,205,139,93,1099,1490,5188
"72127008300",799,445,326,394,127,294,1252,1133,4770
"72127008400",2032,586,430,252,283,50,2715,888,7236
"72127008500",2190,1010,428,189,135,188,2727,1330,8197
"72127008601",1483,270,104,9,48,41,1583,320,3858
"72127008602",2363,757,92,38,184,46,2515,805,6800
"72127008603",1016,268,112,72,38,21,1146,361,3034
"72127008700",445,859,54,132,161,295,623,1179,3748
"72127008900",368,563,425,185,236,913,987,1616,5293
"72127009000",673,719,149,386,124,244,939,1335,4569
"72127009111",1551,1015,243,120,291,101,1975,1218,6514
"72127009112",1445,1236,91,300,315,203,1720,1698,7008
"72127009121",2140,996,259,73,270,250,2600,1266,7854
"72127009122",3115,961,400,181,890,309,4302,1429,11587
"72127009123",1591,312,152,0,330,67,1993,379,4824
"72127009300",722,1152,222,328,466,664,1409,2107,7070
"72127009400",918,437,145,62,317,202,1318,701,4100
"72127009601",1020,261,35,0,131,34,1134,273,2888
"72127009602",1393,316,69,55,66,33,1528,398,3858
"72127009603",1411,271,47,55,174,139,1622,465,4184
"72127009614",1373,174,28,0,123,0,1496,174,3368
"72127009624",2444,1127,75,158,568,275,3087,1496,9230
"72127009800",3807,970,91,32,422,113,4243,1094,10772
"72127009901",2894,345,158,17,121,284,3115,646,7580
"72127009902",2089,1537,376,117,568,512,3024,2162,10385
"72127009903",2989,396,130,22,389,112,3447,530,8015
"72127009904",1904,233,66,2,94,13,2039,248,4599
"72127010001",3413,1004,32,72,1024,38,4236,1084,10903
"72127010002",4281,185,67,23,647,43,4965,251,10462
"72127010012",2924,1313,119,134,798,194,3841,1641,10964
"72127010022",2223,417,131,19,466,122,2784,558,6720
"72127010032",1634,1745,233,101,669,848,2536,2694,10460
"72127010042",4111,1522,156,69,1449,670,5697,2261,15935
"72127010100",4833,1427,334,445,1246,544,6365,2416,17610
"72127010200",2176,2181,354,317,1366,468,3867,2966,13695
"72127010500",2483,684,31,32,294,93,2727,809,7153
"72127980000",0,15,0,0,0,0,0,15,30
"72127980101",0,0,0,0,0,0,0,0,0
"72127980102",0,0,0,0,0,0,0,0,0
"72127980103",29,1326,22,54,62,344,113,1724,3674
"72127980104",0,0,0,0,0,0,0,0,0
"72127980105",0,0,0,0,0,0,0,0,0
"72127980107",0,0,0,0,0,0,0,0,0
"72127980108",0,0,0,0,0,0,0,0,0
"72127980200",0,44,0,0,0,0,0,44,88
"72127980300",0,0,0,0,0,0,0,0,0
"72127990000",0,0,0,0,0,0,0,0,0
"72129220100",3499,1660,576,243,359,322,4434,2225,13318
"72129220200",972,2349,78,134,165,168,1215,2651,7732
"72129220300",405,948,27,133,39,66,459,1147,3224
"72129220401",2794,1356,362,45,527,171,3675,1572,10502
"72129220402",2594,2014,267,174,196,358,3042,2546,11191
"72129220501",1588,1579,0,100,130,235,1718,1882,7232
"72129220502",1827,1332,196,106,409,502,2432,1940,8744
"72129220600",1149,1589,18,150,128,88,1279,1827,6228
"72129220700",1967,2695,13,283,112,357,2078,3335,10840
"72131009200",298,1749,25,0,15,303,338,2039,4767
"72131958500",1495,2228,43,60,200,371,1719,2659,8775
"72131958700",1817,2245,18,114,361,375,2196,2709,9835
"72131958800",3200,2686,55,56,292,647,3523,3351,13810
"72131958900",1299,1329,0,64,164,60,1448,1453,5817
"72131959000",2124,1957,32,21,305,109,2440,2087,9075
"72131959200",2057,2912,27,0,149,372,2209,3284,11010
"72131959300",1308,2252,10,24,167,417,1485,2647,8310
"72131959500",1894,2088,39,181,122,155,1991,2424,8894
"72133953300",1898,918,288,164,683,630,2829,1712,9122
"72133953500",1138,1726,103,384,541,699,1782,2809,9182
"72133953600",2433,1255,407,514,820,772,3660,2541,12402
"72133953700",598,622,175,350,298,154,1071,1126,4394
"72133953800",1265,1810,415,171,381,1301,2061,3282,10686
"72133990000",0,0,0,0,0,0,0,0,0
"72135510101",5199,547,589,22,1717,554,7505,1123,17256
"72135510102",1705,1539,322,282,283,555,2292,2376,9354
"72135510200",4139,1334,459,498,1179,633,5728,2435,16405
"72135510300",918,1077,325,129,142,60,1385,1266,5302
"72135510400",1461,2015,86,188,475,597,2022,2800,9644
"72135510502",2711,1470,206,91,688,234,3605,1795,10800
"72135510503",5309,1165,744,131,1191,827,7244,2123,18734
"72135510504",2856,771,237,47,557,427,3553,1245,9693
"72135510505",3360,385,336,145,424,110,4088,640,9488
"72135510601",2984,812,68,113,1025,266,4045,1019,10332
"72135510602",3022,1578,64,348,1074,810,4160,2736,13792
"72135510701",1833,589,250,108,755,109,2838,806,7288
"72135510702",1578,2003,277,103,621,685,2476,2791,10534
"72137120200",1552,550,65,231,936,432,2553,1213,7532
"72137120300",934,444,119,54,384,130,1437,628,4130
"72137120400",575,180,109,31,453,66,1099,277,2790
"72137120500",717,268,169,37,312,203,1187,502,3395
"72137120600",1381,565,277,106,497,220,2155,891,6092
"72137120700",326,244,86,22,545,74,922,340,2559
"72137120800",1804,435,397,29,843,310,2934,774,7526
"72137120900",1946,482,260,80,907,503,3106,1023,8307
"72137121001",1643,453,306,114,854,195,2776,762,7103
"72137121002",1766,392,251,362,884,317,2901,1063,7936
"72137121100",621,330,209,228,1011,886,1841,1444,6570
"72137121200",458,601,144,52,1198,1302,1800,1913,7468
"72137121300",470,218,152,52,600,409,1222,679,3802
"72137121400",2114,385,254,55,1857,97,4212,537,9511
"72137121701",548,356,134,40,1205,920,1853,1316,6372
"72137121702",518,815,93,49,1817,2185,2428,3049,10954
"72137121801",1251,1798,240,160,929,1587,2420,3545,11930
"72137121802",1654,1272,245,297,809,373,2708,1919,9277
"72137121900",1086,732,201,181,441,322,1720,1235,5918
"72137122001",1674,1444,99,131,1290,527,3042,2077,10284
"72137122002",2269,391,169,0,1065,428,3503,819,8644
"72137122100",264,911,87,192,417,793,768,1896,5328
"72137122201",503,1124,14,105,716,874,1233,2103,6672
"72137122202",530,553,214,174,694,704,1438,1431,5738
"72137122400",393,533,104,242,297,335,794,1092,3790
"72137990000",0,0,0,0,0,0,0,0,0
"72139060102",2083,535,233,151,556,91,2872,763,7284
"72139060103",1326,455,250,105,397,315,1973,853,5674
"72139060104",3555,650,525,0,1365,345,5426,995,12861
"72139060211",2561,1481,471,495,325,553,3343,2529,11758
"72139060212",1621,1171,167,307,758,1078,2546,2556,10204
"72139060213",1645,366,220,0,396,0,2254,366,5247
"72139060222",2825,912,427,228,936,315,4147,1454,11244
"72139060223",1490,975,142,116,549,389,2165,1480,7306
"72139060301",3466,825,139,75,1522,300,5111,1200,12638
"72139060302",3570,1278,643,44,1818,459,6004,1781,15597
"72139060401",1363,1018,62,58,836,235,2261,1297,7130
"72139060403",2511,568,206,51,428,175,3093,794,7826
"72139060404",3270,410,288,0,526,44,4038,454,9030
"72139060501",1864,1651,277,499,504,409,2645,2551,10400
"72139060502",1284,1257,174,90,569,774,2027,2121,8296
"72141956900",1358,2323,77,134,125,306,1560,2763,8646
"72141957000",2266,2275,48,0,218,476,2532,2751,10566
"72141957100",2191,2054,62,57,303,213,2495,2307,9682
"72141957200",1752,1955,47,14,309,268,2089,2219,8653
"72141957300",1929,1393,96,63,254,142,2279,1598,7754
"72141957400",722,1593,36,7,25,168,773,1768,5092
"72141957500",908,1306,37,48,85,112,1030,1466,4992
"72141957600",1705,1348,30,0,412,190,2147,1538,7370
"72143550100",3746,2790,624,662,449,315,4739,3741,17066
"72143550200",1950,2636,67,27,229,84,2190,2743,9926
"72143550300",2501,2140,336,303,248,400,3040,2794,11762
"72143550400",1315,1978,125,222,78,432,1451,2618,8219
"72143550500",2469,1276,295,275,384,365,3066,1916,10046
"72143550601",1638,2523,160,191,372,260,2156,2947,10247
"72143550602",1494,1802,324,319,319,358,2137,2416,9169
"72143990000",0,0,0,0,0,0,0,0,0
"72145560100",1298,2015,149,66,85,24,1426,2022,7085
"72145560201",2763,1662,59,59,410,0,3190,1647,9790
"72145560204",1275,1898,0,0,93,74,1367,1833,6540
"72145560300",1959,1878,58,82,239,51,2224,1874,8365
"72145560401",1286,963,22,6,44,65,1317,983,4686
"72145560402",3216,1984,193,10,235,141,3499,2057,11335
"72145560500",882,446,17,22,9,7,864,464,2711
"72145560600",2652,3534,179,15,141,128,2805,3472,12926
"72145560701",3444,2495,90,14,434,134,3850,2396,12857
"72145560702",2748,2631,467,59,307,80,3500,2732,12524
"72145560801",1010,1671,38,19,97,0,1122,1616,5573
"72145560802",1236,2251,78,35,109,45,1401,2302,7457
"72145560900",1482,2427,33,187,170,182,1667,2684,8832
"72145990000",0,0,0,0,0,0,0,0,0
"72147950500",2082,730,357,205,873,1111,3269,2046,10673
"72147950600",1105,281,87,371,1057,871,2003,1511,7286
"72147990000",0,0,0,0,0,0,0,0,0
"72149720100",1040,1554,44,248,542,1386,1626,3188,9628
"72149720300",1655,1355,102,62,1186,1261,2943,2678,11242
"72149720400",657,607,51,12,368,378,1076,997,4146
"72149720502",977,971,54,92,430,911,1461,1974,6870
"72149720503",1363,1402,43,102,743,1029,2149,2533,9364
"72149720504",1311,870,29,13,674,970,2014,1778,7659
"72151950600",2267,2129,873,928,462,494,3602,3551,14306
"72151950700",1896,1383,379,731,250,146,2525,2260,9570
"72151950800",1230,1385,479,339,279,157,1988,1881,7738
"72151950900",1940,1857,347,849,157,195,2444,2882,10671
"72151951000",1006,991,315,260,137,43,1448,1294,5494
"72151951100",817,889,114,320,161,214,1074,1418,5007
"72151951200",909,1705,263,893,275,226,1447,2824,8542
"72151951300",1515,1785,815,771,365,209,2682,2751,10893
"72151990000",0,0,0,0,0,0,0,0,0
"72153750101",458,1420,0,68,0,199,458,1687,4290
"72153750102",1420,1870,58,104,15,273,1493,2247,7480
"72153750201",1407,1374,19,0,80,236,1491,1610,6217
"72153750202",928,2259,60,58,138,300,1126,2617,7486
"72153750300",2806,1286,76,9,150,154,3011,1435,8927
"72153750400",1235,1702,20,48,127,124,1382,1855,6493
"72153750501",3285,2230,119,78,240,189,3644,2481,12266
"72153750502",1181,601,25,4,221,90,1421,684,4227
"72153750503",919,1112,42,71,28,105,977,1288,4542
"72153750601",2884,1691,96,165,187,244,3104,2100,10471
"72153750602",581,1772,8,64,48,268,618,2104,5463
